,category_,the,and,to,a,of,i,he,in,was,it,you,his,that,she,her,on,had,with,for,said,at,but,as,him,my,not,me,they,out,is,from,up,what,be,this,have,were,all,we,one,if,like,there,no,about,when,or,so,would,then,back,them,could,into,an,by,been,know,do,just,down,don't,who,now,your,time,their,over,are,did,get,i'm,how,see,got,more,two,didn't,some,here,off,it's,man,right,way,looked,where,can,even,too,say,go,only,through,think,after,around,other,good,before,never,little,going,than,thought,which,still,again,want,something,come,old,us,head,first,door,away,well,made,people,asked,will,went,eyes,room,told,long,look,knew,tell,saw,came,that's,took,hand,much,our,face,left,any,house,why,he'd,you're,because,put,make,might,take,maybe,day,very,turned,another,nothing,he's,has,night,three,himself,new,felt,wasn't,thing,behind,its,own,while,things,looking,i'd,years,those,i'll,car,these,life,place,last,sure,always,wanted,yes,found,let,home,anything,heard,side,every,front,few,enough,same,white,hands,father,work,woman,though,can't,seemed,called,once,being,mr,next,black,couldn't,big,mother,under,men,find,against,each,until,toward,ever,sat,without,most,both,across,call,light,should,name,need,really,moment,small,stood,voice,seen,she'd,hair,open,dark,many,talk,i've,inside,everything,later,hard,five,gone,someone,dead,better,water,along,walked,feet,give,mean,keep,between,world,end,lot,oh,half,also,love,else,must,four,far,feel,kind,course,morning,gave,since,days,help,mind,done,floor,table,hear,remember,almost,street,trying,bed,already,air,pulled,says,phone,young,coming,used,tried,doing,she's,wouldn't,bad,together,okay,set,began,there's,money,girl,moved,may,yet,myself,am,part,such,held,minutes,red,close,we're,great,probably,kept,boy,herself,window,god,real,read,opened,started,believe,second,stopped,road,getting,high,children,ask,happened,past,times,leave,office,talking,body,stop,guy,full,what's,least,watched,thinking,run,sound,family,case,hadn't,outside,year,twenty,nodded,does,women,point,smiled,soon,finally,they're,whole,lost,shot,ten,kitchen,six,mouth,death,wife,sometimes,doesn't,wall,arm,hundred,shook,hours,police,bosch,word,won't,blue,dog,saying,story,yeah,turn,either,arms,brought,best,hell,school,blood,closed,living,taken,having,making,pretty,waiting,heart,ran,alone,cold,town,deep,perhaps,ago,top,hour,fact,sitting,dick,miss,business,move,line,anyone,glass,try,couple,standing,care,chair,feeling,english,fire,cut,words,dr,wrong,watch,taking,we'll,matter,sorry,number,suddenly,understand,use,rest,reached,near,everyone,idea,isn't,show,stay,book,passed,running,fine,brother,scott,city,person,job,beside,others,husband,kill,several,slowly,late,ain't,onto,known,ground,building,garp,walk,different,smile,shoulder,gun,child,hot,forward,rose,guess,working,sleep,worked,green,live,less,stared,watching,picked,war,bit,caught,killed,desk,followed,clear,minute,they'd,meant,answer,coffee,large,fingers,whatever,lay,friend,true,hollis,wait,laughed,hit,eye,died,holding,nice,sense,needed,you'll,knows,hold,sort,john,legs,short,you've,spoke,mary,except,quite,quickly,during,fell,met,actually,corner,shirt,above,elsie,horse,thirty,shit,moving,question,week,sir,neck,friends,please,exactly,often,apartment,bag,paper,reason,mrs,hope,start,straight,trees,baby,nearly,son,let's,ready,empty,liked,seat,stand,sister,sit,happy,breath,able,bring,foot,jack,low,speak,anyway,brown,country,given,eight,waited,months,fast,you'd,among,stepped,lived,middle,hurt,wind,instead,human,food,maggie,harry,afraid,leaned,looks,quiet,glanced,longer,early,church,free,nose,round,talked,gray,clothes,drive,loved,change,chest,stuff,box,dropped,sun,bar,drove,realized,windows,boys,wondered,owen,afternoon,pushed,remembered,filled,easy,beautiful,walking,returned,guys,wearing,decided,play,doctor,shut,cole,skin,truth,telling,sky,smell,edge,nobody,ahead,american,problem,sent,hung,chance,hospital,somewhere,lips,yourself,trouble,silence,pain,listen,appeared,certain,weeks,eat,wants,itself,seem,meet,lights,today,possible,clean,supposed,weren't,boat,become,covered,thousand,happen,dinner,cross,pocket,bedroom,seven,whose,captain,drink,miles,comes,somebody,teeth,none,thank,die,daughter,sign,news,became,mark,raised,river,heavy,spent,kid,attention,beyond,piece,leaving,hey,truck,south,sea,fear,wide,state,parents,themselves,showed,seeing,pay,rain,stone,lucas,crazy,evening,noticed,north,step,bright,picture,york,hall,james,v,station,touch,deal,field,ice,tree,warm,age,information,beneath,check,married,staring,s,pointed,thick,single,jesus,doors,kids,makes,tall,man's,rather,finished,company,gonna,stairs,michael,order,poor,touched,girls,added,soft,self,within,steps,whispered,worse,smoke,reading,gets,safe,bottle,wore,paul,rolled,carried,books,fbi,changed,billy,sight,damn,dress,land,surprised,power,continued,although,important,we've,beer,led,simply,fall,hotel,turning,goes,everybody,diesel,shoulders,summer,named,wrote,control,alive,third,game,figure,center,fifty,forty,especially,van,woods,pick,officer,slow,sick,questions,chris,mine,yellow,stayed,wet,tiny,throat,walls,haven't,lula,crossed,area,strong,knees,beach,learned,return,music,we'd,screen,writing,lying,flat,whether,tomorrow,closer,west,below,write,travis,stuck,broken,break,nine,laugh,law,helen,shoes,m,broke,imagine,quick,strange,forget,sounds,finger,cause,pull,bottom,worry,tight,wonder,fifteen,immediately,letter,checked,color,believed,upon,eddie,earth,dream,special,park,carefully,answered,suppose,ass,somehow,headed,thin,machine,neither,quinn,tired,dylan,lives,dogs,gold,paid,ones,he'll,playing,de,arrived,lifted,dressed,memory,history,jane,gotten,gate,fuck,shrugged,pale,chapter,private,lady,pass,threw,bought,tonight,asking,fucking,cars,space,distance,east,service,secret,wish,plastic,means,twice,ear,jacket,french,silent,porch,loud,seems,o,elliot,lie,glad,sam,suit,doubt,party,train,general,handed,conversation,joe,understood,note,whom,dry,played,usually,locked,computer,thomas,sounded,catch,evidence,parked,em,listening,colonel,seconds,store,pressed,darkness,calling,ears,older,size,paris,view,funny,marino,loose,converse,who's,lieutenant,grass,smiling,mitch,trout,c,scared,names,plan,murder,snow,bathroom,force,hardly,adam,missing,giving,security,cover,parking,detective,replied,file,nor,yard,radio,send,driving,key,grew,explain,surprise,coat,knowing,mother's,worried,tears,anymore,trust,cell,follow,paused,stories,grabbed,dirt,dollars,thanks,however,cool,father's,anybody,fight,poole,they'll,beginning,ah,dear,usual,leg,savich,scene,direction,knife,buy,public,eric,mccaleb,amy,agent,following,perfect,card,reach,personal,ella,act,huge,tape,colored,lunch,glasses,bank,houses,u,certainly,track,judge,message,ethan,expected,listened,guard,month,brain,quietly,stupid,spot,block,ate,mirror,aren't,worth,laid,hanging,forever,using,speaking,weight,simple,climbed,angry,maxine,grandmother,explained,crowd,fresh,heat,sweet,mostly,bill,pair,faces,visit,drop,dozen,driver,peter,jumped,mom,begin,lord,wood,struck,slipped,ride,takes,hat,terrible,who'd,papers,places,noise,fish,drew,meeting,cup,nature,gas,washington,wild,interest,shaking,entered,chief,helped,group,written,wine,entire,form,pants,kate,court,uncle,completely,blessed,bob,sheriff,carrying,thoughts,silver,directly,laughing,camp,village,speed,pike,letters,metal,boots,built,beat,wheel,lisa,tie,sharp,paco,unless,agreed,laura,clearly,bodies,pink,familiar,fat,ray,managed,cigarette,becca,serious,ways,rock,army,autumn,future,asleep,twelve,graham,leather,forth,dust,class,sampson,munro,narrow,slid,earlier,main,counter,shoot,studied,bent,ball,calls,hole,born,passing,heads,likely,horses,hoped,plate,marek,involved,bear,search,trip,square,learn,lit,ross,major,team,berlin,list,keeping,busy,report,apparently,breathing,pulling,e,path,shouted,accident,doc,pack,stomach,seagraves,traffic,careful,hicks,rear,calm,island,luck,drinking,mama,p,cop,placed,cassie,tea,aside,bare,franco,dad,engine,sleeping,eating,roof,slightly,putting,bet,shop,fit,pictures,osborn,offered,position,thinks,smart,notice,sex,drunk,bout,telephone,throw,expression,disappeared,allowed,wondering,ring,club,animal,folded,language,garden,till,imagined,grown,medicine,double,sweat,cried,sad,board,mad,chin,camera,victor,handle,drank,everywhere,smelled,difficult,anywhere,ward,leaves,odd,attack,mail,falling,local,pistol,t,missed,spread,forehead,college,dennis,wooden,tv,million,hill,level,bus,burned,animals,interested,palm,slept,cannot,doorway,ended,expect,lawyer,television,rich,lines,parker,considered,flight,situation,system,swung,lose,crime,remained,aware,county,page,raymond,rowan,upstairs,lecter,cops,soldiers,inman,works,cry,fool,save,peace,yards,folks,lead,ought,crying,sudden,lake,christmas,plane,rooms,pierce,naked,government,jenny,ranger,shep,pieces,carl,dying,ship,mcvey,according,couch,interesting,barely,winter,breakfast,lucy,reminded,softly,shooting,subject,kissed,moon,keys,firm,needs,weather,instant,address,prison,killing,besides,waved,present,starling,jilly,figured,sides,gaze,fired,wrapped,further,settled,cases,medical,lucky,charlie,cheek,cash,roll,easily,experience,carry,hate,trevor,spring,promise,scarpetta,voices,department,tongue,hallway,shouldn't,dangerous,opening,melissa,sunday,plenty,stick,ricky,hang,turns,happening,including,forced,apart,ryan,rifle,storm,movie,chairs,wire,happens,fun,holy,nights,garage,hearing,anger,christ,wedding,sighed,lots,worst,date,recognized,tied,soul,benton,tommy,fields,post,shape,sherlock,russian,bree,shug,birds,alevy,cleared,numbers,st,mistake,brothers,streets,nurse,dreams,mile,crew,abby,president,contact,trail,blow,gently,sink,growing,indeed,bridge,hoping,heading,lap,notes,removed,d,shower,hidden,ed,finding,marriage,study,favorite,fair,poured,mention,younger,knocked,length,spend,danny,burning,ordered,lower,belt,dirty,choice,cat,blond,evil,forest,circle,hide,hello,surface,hated,account,wear,america,guns,yelled,shock,bunch,impossible,fallen,discovered,joanna,image,kiss,forgotten,killer,begun,charge,famous,belly,showing,meat,yours,promised,rang,mess,aunt,wished,sportcoat,wake,o'clock,george,meaning,leaning,steel,alex,eventually,button,dan,officers,sofia,nervous,purpose,ceiling,possibly,suggested,drawn,pleasure,saved,fly,restaurant,students,entirely,gathered,jessica,letting,wade,orange,entrance,eleven,woke,marge,tells,particular,presence,flowers,master,deck,realize,files,grace,neighborhood,iron,fence,natural,pleased,states,occurred,normal,former,rolling,difference,gordon,agents,david,moments,shake,despite,gotta,painted,flesh,sand,song,upper,film,lock,details,bloody,backed,perfectly,taught,whenever,lawn,knowledge,kicked,soneji,finish,tracks,uh,surely,bitch,tone,obviously,snapped,federal,share,cabin,pushing,jeans,band,flying,race,bird,priest,basement,smooth,count,wound,record,yardley,tail,grand,jeep,farm,relief,military,awake,mentioned,shadows,spirit,wiped,male,mountain,escape,rising,they've,singing,airport,tank,plain,driveway,plus,row,faced,drug,boxes,weber,flew,duty,common,ancient,chicken,chain,helicopter,sixty,shed,knee,bones,base,cap,final,von,sold,wonderful,closet,necessary,screaming,where's,press,bread,shadow,push,sonia,b,fighting,dance,blew,frowned,yesterday,setting,shall,cards,san,eyed,jock,stretched,beauty,steady,taste,newspaper,parts,rode,offer,waist,envelope,twisted,problems,ast,nearby,training,don,nowhere,she'll,elevator,dining,movement,highway,appear,pool,saturday,excuse,wave,jail,repeated,solid,patient,inch,curious,vision,buried,grandma,grow,type,pat,opposite,feels,halfway,starting,mud,photographs,pages,comfortable,lovely,orders,hers,obvious,king,ocean,fixed,glance,clock,protect,buildings,it'll,served,lewis,bowl,ugly,joke,effort,sheryl,mooshum,signs,style,sands,art,ada,perry,daniel,screamed,draw,extra,soldier,lip,tough,recognize,kathy,confused,california,quit,mason,flash,desert,absolutely,burst,fourth,sell,cousin,rise,farther,approached,god's,price,library,cheeks,complete,blocks,failed,washed,handsome,star,henry,daddy,coast,german,motion,queen,frightened,mountains,fully,smith,leading,blanket,otherwise,cook,sidewalk,awful,route,crawford,sing,sake,purse,guards,broad,admit,century,ordinary,downstairs,milk,lined,oscar,march,map,video,here's,mission,student,reasons,berger,damned,fault,pressure,pw,loss,risk,intelligence,tom,physical,meany,inches,bound,sears,hurry,response,rubbed,riding,weak,danger,forgot,tony,mona,bags,deeply,backward,powerful,investigation,joined,action,ms,alley,morelli,rush,uniform,krista,plans,ends,cappy,pen,records,members,conor,distant,sergeant,spoken,license,funeral,dollar,cheese,crowded,jump,photo,rage,jungle,afterward,shepherd,concerned,scent,overhead,mental,checking,grave,pockets,tossed,bay,signed,boss,suspect,blind,packed,touching,data,bibianna,furniture,whoever,cotton,thumb,upset,fill,skip,harder,breaking,pause,bullet,staying,pine,feelings,effect,staff,weapon,lobby,assumed,murdered,mass,copy,cream,jeff,various,female,worn,cia,prepared,dragged,drugs,decide,section,tucked,witness,avenue,property,hiding,la,wanting,concrete,midnight,sheet,manner,shared,proud,match,barn,pointing,stare,shoved,clem,paint,woman's,frame,celie,rubber,truly,travel,wash,wagon,reply,clouds,weapons,refused,tables,quarter,oil,tunnel,jill,ash,collar,range,partner,hungry,pile,dumb,bother,drawer,sunlight,test,laughter,smoking,grinned,gift,dawn,briefly,correct,birth,higher,bringing,brush,battle,join,bigger,pot,soviet,stern,win,willing,mayfair,sausage,weird,breasts,birthday,merely,huh,social,driver's,brief,strength,frozen,africa,git,lab,ladies,waves,ignored,toilet,lowered,required,faded,goddamn,monkey,bite,driven,project,slave,crack,sees,central,pure,duncan,vietnam,connection,facing,swear,agree,buddy,unable,owned,indian,asks,feed,cowly,ralph,bastard,beevers,consider,bone,slothrop,lentz,professional,practice,market,slip,smaller,losing,wrist,cake,karin,easier,picking,badly,flipped,gives,energy,spotted,deeper,creek,ghost,thrown,vehicle,bow,harpo,career,stink,welcome,virginia,pam,split,tyler,cast,definitely,faint,closing,burov,fist,london,research,faster,alarm,knock,soup,photograph,equipment,angle,chinese,gear,marie,points,claude,zuk,cloth,shore,command,magic,linda,fern,spanish,salt,insisted,trunk,process,claim,boats,victim,blank,possibility,united,sheets,giant,operation,marked,cheap,regular,orleans,invisible,university,faith,series,corridor,deems,mario,ill,tip,health,stiff,enjoy,rough,favor,aircraft,site,claimed,example,pounds,caused,planned,desire,americans,described,loaded,visible,total,bars,guest,heaven,pattern,trained,current,brick,sideways,received,ellen,sang,macduff,likes,october,stars,keeps,shoe,comfort,burn,stolen,marks,mood,safety,decision,william,damp,fix,drawing,stands,purple,lift,italian,marry,target,ourselves,rules,credit,surrounded,stretch,fellow,hasn't,charles,l,clark,code,speech,vampire,drinks,suspected,embarrassed,heels,magazine,lamp,panic,lane,warning,events,detail,opinion,cost,bomb,bottles,cutting,eighty,blame,gesture,appreciate,landing,bible,eyebrows,scream,particularly,squeezed,interview,avoid,convinced,babies,pleasant,plant,legal,towel,separate,lies,shade,kick,fought,relieved,accept,enjoyed,defense,dried,wounded,theory,bench,flo,june,stage,rocks,honest,breeze,reaching,continue,eve,balls,shopping,torn,motel,chicago,emergency,strip,slammed,silk,totally,connected,hesitated,armed,national,attorney,hundreds,fed,england,bureau,horror,understanding,r,elbow,wolf,issue,insurance,cloud,freedom,trial,abruptly,instantly,paying,skirt,how's,stuffed,grab,clerk,clearing,enemy,colors,harbor,curb,photos,novel,amelia,trick,popped,attached,grip,charlotte,build,dude,trade,tower,stefan,clothing,steering,victims,mystery,period,expensive,unusual,swept,shots,gloves,haired,irish,studying,cracked,abandoned,startled,object,dolarhyde,edward,supper,golden,honey,raise,whiskey,matters,baseball,weekend,recently,bullshit,justice,piano,statue,reilly,explosion,respect,political,friendly,teacher,pickup,underhill,fairy,bell,season,samuel,source,habit,guessed,eased,lightly,hills,shifted,devil,helping,foreign,phoebe,curled,cab,fred,support,vance,jerked,joy,landed,sexual,becoming,enormous,innocent,noon,harvey,intended,glow,negro,shirts,member,exhausted,hurried,dancing,plates,writer,damage,jimmy,boston,assume,joseph,ramius,pop,wings,teach,prove,meal,fanny,families,kinds,advice,signal,spit,passenger,blown,nathan,bleeding,tore,leland,straw,shame,throwing,ruby,stranger,heavily,cared,determined,whisper,waste,guilty,creature,somewhat,searching,trousers,barrel,rounds,desperate,roberta,stella,science,missile,fog,concern,gorillas,navy,solana,lately,dishes,climb,doctors,shows,fishing,fruit,seats,owner,package,material,boyfriend,estate,rested,seriously,arranged,guests,runs,nuts,sending,underneath,refrigerator,mixed,neat,ex,eighteen,ramos,alert,background,pregnant,rid,flashed,character,enter,peered,reported,criminal,lissy,facts,recall,changing,brilliant,palms,mal,reaction,sliding,sisters,society,blinked,behavior,hunting,valley,firing,routine,castle,garbage,deirdre,suwelo,quarters,dale,acheman,blade,lean,munch,previous,threat,dim,larger,cleaning,fourteen,fashion,pity,relationship,detectives,hired,rope,progress,released,jaw,shaped,wing,stall,suffering,grateful,bug,expecting,pie,brushed,slight,mask,stream,branches,thousands,accepted,jim,sixteen,rail,skull,ya,remembering,planning,won,martin,original,friday,violence,event,false,violent,k,spun,occasionally,scattered,bullets,climbing,fuel,belonged,nettie,booth,destroyed,loudly,gary,daily,rule,oliver,reports,fuckin,flashlight,carpet,sits,im,tightly,eggs,al,sumpm,walt,sooner,stove,cute,excited,fake,angel,flies,ninety,slowed,rate,bitter,traveling,breathe,shiny,tapped,hip,seated,allow,punched,someplace,europe,announced,deputy,honor,secretary,swing,fur,lack,bud,stack,guilt,proper,counted,mills,cigarettes,rick,gentle,shining,chose,finds,pazzi,included,cleaned,ease,elefante,interior,shorts,childhood,fancy,toes,lied,games,terror,painting,feared,director,task,downtown,sometime,delivered,program,holes,print,soap,memories,slaves,neighbors,condition,juice,version,naturally,electric,grief,professor,teaching,eaten,tennis,pots,july,cats,luis,dull,waving,tour,moscow,exit,circumstances,arrest,fucked,passage,anyhow,mike,term,approach,galen,bucket,fifth,sank,dug,orso,maeve,humans,add,pray,lawyers,raw,mitchell,ticket,settle,jet,reality,vanished,directions,harold,sentence,loves,pipe,trace,pillow,relaxed,searched,elena,grin,answering,holden,movies,lonely,nerve,china,bye,unit,blowing,returning,florida,therefore,percent,prayer,degree,policeman,rare,suits,ma'am,france,starts,dock,disappear,hooked,museum,strike,unlike,focus,pretending,odor,roscani,hester,dusty,horizon,patrol,spare,lincoln,dig,one's,smells,slapped,bothered,impression,homicide,drifted,socks,shouting,newspapers,endless,learning,string,steam,alongside,fortune,contained,covering,amazing,banks,visited,los,excitement,appearance,closely,answers,located,tarrance,recent,formed,lightning,admitted,african,shift,sofa,demanded,silently,cemetery,kay,governor,respond,access,swinging,corners,wherever,switched,breathed,trucks,observed,crossing,complex,grandfather,raziel,noted,pumo,slide,thus,stones,community,border,sons,crawled,smoked,attempt,sport,wulf,pissed,witch,pilot,seventy,oak,moves,invited,silly,images,curtains,sandwich,aaron,thighs,modern,fort,meters,traveled,sugar,features,crash,roads,hips,similar,choose,explanation,avery,monkeys,crap,cacciato,cira,accent,aboard,brass,christian,arrested,remain,jersey,pad,due,switch,automatic,shotgun,tracy,lover,beating,confusion,carlotta,figures,buzz,suicide,audience,collection,sally,ripped,monday,result,paintings,tear,flower,shocked,rushed,nodding,yuri,cans,amount,treated,inner,bucks,gathering,homes,catholic,stuart,aged,chocolate,based,cave,andrew,courtyard,british,balance,acting,terry,nod,dancer,edges,joyce,afford,kidding,elmer,basket,discuss,id,deborah,opportunity,wheels,mothers,remains,dreamed,humor,railroad,kgb,bills,vera,chavez,stepping,copies,chosen,sucked,secrets,examined,miami,dropping,diamonds,andreas,cousins,stopping,egg,muscles,hollow,available,thelma,massive,powder,gorilla,grozak,anxious,release,survive,partly,hed,excellent,aisle,deserted,idiot,bored,conference,winston,gazed,deucey,remaining,extended,interrupted,dealing,tray,cabinet,backs,ditch,ideas,cooking,satisfied,suffered,swallowed,hillary,extremely,evidently,squad,breast,shown,imagination,proof,printed,vast,briefcase,dope,skinny,louder,harm,butt,southern,unknown,charged,dare,tipped,miracle,patch,rice,j,trash,remind,capable,asshole,random,pond,remote,doña,revealed,sleeve,ambulance,rows,quality,rent,soaked,statement,dermot,protection,branch,backseat,polite,jobs,wandered,hi,horrible,santa,zero,headquarters,rented,trigger,responsible,hatch,noble,suitcase,tim,offices,hannibal,filling,neatly,sigh,personally,documents,official,warned,rarely,chill,beard,begins,western,aid,smiles,media,girlfriend,direct,trusted,highly,muscle,louisa,bath,taltos,messages,provided,judgment,chase,hook,focused,resting,advantage,x,dialed,murphy,grinning,changes,suspicious,pig,dont,trap,fisher,clever,religious,cigar,selling,bike,danskin,makeup,girl's,mounted,sensed,exercise,gee,awkward,butter,doll,tale,thirteen,gather,introduced,cart,expedition,wives,terminal,jon,struggling,tent,relax,christine,treat,nearest,junk,bush,counting,tin,elbows,pace,model,patients,flow,smitty,union,courage,lungs,stained,value,planted,bushes,surrounding,pastor,monster,motor,windshield,apple,spell,krimakov,instance,circles,peculiar,buttons,channel,notebook,floating,hunter,saint,raising,height,exchange,coke,popov,pound,forms,handful,terrified,liquor,pencil,assured,muttered,walks,knocking,fairly,reporter,rubbing,swimming,laundry,emily,struggle,pete,produced,hugged,tub,useful,sipped,puzzled,glancing,impressed,struggled,stock,expert,wesley,tan,related,occasional,junior,manage,upward,created,kyle,warmth,melon,boy's,spite,corn,groups,champagne,per,washing,wrists,fenno,actual,earl,koko,embassy,boot,grade,someday,politics,songs,load,shortly,rapidly,shelf,ankles,elizabeth,collected,angeles,recalled,men's,anxiety,lifting,sticking,husband's,replaced,escaped,gus,international,august,pulse,nails,bearing,platform,instructions,intense,pressing,bits,fork,sweater,describe,brother's,vampires,fan,hood,altogether,temple,factory,religion,location,identify,occasion,pounding,curiosity,crushed,youth,machines,request,jury,le,nasty,daryl,rings,stanley,pitch,danced,glimpse,constant,wallet,nightmare,deschamps,terms,considering,confidence,fate,arrive,gravel,richmond,assistant,seventeen,comment,authority,cow,digging,academy,lynch,snake,serve,throughout,tightened,identified,catching,divorce,developed,jar,attractive,beans,hal,nana,curve,stumbled,straightened,drag,blinking,dripping,experienced,structure,floors,greatest,cups,appears,exact,plaza,curtain,sharply,separated,cardboard,occupied,shell,storage,simon,h,emerged,patted,sympathy,unlocked,destroy,carriage,scratched,alice,declared,district,spoon,strangers,rocket,latest,owe,indians,complicated,flames,draped,heel,framed,profile,roger,brand,pretend,brave,cancer,mattress,trembling,partners,success,uncomfortable,exist,decent,atlantic,backyard,informed,commander,jones,notion,rome,bolt,affair,incredible,tooth,exploded,charges,wounds,piled,senior,paraguay,belong,marine,puts,anna,pa,froze,swim,congo,responsibility,grim,bond,passengers,polished,september,pride,items,railing,fiction,reporters,confirmed,duck,attic,cottage,jannie,ability,mysterious,visiting,receiver,dieter,ted,universe,plants,creatures,trapped,upright,krendler,gripped,jewish,pills,passport,covers,scanlon,amused,healthy,steal,spine,helpless,limp,kennedy,eager,buying,troubled,narrowed,murmured,magazines,dutch,hannah,ridiculous,gang,exposed,secure,thigh,sack,arrival,mid,operations,needle,robe,journey,existed,snap,addition,argument,zone,trailer,stacked,sookie,sets,popular,angus,marsciano,spy,houston,survived,other's,nuala,tension,eva,toast,shy,retired,pouring,hunt,precisely,basic,deliver,puzzle,handled,hid,brains,bowed,sniffed,submarine,produce,greater,gut,forces,beds,painful,engaged,recovered,workers,education,delicate,attacked,sword,theater,existence,cardinal,entry,pavement,stole,sour,assigned,ford,lissie,smelling,threatened,standard,sawtooth,richard,loving,tires,leader,sweating,ashamed,slope,knelt,dragging,sealed,aloud,foolish,preferred,piss,tube,generally,phones,murders,outfit,stripped,jokes,visitors,sounding,slavery,blouse,max,drawers,robert,fever,headlights,twin,mate,clients,memorial,sunglasses,frederick,ruined,rojas,stunned,consciousness,flame,falls,furious,net,display,slim,disease,player,passion,waitress,tuesday,jean,territory,click,garp's,species,tilted,collapsed,rights,billy's,remembers,louis,conscious,footsteps,surgery,forgive,mug,port,hammer,remove,cocked,admired,rosie,web,child's,dragon,stirred,chamber,ernest,flashing,maps,handkerchief,prayed,spray,approaching,degrees,yelling,pitched,kin,helmet,parties,elegant,memphis,parlor,guy's,taxi,ringing,labor,agreement,link,patience,couples,unfortunately,services,cane,wise,el,grease,canvas,stronger,hearts,fashioned,bend,native,activity,henri,tap,beam,sized,wanna,mercy,onion,cruel,offering,meanwhile,suspicion,surveillance,happiness,candy,nineteen,snatched,electronic,vague,minds,bull,marble,thunder,chances,pinned,screw,bonner,connie,storey,compared,hauled,rescue,emotional,description,shades,acted,whipped,minister,racing,n,landscape,proved,manager,mustache,haul,ox,northern,hollywood,peering,hero,hunched,sleeves,ladder,belief,scary,noises,witnesses,swore,dresses,fucken,emotion,agency,fists,talent,fierce,institute,flung,punch,clue,slick,flag,candles,maria,nail,dreaming,people's,bore,zip,wrinkled,cage,client,recorded,neighbor,shone,writers,happily,incident,somebody's,complained,maid,ramp,talks,compound,townes,daylight,swallow,crawl,georgia,buick,insane,ankle,potts,perimeter,whispering,appointment,rat,russians,dengler,log,assuming,would've,hes,disappointed,cells,warrant,springs,personnel,imagining,sorts,francisco,kuff,objects,witches,johnston,hitting,chuckled,sale,advance,planet,johnson,albert,tense,tobacco,grounds,towels,tire,scrambled,horst,velvet,folding,reasonable,how'd,dna,contents,circled,ragged,glared,cities,feathers,customers,ours,editor,successful,clipped,beings,claims,phrase,sheer,dammit,individual,sip,jackson,wife's,darkened,holds,prisoners,shallow,screwed,sought,sports,spirits,argue,lovers,tourists,reflection,impatient,pan,dense,spilled,slipping,relatives,reckon,content,average,pulls,weeds,fond,beaten,sheriff's,precious,discover,nevertheless,frank,nurses,aimed,chewing,calmly,blankets,bernie,disaster,nursing,spartina,troops,role,register,gym,kinda,constantly,alcohol,guide,grocery,clicked,barbara,reception,comrade,filed,tune,committed,deer,permission,hug,joint,tax,ha,lighter,ending,charming,failure,contract,prints,homer,brings,dish,kicking,scars,dockweiler,praying,faintly,carley,oven,oddly,gestured,valdez,dillon,everybody's,carved,taylor,supply,diamond,moral,fingertips,gentleman,ridge,pretended,organized,absence,bark,properly,scanned,seek,politely,capital,mainly,barney,owl,crouched,drowned,shout,smashed,active,golf,badge,commercial,scholl,blast,hadley,thursday,meantime,dizzy,bartender,lesson,motioned,satisfaction,propped,texas,sheep,attitude,chasing,fled,desperately,vehicles,steep,shelves,graduate,adult,intelligent,chopper,tries,tide,ships,engines,paperwork,spending,scale,treatment,twilight,rude,sonja,wool,spots,mornings,stops,measure,hao,lid,ducked,culture,pin,ho,mexico,mcdeere,beef,charm,greasy,squinted,gerald,challenge,knowed,firmly,mere,bald,scare,construction,f,goddamned,lazy,airplane,design,poison,upside,foul,laughs,japanese,whistle,lighted,skipper,collect,youre,published,artist,vaguely,outer,antique,lounds,gentlemen,twenties,drops,ribs,cargo,stroke,dusk,wetter,taller,reputation,scarf,sin,frowning,muddy,decades,fleet,distracted,staircase,banged,sore,tissue,bum,filthy,january,enjoying,captured,chips,reflected,article,latin,entering,minor,brow,tools,sensation,shelter,indicated,pizza,remmer,rolls,glowing,motels,panel,fold,chapel,margot,provide,pit,generous,yanked,hint,dozens,margaret,elderly,boiled,suggest,crawling,emotions,ignore,vacation,specific,atlanta,compartment,shifting,referred,operating,cooked,eastern,barked,admiral,text,types,deaths,biggest,useless,suck,floated,mix,odds,francis,horn,wheelchair,drifting,underground,tracking,mexican,stool,literally,absolute,toe,powers,combat,clenched,awhile,mattered,whitey,illegal,napkin,dumped,studio,deliberately,casual,rocking,perfume,weary,perry's,wandering,johnny,vatican,heidi,systems,cliff,schuyler,swollen,towards,spinning,elaborate,cape,privacy,bat,nope,world's,grandmother's,closest,serving,kissing,believing,listed,fantasy,razor,ceremony,harsh,identity,designed,cant,chart,vietnamese,knots,overnight,day's,joxer,gradually,convince,pet,ma,ashes,rushing,peaceful,carlo,bannister,thanked,doctor's,videotape,wires,assault,westlake,lace,gravesend,explaining,langwiser,knives,crimes,cameras,dealer,crept,royal,buffalo,shattered,survival,ferry,urgent,crystal,leap,shops,repeat,skiff,responded,practically,review,device,cautiously,palace,packing,nest,depth,mancuso,uniformed,lipstick,movements,intent,sunset,cellar,scratch,ian,leads,rug,elephant,alike,sensitive,football,didnt,create,civil,candle,someone's,there'd,moonlight,carol,formal,thoroughly,hay,mount,eh,jerk,roots,salad,sixth,stacks,platoon,colleagues,equally,mumbled,laptop,beg,jason,crisp,teachers,gallery,drained,flushed,confess,tunnels,dog's,permanent,knot,remarkable,elsie's,brightly,mild,fail,lantern,instrument,bounced,believes,dump,baltimore,pier,weeping,mist,express,sub,becomes,document,limbs,twins,identical,core,corpse,protected,positive,striking,barking,ding,millions,mouths,annoyed,sketch,honestly,argued,unhappy,root,amazed,wilderness,ruth,oldest,dallas,fox,doniger,ok,nonsense,conversations,immediate,aim,dread,wednesday,snorted,regarding,evenings,ruin,guardian,miserable,schedule,delivery,owen's,manhattan,fried,safely,tangled,busted,cuffs,dressing,slumped,everything's,negroes,sticks,boring,volume,taped,wasted,streak,waking,sadness,waiter,lounge,reaches,pearl,december,campus,friendship,rocked,curse,liquid,hire,conclusion,earned,results,unpleasant,rattled,roar,winslow,hopes,potatoes,wander,ta,yep,pole,enemies,investigator,chains,fireplace,toy,swamp,completed,accused,resist,swiss,romantic,muffled,frightening,testimony,prefer,vodka,confession,computers,negative,despair,skills,appropriate,whites,influence,intention,prisoner,pee,sadly,uneasy,bugs,boulevard,delighted,rack,pigs,curved,stobrod,hats,flicked,suffer,embarrassment,newly,areas,confident,bloom,internet,dangling,nerves,jumping,personality,blocked,equal,technology,regarded,facility,affection,else's,judy,obermann,rhythm,revenge,italy,merrill,bella,addison,lifetime,reservation,tasted,souls,genius,tricks,guts,arched,ties,andy,slack,forensic,grey,ignoring,humming,that'll,tag,valuable,discussed,rape,barefoot,raced,coats,depressed,enforcement,tips,tearing,genuine,reveal,helpful,plays,nobody's,cooler,bang,wow,shivering,bust,stealing,debris,crashed,temperature,practical,concluded,meals,lambert,casually,descended,physically,recognition,concealed,cursed,stable,tops,borrowed,waters,rockets,unconscious,gum,nigger,women's,recorder,avoided,stretching,recording,spitalny,virgin,drift,scar,depends,supplies,choked,controlled,attempted,presented,resembled,tech,directed,cord,sailor,opens,agee,café,literature,visitor,fading,occasions,backwards,aye,echo,niece,chewed,palestrina,armor,slender,naval,hears,kansas,potato,rental,sez,hurting,superior,rabbit,locks,bless,granite,rounded,mayor,normally,staggered,thirties,saving,darker,observation,exchanged,disappointment,courtroom,grady,tales,analysis,clung,studies,discussion,sipping,torture,tribe,sweeping,thrust,typical,rev,year's,locate,utterly,sucking,rats,status,efforts,registered,glove,linen,february,affairs,potential,apologize,terrorist,sharing,gossip,g,thread,disgust,title,mister,extreme,harvard,rainbow,dresser,sacred,patterns,gates,unlikely,restaurants,variety,goods,coincidence,flattened,threatening,connections,poked,thats,scenes,sonar,aluminum,stores,prevent,performance,irritated,hercules,legged,frequently,greek,coughed,tina,injury,invitation,slippery,interstate,nash,surprisingly,everyone's,roses,irony,paranoid,draft,prime,civilian,da,hawthorne,gleaming,tests,advanced,saddle,practiced,monroe,begged,disturbed,laying,ups,wired,o'shea,clip,bensenhaver,hissed,wheeled,companies,satellite,lets,reduced,mistaken,dipped,melted,menu,retreat,seized,accounts,coffin,distinct,pipes,limit,banging,grabbing,containing,reference,limited,dates,unexpected,benefit,lamps,canada,radar,rifles,countries,feller,bouncing,addressed,plot,sandy,boom,ghosts,senses,possession,aft,encouraged,temporary,arguing,rank,pump,effects,zimmer,beloved,generation,tafero,via,microphone,wept,division,watches,engineer,column,shapes,weighed,buster,marched,companion,chemical,grain,couldnt,hum,shaved,bastards,deny,surprising,mirrors,suited,children's,goodbye,darling,wiping,reward,nap,lighting,stress,worrying,warn,adopted,mansion,classes,issues,established,folder,crown,handing,absorbed,begging,arveyda,trains,atmosphere,extraordinary,gazing,attended,seal,clutching,repair,kanarack,tragic,altar,glare,critical,hawk,priests,regard,dive,clarice,serial,internal,citizens,freddy,toni,possibilities,elsewhere,lasted,padded,julien,considerable,boards,stirring,servants,classic,brushing,authorities,slightest,gardens,adjusted,shakes,strangely,visits,network,germany,examine,manila,development,policemen,receive,murderer,cries,noisy,impact,throwed,sean,muzzle,inevitable,binoculars,exciting,towns,parted,flowing,passes,coins,tender,transferred,psychic,autopsy,doubted,betrayed,approval,holiday,possessed,tragedy,tubes,sweep,der,atop,discovery,burnt,stations,suggestion,cheerful,knight,lestrade,fingerprints,instructed,theirs,basically,seeking,mob,coal,angels,advised,interests,villa,wrestling,glory,checks,portrait,policy,characters,gods,bedside,citizen,fires,breaks,employees,apparent,laws,european,arrange,ritual,gain,subjects,significant,causing,marsh,tile,dodson,centuries,wishing,financial,beth,physician,saigon,battery,twisting,spiritual,substance,jews,delicious,guarded,madness,flashes,arriving,beautifully,gived,conspiracy,suite,spaces,intact,beast,countryside,fragile,farmer,bending,legend,persons,olive,crowds,jerry,lebrun,russia,seth,destruction,uniforms,foster,blonde,shine,whispers,attend,grasp,non,increased,talamasca,determine,cable,identification,knob,dolls,tourist,destiny,screams,ernie,w,tanks,investigators,terribly,instruments,players,lybarger,testing,milburn,kokoschka,illusion,motionless,plaster,ben,freezing,laboratory,roughly,helen's,rupp,harry's,layer,nation,marklin,faculty,bulb,anti,hardesty,require,toad,nuclear,innocence,presently,lust,assignment,lydia,gulf,cock,diplomatic,towers,prince,barnes,farel,noonan,merriman,submarines,alma,assistance,plantation,immense,lasher,organization,interpol,michael's,gregory,dummy,minh,committee,hardie,hampshire,brennan,terrorists,noah,glen,trung,parish,hostage,wiggin,brightling,belle,rhodes,headmaster,numerous,nuns,osborn's,hostages,killgore,rita,needham,surikov,emerald,visions,bellow,henriksen,barb,dmitriy,nancy,beatrice,cortland,antha,pökler,pointsman,tchitcherine,slothrop's,katherine,malloy,lightner,mayfairs,rowan's,curry,enzian,ellie,petyr
K01 Carrie,king,3356,2082,1317,1472,1382,669,441,941,1167,871,502,288,663,1124,1189,510,571,471,325,273,399,334,294,122,145,232,139,268,287,223,271,256,168,241,187,175,268,254,118,205,214,227,213,177,80,179,131,108,162,192,181,211,154,157,136,145,205,112,101,121,149,101,82,100,109,114,98,184,86,137,93,76,66,94,81,88,69,64,80,40,81,70,34,95,68,108,62,49,80,60,44,96,97,79,75,49,84,66,70,51,55,107,110,39,78,51,84,68,55,90,51,51,35,67,71,56,45,47,74,47,38,52,95,113,47,33,43,40,53,28,49,76,53,39,64,29,20,101,41,46,38,33,3,35,26,54,40,41,49,28,30,54,41,22,38,10,56,54,46,11,22,59,30,39,30,34,43,29,31,50,14,25,44,21,45,24,23,41,34,36,40,25,64,29,47,38,33,22,33,29,33,13,27,23,161,56,15,14,26,8,26,49,35,35,20,48,25,51,27,40,35,31,9,22,35,28,31,37,30,32,25,24,35,45,23,59,18,22,11,37,31,39,29,16,21,11,38,32,29,28,13,17,25,11,24,20,20,46,39,34,18,37,23,29,39,11,13,12,20,16,28,33,45,36,28,26,18,26,21,16,31,25,48,20,23,20,10,14,67,25,52,22,20,24,49,73,21,21,17,25,17,14,6,7,22,13,24,19,17,13,22,15,9,13,84,19,6,54,8,45,29,10,21,31,15,20,15,41,17,12,27,13,14,15,66,34,56,15,7,31,44,29,26,25,21,20,64,5,19,39,13,11,8,11,7,26,31,6,23,5,12,10,17,30,33,6,18,10,6,21,17,10,14,4,16,19,8,21,17,29,13,2,16,11,17,34,9,2,11,11,17,14,15,4,16,21,0,16,13,25,4,9,6,8,25,17,13,7,7,20,98,93,23,27,28,10,23,21,14,21,29,19,11,53,6,18,7,16,10,13,9,1,70,12,8,7,13,10,5,10,14,13,7,17,2,72,17,15,0,11,7,13,10,23,22,8,57,23,6,16,15,5,12,13,13,12,4,10,9,22,7,3,0,3,8,10,17,13,4,13,6,14,9,5,22,10,9,8,0,13,6,23,20,0,9,11,14,20,12,9,7,7,17,15,8,20,10,10,4,11,14,7,16,8,8,9,2,2,9,7,14,9,4,13,5,10,0,13,9,24,17,8,20,11,8,1,8,3,5,11,12,11,14,4,5,3,6,14,7,9,52,6,20,18,7,9,0,2,12,11,9,9,9,12,18,18,21,9,5,1,11,25,11,42,8,14,14,1,7,12,6,12,5,7,6,9,8,3,11,3,16,10,6,12,3,9,2,16,8,7,6,4,3,3,6,4,7,11,6,13,23,3,2,7,1,0,1,15,8,4,7,4,7,5,14,6,15,1,8,1,4,5,4,5,8,5,5,22,8,3,9,6,10,16,3,0,9,12,8,16,10,16,11,3,2,13,9,6,4,22,0,5,8,8,10,21,13,13,4,2,1,3,8,2,4,4,19,8,9,16,7,7,2,4,5,4,2,18,14,6,19,11,9,2,11,4,2,12,13,5,11,4,9,4,4,19,3,0,4,7,8,7,8,9,11,8,28,14,6,7,6,10,1,22,3,6,4,5,4,11,17,5,2,2,11,11,13,10,8,4,8,4,7,3,0,8,5,6,3,12,21,16,4,20,1,1,23,4,7,3,11,5,6,9,1,9,1,3,8,4,2,7,2,26,27,27,7,2,1,7,5,7,9,7,0,2,5,12,42,2,10,6,7,4,10,9,5,2,5,2,3,6,1,11,11,10,0,4,96,6,4,26,2,7,31,13,11,4,3,11,12,8,16,0,13,6,5,0,6,14,3,1,7,6,11,11,5,9,5,9,3,0,0,6,4,12,7,3,77,4,11,1,14,8,16,6,3,0,15,15,12,18,1,2,0,17,2,1,1,8,14,1,4,2,7,13,4,0,9,14,8,11,14,3,19,9,16,15,3,8,13,7,2,6,3,12,3,6,4,6,2,4,9,0,6,12,14,1,6,7,5,3,10,0,8,9,5,0,10,11,9,0,3,2,2,5,5,7,11,3,12,0,2,4,9,16,3,0,14,1,4,5,2,0,1,6,1,7,6,12,5,9,12,2,2,3,1,5,7,7,2,13,2,6,1,6,2,7,9,42,0,5,9,1,4,6,6,1,4,4,3,1,5,3,1,5,10,8,7,0,10,5,5,4,3,3,5,0,1,5,3,13,8,4,1,2,0,5,10,0,8,0,3,0,9,5,0,0,2,6,5,6,4,1,3,8,17,2,2,2,1,5,22,0,3,2,2,11,9,11,0,2,1,8,12,3,5,11,2,7,0,2,5,5,7,0,2,5,2,1,6,7,2,2,5,0,7,8,2,9,1,4,0,7,0,21,3,4,0,0,0,0,12,3,3,3,2,0,6,31,1,6,5,3,5,3,6,8,2,0,0,0,2,1,3,7,2,6,8,6,10,2,6,5,1,1,6,4,3,4,3,2,9,8,0,2,1,5,4,4,15,5,1,3,5,3,2,3,2,3,7,8,7,12,6,24,8,4,2,3,9,0,4,1,6,8,3,4,3,7,25,0,4,1,4,4,2,1,3,9,4,11,6,7,0,8,3,5,2,2,12,3,6,7,4,14,3,0,10,0,3,5,1,0,5,12,0,1,3,0,2,3,0,9,5,5,7,6,1,1,15,0,1,5,17,0,0,3,5,6,0,3,6,6,16,0,0,2,10,7,25,1,1,1,2,26,3,1,1,2,7,2,0,1,1,0,5,1,1,6,3,0,7,29,5,2,0,1,3,3,9,8,5,7,3,2,2,9,0,0,7,0,0,3,0,3,4,1,3,6,0,45,0,4,2,4,1,6,0,1,4,1,0,16,8,9,7,5,3,10,0,4,4,2,0,2,0,8,0,2,10,10,2,4,1,5,6,1,4,0,2,1,2,3,1,2,8,9,3,9,3,4,0,0,3,5,0,5,4,0,0,2,11,1,2,7,4,0,5,0,6,7,6,0,5,1,3,12,2,2,5,2,3,3,3,1,4,5,4,4,3,3,12,0,2,1,6,7,9,2,3,8,11,1,4,0,0,7,0,0,0,0,1,11,1,4,1,4,0,2,4,4,20,0,0,0,1,0,7,0,1,0,0,2,0,6,1,0,4,1,2,3,0,0,0,4,16,3,5,2,1,1,3,0,0,6,2,1,0,5,1,5,0,0,1,2,1,0,6,5,0,3,1,3,2,6,1,6,4,2,2,13,3,23,0,0,4,6,7,3,1,3,4,0,2,0,7,0,3,2,10,3,5,0,0,0,3,6,6,4,3,2,5,2,3,3,5,9,2,2,11,5,4,0,2,5,0,87,1,0,1,0,0,0,0,3,0,3,2,3,2,3,9,0,5,0,1,0,4,0,3,3,2,0,4,3,2,1,1,1,1,1,6,23,7,1,3,3,6,0,1,0,1,1,6,7,3,3,21,2,4,4,14,0,4,1,13,8,10,7,0,4,11,0,2,3,1,11,1,2,1,5,2,0,10,0,8,0,12,1,2,9,4,0,2,6,1,2,1,1,0,3,7,21,0,2,12,0,4,1,0,0,0,8,2,8,2,3,5,4,2,1,1,8,3,2,6,4,0,5,1,4,3,0,5,0,5,3,0,0,5,0,1,0,5,2,2,1,0,3,1,0,1,3,0,0,4,3,2,0,0,5,8,1,11,5,0,3,0,13,6,4,1,4,12,15,2,0,1,1,8,4,12,1,0,4,0,0,0,3,4,19,7,2,6,0,0,4,1,3,6,0,2,0,0,3,4,0,2,0,10,2,1,10,1,0,4,4,3,0,2,4,2,0,4,4,3,0,0,7,3,4,5,1,1,0,8,1,5,1,2,1,8,0,2,1,21,2,17,1,5,0,22,5,0,4,5,30,11,1,1,0,6,3,1,1,2,2,3,6,5,0,2,0,1,4,0,11,0,0,0,2,5,5,4,1,1,0,1,0,3,5,2,5,4,4,2,1,3,1,1,2,0,2,2,0,1,1,6,1,0,0,1,0,2,1,3,1,18,1,10,1,15,2,4,2,2,0,1,6,11,2,0,0,7,0,0,1,0,0,0,30,2,0,0,6,2,0,0,1,3,0,0,14,0,2,9,2,2,0,6,0,3,6,6,2,6,13,0,4,4,3,3,22,11,0,0,3,16,3,1,1,2,5,2,0,0,4,18,10,0,1,3,6,1,4,3,2,1,3,6,0,0,1,1,0,2,0,8,2,0,2,2,7,0,2,3,0,5,9,0,2,1,0,1,0,1,1,12,1,1,0,0,1,5,2,0,2,1,1,2,0,0,3,0,0,3,5,0,2,6,4,0,2,0,4,0,3,0,0,1,1,1,5,1,2,0,3,0,5,7,1,3,2,2,0,0,0,5,4,0,0,0,0,0,0,4,6,6,2,0,3,0,3,1,0,1,2,1,1,0,6,2,2,5,1,1,0,3,7,3,0,1,2,1,2,2,2,3,3,3,0,0,2,1,2,4,1,1,2,2,3,3,1,0,0,5,1,3,0,6,0,0,5,0,1,1,1,2,9,3,7,3,0,0,2,1,0,3,5,7,2,4,2,4,17,4,6,1,1,2,4,3,2,4,4,0,1,1,2,0,0,7,2,0,0,4,13,2,2,8,2,1,6,2,7,0,0,0,3,3,3,1,6,1,7,0,1,1,5,2,1,2,1,0,2,0,0,4,3,1,2,2,7,2,3,1,2,0,13,3,0,0,1,0,0,0,2,0,9,0,4,4,0,0,4,2,6,0,2,2,2,1,0,1,10,1,1,0,1,4,1,2,0,8,0,5,0,6,0,0,1,0,1,2,1,3,0,1,7,1,0,0,0,4,0,0,5,1,0,2,0,1,0,1,0,5,2,5,0,2,7,3,0,2,5,4,8,6,2,0,4,3,1,1,1,0,0,3,2,0,2,0,3,4,0,0,3,0,2,4,2,1,0,0,0,0,3,2,2,4,3,0,1,1,0,4,0,0,0,2,2,4,0,2,0,11,1,4,1,2,0,5,0,1,0,7,4,3,0,2,1,1,1,0,0,1,2,3,0,2,0,0,2,0,0,4,1,2,5,2,3,0,1,9,0,1,2,2,3,3,2,3,4,0,0,11,1,17,5,4,0,3,2,0,0,1,2,2,0,1,1,4,2,1,2,0,0,2,3,2,0,0,8,22,3,2,3,2,4,12,4,0,4,0,0,3,0,16,3,0,1,4,1,5,0,0,2,5,3,11,1,5,4,0,10,4,2,0,0,2,1,1,9,1,3,2,0,2,1,2,0,1,1,1,1,7,12,1,2,0,0,0,0,1,0,0,4,1,1,18,1,1,4,1,3,0,0,0,1,0,8,2,0,0,3,2,0,3,3,0,3,2,1,3,3,1,0,0,18,1,1,1,6,0,0,2,4,1,0,1,1,2,0,6,0,1,8,1,1,0,4,1,1,0,0,8,0,2,0,2,1,2,2,1,0,9,1,2,1,1,1,5,1,0,3,1,5,1,1,0,5,3,1,1,0,0,1,0,1,2,3,0,0,0,10,2,0,1,8,10,0,0,3,2,1,1,1,1,0,0,1,0,0,0,4,0,6,3,0,1,1,0,0,0,3,0,0,1,4,0,9,3,0,2,5,0,1,3,0,0,0,2,7,0,0,1,6,4,0,6,0,0,1,2,1,6,2,0,2,7,2,0,2,1,0,1,2,0,8,2,0,6,9,0,0,0,0,2,0,2,0,0,0,2,0,3,0,0,0,0,1,2,0,2,1,3,1,0,2,2,3,1,2,1,6,2,3,1,0,2,3,1,1,0,0,0,1,5,0,4,3,1,0,1,1,1,0,1,16,1,3,1,0,3,1,2,1,0,2,2,0,0,2,1,2,0,1,0,0,3,5,2,0,0,0,2,1,0,0,1,0,1,3,3,0,4,6,0,5,1,3,0,1,2,1,0,3,6,4,1,0,3,0,3,0,1,2,2,0,5,2,2,3,1,2,0,0,3,0,1,0,2,1,4,0,0,6,5,1,1,0,1,11,0,0,0,0,10,1,0,1,2,1,4,3,0,3,0,0,3,2,4,1,2,3,2,0,1,1,0,0,8,0,0,0,1,1,0,1,1,0,9,5,0,0,4,5,0,1,0,0,1,4,17,0,4,0,2,0,0,3,1,0,4,0,1,2,3,3,1,1,0,15,0,0,1,0,2,3,1,0,3,2,0,0,0,4,1,2,1,0,0,0,0,0,1,5,0,3,2,1,0,2,0,0,2,1,0,1,0,3,0,0,8,1,3,0,2,1,3,0,3,0,5,1,0,0,1,0,1,0,4,0,4,1,1,0,2,0,2,2,2,5,0,1,4,0,2,0,0,1,2,1,5,1,0,2,1,9,0,1,1,0,0,3,0,2,2,19,3,1,0,6,2,3,2,0,0,5,0,7,2,0,1,1,2,1,0,0,3,1,0,0,1,2,4,6,0,2,0,0,1,0,0,0,0,0,0,1,1,3,0,1,0,2,2,0,1,1,0,2,4,2,0,3,4,0,2,0,1,7,8,6,0,0,2,6,0,0,0,0,0,1,4,1,1,0,1,0,0,0,0,1,0,0,0,1,0,0,1,0,2,0,0,0,0,3,4,1,0,0,7,0,3,1,6,0,0,0,0,0,1,0,0,2,1,1,0,0,0,0,2,0,0,2,1,4,0,1,2,0,0,0,0,0,0,0,2,1,5,5,1,0,0,0,0,1,0,1,1,0,6,3,0,1,0,3,0,1,0,2,0,3,3,2,1,2,1,0,2,0,1,5,3,8,2,0,1,1,2,0,3,0,1,0,0,3,1,2,2,0,0,0,0,1,1,1,0,0,2,0,0,3,0,1,0,1,3,5,0,0,0,0,3,1,0,0,0,0,1,0,3,1,1,2,0,2,0,0,0,0,1,2,2,3,1,0,0,0,3,6,0,0,0,0,1,4,0,3,0,0,0,1,0,0,15,2,0,17,0,1,0,1,6,0,1,5,0,0,6,2,2,1,0,3,4,3,2,1,0,0,1,0,0,1,0,2,0,1,9,0,0,0,1,1,1,2,0,1,0,12,0,1,1,1,3,0,0,2,2,0,2,2,3,3,1,0,3,0,4,2,0,1,4,0,1,1,0,2,2,0,3,0,0,2,0,7,1,5,0,1,5,1,4,0,5,0,1,3,3,1,1,0,0,1,0,1,2,0,0,0,0,0,0,7,0,5,0,0,3,0,1,3,1,2,0,8,1,0,0,4,0,0,0,0,10,2,0,0,2,2,5,2,1,0,1,0,1,0,0,5,1,0,1,2,0,0,7,0,4,0,5,0,2,0,0,0,5,2,1,0,0,1,0,2,0,0,1,0,0,6,1,3,2,2,0,0,0,4,0,0,0,2,2,2,5,0,3,0,2,0,0,0,2,1,0,3,5,3,0,2,1,1,0,3,2,0,3,1,6,0,1,0,0,0,0,0,1,4,2,1,2,6,1,0,1,1,2,3,0,4,4,1,0,0,1,1,1,1,1,0,1,0,2,5,0,6,0,1,4,0,2,0,6,1,0,0,7,0,1,0,0,1,1,0,0,4,0,6,0,0,2,0,2,1,0,2,0,1,0,0,1,8,3,3,28,0,1,1,8,0,0,0,1,0,0,0,1,1,1,2,0,0,0,7,2,0,0,0,0,0,4,2,1,0,10,2,0,0,0,0,0,0,1,4,2,0,2,0,2,0,3,0,1,0,0,0,3,1,2,1,0,1,1,4,0,0,0,0,0,2,0,0,1,0,0,0,1,1,0,1,2,0,0,1,0,0,0,0,11,0,0,0,0,1,1,0,3,0,0,0,0,1,1,0,1,0,0,1,1,2,2,0,0,0,0,1,0,1,1,0,2,0,1,0,1,7,0,1,0,0,1,1,0,2,2,0,2,2,3,0,0,0,5,0,3,4,0,1,1,0,2,1,0,1,1,1,0,0,0,3,1,0,0,0,5,0,0,0,1,2,3,0,0,1,1,0,1,0,4,0,7,0,0,1,0,2,3,1,0,1,1,0,0,0,0,0,1,6,1,4,1,1,6,2,0,0,1,0,2,0,0,0,0,0,0,0,1,0,0,3,0,1,5,0,1,1,7,4,0,1,1,0,0,3,0,1,0,1,1,0,0,0,1,1,0,0,0,7,3,0,2,2,0,0,0,0,0,7,1,0,3,0,1,0,0,0,0,0,1,1,1,1,0,2,1,3,0,4,2,2,0,0,0,0,0,1,3,0,0,2,4,1,1,3,0,0,1,1,0,2,0,0,0,0,1,3,5,2,1,1,2,0,5,0,2,1,4,6,2,0,0,6,0,1,1,2,0,1,0,1,2,0,0,1,0,1,0,3,2,1,11,2,1,1,1,2,0,0,2,2,7,2,0,4,0,0,0,1,0,2,0,0,0,0,0,0,0,0,0,1,0,0,0,0,0,5,1,0,2,1,1,1,0,0,0,0,3,3,2,1,0,0,6,2,1,0,0,1,2,4,5,0,0,0,1,0,2,0,1,2,3,0,0,1,0,2,0,1,0,0,0,1,0,0,1,1,1,0,4,0,3,0,0,0,1,0,0,3,0,1,1,2,0,0,1,0,5,0,0,1,2,0,0,3,2,0,0,0,0,15,0,3,0,1,1,4,0,0,0,0,1,1,0,0,1,1,0,0,0,2,0,4,3,1,0,0,1,0,0,0,4,4,0,0,3,0,0,0,2,0,0,0,1,2,0,0,0,0,0,0,0,0,0,0,0,0,0,0,0,1,0,0,2,1,1,0,1,0,1,0,2,0,0,0,2,0,2,0,0,0,2,0,2,0,1,0,1,1,1,1,0,1,0,0,1,0,1,0,1,0,0,0,1,3,1,1,0,0,3,1,0,0,0,0,0,1,1,0,0,1,0,0,1,0,1,0,1,1,2,0,1,0,2,0,1,3,0,16,3,0,1,0,2,0,3,3,0,0,1,0,3,2,0,2,0,0,1,0,0,23,1,0,2,0,0,0,1,0,1,2,2,0,0,0,1,2,2,0,4,4,0,2,2,1,1,0,0,0,4,0,0,2,1,0,0,1,0,2,0,2,45,1,0,0,5,1,0,0,5,0,3,2,3,0,0,1,1,0,0,0,1,0,3,2,1,2,0,0,0,0,1,0,0,0,4,2,0,0,3,0,0,0,0,0,0,7,3,1,2,1,1,1,0,0,6,0,0,0,0,0,0,1,0,0,2,0,2,1,3,0,0,4,0,0,2,1,0,1,3,3,0,0,0,2,0,0,0,0,0,0,1,2,0,3,2,0,0,0,2,0,1,5,2,0,1,0,0,0,0,0,0,0,1,2,0,3,1,0,1,0,1,0,2,0,0,0,0,0,0,0,0,2,0,0,0,3,0,1,2,4,1,0,0,4,0,0,0,3,0,0,1,4,1,1,1,0,2,0,1,0,0,0,0,0,2,2,0,0,0,0,0,2,2,0,1,1,1,0,0,0,0,0,0,0,0,1,1,0,0,2,1,0,1,0,0,7,1,3,0,2,0,0,0,0,0,1,0,5,2,1,0,0,1,0,1,0,0,0,10,3,0,3,0,0,0,0,0,0,0,3,0,2,1,0,0,0,3,0,7,0,0,0,0,0,0,3,3,1,1,3,0,0,2,0,1,0,0,2,0,1,0,0,0,0,0,0,0,5,10,1,0,3,2,2,1,0,3,0,2,0,1,0,0,2,0,0,0,1,0,1,0,0,1,0,1,1,4,9,0,0,1,0,0,0,0,0,11,1,0,1,1,0,3,0,0,0,4,3,1,0,0,0,3,0,1,0,2,1,0,5,0,0,1,2,0,0,2,0,0,0,0,0,1,0,0,0,0,0,1,0,4,1,0,3,6,2,0,0,3,0,0,0,4,2,0,0,0,0,2,0,0,1,0,0,0,2,0,0,1,0,0,2,0,1,3,1,2,0,1,3,0,0,0,1,2,1,0,1,2,0,0,1,3,0,1,2,0,1,1,0,0,0,0,1,1,0,0,0,0,5,0,1,0,0,2,5,2,0,0,0,1,0,1,0,0,0,1,0,0,0,0,0,0,0,0,4,0,0,2,3,0,1,0,1,1,0,0,4,0,0,2,0,0,0,0,0,1,3,0,0,0,0,1,0,3,2,3,0,1,0,5,0,1,2,0,1,3,0,1,0,1,1,0,0,0,3,1,5,2,2,6,1,0,3,0,2,0,0,0,0,0,0,0,0,1,2,0,2,0,2,0,0,0,1,0,0,1,0,1,12,1,0,0,0,0,2,0,3,0,0,1,0,0,0,0,1,1,1,0,1,0,1,2,3,1,0,0,5,0,2,0,0,0,0,0,2,2,0,0,2,0,0,0,0,5,0,3,1,0,0,0,5,0,0,1,0,0,0,0,0,0,0,0,0,0,1,0,1,0,0,0,0,1,1,0,0,0,1,0,0,1,1,1,1,0,1,0,2,0,0,0,0,0,0,1,1,0,1,2,0,0,0,0,0,4,0,0,4,6,1,0,2,0,5,1,2,2,2,1,1,1,0,0,1,1,0,1,0,2,0,0,0,5,3,3,0,0,2,1,0,0,1,0,5,0,1,2,1,1,0,0,1,1,0,0,0,1,0,0,1,1,2,0,0,0,1,0,0,0,2,0,1,1,1,0,0,0,2,0,3,1,1,2,1,0,0,0,4,2,3,0,0,0,1,3,1,2,0,3,0,2,1,0,0,0,0,3,0,1,0,2,0,0,0,0,1,0,1,1,0,0,1,0,0,0,0,5,2,0,3,3,0,0,1,1,0,2,2,2,2,0,2,0,1,0,0,0,0,1,1,1,0,1,1,0,3,1,1,0,4,0,0,1,0,0,0,2,3,2,2,2,0,1,0,0,0,8,2,0,4,3,0,0,0,0,0,0,1,2,0,1,0,0,0,5,1,3,2,0,0,0,0,0,3,0,0,0,1,5,0,0,0,1,1,0,0,0,0,0,0,2,0,0,0,1,0,0,0,3,1,0,0,1,0,0,1,0,0,0,0,0,0,1,0,1,0,0,0,0,0,0,0,11,0,0,0,0,0,0,0,0,0,0,0,0,0,0,0,0,0,0,0,3,0,0,0,0,0,0,0,0,1,0,0,0,0,0,0,0,0,0,0,0,0,0,0,0,0
K02 Salem's Lot,king,10958,6175,3870,4556,4177,2047,3491,3355,2771,2639,1968,2574,2019,1078,1039,1531,1837,1368,977,1335,1234,936,853,982,487,774,508,922,961,781,710,1041,484,704,647,648,616,673,333,637,612,729,736,676,354,503,505,363,459,442,550,565,388,510,508,488,618,327,381,330,495,298,360,384,407,289,307,455,368,264,245,254,218,320,340,257,284,155,304,224,287,211,269,272,202,404,239,205,225,180,146,288,289,282,273,229,318,167,221,243,162,280,281,185,258,278,271,262,151,262,261,281,122,178,188,252,261,183,187,123,218,255,305,378,185,135,151,182,97,109,176,196,175,172,236,133,106,269,174,113,335,100,12,108,80,167,97,158,103,100,154,175,194,102,142,125,207,202,172,165,152,166,53,113,136,215,133,73,123,159,45,151,151,97,142,95,105,122,147,127,89,56,240,131,142,88,82,95,100,70,96,58,110,69,117,182,167,82,39,34,90,221,91,87,46,178,54,113,61,63,81,116,48,54,133,107,126,111,104,65,95,110,148,113,73,164,74,90,34,54,116,153,132,136,84,5,69,149,165,58,55,72,73,45,80,66,95,167,72,152,95,61,35,88,99,59,36,52,74,53,97,269,85,95,58,59,55,146,100,72,74,54,65,87,54,87,68,33,113,74,121,87,71,55,172,67,41,104,33,94,120,60,43,57,74,62,67,48,37,50,69,76,56,85,164,73,37,64,45,80,135,43,100,55,60,104,52,82,50,40,101,49,34,181,32,148,103,58,54,98,77,88,70,47,133,44,110,25,39,65,50,29,53,45,34,116,73,29,83,65,38,28,60,65,104,35,30,39,48,50,64,47,58,13,39,68,39,28,37,38,25,23,84,92,78,124,62,68,42,38,55,74,44,47,21,28,0,53,39,64,35,26,60,45,67,44,51,58,42,52,88,98,100,58,57,25,39,34,35,52,72,40,70,309,62,111,59,56,27,28,59,3,21,59,35,44,41,70,30,24,47,28,33,50,17,72,51,58,21,25,50,19,41,69,40,33,75,45,35,40,45,31,11,33,42,26,29,118,54,37,61,36,1,16,26,38,50,42,22,24,34,58,45,58,57,45,44,28,0,47,25,53,55,31,32,32,51,33,41,23,69,31,65,25,28,28,38,54,19,53,44,38,29,22,33,38,9,13,44,27,59,53,39,60,33,36,0,41,45,26,46,50,66,41,26,6,23,29,35,28,18,36,27,33,42,8,43,56,22,30,98,29,28,47,51,46,1,7,41,33,43,22,43,13,70,27,39,22,11,7,30,29,28,109,35,25,26,34,39,47,48,40,31,65,29,14,20,15,24,8,35,26,35,37,9,26,29,40,23,32,24,35,18,21,20,21,17,47,22,24,18,65,25,32,4,0,0,47,18,15,15,28,46,28,76,17,28,7,17,27,18,36,13,24,42,20,42,49,54,28,48,8,37,37,18,0,42,30,19,57,28,19,28,5,10,41,20,23,37,53,0,38,24,24,46,65,19,7,25,11,12,14,76,23,39,21,63,26,17,29,34,21,10,18,16,29,6,43,52,22,34,33,15,19,20,9,1,31,38,21,13,20,87,49,42,52,24,1,26,38,31,14,57,42,21,9,28,67,10,38,372,26,22,61,15,66,5,58,22,22,22,50,15,16,72,39,27,20,29,34,21,10,34,18,0,32,22,25,13,38,37,17,25,58,22,4,20,36,33,8,20,9,19,22,2,43,22,10,25,28,10,21,15,28,19,59,24,35,17,58,47,25,13,56,1,16,30,35,13,26,33,7,19,62,40,24,28,24,11,13,39,11,2,24,17,40,1,16,10,36,18,16,35,8,31,13,74,17,19,46,17,21,48,4,20,18,6,0,22,43,26,21,17,18,27,17,27,31,19,28,13,7,45,28,3,51,36,17,0,15,44,6,27,17,59,31,19,0,23,27,41,31,4,3,13,13,8,23,24,39,28,3,38,21,20,40,26,1,11,42,31,54,26,11,0,11,28,32,10,15,31,10,28,25,7,22,16,11,11,25,17,17,24,17,23,12,18,0,25,38,10,43,24,18,43,13,17,7,37,4,26,0,14,1,18,7,14,14,22,22,23,6,19,20,22,19,13,1,33,22,8,22,33,23,3,11,12,45,30,43,8,12,18,25,12,22,17,14,11,25,11,17,10,16,6,30,35,9,45,13,0,19,17,0,15,19,11,6,15,13,14,17,11,16,11,30,13,13,31,0,2,17,23,0,22,18,14,0,9,44,23,66,19,20,19,4,0,17,40,0,13,1,10,0,32,28,0,1,11,36,6,2,15,66,16,29,28,0,9,20,1,23,15,1,5,2,18,14,15,16,27,17,15,11,19,27,27,20,14,16,10,8,11,13,48,15,22,27,31,17,17,26,12,9,7,0,17,26,9,26,8,14,0,22,8,16,13,12,0,0,2,10,19,14,2,16,7,0,21,52,9,13,15,16,18,31,8,22,5,3,2,0,5,10,5,23,23,22,20,10,5,6,16,11,18,14,21,9,9,20,20,14,8,6,0,2,4,10,18,12,22,12,41,11,20,13,20,20,10,4,23,24,25,25,51,55,31,15,6,10,16,2,30,19,25,14,25,9,16,8,31,4,23,13,9,16,3,4,6,18,22,9,17,21,3,4,16,16,8,4,22,11,25,19,15,5,1,37,13,0,14,7,10,19,27,17,0,8,28,0,15,24,0,9,19,8,19,18,6,3,36,0,19,12,22,9,14,4,11,21,0,7,19,36,21,0,0,12,16,8,18,11,10,2,23,6,8,20,9,11,13,8,0,11,13,0,6,10,11,13,16,3,22,1,3,2,0,4,11,5,8,15,15,14,32,19,9,13,14,12,16,0,3,14,0,5,25,7,6,20,1,21,3,9,0,9,5,21,0,11,11,27,13,17,31,16,18,31,11,14,0,12,12,6,3,8,14,23,1,34,18,21,34,13,9,25,11,9,13,3,3,2,3,18,6,13,22,38,6,23,20,19,3,0,15,10,5,5,4,7,4,19,19,19,5,16,31,11,14,11,15,25,8,0,20,29,11,66,15,36,27,6,7,9,28,12,9,8,5,4,6,14,23,8,12,5,8,6,19,8,4,20,14,25,8,1,0,54,0,3,3,0,14,19,8,10,9,3,26,18,26,11,23,2,1,0,11,1,17,5,0,0,0,10,20,9,2,0,19,1,8,6,24,10,0,13,35,4,18,6,10,15,9,8,14,15,5,4,6,4,11,11,0,0,4,17,9,2,12,31,14,11,11,5,9,13,11,18,15,10,7,16,0,13,7,0,8,9,25,8,6,4,12,0,28,4,12,0,12,7,10,6,10,7,0,3,8,15,12,15,10,7,31,12,9,10,8,45,4,19,4,8,9,9,11,17,0,1,6,12,16,0,1,0,0,7,0,4,2,17,3,1,16,19,23,13,4,0,3,3,6,18,24,16,14,20,6,4,1,15,6,4,19,7,8,18,5,5,12,5,14,15,13,3,22,15,10,102,12,1,11,10,14,1,5,2,55,4,11,9,14,11,5,6,13,5,5,11,14,8,18,24,10,0,13,17,20,4,41,10,5,21,12,9,4,6,12,5,14,8,0,21,28,14,11,14,22,0,7,6,0,1,0,13,9,10,8,5,34,9,3,8,0,8,8,5,0,7,1,10,3,26,18,2,4,9,12,9,26,1,5,0,5,1,17,8,21,13,5,10,6,4,8,4,1,0,5,10,10,6,2,11,35,5,5,19,1,32,0,12,19,13,3,2,14,11,22,0,10,14,2,14,12,10,6,18,2,4,1,7,8,11,12,5,10,34,14,8,13,8,4,0,5,7,0,8,19,1,17,12,49,3,10,3,1,4,23,12,6,1,6,10,28,4,6,14,1,15,0,16,3,14,20,5,13,2,14,7,9,44,6,6,23,0,16,9,18,12,25,17,10,15,33,12,0,11,8,24,10,3,12,1,25,3,1,6,0,13,6,29,15,4,7,3,6,9,11,33,2,0,2,0,0,5,9,3,8,13,4,2,22,15,6,11,6,7,11,8,8,11,5,23,0,14,5,7,0,2,7,3,4,0,13,6,23,7,9,6,8,4,8,12,25,1,13,4,7,1,9,12,13,12,0,0,12,4,0,14,0,3,11,52,10,4,0,9,5,1,0,4,3,9,1,10,3,2,14,2,6,6,18,0,6,15,11,20,23,16,4,6,18,5,4,28,2,2,4,12,4,31,3,11,7,14,7,4,2,3,50,17,0,3,12,2,1,2,5,5,10,29,14,10,0,5,5,1,4,1,6,4,0,17,3,11,0,3,5,1,1,11,0,8,8,3,14,10,8,6,16,4,4,21,0,10,8,26,3,0,6,4,0,1,0,6,11,0,6,3,0,7,2,2,0,14,0,16,3,20,13,3,3,10,1,8,3,4,2,4,3,17,13,4,37,5,6,6,6,3,23,10,6,2,2,0,12,2,4,15,4,12,0,6,6,14,0,5,9,5,4,1,1,6,7,5,9,7,20,0,3,2,8,0,8,14,5,5,16,11,0,39,3,10,3,8,6,13,36,8,4,2,10,12,9,3,4,0,17,4,10,0,16,1,1,10,4,4,13,1,8,11,33,17,2,0,15,11,2,12,7,15,2,3,11,10,13,22,11,8,2,5,11,4,6,3,3,3,5,5,5,9,0,0,16,5,0,0,5,5,5,3,2,13,11,7,13,16,0,0,0,12,9,2,4,4,1,27,25,1,6,9,0,1,11,6,13,6,0,8,8,0,5,5,19,15,7,6,5,4,0,10,8,0,6,5,0,0,2,4,3,9,7,5,7,1,0,9,11,13,2,3,0,3,7,1,22,23,1,3,0,5,8,8,0,0,20,0,16,2,28,8,0,10,4,4,4,3,8,2,3,0,9,2,2,1,7,1,0,8,0,14,7,0,0,4,5,4,13,8,2,0,3,17,10,3,6,4,4,12,15,7,0,4,3,23,7,5,0,0,3,6,5,2,8,8,14,0,1,2,0,6,9,4,0,1,4,11,9,9,7,16,13,6,4,5,7,3,6,0,4,0,3,21,6,5,8,11,5,5,23,3,4,2,3,2,4,6,7,7,8,2,0,3,4,5,3,7,9,15,6,33,7,0,3,5,30,3,11,1,11,12,13,6,6,11,5,4,2,4,1,11,8,6,3,4,1,6,10,8,53,7,9,4,3,6,2,10,3,1,8,1,7,8,3,2,5,8,6,3,5,2,11,2,0,7,2,6,6,12,5,6,1,5,7,8,8,0,2,2,6,5,7,3,17,1,2,0,1,4,15,3,36,12,19,10,3,5,8,6,0,2,2,8,2,4,6,7,6,2,3,2,3,1,7,2,19,0,8,7,4,19,0,2,1,4,2,0,0,4,2,3,17,2,5,22,1,7,2,3,1,11,3,10,3,0,2,10,9,9,5,1,0,4,7,3,2,1,4,1,0,5,3,0,6,11,10,0,4,12,8,0,4,1,4,2,13,2,14,16,3,4,0,10,6,4,6,0,13,0,1,2,8,2,5,14,0,5,45,0,4,4,1,4,5,6,23,4,323,23,4,1,0,5,5,2,6,5,1,3,5,2,0,12,3,3,0,7,5,0,6,6,5,2,23,17,3,5,5,6,3,7,1,3,3,10,4,3,0,0,5,0,2,2,0,2,0,13,2,5,1,11,4,1,1,8,2,1,1,6,7,7,5,1,5,10,7,8,4,11,13,3,10,0,0,9,6,6,20,2,9,9,6,0,0,3,4,4,5,4,0,13,5,0,2,3,0,1,4,2,5,1,7,0,0,8,0,0,19,4,0,9,1,12,5,6,14,3,6,3,1,3,15,5,1,11,7,4,0,3,1,1,1,3,8,2,8,22,6,3,5,7,10,2,16,0,10,1,4,1,18,13,3,3,8,1,5,2,0,3,1,4,3,3,0,20,3,2,1,8,5,0,2,0,30,9,3,0,13,4,1,0,1,4,19,5,6,5,4,10,5,5,5,10,8,3,3,8,5,1,11,7,7,2,1,6,1,2,2,4,12,1,7,0,3,5,1,11,0,13,14,0,5,0,2,3,8,0,3,3,8,11,5,2,2,25,4,1,0,2,7,2,2,2,6,7,1,9,1,1,19,3,2,5,13,4,1,5,8,3,0,5,1,0,10,4,1,0,4,2,0,0,9,2,122,4,3,0,1,4,4,10,0,0,1,7,11,0,7,0,7,5,0,11,3,4,11,1,1,11,6,8,9,2,0,9,5,0,7,3,6,2,0,2,5,1,5,3,3,9,5,0,5,1,2,1,3,0,8,16,0,4,5,1,2,18,0,0,19,12,3,5,0,3,6,4,5,5,7,0,9,1,1,11,9,3,1,1,0,3,6,5,17,1,8,5,12,5,12,1,4,0,6,11,2,8,1,6,4,6,7,19,1,1,0,0,1,22,5,3,1,4,5,3,2,8,0,7,0,3,6,12,7,4,9,18,7,3,2,0,1,5,1,8,3,1,12,4,6,3,4,0,9,6,0,0,1,3,11,12,17,3,8,1,1,0,0,3,0,0,3,0,8,4,3,4,6,4,4,6,1,14,1,4,12,5,0,4,2,4,2,4,1,12,14,12,4,4,5,9,2,4,0,11,6,3,7,5,5,1,25,0,3,10,2,0,0,0,2,2,2,1,1,2,4,0,5,1,0,6,9,1,0,2,8,4,1,9,7,9,0,8,0,0,8,7,2,8,8,7,0,4,3,0,2,4,4,18,9,3,0,4,2,0,0,4,3,1,3,0,14,6,24,3,0,0,0,2,0,1,1,5,4,9,2,3,2,5,3,4,1,9,0,12,0,2,15,5,2,5,3,3,5,6,0,1,3,7,10,12,1,13,3,0,11,2,3,4,1,1,2,3,2,0,0,3,3,3,3,6,1,5,1,0,2,4,7,10,2,10,11,19,0,1,0,2,2,2,3,0,4,0,2,0,13,27,11,2,0,2,5,3,5,1,6,13,3,2,0,2,6,0,3,8,0,3,0,1,0,5,4,10,3,5,3,4,10,0,17,3,0,5,0,10,0,1,7,1,4,1,0,1,8,7,6,2,1,0,3,5,4,12,2,3,4,2,2,1,0,6,1,4,0,0,2,7,8,1,8,7,0,7,6,3,0,1,3,6,4,4,9,9,4,2,10,8,3,1,3,0,4,7,12,5,2,4,4,2,1,2,4,0,2,1,16,4,1,9,6,9,4,30,3,9,5,2,4,5,6,0,7,3,8,1,2,1,3,5,1,3,6,6,1,0,5,1,3,3,1,20,0,0,3,0,15,15,4,0,0,2,2,4,0,3,0,0,0,3,7,5,3,1,7,8,8,13,4,0,2,2,0,5,1,4,3,5,8,10,0,1,10,7,7,3,2,3,2,5,4,6,2,8,6,22,7,5,4,4,0,1,3,0,8,4,4,8,2,2,4,3,0,12,0,5,6,1,6,5,4,8,13,0,6,3,4,3,2,8,0,3,5,4,2,7,6,0,0,3,9,1,7,3,3,0,3,2,2,7,9,0,5,8,3,8,7,2,0,0,8,5,4,1,1,1,5,10,1,2,7,2,7,0,7,2,2,2,10,3,0,7,0,1,4,7,1,3,7,2,0,0,5,1,1,1,2,0,4,3,2,7,2,25,1,3,9,5,4,3,11,5,1,0,1,1,8,2,0,1,4,2,5,5,2,0,0,0,4,0,0,3,2,0,2,8,4,1,4,16,5,9,4,6,0,1,3,8,3,0,0,4,3,4,0,0,4,0,4,4,4,0,10,4,5,0,7,0,6,4,4,1,6,5,1,6,7,2,1,10,8,1,0,0,1,5,0,4,2,2,6,1,7,4,3,6,3,3,3,1,14,5,0,5,0,0,0,2,2,0,4,0,3,56,2,3,5,2,3,8,2,3,1,2,2,5,3,2,0,2,5,4,4,5,5,1,2,3,4,3,6,0,1,4,0,7,6,3,11,0,2,0,5,5,1,0,5,0,7,1,7,2,2,4,6,4,14,6,0,1,3,3,1,2,2,4,3,1,13,0,9,0,3,18,11,10,4,0,1,4,3,0,3,0,8,8,7,14,0,2,3,1,5,3,2,6,11,0,0,5,0,1,3,9,3,1,2,0,5,9,0,6,0,0,45,2,15,1,0,1,11,0,3,4,0,3,1,2,0,7,2,6,2,3,0,0,2,2,0,5,4,0,2,0,5,4,1,3,1,12,3,8,2,5,4,3,3,5,17,1,3,0,9,20,2,0,5,0,5,5,1,4,0,0,3,4,8,0,4,4,2,3,2,1,1,7,0,0,0,2,1,2,1,4,16,2,3,1,2,11,0,5,0,2,8,0,7,5,10,4,7,0,4,10,2,11,5,0,1,0,4,1,6,4,3,0,4,4,0,3,7,3,0,1,6,0,10,0,4,4,2,1,1,17,7,1,2,3,1,0,5,0,0,0,24,6,17,0,9,6,6,0,0,3,0,22,0,0,1,1,0,0,1,1,2,3,1,1,0,1,0,1,3,0,2,8,7,7,0,0,0,1,6,1,0,5,4,0,3,5,3,2,1,2,2,8,6,4,3,2,2,3,4,2,1,9,2,0,0,0,1,4,9,7,4,1,6,2,3,2,5,3,1,11,2,0,2,0,15,7,7,1,1,4,2,1,0,9,0,5,2,2,8,4,3,4,8,5,0,3,2,0,0,1,5,0,1,0,4,0,0,11,1,2,0,0,1,2,3,2,0,1,3,1,5,4,6,4,3,1,9,0,2,3,0,0,3,6,0,3,15,8,0,0,0,3,0,3,2,6,4,1,0,1,2,3,3,1,1,3,4,0,1,0,0,5,2,1,9,3,1,2,1,0,3,0,9,1,0,1,1,0,2,9,5,5,0,2,12,3,0,2,3,1,5,4,3,0,6,1,0,1,0,1,0,6,2,0,5,1,5,2,2,0,2,1,0,5,0,1,0,4,1,4,2,0,2,0,7,3,15,3,5,0,5,1,3,1,8,5,5,5,2,7,4,0,1,0,14,2,7,6,9,0,8,0,4,2,1,5,1,0,2,2,3,2,11,4,4,0,2,0,3,2,0,0,1,4,1,1,3,7,4,6,0,2,14,4,5,0,2,0,0,0,10,1,2,2,2,0,1,11,0,5,3,0,0,8,4,4,8,4,0,4,0,0,0,3,4,0,1,2,2,0,1,2,2,3,2,11,1,1,0,3,8,0,9,1,0,1,3,3,4,5,3,1,3,2,2,0,1,1,5,0,7,5,5,0,0,0,5,6,0,0,0,0,0,2,0,5,2,1,1,4,3,1,0,6,1,1,1,2,3,2,1,8,2,0,3,2,0,3,7,8,0,0,2,4,0,2,2,2,0,0,3,3,0,12,0,0,0,0,0,0,2,3,0,1,11,66,0,15,0,1,0,1,1,3,1,0,1,1,1,1,3,1,3,3,1,0,0,0,4,3,13,85,3,0,2,6,1,0,5,4,0,0,2,11,3,0,7,0,0,1,6,2,8,5,0,5,3,4,0,1,0,0,0,0,0,4,4,5,3,4,1,0,3,0,8,4,0,1,7,3,1,1,3,3,32,0,0,3,3,2,0,4,2,1,0,6,1,16,1,3,5,0,0,2,1,0,1,5,1,1,11,5,0,0,6,0,0,0,0,5,2,4,3,9,10,2,0,2,6,0,10,2,4,0,0,3,1,1,5,2,7,4,0,0,4,0,2,5,2,5,3,3,0,1,0,3,1,1,1,7,6,3,2,8,1,1,9,4,0,0,3,3,2,0,5,1,4,0,2,5,5,0,1,1,0,0,2,5,4,2,2,3,12,1,3,3,0,0,3,0,2,0,0,4,7,2,0,2,11,2,4,0,1,8,3,2,2,0,2,1,0,13,3,2,2,3,2,0,9,1,0,0,1,0,1,2,0,0,0,0,2,0,3,3,0,1,5,2,2,3,7,0,0,3,6,2,2,3,3,4,0,1,1,2,0,1,2,2,4,0,1,0,6,3,3,1,3,1,0,9,3,5,0,2,0,5,4,1,3,1,10,1,3,1,12,1,4,6,0,1,3,2,1,2,0,2,10,1,1,1,13,5,1,3,1,1,1,4,0,3,0,10,7,2,8,0,0,0,3,1,2,0,0,2,0,0,0,1,2,0,2,1,1,9,8,8,1,0,0,12,2,3,7,1,1,5,0,0,3,3,2,1,4,2,1,0,3,9,2,0,4,3,8,5,66,2,1,2,1,8,3,1,3,0,0,0,10,4,8,1,6,13,7,0,1,16,0,4,20,3,0,2,4,3,2,1,2,9,0,6,0,5,5,0,0,4,0,2,1,2,3,0,0,2,1,2,0,3,0,2,0,3,2,2,0,0,1,4,6,7,1,0,0,1,2,6,0,1,0,0,0,8,2,1,0,0,1,0,5,4,1,0,5,0,46,0,4,5,3,3,4,3,0,4,2,0,3,0,0,0,2,0,1,3,2,10,1,19,2,6,0,1,0,2,5,1,0,0,0,4,0,0,0,4,2,0,0,4,5,4,1,3,3,3,1,0,12,0,4,2,4,2,0,4,0,4,0,0,4,5,2,1,1,0,1,5,2,0,3,0,2,4,6,0,1,7,1,0,3,1,6,2,0,1,4,4,0,1,5,3,1,0,0,4,0,1,1,6,2,1,3,0,1,14,0,0,1,2,1,4,0,1,1,9,0,1,1,3,1,0,0,2,3,5,0,0,0,0,1,2,6,5,9,5,2,0,0,2,1,6,3,3,0,3,0,4,3,1,2,0,5,3,1,1,2,1,0,0,1,1,3,2,0,0,3,2,0,1,0,0,0,1,3,1,2,5,6,0,7,3,0,2,3,2,0,4,6,2,1,1,0,1,0,3,3,2,0,3,1,5,18,3,3,0,0,0,9,2,0,2,0,1,0,0,5,2,3,3,6,5,6,2,0,0,3,0,0,0,1,0,0,0,1,6,3,5,0,3,0,0,0,1,6,0,1,0,9,0,3,1,1,4,1,1,0,2,0,0,0,0,13,759,1,1,2,0,0,0,2,0,0,0,2,1,0,1,2,0,0,1,3,0,0,0,3,0,0,1,0,0,0,0,0,0,2,0,0,0,1,0,0,0,4,0,1,0,4,1,0,0,0,0,5,0,0,0,2,9,0,0,0,0,0,0,0,0,0,0,1,0,0,0,0,0,0,0,0,0,0,0,0,0,0,0,0,0,0,0,0,0
K03 The Shining,king,9663,4981,3651,3815,3286,1217,3734,2603,2769,2587,1702,2556,1864,1250,1148,1342,2296,1104,824,811,1071,954,752,1127,276,563,348,641,767,341,617,861,473,623,450,476,558,687,195,563,582,648,651,546,311,464,422,342,621,439,586,561,469,506,362,362,677,254,306,421,555,303,224,479,401,274,216,444,207,233,317,155,208,250,236,253,261,238,234,305,239,225,175,316,269,263,195,160,210,209,91,251,265,271,198,183,310,162,164,194,179,306,202,164,244,154,238,316,168,206,297,198,61,208,157,239,187,117,150,77,128,137,217,202,177,110,176,106,125,76,137,214,123,96,256,152,24,215,146,100,42,108,42,107,177,169,103,163,143,116,105,121,172,118,123,89,95,118,177,156,82,129,101,156,160,215,137,83,205,149,25,84,124,120,84,60,69,129,134,131,108,74,149,73,113,61,64,76,113,86,91,46,88,59,120,164,114,36,84,19,82,166,84,84,42,155,75,84,76,103,88,102,39,56,144,76,74,64,73,59,55,54,88,77,60,98,52,48,43,101,111,112,108,158,78,16,67,99,96,43,51,52,71,59,82,108,106,120,35,91,73,29,69,58,111,55,42,73,113,56,101,44,126,76,49,55,71,70,64,62,65,45,88,43,57,51,45,67,122,68,149,41,63,74,154,25,58,76,38,45,68,37,34,28,88,33,102,46,17,55,127,85,74,58,174,56,21,25,25,40,60,11,29,59,43,52,48,83,52,27,61,20,43,183,50,57,116,64,52,54,30,64,56,64,63,53,110,22,31,76,49,56,35,39,33,28,74,16,56,47,34,26,80,60,142,27,27,76,81,69,54,41,28,11,19,37,21,22,34,63,60,24,66,74,51,103,43,65,90,39,62,76,53,49,28,7,0,65,47,69,40,36,38,32,54,41,42,47,35,43,52,74,86,18,42,35,69,31,31,51,72,43,59,13,36,57,52,72,33,30,75,72,12,24,35,34,13,61,40,16,69,46,31,60,12,67,39,50,16,44,38,21,30,50,37,25,106,43,29,42,42,25,13,37,37,38,45,61,29,46,48,7,7,4,9,73,48,32,23,31,20,52,38,24,52,34,20,24,0,30,32,33,62,8,25,38,36,33,66,20,56,18,38,16,23,30,33,35,21,33,46,29,55,34,33,33,12,19,33,10,55,46,36,46,25,36,1,17,24,34,34,20,39,25,22,17,60,19,30,37,11,38,38,20,14,1,48,47,20,29,82,14,24,54,28,47,0,5,50,27,36,20,42,84,45,20,84,21,12,20,17,41,27,22,28,27,17,5,41,31,131,20,20,58,14,25,22,15,19,20,49,46,22,33,748,47,14,39,17,25,16,28,18,24,17,17,14,35,16,28,73,84,37,24,15,0,11,29,16,16,20,14,31,24,6,24,36,8,11,29,15,12,13,22,29,25,29,53,27,48,10,13,30,9,23,0,33,39,41,25,9,16,16,7,6,25,22,82,31,42,0,15,16,24,24,58,17,9,45,18,15,17,34,20,11,58,57,24,37,28,47,13,9,16,12,23,27,39,23,8,28,19,24,17,34,16,2,32,21,23,30,17,9,46,49,36,14,3,75,33,25,12,27,17,30,14,4,27,5,32,9,18,1,37,9,40,6,35,11,27,13,28,6,3,36,43,19,17,12,38,21,18,7,13,0,18,13,6,5,33,25,35,15,53,0,4,14,22,16,10,17,7,25,16,6,31,17,12,27,20,15,16,32,25,46,22,15,9,17,23,15,18,28,76,0,8,12,20,10,14,42,18,12,27,41,40,14,28,12,19,27,6,3,26,16,20,1,15,0,15,25,16,13,10,13,11,43,14,5,28,17,18,29,190,21,13,7,1,31,18,20,2,19,13,42,44,23,28,27,38,11,2,0,17,3,31,25,11,0,5,26,21,14,21,53,26,10,0,28,14,21,24,1,4,8,18,2,4,23,45,27,8,14,24,37,62,14,0,21,59,18,16,7,3,0,9,20,28,5,18,24,16,34,23,3,19,14,19,28,20,11,11,4,8,10,14,11,1,2,27,7,32,21,12,9,9,19,9,20,18,8,0,18,0,7,3,16,3,24,18,37,5,4,7,18,18,24,2,39,27,16,12,20,62,10,12,13,19,6,16,10,19,9,9,11,12,9,17,15,16,10,20,14,17,3,26,42,23,24,5,0,16,21,2,12,16,46,7,7,11,12,1,16,7,3,44,17,12,42,0,0,19,22,0,8,24,16,0,14,9,13,49,20,26,12,7,0,23,14,0,11,0,10,0,10,21,0,2,5,45,8,7,21,175,54,23,16,1,8,9,7,9,16,1,2,6,3,2,45,15,14,40,9,10,13,13,20,15,25,33,19,4,4,3,18,7,8,3,23,15,3,8,26,15,6,0,7,24,3,32,4,23,0,9,4,33,5,4,0,0,0,9,9,8,12,4,6,0,16,37,4,7,11,9,7,3,5,11,7,2,3,0,17,8,2,11,21,14,23,5,13,2,23,15,8,10,14,15,18,10,13,16,6,18,0,1,4,2,23,16,25,13,9,17,14,3,21,33,20,1,13,21,8,5,9,33,46,8,2,7,12,1,33,17,12,13,13,6,16,4,27,0,10,16,15,2,1,7,17,23,5,7,5,28,0,17,15,26,3,2,0,4,27,32,18,12,5,0,16,0,8,7,7,9,14,29,0,5,24,0,15,12,0,14,7,18,10,13,1,7,15,0,8,9,19,6,10,13,26,15,0,13,22,13,15,0,0,5,11,9,35,7,3,2,16,29,5,26,10,10,12,5,1,4,13,0,4,4,0,5,12,11,15,0,4,8,5,5,4,9,3,8,19,14,4,20,19,25,77,6,12,0,8,12,0,13,11,2,18,36,1,7,9,6,0,11,11,13,0,24,15,29,13,30,37,27,7,2,16,22,0,11,16,7,2,5,4,38,0,24,10,20,12,12,6,27,10,9,9,1,3,1,4,16,30,30,13,40,10,20,13,11,6,1,18,10,15,12,1,3,3,30,8,6,1,32,4,3,9,11,14,18,13,0,12,21,7,3,20,8,8,33,7,8,13,2,8,16,5,12,1,13,15,0,5,30,12,4,22,13,3,12,25,3,12,0,0,25,0,3,3,0,5,37,1,8,8,5,13,7,5,28,28,6,8,17,30,0,14,1,0,13,0,11,3,3,1,0,3,7,5,10,45,3,0,7,26,4,3,9,13,10,7,4,15,11,5,3,5,5,1,10,0,0,4,22,10,11,12,15,9,4,1,6,2,12,10,19,4,10,8,14,0,24,15,0,11,6,14,26,14,9,13,0,12,10,10,0,5,6,7,4,12,10,2,1,14,12,10,8,10,13,6,17,7,8,18,19,4,8,6,18,5,6,6,9,0,3,2,10,18,0,2,0,0,5,0,13,10,7,12,6,3,8,33,8,2,0,5,1,3,23,13,12,9,6,5,9,1,19,5,8,12,17,9,0,5,12,8,8,7,4,4,2,15,19,7,915,15,2,16,3,20,4,11,11,4,2,14,7,5,9,9,11,6,7,1,4,6,9,8,19,7,0,24,6,18,0,49,16,9,17,10,5,7,12,4,10,0,7,0,11,11,73,6,12,22,0,3,8,14,0,0,9,3,16,15,3,17,13,6,9,1,4,12,6,0,10,0,9,5,9,12,0,1,5,4,2,3,3,5,2,6,1,8,9,9,12,1,16,11,3,11,7,0,1,2,5,16,1,0,7,14,4,12,4,1,26,0,19,18,24,5,3,18,8,9,0,18,10,10,16,28,2,1,18,3,3,3,9,9,13,9,2,5,1,28,6,5,15,13,0,17,9,0,1,12,0,19,7,22,5,21,2,19,8,22,5,10,12,3,3,7,6,2,13,2,13,0,11,6,11,2,1,19,4,17,26,8,7,4,17,22,0,14,4,15,9,18,6,14,5,27,15,0,7,3,3,7,15,6,3,9,5,2,9,5,5,3,16,17,9,3,0,4,6,4,19,8,0,0,4,0,5,2,72,26,5,10,4,10,6,6,13,2,7,7,1,13,9,4,26,1,17,9,3,0,2,26,8,0,2,9,1,4,2,2,3,5,2,10,17,39,1,0,9,7,0,16,4,4,9,0,0,15,13,0,1,0,0,4,51,2,10,1,10,5,1,0,9,10,1,0,9,0,5,22,6,2,1,16,14,3,7,6,7,11,8,7,5,3,4,6,2,276,2,1,6,3,23,29,12,0,13,8,2,11,2,10,5,0,6,11,1,1,3,11,10,3,29,26,8,0,4,0,0,7,1,6,2,0,11,12,17,0,4,1,1,8,4,0,14,12,1,11,0,7,11,8,4,9,132,0,12,10,19,9,2,10,3,0,0,0,4,7,0,2,5,0,3,10,5,0,12,0,4,2,3,13,8,3,8,2,11,17,3,1,2,4,12,9,8,5,5,4,3,4,6,4,4,4,4,0,0,5,2,2,21,8,2,9,15,13,5,2,3,5,15,2,3,3,57,5,2,3,6,4,0,4,3,4,4,3,12,1,5,9,12,4,0,3,9,2,14,19,15,7,5,5,1,4,0,14,11,2,0,8,1,8,0,16,3,3,4,22,2,12,0,7,11,20,5,7,2,1,10,12,2,6,24,2,5,5,8,4,26,10,7,0,3,3,5,2,9,2,2,5,0,4,2,0,0,6,3,0,1,6,14,5,3,14,3,3,9,11,17,0,0,0,4,2,3,11,3,1,21,1,9,5,11,3,0,7,6,7,4,0,0,6,3,12,4,3,16,9,1,1,1,0,0,7,0,5,15,0,0,0,5,2,4,4,14,6,2,0,9,8,16,5,4,1,2,5,2,16,19,0,5,0,3,0,5,0,0,7,0,10,3,24,19,0,11,1,1,9,3,5,11,0,24,13,0,6,0,0,0,0,5,0,3,4,0,0,1,4,3,14,1,2,0,1,18,2,5,11,12,5,10,13,9,1,11,2,0,11,29,0,0,8,6,1,8,6,8,9,1,1,3,1,10,0,5,1,1,3,2,3,3,12,8,3,6,1,2,1,2,2,0,4,0,3,8,6,2,6,2,14,4,4,3,6,13,1,9,5,4,0,17,3,0,4,0,0,1,9,2,7,9,9,9,1,1,0,3,1,12,3,5,10,5,4,14,7,2,0,1,2,1,13,16,14,14,6,6,2,9,2,3,19,5,13,6,4,10,2,12,1,0,6,6,2,3,4,6,7,5,2,0,7,2,0,1,0,5,0,2,5,4,4,1,0,10,4,7,4,3,7,4,18,19,3,1,10,0,7,0,4,2,9,3,20,7,6,5,3,6,6,8,0,1,6,1,2,4,4,11,4,10,2,1,10,2,12,2,8,0,8,4,8,10,0,3,1,6,1,0,1,5,2,3,4,6,5,11,2,5,1,0,5,6,0,9,5,0,0,17,11,21,3,1,8,5,7,2,2,0,8,2,0,10,4,0,3,4,1,0,5,10,27,1,0,4,5,2,7,4,11,2,3,3,0,17,2,0,5,0,15,3,13,0,6,0,4,5,0,6,14,1,2,3,2,12,11,4,4,4,1,4,4,0,0,7,6,11,3,2,0,1,2,1,5,6,5,4,0,11,4,0,5,9,8,0,6,5,1,1,8,2,2,7,3,6,0,6,1,6,0,0,0,0,3,4,0,3,0,2,7,4,4,7,3,6,5,8,2,1,1,0,2,4,1,17,4,5,9,3,4,6,6,1,2,0,3,6,1,6,10,7,1,6,3,0,0,3,4,7,3,6,0,8,5,1,0,12,2,4,5,0,2,3,1,0,0,20,0,0,7,2,0,5,0,6,2,2,4,1,9,3,0,12,5,5,3,5,9,29,4,2,0,24,6,2,13,3,19,0,8,7,2,2,3,4,12,0,4,4,3,1,8,2,1,0,8,6,0,6,2,8,0,7,9,5,0,9,2,7,11,3,1,0,0,9,12,25,1,0,13,4,108,0,0,8,1,3,3,1,1,2,8,3,4,17,4,4,5,3,4,1,9,3,11,0,4,0,3,1,14,6,3,0,3,3,0,7,1,3,0,4,16,0,2,0,3,1,3,0,4,2,5,4,2,2,5,42,1,1,1,2,0,8,0,3,6,4,6,4,0,0,5,4,3,0,9,3,0,8,5,3,1,5,2,0,14,7,6,0,2,7,1,2,1,1,10,4,4,0,3,1,9,9,0,0,0,3,1,0,4,0,5,1,2,8,1,6,0,2,6,2,4,3,5,1,0,26,3,0,6,6,3,1,3,1,9,2,19,0,6,2,5,1,4,2,9,0,2,4,0,6,1,10,3,2,3,6,0,0,2,1,1,3,3,8,1,1,5,6,0,0,15,0,6,5,8,2,7,15,0,2,3,5,3,1,0,1,2,0,16,1,2,0,2,4,2,5,0,2,7,2,12,0,2,0,1,0,12,3,2,7,1,9,2,3,3,2,0,0,0,8,1,1,1,1,2,6,3,1,1,0,2,1,3,13,2,2,1,6,10,2,5,0,8,2,1,0,3,3,8,19,10,4,4,2,5,0,0,0,0,0,2,2,26,0,1,1,1,4,6,7,5,4,0,1,8,5,0,5,5,7,2,1,3,18,0,4,0,3,3,4,7,3,0,4,2,1,13,6,2,0,2,6,1,0,2,1,0,0,1,14,3,1,4,0,5,0,9,0,0,2,3,0,0,3,12,3,0,8,2,2,2,8,0,0,2,1,2,1,2,2,4,7,2,0,0,4,2,8,13,0,0,3,6,0,0,3,0,1,1,0,2,3,15,2,2,1,0,4,0,2,1,2,2,7,14,6,0,4,5,5,4,12,0,5,0,4,14,3,7,1,5,0,1,1,2,16,1,3,5,6,2,9,3,2,4,2,1,1,1,2,3,0,2,1,0,5,4,0,2,2,3,1,0,0,0,1,0,3,1,6,14,16,1,4,0,0,0,6,0,1,0,0,2,0,1,10,9,4,0,1,7,8,4,1,1,17,0,0,0,1,0,1,3,0,0,2,0,0,1,1,2,6,1,6,0,0,8,0,22,0,0,3,0,2,0,1,0,1,1,9,0,0,3,6,7,3,1,2,8,1,3,4,2,1,6,0,5,4,0,5,0,2,0,2,5,4,1,0,3,8,0,9,1,3,0,2,1,2,4,0,1,1,1,0,11,13,4,5,2,0,3,3,3,5,1,5,8,3,0,1,8,1,4,0,5,3,3,8,14,12,0,23,1,11,4,1,7,5,3,0,5,2,7,13,28,0,0,7,3,1,14,4,0,0,4,1,8,3,2,12,1,0,3,0,20,7,2,1,8,5,3,1,0,7,0,0,0,3,13,12,0,1,2,7,7,15,6,0,1,1,4,3,1,1,11,5,10,11,0,4,9,7,8,5,6,2,1,5,6,1,2,2,2,0,1,12,0,3,2,0,3,0,1,11,8,5,0,5,4,2,0,8,0,8,0,3,7,3,12,7,16,0,4,5,0,3,1,7,0,0,4,3,2,1,7,2,0,12,5,1,7,2,5,27,3,2,0,4,1,1,8,11,3,10,6,5,1,1,5,2,0,1,5,0,19,5,3,3,5,1,2,0,4,0,2,3,5,2,1,6,1,1,1,0,1,3,1,0,3,1,13,1,1,1,0,13,4,1,4,3,3,13,0,2,2,1,1,0,5,6,0,1,1,2,35,0,0,1,9,7,1,3,2,0,2,0,1,0,0,8,1,0,9,0,1,4,2,7,8,2,3,2,0,1,3,15,0,0,6,1,0,3,0,0,1,3,3,6,3,0,3,0,2,0,12,0,6,3,3,4,7,5,0,3,3,7,0,4,2,2,0,2,1,4,0,5,3,0,6,3,12,9,0,1,10,2,3,3,0,3,0,9,1,0,0,0,1,1,2,0,3,0,1,2,1,2,2,5,2,1,2,3,0,9,3,0,0,0,0,2,0,9,3,1,1,0,2,2,3,1,0,0,0,0,0,3,5,0,1,0,9,1,1,0,2,8,13,0,5,4,6,1,4,0,10,5,0,3,3,1,1,3,1,3,2,2,5,0,0,0,1,5,4,2,3,0,0,0,0,0,2,0,7,6,9,1,4,2,0,0,1,8,0,2,0,1,0,9,0,0,2,11,4,0,0,0,7,4,2,3,1,0,12,0,5,2,1,0,2,0,6,2,0,20,6,21,1,5,5,2,5,4,0,0,3,1,0,2,0,0,5,1,3,8,2,2,0,0,22,2,5,5,5,12,1,13,1,1,1,0,0,5,4,0,4,0,2,2,1,0,0,1,5,9,5,2,10,2,1,2,2,3,1,1,0,0,0,0,1,2,2,0,3,3,0,1,8,7,0,1,24,3,2,2,0,1,3,3,7,1,8,2,8,9,0,0,2,0,4,1,14,5,7,0,5,2,0,2,2,2,0,1,3,2,5,0,9,2,0,0,1,5,2,1,5,0,0,8,4,1,1,0,4,0,4,3,14,3,11,0,0,7,3,10,0,0,1,1,0,0,0,0,1,1,0,0,1,1,0,1,0,0,4,0,1,1,0,2,3,5,1,6,2,3,7,0,4,0,2,1,0,4,4,2,1,1,0,0,1,3,3,12,0,0,4,2,0,1,0,1,2,6,2,0,2,3,3,1,2,0,0,1,0,2,3,0,8,4,0,0,3,2,0,1,0,4,0,1,2,8,6,1,1,6,4,9,0,1,1,0,0,1,9,5,1,8,3,3,1,2,0,1,0,3,8,1,1,1,5,4,5,5,7,6,1,4,0,2,0,1,5,3,1,0,2,14,0,2,3,1,0,0,0,3,0,1,6,1,1,2,3,1,1,1,1,1,0,1,1,1,0,0,0,6,0,8,9,7,0,0,2,0,6,0,0,0,2,2,0,0,4,4,0,0,1,3,10,9,2,2,12,5,9,2,4,3,0,0,3,0,2,3,0,0,0,0,3,2,5,0,0,0,1,2,0,3,5,2,0,2,1,4,2,0,0,0,11,4,1,12,0,3,3,5,1,1,13,0,3,1,3,6,3,0,4,0,4,2,9,0,0,0,2,5,3,12,1,14,3,0,4,7,2,1,4,1,1,0,1,1,2,1,5,0,0,2,1,0,2,5,5,0,1,4,8,3,2,0,0,1,0,1,7,1,1,2,0,0,3,0,1,10,1,4,0,1,2,1,8,5,2,1,2,0,2,5,1,2,2,3,3,0,2,2,0,4,3,4,10,0,1,0,2,0,12,1,0,0,10,3,1,1,1,1,8,4,4,0,2,0,4,3,3,2,8,1,2,0,1,1,0,0,1,1,0,5,0,4,0,0,3,0,2,4,0,2,2,1,1,0,1,6,1,9,0,2,0,0,0,1,3,3,0,2,3,1,0,1,2,0,0,0,1,2,0,7,3,0,2,0,1,0,3,0,0,0,7,0,4,11,0,0,5,8,5,1,6,0,3,3,1,0,8,2,0,42,0,0,0,0,0,1,1,10,2,0,0,27,1,1,0,6,0,0,3,1,1,1,0,0,2,0,1,1,0,5,0,4,1,1,1,1,1,0,0,6,0,3,1,1,3,5,1,0,3,2,4,3,0,6,5,4,0,1,2,1,10,0,0,4,7,6,0,1,2,0,1,0,2,9,0,6,12,3,3,1,6,0,0,4,1,7,6,4,0,2,2,0,0,0,2,4,2,1,2,8,0,0,0,2,3,0,4,0,2,0,1,0,4,1,0,1,2,5,2,0,3,0,3,0,0,1,8,2,0,19,0,2,7,0,0,10,2,5,2,3,1,3,5,8,8,0,4,9,2,0,0,7,0,2,8,11,4,1,4,3,0,1,0,13,13,0,1,0,2,0,2,3,0,0,12,1,4,1,5,1,8,5,0,0,7,0,0,0,1,4,2,0,2,2,2,0,0,7,1,4,2,3,0,0,3,1,0,0,0,0,4,0,0,0,0,0,1,1,2,2,0,1,4,3,3,2,3,0,0,1,10,3,2,1,5,2,0,4,6,1,0,3,1,1,1,0,0,0,1,10,5,0,1,0,1,10,4,1,2,5,0,4,3,3,0,2,4,0,5,1,1,0,5,0,10,0,0,1,2,1,0,1,12,0,0,3,3,2,0,2,0,0,2,6,1,3,0,2,2,0,11,2,0,0,5,0,3,0,0,0,0,0,0,3,2,0,6,0,20,0,1,0,3,0,1,5,2,2,4,0,9,2,0,41,2,2,2,0,1,1,1,0,2,4,2,0,3,0,2,5,5,2,0,2,1,9,3,1,2,4,0,5,1,7,2,1,1,5,3,0,2,6,2,2,1,1,0,3,2,1,1,4,4,8,0,0,0,0,0,1,0,1,0,3,1,0,2,0,0,3,0,0,0,1,0,0,1,0,1,0,0,0,0,8,1,2,1,1,2,1,0,4,3,0,0,4,0,3,3,2,0,1,5,1,1,5,4,4,7,1,0,1,6,3,4,2,0,1,1,1,5,2,1,0,0,0,0,0,2,1,0,0,9,9,1,1,0,0,0,1,0,8,0,0,0,1,0,2,1,2,0,0,3,4,10,0,1,0,1,4,1,0,5,2,1,2,0,3,0,3,0,0,9,1,5,2,0,1,1,1,0,5,0,0,0,1,2,4,4,0,0,1,2,1,2,0,7,1,0,0,1,4,2,0,0,0,0,0,0,2,0,0,0,1,0,2,6,0,0,12,1,0,0,7,2,4,0,2,3,2,0,1,2,1,0,3,0,0,1,2,0,0,0,1,4,1,2,1,0,3,2,2,3,1,0,4,0,4,0,0,1,2,6,1,4,0,2,1,0,1,0,2,1,0,0,0,3,0,0,0,1,2,2,5,0,0,1,1,1,2,3,0,0,1,1,0,1,1,0,0,0,1,0,0,0,0,0,2,0,0,3,4,0,0,0,18,12,0,0,0,0,1,3,7,1,1,0,2,22,0,0,1,0,2,1,3,2,1,3,0,0,0,0,0,4,0,0,1,30,0,0,1,0,4,0,0,3,0,10,0,2,0,10,0,8,0,0,4,3,3,0,0,0,0,2,4,6,0,4,0,0,0,0,0,2,1,0,7,2,0,0,0,0,0,1,0,1,0,0,0,2,1,0,1,0,0,0,0,0,0,0,0,3,0,3,0,0,0,3,0,1,0,8,0,0,0,0,0,1,0,0,0,0,0,4,0,5,0,2,0,0,0,0,0,4,4,0,0,0,0,3,0,0,0,0,0,0,0,0,0,0,0,0,0,0,0
K04 Rage,king,2306,1595,1252,1239,982,1729,671,732,1024,933,744,374,647,388,403,489,450,360,286,414,411,323,235,227,570,150,505,231,300,184,140,318,223,183,127,222,225,326,135,189,216,279,242,154,156,160,150,129,106,127,161,169,137,115,114,93,134,122,125,188,201,140,112,94,172,118,50,106,63,86,124,90,85,92,124,53,55,157,80,60,100,58,35,107,88,195,57,83,84,52,75,117,64,59,104,58,101,40,71,59,65,104,135,35,67,42,64,78,74,67,56,78,53,63,49,51,64,47,75,47,80,40,104,73,62,32,48,76,54,72,39,43,70,31,69,44,19,77,33,56,16,47,14,68,41,71,47,57,44,62,42,104,42,28,27,22,43,22,25,9,17,53,56,57,32,20,23,32,38,66,35,22,56,40,22,15,27,19,34,45,60,34,28,5,57,27,52,11,22,34,27,21,26,23,29,57,47,12,6,9,36,46,20,24,27,108,26,28,42,67,59,18,12,12,20,13,31,31,47,32,10,23,36,24,26,16,15,19,9,66,30,24,23,37,14,2,33,29,22,11,26,30,18,20,16,24,23,25,28,21,29,9,21,21,19,28,23,19,30,12,26,29,27,35,20,8,22,21,19,15,42,27,15,13,17,16,11,19,34,16,32,3,33,29,45,6,18,11,10,13,24,20,1,8,23,19,25,21,14,22,31,17,27,11,40,14,4,28,9,7,11,30,11,21,11,19,12,25,13,4,31,29,19,32,8,21,31,27,18,19,54,17,18,21,14,36,38,5,19,26,9,11,12,11,31,13,33,22,17,13,12,14,20,11,43,6,10,21,24,23,13,16,16,5,12,24,5,15,6,18,8,25,15,3,13,43,7,22,15,12,23,8,10,10,5,14,0,12,13,21,2,20,10,17,22,16,9,8,19,21,52,6,12,10,12,16,7,46,5,4,16,13,9,15,8,11,11,16,8,11,14,21,12,18,19,17,17,11,23,15,16,9,4,21,4,22,14,13,2,9,5,12,5,15,16,8,38,16,7,11,13,5,17,15,16,21,8,15,8,8,11,10,0,3,4,13,15,5,4,18,10,20,7,2,12,7,7,13,0,5,7,24,23,20,10,13,6,5,19,3,6,6,16,7,4,5,20,18,5,14,14,14,35,2,7,11,1,11,14,3,8,15,10,6,4,6,0,7,21,28,16,7,26,23,3,5,15,8,15,16,12,16,10,20,3,0,16,11,6,8,21,1,7,11,26,12,0,2,4,28,11,6,4,11,17,15,20,12,4,2,15,23,8,51,3,10,9,3,10,7,11,10,24,5,6,24,8,8,21,11,14,8,6,6,8,4,13,10,5,7,9,7,9,6,14,12,3,7,2,12,25,10,13,10,0,0,0,18,5,3,12,4,5,3,3,4,28,3,5,6,5,15,3,8,13,11,10,13,8,2,6,7,21,19,13,0,3,10,9,3,5,11,11,1,7,19,14,15,5,48,0,5,7,9,4,10,8,18,9,9,3,5,7,9,4,8,8,17,6,13,7,11,1,5,4,10,3,6,14,3,4,6,6,1,3,11,0,3,2,8,10,2,25,19,5,8,3,2,4,6,6,27,13,14,9,1,6,5,5,4,2,14,0,11,3,29,4,6,13,6,17,3,3,2,1,5,19,11,5,7,8,1,1,3,0,16,2,8,1,9,26,11,2,21,4,1,3,3,16,2,2,5,6,4,2,1,1,4,12,6,15,0,3,6,5,22,10,4,0,3,3,1,3,1,0,8,6,8,21,2,9,5,1,7,10,5,9,5,4,2,5,8,0,12,5,12,0,6,7,13,3,10,0,11,5,1,10,6,4,1,2,1,9,0,5,9,25,0,3,10,5,6,5,7,7,14,7,6,11,4,1,0,2,7,3,12,14,4,0,8,7,2,6,9,14,3,10,1,11,2,2,6,8,4,1,9,0,1,1,7,7,3,1,3,1,9,5,0,7,10,16,9,12,0,0,5,4,10,5,9,22,3,4,7,1,10,8,3,14,5,5,1,2,2,5,1,3,0,5,12,3,1,20,1,1,12,8,2,3,3,3,0,9,1,7,1,1,3,12,5,18,3,5,5,2,2,2,0,9,1,15,1,6,35,6,3,6,16,4,2,3,7,15,0,1,1,0,8,5,7,9,3,6,11,3,3,5,9,9,4,0,8,5,3,12,3,17,2,8,2,3,49,5,5,3,6,6,6,2,0,7,26,5,0,6,7,5,0,7,5,2,7,0,3,5,1,0,1,19,0,3,0,4,1,13,19,0,0,3,12,2,2,4,2,19,2,6,0,0,6,0,4,4,1,0,5,2,1,7,4,4,2,2,7,2,6,2,8,5,6,15,1,1,2,6,1,10,3,1,1,4,14,13,3,9,0,6,12,5,3,3,6,0,6,0,12,4,1,0,0,0,0,4,5,1,3,2,0,5,11,0,6,9,6,3,2,4,5,0,8,5,0,12,2,2,4,6,5,8,0,0,3,5,4,1,4,8,0,2,4,1,3,2,12,0,0,2,3,4,2,7,1,3,6,5,0,8,2,1,4,11,22,4,1,4,10,4,6,2,2,4,0,6,1,6,2,10,3,2,0,6,0,3,4,3,0,9,4,2,2,1,1,1,9,0,4,5,3,0,1,0,8,2,3,2,8,1,1,0,0,3,0,0,1,7,5,0,4,3,0,6,3,0,2,0,3,3,9,3,1,6,0,3,3,5,6,1,1,2,6,0,0,9,4,27,0,0,1,2,1,8,0,29,0,1,12,0,5,0,0,4,0,0,4,2,0,0,1,0,10,5,2,3,0,2,2,0,2,6,6,3,3,11,4,3,0,3,3,0,4,20,0,4,5,0,0,4,2,0,2,0,1,8,1,0,1,2,8,0,32,1,7,6,1,5,2,8,4,1,6,0,5,6,6,5,2,11,12,1,4,12,9,0,2,8,4,3,1,2,0,1,0,3,2,1,2,8,11,4,9,11,2,3,1,4,2,0,6,1,4,0,3,2,3,2,4,8,28,3,3,6,5,10,0,1,12,2,3,8,2,4,2,3,2,0,1,1,6,3,0,2,5,4,1,0,1,3,5,7,6,1,1,4,0,2,0,0,7,0,11,0,0,1,10,1,7,0,0,5,6,5,7,14,1,6,7,3,0,3,2,0,0,0,3,11,1,0,0,1,1,4,1,1,7,0,6,5,5,2,6,7,0,0,1,2,3,0,1,2,9,7,1,0,0,6,1,1,8,4,1,1,1,0,1,129,14,0,6,3,3,5,9,0,3,1,0,1,4,5,0,2,2,0,0,4,1,14,0,3,2,7,2,3,3,0,5,8,6,0,0,4,5,2,5,5,0,3,3,4,4,2,2,5,0,4,9,0,2,0,2,1,0,1,0,0,2,0,2,3,1,2,5,0,0,8,5,2,0,3,0,0,20,4,0,3,3,5,3,3,2,0,1,5,4,1,0,3,1,8,0,5,0,1,0,4,1,3,0,5,0,6,11,16,2,2,4,2,1,10,2,3,3,6,0,6,3,2,12,6,6,2,4,2,0,1,8,7,5,5,6,0,10,4,4,4,1,0,1,4,3,0,5,8,9,1,2,4,0,3,5,3,0,0,5,1,4,4,0,1,2,3,3,1,5,3,1,0,6,0,3,0,1,3,0,1,8,0,0,1,2,2,0,88,2,0,2,3,3,1,4,3,0,4,3,0,0,1,0,1,0,3,3,7,3,3,6,1,10,1,1,0,2,1,1,22,0,3,0,3,0,5,3,10,3,4,11,0,0,3,5,6,1,0,4,1,2,1,3,2,0,5,0,2,0,0,0,2,3,2,1,11,3,4,3,3,0,6,2,3,0,2,1,1,4,6,1,1,1,0,7,1,1,2,1,1,0,3,1,1,0,0,2,3,0,1,7,3,1,8,2,0,1,13,3,0,2,3,10,5,1,1,0,2,2,0,3,0,3,1,8,5,1,0,0,2,2,0,9,1,0,0,4,32,0,1,0,0,2,4,1,4,6,0,0,1,2,3,2,1,0,0,0,0,6,5,16,1,0,3,7,2,0,1,0,1,1,4,2,0,2,2,2,9,1,0,0,0,0,1,6,4,2,0,0,1,6,0,0,0,0,2,22,3,0,0,6,10,0,0,2,1,5,0,3,1,2,5,2,6,0,1,0,0,5,4,1,10,1,1,0,1,3,2,2,1,2,1,3,2,4,0,4,0,1,1,2,0,1,5,3,0,3,9,2,0,1,4,2,0,1,2,2,0,1,0,0,1,1,3,0,0,4,3,0,0,1,0,0,38,2,0,2,2,0,2,2,2,5,0,0,3,0,0,5,3,4,0,0,6,2,0,4,0,3,4,0,0,2,0,44,4,0,0,3,0,1,3,0,1,2,1,5,0,1,3,2,1,1,0,2,4,1,0,3,0,0,3,0,1,2,4,4,0,0,1,1,0,4,3,1,0,3,4,12,9,0,2,0,1,0,2,0,1,0,2,0,3,0,0,0,1,0,2,3,0,1,1,2,2,0,0,1,0,3,3,0,3,0,0,2,3,0,3,2,4,0,3,0,0,0,4,0,0,2,3,0,0,0,0,0,3,2,1,1,0,4,0,0,1,1,1,6,4,2,1,6,4,6,1,1,0,0,1,2,2,1,2,1,1,2,0,0,1,0,0,0,10,7,6,1,10,0,6,3,1,4,1,1,1,2,3,0,4,1,0,3,13,1,3,4,0,1,4,0,1,0,0,0,0,1,1,3,4,1,0,0,1,0,0,0,2,0,1,2,0,0,0,0,0,8,2,1,1,2,0,2,4,5,0,2,0,3,3,1,4,1,0,5,0,1,4,0,0,0,0,0,3,0,5,1,0,4,0,0,1,4,2,2,0,2,2,0,1,0,0,0,0,0,0,2,2,0,0,0,0,1,2,2,0,0,0,2,0,1,0,1,0,2,5,5,0,1,2,0,0,1,0,0,0,0,2,1,2,0,4,1,0,0,1,0,0,0,0,1,1,4,0,0,1,0,1,1,0,1,2,3,0,0,4,0,3,7,1,3,1,0,2,0,1,0,2,1,0,0,1,0,1,5,0,0,3,0,2,3,0,0,1,2,1,12,1,0,0,2,0,2,2,4,4,4,1,0,0,2,0,0,0,0,1,1,1,0,3,4,2,1,7,0,8,3,0,0,0,1,1,4,1,0,1,1,0,2,1,0,3,0,0,0,3,2,0,0,0,2,3,1,0,4,2,1,2,7,0,1,0,0,1,3,6,2,1,0,0,1,2,1,4,1,0,0,6,3,1,4,1,1,0,2,0,0,2,2,0,10,4,4,3,0,0,0,1,1,0,0,0,0,2,3,0,0,0,2,0,2,0,0,0,0,0,0,2,0,0,1,0,0,0,0,3,5,0,3,0,0,0,3,3,2,0,0,1,3,3,0,2,0,3,0,0,1,2,1,1,6,1,0,0,5,0,1,0,2,1,0,4,0,2,0,2,1,0,1,0,1,2,9,7,0,1,2,0,0,1,2,0,1,3,0,0,1,1,4,3,0,0,2,1,2,1,0,0,5,2,3,1,1,1,1,0,1,0,6,1,2,0,1,1,0,1,2,4,0,1,3,2,2,0,2,1,0,0,1,0,3,1,4,0,0,1,0,0,2,0,5,0,2,0,0,0,3,0,0,1,1,1,1,2,0,1,2,0,0,3,2,1,4,1,1,2,0,0,0,0,3,11,4,2,1,1,1,0,1,0,1,0,1,0,3,0,0,3,0,3,5,0,19,1,0,1,1,0,0,0,0,1,0,0,1,0,1,0,4,0,0,1,1,3,1,0,0,0,1,0,2,2,1,0,0,0,5,2,0,3,0,3,0,3,2,1,0,3,1,2,2,3,2,1,0,3,4,3,0,0,1,1,0,0,0,0,0,1,2,0,0,0,1,0,0,2,0,1,0,0,1,0,0,8,1,12,0,1,2,3,3,4,2,1,1,4,0,1,2,0,3,3,2,4,0,0,0,3,0,1,0,1,0,1,0,0,1,0,0,2,1,0,3,0,0,1,0,0,0,0,0,1,0,1,3,0,2,0,3,1,4,0,1,1,0,3,2,0,0,1,0,0,1,0,1,0,0,1,0,2,1,1,0,5,0,1,2,1,0,3,1,0,0,1,0,1,3,0,0,7,1,1,0,0,2,0,1,0,0,0,4,1,0,2,1,0,1,0,1,0,2,0,0,1,15,0,1,0,0,0,18,1,0,6,1,0,0,5,0,5,0,1,4,1,1,1,2,1,1,0,0,3,0,0,2,0,0,0,0,1,0,0,0,1,0,2,0,0,4,1,0,1,2,3,0,0,1,5,1,2,4,3,1,1,0,0,2,5,0,2,0,1,0,3,0,0,0,0,0,0,0,0,1,0,1,2,2,0,0,0,0,0,2,0,2,2,0,0,4,0,0,0,0,0,2,0,4,1,0,2,2,0,0,4,0,1,1,1,1,1,0,1,3,0,0,1,0,4,4,2,0,1,0,0,4,0,1,0,1,2,0,0,2,0,0,0,0,3,0,1,0,0,0,1,1,0,0,0,1,2,1,0,1,1,2,1,1,0,4,1,0,0,4,1,3,1,2,0,0,0,0,2,1,1,0,0,0,0,4,0,0,0,0,0,1,0,0,0,0,0,0,0,0,0,0,2,0,0,1,0,1,1,4,3,0,0,0,0,0,1,0,0,0,3,0,0,0,2,0,0,0,0,4,1,0,0,0,2,0,0,3,0,0,3,0,0,4,1,1,1,4,0,0,0,0,0,1,1,0,2,0,0,1,1,0,1,6,0,0,0,0,4,0,1,0,1,0,2,4,2,1,0,1,0,0,0,4,1,0,3,0,7,0,1,1,3,2,1,1,0,0,0,0,2,0,1,0,3,0,0,1,0,1,1,2,13,7,1,1,0,0,4,2,0,0,1,0,2,0,4,10,2,0,0,0,0,0,1,1,1,3,0,0,0,0,2,1,0,4,0,1,0,0,0,1,1,5,0,0,0,1,0,0,17,3,0,44,0,0,0,2,1,1,2,0,0,1,0,1,1,0,0,0,0,3,0,1,0,2,2,0,0,1,0,1,8,0,0,2,1,0,0,0,1,1,0,1,1,0,0,0,1,1,1,0,1,2,1,0,5,1,2,3,2,0,3,2,1,11,1,2,1,0,0,0,2,0,1,0,1,0,0,4,1,13,0,3,2,1,3,0,1,4,3,0,0,27,3,1,0,0,0,3,0,0,3,2,0,0,0,0,0,7,0,3,0,0,1,0,0,2,2,0,0,0,1,0,0,0,1,0,0,0,4,5,1,0,1,2,2,1,5,0,0,0,0,0,0,0,1,0,2,2,1,0,3,0,2,0,0,0,0,0,2,0,6,1,0,0,2,1,1,0,1,0,0,0,0,0,0,1,0,2,0,2,1,5,0,1,0,0,1,0,1,0,2,0,0,2,0,0,0,4,0,0,2,1,0,1,0,1,0,1,0,0,0,1,0,1,0,1,0,0,0,0,1,2,2,1,0,1,0,0,0,0,0,0,1,0,0,2,0,1,0,0,0,0,4,0,1,3,0,0,0,0,1,0,0,1,0,1,2,2,1,0,2,0,1,0,1,0,0,1,2,0,0,7,0,2,4,0,0,1,1,1,0,46,0,0,2,1,2,0,2,1,0,1,5,0,2,0,1,0,0,2,0,0,5,0,1,0,0,3,0,0,3,0,2,0,2,2,0,0,1,0,0,0,0,184,5,1,0,0,0,0,1,0,0,0,0,0,1,2,2,0,2,0,1,2,1,0,0,0,5,1,0,0,0,0,0,3,3,0,1,0,1,0,0,0,4,0,1,0,0,2,0,0,1,0,0,0,0,0,0,0,0,0,0,0,1,1,0,1,4,0,9,0,0,8,0,0,2,0,1,2,0,0,0,3,1,0,3,0,0,0,0,1,0,0,0,0,3,1,2,0,2,2,3,0,4,1,0,1,3,4,0,2,0,0,1,3,0,3,0,0,0,1,0,0,1,1,0,0,7,0,0,1,0,0,1,0,0,2,0,0,0,0,3,0,0,3,2,0,0,0,1,0,1,0,0,2,1,1,0,1,0,1,1,0,0,0,2,1,0,2,0,1,1,0,1,3,0,1,0,0,1,0,1,1,1,1,0,0,0,2,5,0,0,0,0,1,0,3,2,0,1,2,1,1,0,0,0,0,0,2,0,2,8,0,1,0,1,0,1,0,0,0,0,1,1,0,1,0,2,0,0,0,3,4,3,0,4,3,5,3,0,1,3,1,0,0,0,0,1,1,0,0,8,3,2,1,0,4,1,1,0,2,0,1,0,0,4,5,4,0,1,1,0,0,1,0,1,0,2,0,7,0,0,1,0,1,0,4,0,0,0,0,1,2,1,0,1,1,0,0,0,1,0,0,1,2,0,0,0,0,0,0,0,0,2,1,1,3,0,0,0,1,0,1,0,0,1,0,0,0,0,0,0,2,0,0,1,0,0,0,0,0,0,2,0,0,1,8,0,0,0,0,0,0,0,0,1,1,0,1,0,0,0,2,2,0,0,0,1,0,1,1,1,0,2,2,0,2,0,8,1,0,1,0,0,6,0,1,0,0,0,0,1,0,0,0,4,4,0,0,0,0,1,0,1,1,0,4,1,0,8,0,0,3,2,0,0,2,0,0,0,0,0,5,0,1,0,1,0,3,0,2,0,0,0,1,4,0,0,1,0,9,2,1,0,0,1,0,0,1,1,1,0,0,2,3,0,0,1,2,0,0,1,1,1,0,0,2,0,2,1,2,0,0,0,0,0,0,2,0,0,0,3,0,0,1,2,0,1,2,3,0,0,0,2,0,0,0,2,1,0,1,0,1,0,0,0,0,4,0,0,0,0,3,0,0,1,0,1,0,0,0,1,0,1,0,0,1,0,1,0,0,0,2,0,1,3,0,0,0,0,2,0,0,2,0,0,1,5,1,0,4,0,0,1,0,1,1,1,4,1,3,1,0,0,0,0,1,1,2,2,0,0,0,0,0,0,0,1,0,0,1,3,0,3,0,0,0,0,2,0,0,0,0,1,0,0,0,2,1,1,0,0,2,2,1,1,0,0,4,0,2,0,0,0,1,0,0,0,2,0,1,0,0,0,0,0,0,1,1,0,1,0,0,0,0,0,1,0,0,1,0,1,1,0,3,0,3,0,0,0,0,3,0,0,0,0,0,0,0,0,2,0,0,6,1,1,0,2,0,1,0,3,2,1,0,0,0,1,0,0,0,0,0,0,1,0,0,1,0,0,4,0,0,0,2,1,1,0,0,2,0,0,2,0,1,0,0,0,0,0,2,0,0,0,2,8,0,1,0,0,0,0,1,0,0,1,2,2,0,0,0,0,0,2,1,3,0,0,0,0,0,0,1,0,1,2,0,0,0,1,0,0,1,0,0,1,0,0,0,1,0,0,1,1,0,0,1,0,0,0,6,0,0,0,1,4,0,0,59,1,0,0,1,0,6,1,0,1,1,1,0,0,0,0,0,0,0,6,0,0,4,0,0,1,0,0,0,0,1,0,1,1,2,0,0,0,0,0,1,2,2,0,0,0,0,0,0,2,2,0,0,1,0,0,0,3,0,0,0,0,1,0,0,0,0,0,0,0,0,1,0,1,0,1,1,2,1,1,0,1,2,2,1,1,0,0,0,4,0,0,1,1,1,0,0,1,0,0,1,0,0,2,0,0,0,0,1,2,3,0,0,0,0,0,0,0,0,1,2,2,0,1,0,1,0,0,2,0,0,1,1,0,1,0,0,0,0,0,0,0,0,0,0,0,0,1,0,0,1,1,1,1,0,1,0,2,3,0,0,2,0,0,0,1,0,1,0,1,0,5,0,0,3,1,0,1,0,0,0,1,0,0,0,0,0,0,1,0,0,0,0,0,1,0,1,0,2,9,0,1,0,1,0,0,0,1,1,1,1,1,2,0,1,1,0,0,1,0,0,0,3,0,1,0,3,0,1,1,2,0,0,1,0,1,0,0,2,0,0,1,1,0,0,1,0,0,0,3,4,0,2,0,1,0,0,0,6,0,0,0,0,1,0,0,0,0,0,0,0,0,0,0,0,0,0,0,0,1,0,2,0,0,0,0,0,0,0,0,0,0,0,1,2,1,1,0,0,0,0,0,1,0,0,1,0,0,2,0,0,0,1,0,0,1,0,2,2,1,0,0,0,3,0,0,1,0,0,0,0,0,0,0,0,0,0,0,0,0,3,0,1,1,1,0,0,0,0,0,1,1,0,0,1,0,0,0,1,0,4,0,0,0,0,0,0,0,2,0,0,0,0,1,0,0,0,1,1,0,0,0,1,0,0,0,0,0,1,0,2,0,1,0,1,0,1,6,0,1,1,0,2,0,2,1,0,0,2,0,1,0,0,0,0,0,0,1,1,1,0,1,1,0,0,0,1,0,1,1,0,0,0,0,0,2,0,0,11,0,0,0,1,0,0,0,0,1,0,0,0,0,1,0,0,0,1,2,0,0,1,1,1,0,0,0,0,0,0,3,0,2,0,1,0,0,0,0,0,0,0,1,2,1,0,0,0,0,3,0,0,1,0,2,1,3,0,0,0,0,0,1,0,3,0,0,0,0,2,0,1,0,0,1,0,0,0,1,0,0,0,0,0,0,0,0,0,0,0,2,0,1,0,0,2,3,2,0,0,0,0,0,0,1,0,0,0,0,3,0,0,2,0,0,2,2,1,0,2,0,0,1,2,0,0,0,0,0,0,0,1,0,0,0,0,0,1,0,0,1,0,0,0,1,0,0,2,0,0,0,0,0,2,1,0,0,0,1,2,0,0,0,1,0,0,1,0,0,1,0,0,0,0,0,0,0,0,0,0,0,0,0,2,0,0,0,0,0,0,0,0,0,0,0,0,0,0,0,0,1,0,2,0,0,0,0,1,17,0,0,0,1,0,0,0,0,0,0,4,1,0,0,0,8,0,4,0,0,0,2,0,1,0,0,2,1,0,0,1,0,0,0,0,0,1,0,0,1,0,0,0,0,0,0,0,1,0,0,0,0,0,0,0,0,0,0,0,3,0,0,0,0,0,0,0,0,0,0,0,0,0,0,0,0,0,0,0,1,0,0,0,0,1,0,0,0,3,0,0,0,0,0,0,0,0,2,0,2,0,0,0,0,1,0,0,0,6,0,0,0,0,0,0,0,0,0,0,0,0,0,0,0,0
K05 The Long Walk,king,3870,2425,1783,2201,1592,923,1880,1031,1649,1307,862,1482,792,158,254,728,853,540,389,760,562,472,306,568,210,328,200,622,342,179,199,519,294,283,203,209,423,393,115,329,306,406,310,302,209,157,210,167,184,250,298,382,232,217,190,173,224,168,179,284,246,218,128,274,189,184,146,216,79,130,157,135,133,159,167,109,130,168,102,78,156,150,63,174,106,219,65,72,111,102,78,172,116,145,157,95,141,97,102,77,64,184,149,65,225,39,137,180,112,102,97,72,56,110,80,7,127,67,111,68,128,47,98,122,8,57,167,90,56,61,51,95,119,56,73,89,17,160,83,64,14,102,17,89,59,87,79,49,47,84,43,84,80,71,73,87,24,44,106,109,40,127,70,55,71,50,77,32,37,60,48,16,38,64,16,15,40,27,79,80,28,69,31,28,57,41,57,31,53,26,42,25,54,45,52,75,38,14,19,20,58,118,19,52,37,2,43,41,52,63,74,40,19,8,66,37,55,25,54,27,29,31,48,43,16,43,19,43,16,64,60,71,28,88,35,5,38,22,56,32,31,18,19,23,32,39,48,78,77,80,40,32,53,99,131,35,36,49,33,28,41,31,66,61,28,31,43,27,55,42,71,30,24,37,34,25,9,20,38,18,5,1,48,27,99,14,34,7,18,39,17,5,5,15,37,26,29,26,14,36,33,27,37,15,100,17,13,41,30,17,23,13,34,25,17,20,32,28,26,37,29,26,32,117,5,4,62,38,25,10,43,12,53,32,168,45,47,10,22,23,43,12,11,2,23,37,29,34,22,38,21,31,34,20,62,6,6,39,9,22,41,23,17,3,28,40,23,36,34,34,28,34,35,2,31,52,36,10,13,32,9,16,42,15,28,11,0,58,32,31,20,14,25,81,18,23,20,13,11,54,21,38,15,7,11,13,43,51,10,17,26,28,35,28,24,13,22,30,22,8,27,1,5,15,6,39,19,7,12,15,15,16,3,42,1,20,28,13,2,14,46,13,14,28,20,42,77,19,10,28,10,20,24,26,37,15,5,21,104,13,9,4,0,9,6,5,27,17,0,8,14,41,9,23,9,12,17,7,0,176,10,24,49,7,1,29,19,14,31,5,10,4,27,22,8,37,33,20,5,13,36,7,0,9,7,15,16,12,17,0,9,14,10,11,14,20,0,14,50,22,8,16,12,17,9,5,28,6,14,13,6,50,24,14,7,4,13,28,19,6,53,5,9,3,45,20,0,7,36,38,12,10,6,0,25,13,26,8,8,3,6,12,15,4,15,11,22,10,1,16,7,8,14,18,7,4,4,1,16,7,21,15,6,30,3,21,6,18,6,13,15,20,6,1,17,13,9,11,7,11,19,35,10,5,6,0,0,12,6,8,7,12,27,15,1,8,18,4,12,11,10,7,9,9,15,9,5,44,37,5,12,11,2,70,63,0,11,4,7,10,12,8,126,0,32,32,16,4,5,46,2,18,11,7,43,16,13,8,91,1,4,7,13,13,0,20,37,17,9,21,35,10,7,2,3,19,10,12,19,2,8,6,6,9,19,11,1,9,9,6,11,2,7,11,1,18,5,2,6,90,10,24,10,17,6,61,1,42,4,12,6,20,9,22,5,23,4,14,8,11,23,15,8,6,12,18,28,6,7,12,7,5,55,15,0,27,4,10,3,16,14,0,3,3,3,0,11,13,4,11,8,9,17,1,1,17,1,9,20,13,6,7,9,24,2,13,12,11,7,4,13,9,35,0,0,5,8,9,18,11,24,9,2,6,16,7,10,8,11,1,1,9,0,14,9,4,0,3,0,18,13,5,6,11,4,9,7,11,4,9,1,7,22,0,9,7,19,0,9,7,20,1,3,21,33,17,16,9,19,17,1,3,24,19,0,15,18,2,0,3,10,1,17,12,22,3,3,0,14,1,11,21,3,1,0,2,5,7,1,6,16,6,5,18,4,11,7,0,6,21,17,33,13,2,0,25,1,18,0,6,16,7,6,13,1,8,6,5,9,18,11,4,6,5,9,3,5,2,7,10,5,2,11,13,10,23,28,3,18,6,10,0,51,0,3,4,4,2,11,14,11,4,0,1,2,5,7,0,25,3,17,11,7,18,2,9,5,21,22,12,2,21,6,6,11,4,1,6,22,7,6,17,7,21,2,9,4,10,6,7,0,3,10,3,5,11,4,1,2,6,10,12,11,2,2,12,5,4,2,5,0,22,14,0,7,31,3,0,16,4,12,37,5,6,5,2,0,4,26,0,11,0,4,0,7,14,0,0,3,16,7,6,2,4,1,8,7,0,0,7,0,5,4,1,9,0,3,1,8,4,5,4,6,1,7,13,11,6,4,11,29,1,0,0,7,0,9,10,4,9,0,13,1,10,11,0,13,8,8,5,5,27,0,2,4,1,17,3,0,0,0,0,1,5,5,5,3,0,2,22,0,8,3,10,4,4,8,4,10,1,0,0,2,7,10,6,9,14,11,2,4,12,3,8,0,6,9,15,6,6,9,10,4,12,0,3,0,123,11,16,6,3,3,3,19,1,13,7,1,3,15,16,2,3,6,11,7,3,3,8,5,2,1,4,8,3,15,0,1,0,12,2,6,6,6,4,0,2,26,3,1,4,7,24,0,0,9,8,1,1,0,4,8,3,3,18,2,3,21,0,0,4,4,5,9,1,0,2,12,0,6,14,0,11,4,11,9,9,75,8,8,0,3,7,2,5,2,2,7,13,0,10,8,7,7,0,0,1,4,6,8,1,16,3,13,6,0,5,0,18,8,0,2,3,3,0,2,8,0,4,7,8,2,0,75,2,0,2,10,5,4,6,5,8,1,0,13,2,0,9,19,0,5,3,0,4,5,1,8,7,0,1,3,0,0,4,4,2,0,5,4,3,22,1,11,8,12,2,7,2,0,3,4,6,5,6,5,8,0,5,7,7,10,1,10,3,4,5,1,4,3,3,2,2,0,11,19,21,1,3,9,9,5,0,2,5,2,3,0,2,0,2,7,2,1,17,0,2,8,5,21,14,6,0,9,13,3,39,6,2,1,5,4,1,1,0,0,9,6,1,1,7,8,76,8,3,2,0,6,11,0,3,10,3,1,5,0,1,0,4,65,0,3,9,6,9,2,5,8,9,7,5,13,0,2,3,0,0,6,5,0,0,0,4,0,20,1,0,4,0,3,11,0,3,0,8,20,7,7,8,7,0,0,2,1,4,1,0,4,4,29,2,0,0,4,8,2,3,4,10,7,0,0,2,2,10,3,7,3,1,5,11,0,12,11,0,3,1,12,0,0,1,2,0,1,4,7,0,5,3,2,2,5,5,0,10,5,5,3,4,6,13,1,2,1,6,4,15,1,2,4,7,5,1,4,3,0,0,7,7,8,0,0,0,0,2,0,4,3,1,5,3,2,0,3,18,5,0,0,1,1,3,11,1,6,1,26,4,0,0,0,2,3,3,2,0,2,0,1,3,16,0,3,3,3,2,2,0,5,0,5,16,12,0,11,20,5,4,9,2,3,5,4,1,5,1,56,26,4,10,4,11,4,0,5,11,7,9,8,1,2,16,6,3,6,1,2,0,6,11,0,5,32,4,1,4,5,0,2,3,0,0,0,2,0,0,0,2,11,4,10,10,1,1,3,2,0,2,0,4,4,8,2,0,0,8,2,0,1,6,4,0,5,2,3,3,5,8,0,1,2,1,5,5,0,0,0,3,3,0,0,1,12,2,1,4,2,0,0,6,1,4,6,4,4,3,5,0,10,4,4,4,10,2,2,9,1,0,0,1,7,7,16,3,4,2,1,6,12,4,11,0,5,1,14,3,5,1,11,0,10,2,9,1,2,1,8,7,3,1,0,3,2,1,7,13,0,2,0,3,2,0,4,4,2,0,12,2,7,0,5,2,12,0,4,1,0,0,32,6,1,3,9,1,0,2,3,14,4,3,6,3,2,0,1,13,0,8,1,13,3,2,1,7,1,13,0,6,1,0,0,2,2,1,2,0,0,4,8,0,2,4,2,21,0,12,5,0,0,1,4,11,0,5,5,1,2,5,7,14,0,0,0,0,0,0,1,1,2,3,5,6,1,2,1,3,0,0,1,12,7,13,0,0,13,1,0,15,0,0,0,32,2,1,28,8,11,1,0,6,0,6,0,3,2,3,12,2,1,1,11,2,0,9,3,1,9,3,1,2,11,3,3,2,4,1,2,2,1,6,4,4,0,0,1,3,0,1,7,5,0,0,7,1,6,3,7,6,0,0,6,15,0,3,1,1,0,0,1,0,0,4,3,4,0,1,0,1,0,3,0,2,0,0,1,1,6,3,5,1,3,0,0,3,4,10,2,0,7,1,0,1,0,2,1,0,0,2,0,0,2,1,0,2,1,4,0,4,8,11,1,5,1,3,3,3,0,1,0,13,7,0,6,5,5,2,0,0,0,5,3,2,0,0,0,1,2,6,1,0,2,9,6,2,9,3,10,0,1,0,0,0,0,0,2,1,6,1,0,0,4,0,2,10,0,3,3,3,0,2,0,3,0,6,4,8,1,0,0,7,7,3,2,1,3,0,4,1,1,0,3,2,3,2,4,6,10,1,2,2,17,3,5,0,0,8,0,0,7,1,18,4,0,5,2,13,1,20,0,7,11,0,2,6,2,2,0,3,4,0,0,0,39,2,0,0,5,9,2,1,13,0,1,3,2,13,0,2,0,8,4,1,2,3,0,8,0,3,2,1,1,1,3,0,0,4,0,0,0,0,2,3,5,4,0,2,0,0,0,2,12,0,2,2,0,0,0,1,2,3,2,7,4,1,0,3,7,20,3,3,12,2,7,0,2,7,2,3,0,2,1,2,3,0,3,0,5,2,12,4,0,2,0,0,16,2,7,2,2,0,2,0,3,0,4,0,0,7,1,0,3,0,0,0,4,2,0,0,1,0,1,6,3,0,1,7,1,3,2,2,1,3,1,0,3,0,0,0,0,6,0,10,3,1,4,0,0,1,0,2,2,1,1,0,0,1,1,4,2,0,5,3,1,1,0,0,1,1,2,0,5,0,7,6,14,5,6,0,1,1,3,1,0,5,0,5,3,16,4,6,6,0,1,10,0,2,5,6,1,1,2,2,1,7,0,1,1,2,1,3,1,11,6,117,1,0,0,1,1,7,3,16,0,6,0,0,0,1,9,4,5,0,2,1,0,7,1,0,2,3,2,7,4,4,4,1,0,0,4,3,0,2,0,3,2,3,3,12,3,1,1,11,2,2,4,0,1,6,1,8,5,0,2,0,5,0,0,0,3,0,15,0,0,4,0,0,1,3,0,0,12,0,1,1,1,4,5,0,0,0,2,0,1,0,0,1,1,8,1,4,0,5,2,2,2,0,0,0,0,1,1,0,0,3,2,1,4,1,1,15,3,7,1,0,0,3,2,3,1,0,2,9,0,1,4,4,0,1,0,0,0,2,1,1,2,0,5,3,1,0,0,0,2,1,2,10,1,1,2,3,0,5,1,2,2,0,11,7,6,2,0,0,0,5,0,0,5,0,3,0,10,10,3,0,0,1,20,5,0,0,0,5,0,0,0,1,2,1,1,0,1,6,0,3,0,6,5,0,4,4,4,0,0,1,0,2,7,0,1,1,2,2,0,11,1,3,0,0,0,0,8,0,0,1,0,3,2,3,0,0,0,2,0,1,3,1,2,0,1,3,1,0,3,4,1,2,2,4,6,1,7,0,0,2,5,4,2,0,1,2,0,0,0,0,1,1,0,1,0,1,2,1,3,2,0,5,2,0,1,3,0,0,0,2,1,0,0,3,0,0,1,1,1,0,4,1,1,1,0,0,2,1,1,3,3,2,0,0,2,1,2,1,1,1,1,3,1,3,0,5,13,1,6,5,2,2,10,0,3,3,0,1,2,2,0,2,1,8,4,9,0,3,0,1,1,6,4,0,6,0,0,1,1,0,0,1,5,0,1,0,0,4,0,2,4,4,2,2,9,6,1,1,1,1,3,1,3,0,1,4,7,0,2,0,1,0,5,2,0,0,1,4,1,3,2,2,0,1,1,0,1,0,2,0,1,0,0,4,0,0,5,0,3,6,0,1,0,0,4,1,0,0,2,1,0,3,0,2,0,2,1,0,6,1,0,0,4,5,0,1,0,0,4,25,1,0,2,1,0,5,1,2,12,0,0,0,0,3,0,5,0,0,0,4,1,0,16,0,45,3,1,2,0,1,3,1,5,2,2,0,1,1,0,10,0,0,7,2,2,0,0,1,2,0,2,2,0,0,0,2,0,0,0,0,2,0,2,5,0,4,0,4,0,1,0,0,5,14,0,3,0,2,1,0,8,2,2,0,3,4,2,1,4,0,2,2,1,1,0,0,3,0,0,0,8,0,7,1,0,0,0,2,8,1,0,0,0,3,5,1,0,1,2,0,8,0,0,1,1,5,1,2,0,4,0,3,0,5,0,1,1,11,0,4,0,0,5,0,5,1,0,8,0,0,2,3,0,0,13,1,4,2,0,0,3,0,4,3,4,4,0,0,0,0,0,8,0,0,2,0,4,1,0,0,5,0,0,1,0,0,0,1,5,1,0,1,0,2,1,0,1,9,1,0,0,3,0,2,1,2,0,2,0,1,1,1,1,2,1,0,2,7,0,2,0,0,1,4,1,0,0,0,3,0,6,2,0,0,2,3,0,0,2,1,1,2,3,5,0,0,0,0,1,0,0,1,1,1,0,4,2,0,0,3,1,16,10,0,0,0,2,0,0,4,0,0,0,0,0,0,5,8,1,2,0,0,0,3,0,2,0,0,1,3,2,1,0,2,1,9,0,2,0,3,3,2,3,0,1,0,0,0,7,1,0,3,4,2,3,2,3,0,1,0,1,0,2,0,5,2,2,1,0,1,5,0,1,1,0,6,0,0,0,3,0,3,2,3,3,2,0,1,0,0,2,0,4,0,0,0,0,0,1,1,4,0,0,2,33,0,8,6,0,2,3,0,0,4,0,0,0,7,0,0,0,0,1,1,2,2,1,2,1,0,0,0,12,0,1,2,0,3,0,0,3,0,0,3,0,0,0,2,0,1,1,0,5,2,2,7,2,0,0,1,3,3,0,1,4,4,0,0,3,1,2,3,3,2,20,1,0,3,0,0,0,8,3,0,2,3,0,4,2,0,0,4,3,0,0,3,2,5,0,2,2,0,0,1,1,1,1,0,4,0,0,2,0,0,1,20,2,1,1,3,7,2,1,0,7,24,2,1,0,1,0,1,0,0,6,2,0,0,1,1,5,1,1,1,1,0,3,2,6,7,1,5,0,2,3,0,0,2,0,0,0,0,7,1,1,0,0,10,7,1,3,0,2,0,0,1,1,2,1,0,5,1,0,0,0,3,5,1,0,0,5,0,1,1,9,1,2,0,0,2,1,0,6,0,0,0,0,3,3,2,1,1,0,0,0,2,0,0,0,1,2,2,7,0,3,0,0,2,0,1,0,1,0,0,4,0,0,0,2,0,0,1,1,0,3,0,2,0,1,2,0,0,0,0,9,11,1,5,2,4,4,1,0,3,0,0,0,0,4,4,0,1,1,2,0,0,1,0,1,0,0,0,0,2,3,0,3,0,0,0,0,5,3,1,0,1,7,1,0,1,2,1,1,3,0,4,0,1,4,1,0,0,3,2,0,1,0,0,0,0,2,1,1,0,0,1,0,0,1,0,0,0,0,5,1,0,1,3,1,1,0,0,4,0,1,0,0,0,0,0,0,0,0,3,0,0,0,0,3,1,0,2,0,0,0,0,0,0,0,0,5,2,0,6,0,4,0,2,3,1,0,2,0,2,0,3,1,0,2,1,3,1,2,0,0,0,1,1,2,0,1,0,1,1,0,2,1,0,0,0,0,0,0,0,2,0,0,0,0,1,0,0,1,1,0,0,1,9,2,1,0,2,3,5,0,1,1,0,1,1,0,3,0,0,2,1,0,0,17,2,1,0,2,0,4,3,1,0,0,1,0,1,0,5,2,1,4,1,3,1,0,6,8,0,0,0,0,1,0,0,5,0,1,0,0,1,9,0,1,0,0,2,7,0,0,0,3,0,0,0,4,0,0,0,0,1,0,0,0,0,0,1,0,0,1,2,0,0,0,0,6,2,0,1,0,7,1,1,3,0,0,0,2,0,0,1,0,2,0,0,0,2,2,4,9,4,0,0,0,0,0,0,6,0,0,1,0,1,0,0,0,0,0,1,1,0,3,1,0,0,4,2,0,0,1,0,4,3,1,0,2,1,2,0,0,1,6,1,1,0,0,2,2,2,15,3,2,8,0,0,0,1,1,1,1,0,0,0,4,1,2,1,0,1,0,2,0,0,1,0,2,2,1,0,0,0,4,3,0,1,0,0,2,0,3,0,0,0,0,4,0,2,0,0,0,0,1,0,2,3,1,3,0,0,0,0,0,1,1,0,0,0,6,1,0,0,11,2,6,1,0,9,1,0,0,1,0,2,0,0,0,0,0,0,5,0,0,0,0,0,0,0,0,0,1,0,3,5,3,1,0,0,0,2,1,1,0,1,1,0,0,2,0,1,0,0,2,6,2,1,2,0,0,0,0,1,1,0,0,1,1,0,0,1,0,0,0,0,1,6,0,0,3,0,1,2,1,1,0,1,2,2,1,0,0,1,0,2,1,5,0,0,0,1,2,0,0,3,8,1,0,1,0,0,0,1,0,3,0,2,0,0,1,5,0,0,0,0,5,0,0,1,0,1,0,0,2,0,1,3,0,0,0,0,3,2,0,0,2,3,0,0,5,3,0,0,1,0,0,0,1,1,0,1,2,2,0,0,2,0,0,1,1,4,0,0,1,2,4,5,2,0,0,0,0,0,0,0,0,0,0,0,4,0,1,1,1,4,1,1,2,1,1,10,0,0,0,1,0,1,1,0,2,0,0,2,1,2,0,0,1,3,1,1,0,0,4,3,0,1,1,1,0,2,0,2,2,0,1,0,4,3,1,2,0,2,3,1,1,0,4,2,1,1,0,7,0,0,0,0,0,0,2,1,1,0,4,1,2,3,2,1,2,0,0,0,2,0,2,2,0,1,1,0,0,1,1,0,2,0,0,0,0,1,3,2,1,0,3,0,6,0,0,1,0,1,2,0,0,5,1,0,1,1,0,2,12,3,0,2,1,1,7,1,1,0,0,0,2,4,1,0,0,0,1,0,0,0,0,7,2,0,2,0,7,0,3,0,1,2,2,0,0,0,1,3,0,0,3,2,7,0,0,0,0,0,2,0,6,1,3,0,3,2,0,0,0,0,0,2,0,0,0,0,0,0,0,2,0,3,0,4,1,0,0,0,0,1,0,0,0,0,0,1,0,3,0,1,1,1,5,1,3,0,0,0,1,1,0,0,0,0,0,0,1,0,1,0,3,0,2,4,1,3,2,0,0,1,0,0,1,0,0,1,1,1,4,0,0,0,3,0,0,0,0,2,4,2,1,0,0,2,0,0,1,5,0,0,0,0,3,2,0,0,0,0,6,0,0,3,0,2,2,2,0,0,0,1,0,0,0,1,0,0,4,5,0,0,1,0,3,0,0,0,3,1,0,0,4,0,0,0,0,7,3,2,0,1,0,1,0,1,0,0,0,0,0,2,1,0,1,0,0,1,1,0,1,0,0,0,1,0,0,0,3,2,0,0,2,1,1,5,1,0,3,1,0,0,1,0,0,2,1,1,3,1,0,2,1,0,1,2,1,1,1,2,1,0,0,0,0,0,1,0,0,0,1,1,0,1,0,0,2,1,4,0,0,3,1,0,0,7,0,0,0,0,4,1,1,0,1,0,3,2,2,0,1,0,1,0,1,4,1,0,1,0,1,0,2,7,4,4,0,0,0,5,3,0,1,2,0,3,2,1,2,1,0,0,1,0,1,0,0,0,0,0,0,0,0,0,1,0,0,0,0,0,0,1,1,2,0,0,10,1,1,0,0,0,0,2,0,3,1,0,0,1,1,3,1,1,0,1,2,1,0,0,2,0,1,3,0,3,1,0,0,4,2,1,0,0,0,2,0,1,2,0,4,0,0,0,0,0,3,2,1,0,0,0,1,0,0,3,2,21,0,0,2,1,0,0,0,0,1,4,1,0,0,0,0,0,3,0,1,0,0,0,1,0,0,0,0,1,0,2,1,0,6,1,12,0,0,0,7,0,1,4,0,4,1,0,0,3,0,0,0,0,4,0,1,0,0,0,3,1,0,0,5,0,1,1,5,0,0,1,1,0,0,0,1,0,0,0,0,1,0,1,0,0,1,0,3,0,1,2,0,0,0,0,0,0,3,2,0,6,0,1,1,0,1,1,0,1,0,3,0,0,2,0,0,0,2,1,0,0,2,0,0,0,0,4,0,0,0,2,2,1,0,1,1,4,0,5,0,0,0,2,0,3,0,0,0,0,3,0,2,3,0,0,0,0,6,0,1,5,0,0,0,0,0,0,1,0,2,1,3,7,0,0,2,0,0,2,1,3,0,0,0,0,0,0,14,1,0,0,0,0,0,0,2,2,1,0,0,2,4,0,0,2,0,0,2,0,2,0,6,2,1,0,0,1,7,0,1,0,0,1,0,0,2,0,2,0,0,1,1,0,0,0,3,0,0,0,0,0,0,0,3,1,0,0,0,4,0,0,0,0,2,0,0,2,1,0,0,0,0,1,2,0,0,2,1,0,1,1,0,2,0,2,1,1,0,0,0,0,0,0,5,0,7,1,1,2,0,0,0,0,0,1,4,0,1,4,0,1,1,0,0,1,0,1,3,0,0,4,2,0,5,0,2,2,1,0,2,0,0,0,1,2,0,1,0,1,1,0,0,0,0,0,0,0,0,0,0,1,0,0,0,0,1,0,0,4,2,0,0,0,0,0,0,0,1,0,0,0,0,3,1,0,0,0,0,1,2,1,0,0,0,1,0,0,0,0,0,0,5,0,1,0,2,7,0,0,0,0,0,2,3,0,1,1,0,3,0,0,0,0,2,0,1,2,0,0,4,0,1,0,0,5,0,1,0,0,0,0,1,0,0,0,1,0,1,0,0,0,0,1,0,0,0,0,0,0,0,1,0,0,1,0,0,1,6,0,0,1,0,0,0,0,0,0,1,1,1,0,0,0,0,0,1,0,0,0,10,0,0,0,0,0,0,0,0,0,0,0,0,0,0,0,0,0,0,0,0,0,2,0,0,0,0,0,0,0,0,0,0,0,0,0,0,0,0,0,0,0,0,0
K06 The Dead Zone,king,7464,4288,3411,3940,3213,1676,2949,2322,2437,2148,1895,2052,1813,1073,1079,1187,1760,941,920,1131,1004,920,658,959,403,554,384,527,658,617,486,658,502,603,599,544,526,654,246,593,498,566,512,497,431,315,411,344,444,380,479,397,314,404,370,289,569,298,335,390,401,330,362,364,404,307,201,395,276,243,272,261,209,229,254,209,259,202,215,169,201,231,301,307,252,272,136,221,120,152,152,243,183,156,241,176,208,158,262,148,171,270,283,137,241,103,188,264,206,213,233,176,50,177,138,87,175,195,144,174,201,156,215,236,115,132,183,118,83,143,112,221,171,90,186,139,58,205,122,95,128,88,25,145,160,182,97,127,103,140,107,175,140,108,135,127,126,109,119,105,166,137,106,137,114,94,119,79,126,130,76,147,115,108,76,90,74,89,117,129,65,84,217,81,90,102,71,58,76,56,67,76,74,87,84,128,96,58,71,14,70,143,97,64,62,106,72,66,73,107,122,71,51,51,66,48,69,60,84,87,39,88,70,82,82,65,60,90,38,123,83,107,74,161,49,6,75,57,74,49,63,64,61,70,72,82,109,114,57,84,86,39,54,46,47,72,64,48,64,65,65,75,99,80,61,50,38,59,72,50,88,50,71,57,49,43,42,42,95,61,47,33,43,66,121,44,36,55,37,21,42,46,67,80,83,37,54,67,47,48,87,65,76,49,159,45,46,61,36,71,42,25,42,48,43,42,33,63,38,42,67,63,39,107,32,36,164,46,69,50,45,98,62,45,31,68,86,22,45,65,50,46,30,48,50,40,66,108,33,46,51,32,47,54,84,9,52,49,38,116,56,33,37,21,29,85,27,26,28,48,59,11,51,22,49,61,36,33,62,57,25,36,48,42,20,37,0,31,29,71,56,54,45,46,51,41,34,28,62,42,83,34,51,30,40,39,38,48,33,46,34,41,51,120,25,39,55,29,19,30,44,5,12,47,14,36,30,35,48,33,44,23,29,76,5,65,24,29,57,60,27,36,24,34,60,47,98,66,15,36,18,29,18,34,53,35,27,34,36,44,68,17,0,15,17,51,35,28,13,16,23,53,43,15,19,25,14,20,0,18,20,49,31,16,22,66,38,16,85,24,40,21,45,23,30,22,27,29,27,44,36,29,26,14,46,13,10,21,44,24,18,32,36,31,38,29,0,22,33,14,40,30,38,30,29,13,39,25,28,56,94,43,26,35,15,15,43,49,20,35,33,17,18,32,41,34,0,8,25,20,20,38,47,28,48,25,50,22,22,21,10,42,25,29,34,30,17,11,43,46,66,26,27,28,14,37,21,7,15,18,26,59,15,12,5,32,8,35,72,30,31,35,17,28,14,36,2,19,10,29,36,41,38,21,3,0,4,37,18,20,16,36,25,31,7,27,19,14,25,38,7,18,17,29,20,25,24,31,18,27,15,18,3,19,10,0,38,21,20,23,35,4,9,12,23,31,16,30,39,34,0,20,21,28,31,17,10,10,18,32,24,26,28,27,57,33,32,36,18,18,31,12,11,10,27,15,22,20,27,20,22,18,20,27,30,12,1,21,12,20,26,13,13,28,7,28,8,3,20,21,28,6,19,23,41,22,9,27,43,25,10,22,7,21,13,79,7,9,13,16,56,9,19,1,22,17,50,13,20,23,8,28,12,9,0,66,30,9,14,16,46,48,22,52,8,14,20,34,23,11,23,18,25,12,8,15,26,19,16,43,18,15,21,35,14,43,19,19,23,20,22,13,43,18,1,12,15,22,13,12,12,17,7,24,28,14,11,28,9,13,22,11,2,19,7,10,11,34,2,23,36,17,14,23,24,11,30,16,11,27,17,15,36,7,20,17,9,1,12,36,31,16,15,16,48,17,13,19,18,26,7,8,11,16,7,19,38,33,0,15,34,6,8,15,21,10,15,0,17,18,16,32,6,4,16,14,9,4,10,12,16,8,16,15,13,36,21,0,14,12,14,33,17,17,2,18,26,32,1,8,23,17,14,18,7,9,10,15,8,12,17,13,31,5,22,16,11,0,19,20,9,14,21,26,38,12,31,14,40,17,14,1,26,2,13,18,11,27,9,24,20,6,8,7,21,11,6,0,43,3,14,30,12,31,12,17,15,25,10,23,14,11,7,6,10,9,12,17,15,19,8,14,21,9,6,22,18,19,15,13,0,19,25,62,17,4,41,9,12,15,8,2,6,11,1,8,8,8,6,2,0,12,19,2,11,17,10,0,8,8,13,21,19,15,12,4,4,33,25,0,11,0,18,0,7,36,0,1,12,44,9,9,15,60,10,11,11,1,3,10,5,10,25,2,8,10,8,11,17,29,19,7,12,14,12,39,11,19,14,36,16,3,2,7,18,10,14,13,41,30,6,9,20,9,9,0,18,20,7,25,9,12,0,4,4,3,12,16,0,0,0,8,25,9,18,13,20,0,18,5,5,1,9,21,5,6,12,9,5,1,2,0,13,14,3,26,34,17,19,6,17,8,11,5,12,12,10,8,12,15,7,11,3,17,0,3,4,61,13,9,21,20,20,11,20,7,13,26,9,4,1,29,12,18,16,34,29,15,6,15,37,1,19,13,1,6,20,20,13,5,14,24,17,17,21,7,19,10,7,24,8,6,4,16,6,2,8,18,2,1,30,12,16,7,12,16,2,6,7,0,38,3,10,3,14,80,2,3,7,0,13,22,0,8,4,5,4,15,1,8,18,0,9,12,58,9,4,21,8,19,0,2,23,13,37,0,0,8,4,11,17,9,10,2,14,7,11,4,12,10,6,7,4,8,6,0,4,9,4,28,8,3,8,1,4,5,3,6,7,5,10,22,6,8,10,10,15,47,0,8,22,0,6,12,0,11,10,1,21,13,0,16,18,3,1,8,5,20,2,60,9,7,4,10,13,21,19,5,7,30,0,6,9,17,12,12,4,7,3,20,9,20,11,5,12,30,8,4,8,2,0,1,0,10,13,19,17,34,5,36,12,4,10,0,5,6,9,2,7,1,2,9,9,11,13,16,24,5,8,10,12,20,22,2,8,57,12,6,6,3,17,0,17,3,13,4,14,22,5,6,3,9,9,0,5,2,12,10,12,12,6,6,15,24,14,1,0,6,0,7,1,0,8,17,4,10,10,3,9,5,28,14,23,3,24,3,1,0,12,5,2,0,0,5,1,18,2,0,12,3,11,22,22,8,0,8,21,7,3,23,14,2,8,5,3,8,11,2,10,5,5,4,0,0,2,6,1,3,8,10,11,2,13,17,16,15,15,11,11,9,7,11,0,11,2,0,17,14,8,14,10,9,6,1,7,7,18,0,8,8,8,7,12,6,1,13,7,13,7,6,4,5,15,7,5,3,14,19,15,14,6,11,11,9,3,12,1,0,2,5,4,0,1,0,0,4,0,15,13,5,7,0,7,43,22,5,7,0,45,4,1,13,20,4,6,6,11,6,1,9,6,4,8,3,3,4,6,2,7,2,35,7,7,5,7,8,11,14,17,4,11,3,14,2,3,2,7,2,6,6,15,3,4,1,9,23,4,12,14,13,15,10,13,0,11,16,17,28,21,8,7,14,16,8,3,3,4,6,1,17,0,15,12,49,9,10,10,1,10,11,28,2,0,17,5,6,13,7,20,10,12,4,7,10,5,5,0,8,0,12,2,7,9,0,2,8,1,3,1,4,4,1,0,4,5,0,5,8,17,7,7,2,14,5,2,3,11,10,15,1,2,5,6,1,12,7,5,5,0,7,11,9,3,3,11,12,10,0,10,5,5,15,5,7,1,20,3,4,0,6,23,18,21,8,2,1,2,11,7,5,11,0,5,4,0,14,14,0,12,8,10,1,7,2,3,2,7,9,6,2,2,12,12,7,7,3,10,2,0,8,7,22,1,3,8,1,8,8,4,2,8,3,11,0,8,6,17,7,13,2,29,1,6,2,0,4,1,3,11,4,3,6,5,19,3,5,1,4,3,13,9,5,5,1,13,7,16,13,12,0,1,1,2,3,8,5,5,0,3,7,32,11,4,7,4,19,3,9,3,2,15,6,1,4,7,1,3,7,6,9,7,3,5,5,5,2,3,1,1,4,9,8,10,1,2,8,5,2,11,4,13,7,0,0,7,5,0,3,0,0,1,28,6,10,1,2,11,5,2,9,21,8,0,16,3,8,16,10,9,2,2,4,9,21,9,12,16,13,3,0,6,7,4,4,18,1,3,6,0,18,1,3,176,10,5,7,4,1,7,5,0,0,5,3,7,3,7,4,13,5,2,6,0,12,2,1,4,2,11,2,0,8,6,14,0,8,3,4,6,17,0,7,4,0,6,8,14,7,17,2,9,0,0,5,5,14,5,7,7,5,0,3,0,3,3,0,7,1,0,13,4,5,0,18,7,4,3,1,18,4,3,8,6,0,2,8,0,5,1,5,5,1,13,12,3,1,8,2,4,8,6,12,0,0,6,3,5,12,14,4,0,7,6,6,3,4,4,14,3,4,2,7,3,3,2,2,4,0,3,2,4,0,3,6,3,3,7,3,6,1,5,6,0,10,3,9,11,4,1,2,6,8,5,1,7,1,6,9,7,0,11,4,2,3,10,1,13,2,3,2,24,15,2,0,2,11,1,2,1,10,2,4,9,6,11,21,5,19,2,5,9,4,1,7,8,1,2,6,5,5,0,2,10,5,0,1,11,2,5,1,25,3,5,9,5,12,2,1,0,10,5,2,10,6,0,23,0,1,5,9,5,1,4,3,5,4,0,13,4,4,4,5,9,6,5,3,1,5,0,0,6,0,3,3,0,0,4,2,2,10,6,4,2,1,0,4,2,20,2,7,2,1,1,0,6,13,0,2,0,9,1,3,2,0,4,0,5,1,8,8,0,7,0,2,3,3,7,1,2,6,4,1,3,20,5,0,0,6,0,4,1,0,0,2,2,2,1,4,3,0,6,20,7,15,3,2,25,5,9,6,0,5,11,6,16,11,0,0,3,5,7,3,6,9,5,0,0,5,0,11,9,3,1,3,4,5,2,13,6,8,13,3,7,3,6,0,7,0,3,0,3,31,6,5,4,6,13,1,0,4,3,4,7,0,3,9,0,5,3,1,1,0,2,2,2,2,2,28,6,3,17,1,2,5,0,7,7,7,5,9,2,3,1,4,0,1,3,5,2,6,7,6,4,3,2,1,23,4,29,6,8,5,2,4,5,17,1,8,2,1,7,6,12,5,4,4,6,2,3,3,4,18,0,9,6,1,8,2,2,3,2,7,6,2,0,1,2,2,12,2,16,6,9,0,16,2,5,1,21,4,14,12,17,5,1,6,16,4,1,2,7,1,5,5,5,9,9,3,1,2,2,1,2,2,1,0,13,10,3,6,2,6,1,5,3,0,0,2,1,1,15,2,5,9,5,4,7,1,4,3,0,10,2,0,3,5,3,7,3,1,2,3,13,4,4,5,2,1,0,1,5,22,1,21,2,0,1,3,8,3,10,6,8,3,11,1,6,7,7,4,0,1,21,2,9,0,4,10,7,6,2,3,4,4,6,2,7,0,3,4,2,3,4,7,2,7,4,9,3,0,0,3,1,5,7,3,0,2,0,5,1,4,8,5,0,4,5,0,3,1,10,3,3,5,3,2,2,0,4,3,0,5,1,5,2,4,0,0,2,0,0,6,0,3,0,3,2,5,19,5,5,3,2,8,4,1,2,7,1,8,0,1,5,4,10,1,0,7,10,7,10,0,1,8,3,0,8,1,1,2,2,0,0,2,2,4,6,1,0,1,3,1,4,3,1,3,3,0,5,47,2,0,0,14,0,0,6,0,0,5,0,5,2,4,7,3,11,3,0,11,7,4,0,2,2,3,0,5,4,2,5,3,3,1,21,2,1,5,5,5,14,4,4,2,5,11,12,0,7,7,1,0,3,1,1,8,2,5,3,3,1,5,0,7,1,3,0,4,3,0,5,0,2,0,0,0,9,3,2,0,55,9,7,1,5,3,0,0,3,6,7,9,8,2,7,4,8,1,1,3,4,2,4,8,2,3,7,2,2,7,4,5,2,5,34,6,0,4,1,0,1,0,4,1,4,0,3,1,5,3,6,2,6,9,5,2,1,0,4,4,3,10,0,3,1,9,0,3,7,6,0,2,10,3,0,19,5,1,0,8,3,0,17,5,1,0,2,6,1,1,3,1,6,9,1,0,4,6,5,3,0,0,0,3,9,3,3,2,6,2,0,5,0,1,0,1,1,1,5,3,2,2,0,18,7,1,2,2,1,1,8,1,8,1,9,1,18,6,7,3,5,3,3,2,2,1,4,6,0,9,2,3,1,1,0,0,4,2,0,4,1,5,2,4,8,7,6,1,8,3,3,2,5,5,4,5,0,18,1,2,5,1,0,0,7,2,6,3,1,0,0,8,35,5,2,4,3,4,5,2,0,8,1,0,4,6,1,5,3,1,0,7,1,1,0,1,0,4,1,5,6,2,0,3,2,1,3,0,3,1,2,7,2,0,9,4,10,5,0,1,7,3,0,2,2,1,4,11,4,3,9,3,2,0,0,3,0,0,3,0,8,6,1,3,2,3,3,5,0,1,0,5,5,1,0,1,3,2,2,4,0,3,1,11,1,2,0,9,0,3,0,0,2,3,4,12,6,1,2,3,5,0,5,6,1,0,0,7,5,6,2,1,3,0,4,5,1,8,2,4,0,2,2,0,4,5,13,0,0,17,128,0,3,2,0,0,4,0,1,3,4,0,0,4,6,8,6,0,0,1,2,0,0,3,2,2,5,0,3,11,10,2,5,16,0,3,0,0,0,1,0,6,6,3,1,6,4,5,2,7,0,7,0,2,3,5,4,2,7,1,0,4,5,4,4,3,7,3,3,4,3,8,5,0,8,0,3,0,20,0,4,0,0,0,3,2,2,2,0,1,3,0,0,4,0,2,5,6,18,7,1,13,0,1,4,2,1,0,2,1,5,0,3,5,1,4,0,0,2,0,4,1,4,13,3,2,3,0,4,0,2,2,0,2,0,0,1,9,2,6,0,5,1,1,6,1,15,3,0,12,0,3,18,1,14,1,7,6,0,1,5,3,2,4,1,3,1,0,2,3,5,3,4,0,2,7,0,5,3,2,0,0,1,1,1,3,1,3,1,0,6,3,0,8,2,2,1,2,4,0,6,0,5,8,4,6,4,0,3,3,6,4,0,4,3,2,1,7,2,4,1,0,8,2,5,1,1,5,2,23,0,7,7,21,9,7,0,0,2,0,8,5,1,0,3,10,1,6,3,5,0,0,4,4,3,3,0,8,1,0,3,0,13,8,3,4,1,1,2,0,0,2,3,0,0,5,6,7,6,3,11,9,10,2,4,0,2,0,2,3,0,0,3,4,19,5,0,4,15,2,3,3,7,0,3,2,2,1,1,2,0,0,2,7,3,5,4,2,2,2,3,6,3,7,3,0,1,5,2,21,0,7,0,7,3,1,6,9,10,0,7,2,1,7,3,2,0,5,8,3,6,5,3,2,0,4,5,1,3,2,7,0,4,0,1,2,1,0,0,4,1,7,3,1,1,0,1,1,3,4,1,0,2,6,4,1,1,1,1,0,8,2,2,4,3,0,1,0,0,1,23,1,1,0,2,7,1,0,0,0,1,5,0,70,9,1,1,7,0,9,2,6,8,0,0,2,1,6,0,1,4,0,11,5,3,1,2,0,0,2,10,0,5,1,4,0,3,3,6,0,4,2,0,1,2,13,2,2,9,2,31,1,3,9,0,0,13,3,3,3,0,0,2,0,3,3,4,0,2,2,7,0,1,0,4,3,2,3,6,13,2,3,3,5,2,11,10,1,0,6,3,2,0,2,0,1,9,8,2,5,0,0,7,3,5,17,0,4,0,2,4,0,0,0,2,4,1,0,5,0,1,4,0,1,2,2,4,0,2,3,1,6,0,1,0,1,2,2,0,0,7,3,3,3,5,2,1,3,4,1,0,0,0,0,1,0,28,0,3,2,3,0,6,6,3,6,5,1,3,4,5,2,4,1,0,4,2,1,2,8,0,2,3,0,7,0,2,3,0,1,2,3,4,1,0,2,0,2,0,0,4,4,3,4,3,2,0,4,4,6,1,8,3,0,2,5,0,1,4,5,1,0,2,1,6,4,9,3,2,2,1,2,11,0,0,1,2,0,3,3,0,5,0,7,9,2,3,3,5,1,0,15,4,2,0,0,7,4,3,4,2,4,1,3,1,5,5,2,3,2,1,6,2,2,2,2,0,0,5,2,8,4,3,0,3,4,0,1,0,3,2,4,3,1,8,3,4,1,6,2,4,1,0,0,0,2,1,2,5,2,4,1,0,0,3,15,0,3,7,0,2,0,3,0,0,1,1,1,3,5,2,2,0,2,1,0,3,1,1,11,0,1,2,1,0,16,4,1,0,4,1,3,4,0,4,4,0,0,0,4,3,1,6,3,2,0,2,3,0,0,0,2,3,2,1,1,1,0,0,8,1,8,0,0,0,1,0,0,2,0,3,0,0,0,2,1,0,8,1,0,0,2,4,4,2,1,4,2,0,2,0,2,1,0,0,4,1,0,0,0,5,0,1,2,0,1,0,1,3,1,0,3,4,1,1,2,1,16,7,9,1,0,1,0,0,9,1,2,1,2,2,1,0,1,5,5,2,0,6,2,0,2,3,5,6,3,4,0,57,21,0,1,5,3,0,3,1,0,0,2,1,1,1,2,2,1,0,8,0,5,0,0,4,3,1,0,1,7,10,12,2,3,2,0,9,6,0,5,4,5,7,0,1,2,0,3,8,1,0,0,0,1,2,3,6,1,2,4,1,0,2,0,1,2,2,0,1,8,0,0,0,2,3,3,1,2,4,0,3,0,2,0,0,5,1,1,5,1,2,3,2,1,1,3,5,0,1,0,1,1,3,0,0,3,1,0,4,1,3,1,1,1,0,0,3,2,1,0,2,0,3,1,0,7,2,0,0,1,1,3,1,2,0,0,6,1,4,2,15,16,1,1,3,0,2,1,3,5,1,3,0,0,3,0,2,1,3,6,0,0,3,3,1,0,0,7,1,0,0,1,8,6,5,1,0,1,0,0,1,2,3,1,2,17,1,2,0,2,16,1,0,5,2,0,10,1,0,1,0,1,4,0,0,0,0,0,0,3,0,3,1,3,1,2,1,10,3,2,0,4,2,1,0,3,1,4,1,12,1,0,1,1,1,4,2,1,3,4,6,0,8,4,3,1,0,1,5,1,0,1,3,1,2,0,2,0,1,0,0,0,0,0,1,0,2,0,2,1381,0,0,0,0,0,1,0,4,0,1,2,2,4,3,0,1,5,2,2,2,1,3,2,4,0,2,0,5,2,1,1,4,0,5,0,4,11,0,2,0,0,0,4,4,0,4,1,0,0,0,0,0,1,0,4,0,3,1,0,3,0,0,1,1,5,0,2,0,6,3,2,0,0,0,4,2,2,0,0,2,0,1,0,0,5,0,1,8,2,1,0,16,0,0,3,2,2,1,0,2,2,0,2,1,0,1,2,1,8,1,1,3,0,0,0,2,0,6,4,16,3,7,3,0,2,2,3,1,0,2,15,0,0,2,1,3,1,0,0,0,0,1,0,3,0,1,1,0,0,3,1,6,2,2,1,2,4,0,0,6,1,6,2,0,1,1,1,1,0,0,4,3,2,2,0,3,1,1,0,4,1,0,4,3,2,0,0,2,0,1,4,1,4,3,3,1,3,3,2,2,2,5,4,2,0,10,1,0,15,1,1,1,5,0,5,3,1,6,3,2,11,0,2,4,0,0,1,9,0,1,1,1,1,0,0,1,2,1,0,6,5,8,0,1,1,1,1,0,1,0,3,1,2,0,0,0,12,1,1,1,0,2,1,0,5,2,1,4,2,2,4,0,0,2,2,1,3,3,0,0,2,0,2,1,0,0,4,0,0,0,1,0,3,0,5,2,0,1,7,0,2,4,2,0,0,1,7,4,1,0,1,2,0,2,4,4,4,4,5,2,1,3,0,0,2,5,3,1,7,0,0,5,2,3,1,0,0,3,1,3,1,1,2,0,3,0,2,0,0,1,0,0,0,3,4,0,0,0,6,8,0,0,8,1,0,1,0,0,1,4,1,0,0,0,0,0,9,3,0,0,3,0,0,0,0,0,0,1,2,4,1,0,0,1,4,0,3,2,1,21,0,3,2,1,4,3,1,0,0,0,0,0,1,1,2,1,1,1,7,0,2,0,4,0,4,2,0,1,1,1,0,5,6,1,1,2,1,3,2,5,2,4,0,7,1,0,0,1,0,1,1,1,0,1,3,0,2,2,5,3,2,1,0,0,1,2,1,0,0,3,4,2,1,0,5,2,3,0,0,2,2,5,0,2,0,10,0,0,0,2,9,3,1,3,0,2,3,1,2,1,0,2,0,2,3,0,0,0,0,4,3,2,0,0,5,1,3,1,1,7,1,3,2,0,3,9,3,1,2,0,0,0,0,0,1,3,0,1,1,3,4,3,0,0,3,1,1,5,1,0,1,1,0,0,5,4,0,1,3,2,7,1,0,2,0,0,2,0,7,0,1,1,1,1,0,0,0,0,4,1,4,3,2,2,1,2,0,8,3,0,1,0,1,0,0,0,0,0,4,1,2,1,6,1,0,1,0,5,7,4,0,0,0,2,0,0,2,1,0,1,2,1,1,0,2,6,1,0,4,1,0,0,0,0,1,4,1,1,2,1,2,4,0,3,3,1,0,2,0,1,0,5,0,6,9,2,1,0,4,3,0,46,1,6,0,3,6,1,3,0,2,0,1,3,0,1,4,0,0,0,0,0,1,0,2,0,3,9,1,2,0,0,1,1,1,5,0,1,2,2,1,1,0,1,1,0,0,2,3,0,1,0,0,4,0,0,5,2,3,0,1,9,3,3,1,2,0,0,3,6,1,0,0,2,1,0,2,2,0,1,3,3,1,1,2,2,10,0,0,0,2,2,0,8,7,0,2,2,1,1,0,0,1,1,4,1,0,6,4,0,9,1,0,12,1,3,0,1,0,0,3,0,2,0,0,0,1,0,0,0,1,1,0,4,1,1,0,0,0,2,0,1,0,3,0,1,0,0,1,2,0,0,0,0,0,12,3,0,1,0,0,0,0,4,1,0,17,0,49,0,0,0,0,0,1,0,0,0,0,0,0,0,1,0,0,0,0,0,0,0,0,0,0,0,0,0,0,0,0,0,0,0,0,0,0,0,0,0,2,0,0,0
K07 Firestarter,king,7775,4539,3442,3634,3209,1081,3279,2255,2726,2297,1518,1793,2022,1335,1560,1174,2316,1005,856,1105,1000,897,711,788,226,559,261,919,743,383,489,668,512,623,540,516,620,679,232,630,642,544,611,562,390,372,453,340,614,459,464,616,427,414,381,323,698,277,397,399,350,277,315,407,253,283,253,352,178,217,299,124,192,211,321,275,333,272,202,209,211,175,281,281,266,303,167,209,188,169,112,272,256,175,239,192,200,143,207,175,171,370,282,173,269,129,206,295,186,233,191,160,79,176,124,105,195,177,141,143,151,181,226,223,179,138,166,114,125,122,112,222,115,90,136,182,34,192,139,119,95,91,14,99,164,143,116,177,103,141,108,175,106,95,133,49,74,87,140,171,94,160,117,140,112,143,109,83,123,112,33,87,112,104,86,80,58,83,124,116,83,110,178,72,123,42,89,53,93,48,72,45,118,75,100,106,125,32,61,14,67,123,77,91,65,31,64,65,67,110,39,93,117,58,57,54,78,94,53,89,56,83,72,105,34,94,60,59,43,114,103,136,78,129,51,11,71,60,100,46,58,44,66,63,97,81,109,121,55,60,77,74,70,60,50,50,44,82,68,42,75,98,101,85,55,33,73,50,69,76,89,43,81,79,42,63,53,60,140,78,35,40,35,51,142,27,39,49,42,60,62,19,32,61,82,48,59,64,72,62,94,45,64,72,180,36,52,209,23,47,49,22,41,61,39,50,73,63,55,62,59,51,43,25,42,32,66,30,37,50,46,65,50,37,83,70,56,17,33,69,47,52,25,40,56,27,62,50,41,29,35,35,54,59,80,21,37,75,56,70,47,37,31,10,38,68,30,34,52,46,35,32,68,44,104,78,45,57,84,29,39,62,70,23,25,18,0,25,43,60,15,34,44,41,46,46,29,47,36,39,22,45,49,39,62,30,33,57,19,31,51,30,44,42,24,68,55,44,31,51,47,4,6,31,35,41,25,38,29,16,49,25,26,66,10,92,21,20,53,39,30,31,33,42,32,18,113,61,48,47,28,41,11,45,35,35,24,26,51,56,48,27,0,27,20,34,28,32,15,36,19,47,32,17,41,29,17,27,0,36,17,57,43,48,41,67,24,19,48,19,37,25,75,15,26,16,47,34,18,44,33,40,31,14,29,18,22,22,33,21,22,40,38,33,24,34,0,18,22,20,64,25,33,30,25,35,42,18,49,45,142,23,15,33,26,1,54,34,19,29,54,11,14,28,11,16,0,38,35,26,25,35,32,23,29,15,55,24,23,21,33,32,19,26,30,28,14,11,28,50,8,23,29,29,20,21,24,8,15,13,15,57,19,14,3,74,18,28,10,27,29,34,10,35,22,11,7,21,13,16,45,27,30,24,8,0,0,38,19,15,24,26,43,24,3,28,16,10,21,34,23,19,4,42,26,19,33,32,26,3,24,17,11,10,28,0,39,47,36,22,22,13,21,8,26,25,36,26,20,38,0,8,28,28,18,45,19,8,35,9,24,16,26,34,7,33,22,25,31,20,51,35,14,13,23,18,8,24,24,14,36,21,22,17,37,13,4,36,19,26,42,1,16,23,12,29,12,34,5,24,8,10,11,38,19,14,38,25,18,29,6,18,6,23,15,75,11,22,16,31,19,25,10,4,56,34,20,9,14,18,22,21,19,10,0,37,13,16,10,17,49,29,48,24,12,5,17,13,21,12,19,17,24,14,22,23,17,7,6,13,16,20,16,18,46,15,14,17,23,17,22,9,20,15,2,13,16,16,15,9,19,12,14,12,28,24,27,15,13,25,11,14,0,20,8,12,6,26,0,24,19,4,11,19,74,12,37,16,20,9,11,42,16,9,17,23,3,2,30,29,22,5,47,14,35,19,22,16,27,27,3,41,29,21,3,25,24,35,0,8,25,4,8,3,34,9,10,0,18,21,12,14,6,8,8,6,7,7,4,15,14,9,19,14,12,26,12,0,15,26,18,20,19,7,0,21,8,21,6,22,38,13,12,14,5,14,17,10,11,22,22,17,5,18,15,23,12,16,9,37,7,7,35,17,18,9,54,16,25,11,8,0,19,0,13,14,1,16,21,10,14,0,14,5,16,17,4,0,4,10,9,15,20,0,8,11,18,20,9,8,10,18,28,10,6,16,9,21,17,14,9,19,9,21,3,18,26,13,3,5,0,17,13,3,5,19,4,7,12,20,10,4,20,26,9,19,11,18,18,66,1,21,15,3,18,5,18,0,11,13,7,15,8,12,12,6,0,12,33,0,18,1,7,1,32,34,0,2,9,75,4,14,2,12,29,22,13,1,7,9,22,7,15,0,13,22,6,4,9,19,17,17,13,7,10,20,11,10,17,44,35,15,4,9,19,13,16,12,27,21,6,14,6,2,3,0,20,18,5,5,10,12,0,2,8,10,12,6,0,0,0,20,8,7,13,4,9,0,7,11,5,3,20,15,16,9,14,16,4,1,6,0,10,10,9,11,36,19,12,9,15,6,13,8,13,10,7,10,28,8,25,14,7,8,0,2,3,1,17,41,15,15,35,11,17,3,15,33,49,1,10,2,14,3,20,18,24,34,8,5,21,0,9,14,3,4,11,10,13,3,13,12,6,12,11,7,4,10,14,9,2,18,8,29,0,4,1,22,3,1,1,6,14,12,9,8,15,1,17,1,28,4,9,13,15,17,1,2,19,0,15,31,0,2,4,4,8,27,21,10,18,0,7,16,2,12,10,14,12,27,0,6,17,4,9,0,0,8,6,8,13,9,12,2,9,13,4,14,8,13,6,9,39,15,10,0,11,16,4,7,9,2,16,0,7,7,2,3,7,12,25,17,12,10,1,8,11,21,2,6,12,0,8,15,0,9,31,2,9,9,0,9,16,4,0,3,7,7,1,15,9,19,17,7,27,14,11,117,3,12,0,5,10,7,3,9,10,5,0,13,3,15,7,9,13,10,12,6,9,2,9,0,4,8,3,24,24,34,9,19,24,9,6,3,12,4,17,6,4,8,0,11,6,7,20,7,7,10,5,8,12,13,26,0,6,40,9,11,10,3,29,5,18,6,18,1,9,15,8,3,5,5,11,0,6,4,8,25,8,14,0,12,16,4,2,0,0,4,0,10,0,0,3,32,12,10,9,8,3,13,27,19,32,15,8,21,15,0,4,29,1,0,0,11,2,6,2,0,4,8,13,19,30,3,0,5,30,13,10,13,10,22,4,3,2,8,4,2,11,7,6,5,3,0,1,9,2,7,4,18,13,2,5,8,716,11,8,6,7,7,5,5,0,5,8,0,12,16,4,0,8,27,3,0,6,8,14,0,2,4,20,5,10,10,0,10,24,7,4,9,11,7,6,7,3,6,13,20,1,8,8,11,6,11,9,5,0,0,3,6,17,0,4,0,0,2,0,11,4,4,7,4,3,0,17,14,3,0,6,3,10,15,10,13,15,12,3,6,4,8,6,7,11,15,5,0,5,5,10,1,6,9,4,5,8,13,6,0,39,4,8,9,13,3,4,13,5,6,7,4,14,11,6,5,1,9,8,8,14,11,14,15,9,0,9,3,14,1,38,24,2,3,13,6,2,6,6,8,2,8,1,10,23,9,4,9,23,0,11,23,0,0,0,36,6,5,9,7,15,10,6,9,2,3,14,4,0,7,0,9,2,12,13,0,1,7,1,4,2,6,6,7,0,1,8,28,4,12,3,9,19,4,23,6,1,24,1,7,5,0,1,7,6,0,5,8,7,7,2,6,7,23,11,3,20,12,5,0,6,4,7,15,7,12,2,5,1,5,5,10,5,2,9,1,4,3,2,11,3,6,1,0,2,3,3,33,19,2,15,7,9,3,3,1,1,10,12,13,2,36,8,3,9,6,2,8,22,6,0,12,7,2,1,8,17,0,15,2,4,7,12,467,12,0,3,5,8,8,38,7,7,5,10,82,0,7,1,9,9,0,10,7,4,5,10,13,0,6,4,14,3,3,4,10,2,3,2,20,5,0,3,10,22,6,8,13,2,4,15,3,7,6,10,4,4,17,11,0,2,1,5,13,0,2,4,5,2,5,12,16,5,4,2,1,4,9,8,2,4,1,12,9,3,3,1,10,8,0,4,1,6,6,0,0,10,4,1,1,0,0,0,48,2,1,6,5,16,3,1,6,5,9,2,9,6,3,15,5,3,2,3,20,8,2,6,11,14,10,8,1,9,6,2,2,158,1,1,16,1,29,0,7,3,13,4,2,7,2,9,10,0,1,7,2,3,6,4,1,8,4,10,6,1,11,6,0,5,0,10,5,0,15,10,8,0,6,6,5,3,7,0,5,3,0,4,5,7,10,7,8,9,0,1,4,7,9,6,1,2,8,0,2,0,7,5,0,4,3,0,8,3,0,0,6,0,3,2,19,19,4,2,7,4,6,5,10,0,9,2,13,28,5,4,6,6,8,7,10,6,33,4,8,4,0,4,2,3,14,18,6,1,13,8,5,4,7,3,6,10,3,3,9,0,4,1,4,3,0,4,3,3,10,4,5,9,8,2,8,0,10,6,2,2,15,4,9,11,1,3,1,8,24,4,4,7,0,6,4,5,0,4,0,2,7,21,7,11,1,3,2,16,8,6,0,2,3,8,5,11,8,5,3,7,10,29,4,17,19,0,3,14,3,1,2,2,2,3,0,10,5,0,1,3,1,0,0,9,2,7,3,13,0,7,7,4,8,0,0,8,10,6,5,21,2,3,15,1,3,6,8,7,0,9,3,1,6,0,14,8,2,4,4,10,16,5,12,0,7,0,21,10,0,8,4,0,0,1,8,3,9,8,7,8,1,0,5,8,22,5,1,1,0,6,0,3,7,0,2,0,1,0,4,15,0,6,0,6,3,7,6,0,3,0,3,22,11,9,5,2,4,1,1,4,0,5,0,0,6,1,1,1,0,0,0,7,1,10,9,1,2,1,14,3,8,7,3,14,14,5,3,0,10,1,1,25,6,0,0,10,9,0,4,3,9,3,1,1,2,2,13,20,10,1,7,1,6,4,22,6,2,2,7,6,3,1,4,2,0,2,0,4,18,4,4,6,5,26,3,1,1,1,4,2,3,9,9,1,5,2,0,0,0,0,2,2,0,6,22,3,3,6,0,13,3,1,1,9,1,9,2,6,21,20,5,2,2,8,8,7,3,5,10,7,4,1,3,2,3,31,7,10,2,4,9,3,7,2,1,1,3,2,1,3,5,7,1,2,2,2,7,2,0,0,2,0,0,5,3,2,9,0,5,11,8,27,7,1,2,6,2,17,3,9,3,12,0,3,6,4,2,21,9,4,9,0,3,6,2,2,0,10,1,4,3,1,11,5,4,3,0,4,0,6,5,1,0,14,7,4,7,0,5,1,2,0,0,2,0,2,1,9,3,2,15,1,3,4,0,1,6,5,5,5,0,0,5,4,22,3,0,6,6,4,2,2,0,0,1,0,3,1,1,6,4,1,0,6,3,3,0,3,5,10,0,24,8,11,10,5,2,0,3,24,2,4,0,10,4,5,2,2,6,2,8,0,4,4,0,3,2,1,2,5,2,0,5,0,0,5,2,0,2,4,7,2,1,0,2,3,6,2,5,1,18,0,1,2,0,1,9,6,0,5,9,4,2,8,3,5,1,0,1,0,10,2,5,7,0,5,0,6,3,0,1,0,10,6,9,7,1,2,2,1,6,2,2,4,1,3,2,4,0,7,4,4,3,9,7,15,1,3,0,2,3,1,6,11,5,2,3,1,0,0,1,6,1,0,1,0,8,8,2,3,1,1,5,2,5,2,0,10,0,0,18,1,0,3,1,0,3,5,5,1,3,8,5,1,0,0,1,3,7,1,1,5,5,6,2,3,1,6,2,5,11,2,2,5,0,1,3,8,0,4,3,6,6,3,0,8,1,0,1,5,1,1,7,3,4,1,4,1,4,0,13,3,8,1,0,1,0,10,0,0,6,0,2,12,4,49,0,0,12,11,0,9,5,2,2,11,2,6,7,2,5,3,13,3,2,7,4,5,0,3,0,0,10,2,2,5,0,1,13,2,2,0,3,2,6,1,1,2,0,1,1,6,0,2,4,7,2,2,2,4,24,1,3,0,0,2,9,4,14,7,1,0,10,0,2,7,10,0,5,9,5,1,3,1,5,1,4,1,0,13,4,2,0,6,4,4,1,2,2,13,4,0,0,11,2,1,4,0,0,2,3,2,0,0,0,6,1,5,2,0,2,0,0,6,12,2,6,2,4,0,18,6,0,1,4,3,4,7,10,2,0,3,2,13,1,10,1,4,5,1,0,2,0,5,13,0,3,0,0,2,1,0,0,3,1,2,4,1,4,3,4,4,3,2,0,16,4,1,1,11,0,5,15,0,2,5,4,4,2,1,3,6,1,9,4,4,0,1,6,9,3,0,5,4,1,4,1,0,0,3,3,3,7,1,3,3,2,3,5,18,6,0,2,0,1,1,4,1,2,0,6,9,0,6,0,1,5,2,13,4,0,4,3,0,1,4,0,2,4,2,0,0,1,2,3,14,1,4,3,2,0,3,2,0,0,1,1,3,2,0,2,0,4,2,7,0,3,0,0,6,13,0,5,2,15,0,3,4,5,2,10,0,6,2,6,9,2,0,2,5,2,8,7,2,8,1,0,5,3,3,1,20,0,3,2,0,0,1,0,0,0,3,3,0,3,4,8,0,1,3,1,3,7,4,2,1,4,0,0,1,2,2,3,5,3,2,2,1,0,1,4,2,10,8,3,0,1,1,0,0,2,4,1,4,0,1,1,5,1,2,3,1,3,0,5,0,1,6,13,1,2,0,2,0,3,7,2,0,9,0,1,6,8,4,0,6,0,2,3,1,3,3,4,3,2,7,5,20,0,8,2,1,3,0,6,3,6,41,1,0,0,3,0,0,1,1,2,0,0,1,5,0,1,4,2,14,10,0,2,2,0,8,4,1,0,0,0,3,0,1,14,10,5,1,2,1,5,3,4,4,3,3,1,0,5,8,4,0,7,0,1,0,3,3,0,5,7,0,1,1,4,1,0,10,7,2,1,0,1,0,2,1,0,2,4,1,0,18,1,7,6,2,0,2,2,5,0,0,2,6,0,0,14,0,5,0,0,2,4,3,2,1,6,4,2,2,4,0,4,0,5,1,3,3,0,6,5,3,0,11,4,4,10,2,0,7,6,8,4,0,0,7,2,0,3,3,0,2,0,1,2,1,6,2,3,2,12,5,4,4,0,3,5,9,0,6,0,8,4,8,1,2,12,3,0,5,4,3,0,3,3,6,3,1,8,1,0,4,0,2,8,1,3,0,1,8,0,0,3,0,0,0,0,12,3,0,0,3,5,9,2,1,0,2,3,0,2,1,1,11,3,4,5,0,2,11,4,5,1,1,5,3,4,2,4,7,2,1,0,5,4,5,6,0,0,0,2,3,2,4,6,1,1,5,0,0,7,0,2,0,4,4,2,11,3,9,0,7,1,13,0,4,8,1,9,8,4,7,2,2,2,0,15,2,0,2,0,6,2,4,4,0,2,0,0,3,4,1,2,2,5,1,1,4,4,2,2,7,0,4,3,3,5,1,2,0,0,3,0,3,8,4,7,0,7,0,4,2,0,1,4,4,1,1,2,17,1,1,3,1,0,3,2,1,7,0,11,0,7,5,3,2,1,2,0,0,0,0,0,9,4,3,3,8,1,2,0,1,0,5,1,2,0,0,2,0,0,3,2,2,0,2,7,0,2,3,3,0,1,2,2,11,0,31,4,3,1,0,3,4,0,0,0,1,0,3,1,11,0,1,0,1,0,2,3,4,4,1,4,2,6,0,9,1,2,0,7,0,1,1,3,3,0,3,1,4,3,0,2,9,0,1,0,1,3,0,2,0,0,0,0,0,1,0,0,3,0,0,3,1,2,3,2,4,0,0,3,1,3,2,2,0,4,3,1,3,1,7,4,1,1,2,5,1,1,0,0,0,0,9,6,5,1,9,0,4,2,5,0,11,1,6,0,5,2,2,3,2,0,4,3,1,1,4,0,8,0,5,0,1,1,5,0,12,1,0,6,10,2,2,3,0,0,0,0,4,0,4,3,13,2,4,2,0,2,3,1,0,5,3,0,0,3,0,0,1,4,2,0,1,17,5,2,1,2,0,10,4,4,10,4,0,1,8,1,3,0,0,1,1,0,2,3,2,19,1,5,1,0,1,0,0,2,5,5,0,2,4,4,0,0,0,1,5,7,0,0,4,10,0,3,5,1,1,0,7,1,4,0,3,0,3,2,1,3,5,2,3,3,4,2,4,4,1,0,4,4,1,2,0,0,0,3,3,0,2,1,0,2,1,1,2,9,1,3,1,0,2,0,0,0,1,2,1,1,6,1,7,3,6,3,0,0,2,5,0,15,1,0,1,0,0,2,2,1,0,2,2,0,2,1,2,6,0,1,0,6,1,0,9,1,0,0,7,1,15,0,3,3,5,7,0,6,3,0,2,4,6,10,3,0,2,2,1,0,2,2,5,0,2,1,6,0,0,1,0,0,2,3,2,1,4,1,16,4,2,7,4,12,2,0,1,2,7,0,0,5,3,5,1,1,1,0,0,0,3,3,3,0,9,0,2,1,1,1,7,3,2,0,1,2,0,4,2,3,1,0,1,2,1,1,12,4,8,0,0,1,0,2,0,3,0,0,1,4,19,0,3,2,8,2,0,0,0,0,0,1,3,1,1,11,0,2,1,3,0,1,1,4,1,4,4,1,3,0,4,2,3,8,0,7,0,2,0,0,7,2,3,0,0,8,0,3,0,2,0,0,0,0,0,1,3,0,0,2,1,5,0,2,2,1,2,1,4,0,1,0,0,1,0,6,0,2,30,0,1,0,1,0,3,4,0,0,3,0,5,3,1,1,0,4,4,8,0,0,3,2,3,1,0,0,4,0,1,7,4,1,2,2,0,0,2,9,2,1,2,0,1,0,0,2,2,0,0,2,0,0,0,0,0,0,7,1,4,8,2,0,2,4,4,0,5,1,0,0,2,5,0,0,0,0,0,1,7,9,0,0,7,1,5,0,2,9,4,0,0,0,0,3,2,2,1,0,4,1,1,2,6,0,0,2,1,3,3,4,2,0,0,4,8,2,3,0,2,3,0,0,1,2,2,1,6,0,2,4,1,2,0,5,0,8,6,7,8,4,0,5,4,3,2,3,0,3,2,8,3,0,2,3,2,2,7,0,9,0,4,0,3,2,7,3,1,0,1,4,0,1,8,3,1,2,5,0,0,0,2,1,3,1,5,0,2,0,4,4,0,0,3,1,0,0,0,0,0,0,1,1,1,1,1,4,1,1,7,0,2,0,0,1,2,2,0,14,0,0,4,2,0,5,3,3,0,1,2,1,0,0,4,2,1,2,0,0,0,0,2,0,1,1,4,0,1,1,1,6,4,0,3,2,5,2,4,0,6,1,1,2,4,0,1,0,1,0,0,0,3,0,1,6,0,0,0,3,0,1,1,4,0,1,2,2,2,0,4,0,0,0,13,0,1,1,1,3,2,1,0,6,2,0,0,2,11,1,1,3,4,4,0,0,0,1,4,2,0,3,20,0,0,0,2,0,0,1,2,4,5,0,0,6,1,0,0,1,0,1,0,4,5,0,0,2,0,1,0,1,0,0,3,1,0,0,2,0,1,0,1,2,0,4,0,5,22,0,0,1,1,0,9,3,1,0,3,2,1,4,1,3,1,4,4,0,3,3,1,0,3,1,5,0,0,2,0,1,1,6,3,5,4,2,0,3,5,12,6,6,2,0,1,2,1,0,1,2,0,0,0,3,6,1,1,2,2,2,0,4,7,2,2,1,4,1,0,2,0,1,5,3,4,3,0,1,10,6,0,2,4,3,0,0,0,5,3,1,1,2,3,1,0,5,2,3,3,2,1,2,1,3,0,1,0,0,1,1,0,0,0,0,0,1,1,0,0,0,6,0,2,752,2,0,0,2,0,2,1,1,5,0,2,7,7,3,1,3,4,3,0,0,3,1,2,4,0,3,2,3,0,1,14,2,2,0,0,4,0,2,3,1,0,33,0,0,0,0,2,3,1,4,1,2,3,0,0,3,5,6,1,3,4,6,2,3,1,0,1,4,1,0,0,1,1,0,3,2,0,0,14,0,2,0,1,3,0,0,2,2,0,0,6,2,3,3,0,1,1,0,1,6,2,1,3,7,3,1,0,0,0,1,0,0,0,1,1,1,1,3,1,0,2,0,4,1,2,11,2,0,2,0,4,1,9,0,4,5,0,2,2,6,0,15,13,0,1,2,1,3,4,0,0,1,0,0,2,3,0,5,0,0,0,0,1,0,0,2,0,0,2,0,2,0,0,0,2,2,0,2,0,0,2,3,2,1,2,0,0,0,42,2,4,0,0,2,5,1,2,1,0,1,0,2,3,0,0,0,1,1,0,1,0,1,5,0,1,0,1,2,0,1,0,0,3,2,3,0,3,1,2,2,0,0,5,1,1,2,0,1,3,1,0,4,2,1,0,0,6,0,0,0,0,3,1,5,1,2,0,2,2,2,0,2,8,4,1,1,4,0,6,0,1,1,1,1,4,1,1,3,2,11,4,1,1,0,1,3,0,1,3,1,1,1,1,0,1,2,4,1,5,0,4,0,0,0,1,3,4,0,0,0,0,0,0,0,1,3,0,5,1,1,2,0,0,5,0,0,0,4,0,4,0,2,1,4,1,0,0,2,0,2,0,0,1,2,0,0,0,0,7,3,0,1,6,1,0,0,3,2,0,7,0,5,3,3,0,3,1,1,3,1,0,3,0,5,4,0,0,0,0,0,2,0,0,0,1,0,1,0,0,0,1,1,2,1,0,3,0,0,46,0,5,0,5,0,11,2,3,5,2,2,0,3,0,0,2,1,0,0,1,3,2,0,1,2,0,1,2,2,2,0,0,0,1,0,1,0,2,0,4,2,1,0,2,1,0,0,1,0,11,0,0,0,0,0,1,3,0,3,0,0,2,0,2,2,1,0,1,0,4,1,0,11,3,1,0,26,0,0,3,1,1,3,2,1,7,0,0,0,1,0,0,2,0,0,0,0,1,5,0,0,0,3,0,2,0,0,1,4,0,0,0,0,0,0,0,3,1,0,7,0,0,0,0,0,4,0,8,0,2,0,28,0,0,1,0,0,0,0,0,0,0,0,0,0,0,0,0,1,0,0,0,0,0,0,0,0,0,0,0,0,0,0,0,0,0,0,1,0,0,0
K08 Roadwork,king,4895,2619,1990,2417,1646,1034,2581,1324,1253,1320,1351,963,1027,473,412,800,912,582,531,681,535,481,303,530,177,321,262,390,496,284,268,515,365,317,305,268,288,353,144,307,315,404,341,298,266,292,250,228,250,236,270,244,181,297,216,157,243,211,248,244,247,214,156,163,244,139,141,241,177,135,196,163,130,122,252,117,167,134,150,107,140,173,149,214,133,194,92,109,98,74,91,181,93,122,158,98,139,89,154,87,93,168,241,69,180,78,93,109,140,125,107,97,40,74,86,76,89,79,104,98,89,86,177,86,96,51,95,91,67,99,71,104,165,73,68,72,37,55,83,56,129,119,6,146,95,133,57,70,73,75,69,87,75,58,58,42,66,72,96,99,105,66,58,51,63,59,34,44,85,72,33,84,81,98,87,33,52,49,83,96,62,51,100,32,65,84,36,52,40,39,62,25,46,28,76,62,11,32,40,15,50,68,84,36,34,69,38,49,47,54,15,54,22,20,42,49,70,24,49,47,30,41,38,51,59,36,29,49,32,74,42,52,25,35,27,4,26,30,36,17,58,48,39,49,32,28,69,56,32,32,61,26,27,37,22,47,34,33,46,38,49,41,65,43,34,27,30,30,70,14,37,27,35,22,40,29,30,23,56,37,51,45,32,43,70,104,28,28,29,21,34,28,33,34,25,35,20,61,17,49,68,29,52,31,43,29,52,40,9,21,24,17,25,39,19,27,20,31,15,33,30,36,35,34,7,51,50,25,22,34,27,17,24,20,40,36,37,16,12,22,35,23,16,43,36,10,40,63,33,30,16,22,36,24,32,15,23,23,19,49,50,23,27,12,20,44,19,31,45,30,25,20,42,51,38,41,10,38,29,30,23,15,50,25,9,29,0,29,31,55,38,33,12,56,25,18,12,30,24,44,21,8,33,62,27,15,30,27,19,19,30,23,43,15,15,20,49,34,14,11,38,6,5,41,13,26,17,52,18,16,33,17,30,23,3,37,30,23,3,26,25,13,16,22,24,21,23,20,30,29,7,12,11,15,28,20,10,17,21,17,43,9,0,61,23,43,22,6,1,14,7,16,28,13,22,13,10,13,0,14,14,20,15,31,8,29,14,5,33,21,21,13,41,3,7,3,25,30,6,15,21,11,32,7,18,19,12,8,15,37,27,25,12,16,7,9,0,11,40,26,31,22,23,28,16,5,23,11,18,28,17,17,19,31,6,178,15,18,12,16,40,5,8,9,34,14,0,1,39,40,10,17,24,8,10,10,19,10,4,9,7,23,10,5,9,11,8,0,19,6,28,19,9,19,11,18,12,3,10,13,10,20,10,15,25,15,5,22,13,16,21,33,6,16,12,23,1,7,6,33,20,13,14,9,13,0,46,8,7,11,4,9,6,15,3,15,16,8,16,11,16,25,2,13,8,35,31,23,9,7,32,11,12,10,16,0,34,8,18,35,15,12,11,6,21,30,21,16,14,33,0,11,18,16,12,10,7,10,15,11,7,13,36,13,11,12,15,20,10,13,12,41,4,6,15,19,14,4,11,4,17,17,7,17,22,8,1,7,13,38,17,18,2,27,14,25,5,2,70,18,16,23,3,6,18,3,4,34,28,12,2,11,3,26,9,39,2,8,17,14,14,10,6,0,7,5,16,4,3,12,10,12,2,20,0,27,15,4,4,3,19,22,3,14,1,4,23,8,20,3,8,5,13,11,3,10,25,6,2,13,5,14,16,22,7,25,10,10,6,7,13,13,13,7,1,11,3,3,7,7,8,17,3,5,11,15,14,5,14,6,25,3,3,24,10,11,1,11,1,9,7,9,10,9,8,5,14,9,11,21,6,3,11,1,17,16,13,3,2,21,9,11,9,8,11,23,12,8,31,30,3,10,0,21,0,12,10,5,1,4,25,7,12,5,17,16,8,0,7,5,4,13,7,2,7,12,6,4,4,12,13,2,19,6,20,13,6,0,16,17,10,26,9,9,0,6,8,14,3,6,13,3,12,14,3,6,9,7,5,5,14,4,11,2,19,3,3,0,10,18,7,16,22,8,13,25,8,4,12,16,7,0,8,0,7,3,8,12,14,4,13,3,1,2,5,4,0,0,16,1,28,17,0,3,14,8,4,26,10,16,8,36,31,11,5,5,9,10,11,19,3,6,11,8,5,4,0,5,14,10,0,12,27,0,11,3,28,5,6,2,9,4,5,6,3,13,4,6,5,2,1,24,15,1,23,1,7,0,9,17,7,7,11,8,2,6,1,7,30,0,8,0,6,2,2,16,0,0,5,18,6,0,7,70,14,4,14,0,2,7,3,8,13,7,5,1,8,4,15,18,18,4,8,13,3,16,5,3,11,10,26,6,0,6,10,5,3,3,44,15,3,5,1,7,3,0,11,4,1,3,4,4,0,5,2,8,25,14,0,0,0,1,2,4,11,2,17,0,11,20,6,7,20,12,14,12,7,2,9,0,4,0,7,7,5,15,16,10,18,1,7,8,7,7,6,8,2,4,11,3,4,4,4,5,0,0,2,7,5,5,2,13,9,10,2,4,13,5,1,5,12,1,3,1,8,14,13,9,8,7,3,2,12,6,14,1,3,3,9,0,24,1,4,7,12,2,0,3,6,11,1,3,17,15,0,4,1,4,0,7,0,9,11,15,7,10,1,0,7,0,11,5,4,9,18,8,0,5,5,0,8,2,0,3,1,10,4,11,40,0,18,0,8,6,11,5,3,7,15,14,0,4,4,3,5,0,0,3,5,3,7,13,5,0,4,33,3,15,0,5,13,2,2,1,13,0,1,3,3,16,3,2,7,0,1,5,0,5,7,7,8,3,5,2,1,1,2,4,0,4,9,0,10,10,0,7,4,2,2,16,1,4,23,0,0,1,8,7,0,2,6,5,10,10,14,15,8,21,8,5,0,7,5,2,8,1,4,24,1,9,15,10,5,1,6,6,4,9,6,2,3,0,1,3,1,11,5,18,6,8,8,4,14,1,7,8,8,3,1,3,1,1,2,5,8,10,4,8,7,2,12,3,15,0,5,93,7,1,4,14,9,1,6,0,8,2,5,8,6,5,3,3,8,0,4,1,8,9,3,8,6,3,5,2,3,0,0,24,0,17,2,0,4,10,4,13,5,4,7,4,19,22,10,0,40,5,5,2,5,2,0,0,0,6,0,6,3,0,9,12,4,5,14,2,1,5,9,4,3,5,1,2,2,4,7,6,7,1,5,4,7,4,0,0,0,8,1,10,5,2,3,2,0,3,50,4,13,21,3,4,8,9,0,4,3,0,2,17,5,2,3,3,6,0,4,1,14,0,8,3,4,2,1,4,0,20,4,25,6,8,2,7,7,6,37,4,3,21,2,14,7,7,2,2,3,14,0,0,1,2,5,0,0,0,0,0,0,3,2,6,2,3,4,4,11,7,4,0,1,1,2,21,3,9,2,1,2,3,1,3,6,1,1,1,5,1,4,8,4,5,8,11,8,10,12,7,5,0,12,6,1,11,10,1,1,2,5,3,4,3,8,2,2,10,3,6,24,19,3,9,5,6,5,4,6,5,8,0,8,8,4,4,11,7,8,3,7,13,0,1,0,5,20,56,3,7,4,0,4,6,1,0,0,5,4,3,8,2,6,7,6,5,6,0,2,4,0,3,0,13,3,12,9,0,2,2,1,1,6,1,2,0,2,7,5,4,3,6,0,2,7,1,15,2,2,2,4,7,6,2,0,1,4,4,2,4,6,3,0,4,3,11,1,3,10,4,7,0,4,7,4,8,18,5,2,8,4,0,0,5,5,6,7,1,6,14,6,3,3,1,8,0,7,18,0,1,6,0,11,6,5,3,2,2,0,0,7,4,5,2,7,6,8,3,3,1,4,6,0,5,1,2,2,3,7,0,13,0,6,1,2,4,3,2,11,7,13,1,4,2,1,1,2,3,0,2,0,4,11,5,9,1,6,11,3,3,2,3,4,7,13,8,7,3,9,5,12,9,4,0,0,2,17,0,3,3,13,5,19,1,6,8,2,7,8,4,1,2,1,2,4,4,0,3,3,5,2,2,9,3,2,4,7,0,3,8,2,2,6,1,2,4,10,1,7,4,4,0,10,3,9,6,0,0,11,4,0,3,0,0,0,24,4,5,0,0,1,2,0,2,2,4,23,2,0,7,7,3,8,11,2,6,5,3,8,3,8,4,7,0,4,1,2,4,0,0,4,2,3,7,1,2,1,3,0,3,4,10,9,14,1,1,2,0,0,0,8,2,2,15,7,8,0,6,6,0,6,0,2,2,0,3,4,4,0,3,0,0,52,3,0,6,3,2,0,1,1,7,2,0,2,1,0,3,2,4,2,0,4,1,0,5,0,2,2,0,1,4,0,4,3,1,0,6,1,5,2,4,15,1,4,0,0,2,0,0,0,3,0,12,6,4,5,10,4,6,7,5,0,4,0,3,0,0,2,1,1,4,4,3,0,3,3,6,12,2,5,1,5,2,2,3,0,2,0,4,9,6,3,3,4,1,2,5,1,3,2,4,0,9,5,2,0,4,1,11,5,0,2,1,3,0,3,1,1,0,7,4,3,0,9,0,2,9,20,0,1,1,2,3,14,3,1,0,2,5,3,4,1,11,2,5,3,1,5,11,4,12,1,1,4,1,1,1,1,0,0,6,9,4,0,0,2,3,0,0,4,8,4,0,8,5,6,1,1,11,0,0,0,2,3,1,5,2,2,9,0,5,6,3,2,0,7,3,2,2,6,0,2,3,1,3,3,4,3,1,0,2,0,5,6,0,1,1,0,0,2,1,2,7,5,3,0,1,0,4,7,7,2,2,23,2,2,1,2,7,1,2,0,0,1,3,1,0,9,0,2,0,2,5,0,4,1,0,1,1,6,2,3,6,4,1,1,0,2,0,0,2,0,6,3,1,0,2,1,1,3,0,0,2,1,6,1,2,14,4,5,3,8,0,1,3,2,1,7,3,0,0,1,3,0,3,1,1,1,0,10,2,2,5,3,3,2,0,0,6,1,1,6,5,4,3,10,2,6,1,1,6,4,0,1,3,3,4,2,17,4,2,0,0,2,5,0,0,3,1,1,3,1,3,2,0,0,0,10,2,0,10,8,3,2,0,0,0,0,7,3,4,1,3,3,2,16,2,0,0,4,16,4,16,6,7,4,2,2,8,0,7,12,2,3,2,0,2,1,2,34,0,0,0,5,4,1,2,7,4,5,0,0,6,3,4,0,8,1,4,7,0,1,2,7,5,6,1,6,4,3,7,8,1,6,0,6,1,5,1,3,2,1,4,6,0,1,3,0,2,9,0,2,0,2,4,3,2,6,6,0,6,1,1,2,0,8,1,2,0,3,5,4,3,0,6,1,5,1,0,0,2,1,3,3,0,0,9,2,10,0,0,1,2,0,7,4,0,0,2,3,3,0,3,1,3,9,4,7,0,3,1,0,6,1,1,6,0,8,0,0,6,5,0,0,1,0,0,1,1,2,2,0,2,0,4,12,62,0,0,3,4,5,1,1,1,0,3,5,1,2,0,4,0,1,2,3,0,1,4,2,4,0,3,0,6,0,0,3,4,0,1,2,3,1,3,7,3,0,1,7,0,1,3,6,0,2,3,5,1,1,4,4,0,0,1,0,0,3,1,1,0,1,0,0,0,0,3,0,3,1,3,5,7,0,0,1,2,4,2,0,1,0,4,2,1,5,4,2,6,2,5,2,0,8,0,2,2,4,4,3,4,1,4,1,3,0,2,6,4,0,1,0,2,0,0,5,3,1,4,2,5,2,4,1,0,0,4,0,0,1,0,0,4,0,0,3,7,9,4,5,0,0,1,4,7,1,0,3,3,0,1,0,4,2,2,1,2,2,3,1,1,3,1,4,1,1,4,1,5,3,2,4,13,0,1,0,1,1,0,2,1,11,3,0,0,0,2,2,1,3,1,0,0,1,1,0,4,1,0,3,3,3,0,3,3,4,2,4,4,1,0,7,1,3,7,1,1,2,3,1,0,2,11,7,0,2,0,2,4,6,0,2,4,8,0,0,3,0,8,0,2,5,0,1,0,2,1,2,0,3,5,0,1,1,3,2,7,2,1,0,0,12,1,2,8,6,0,2,1,0,4,3,3,1,0,9,1,0,0,5,0,1,5,0,0,2,3,1,0,9,0,0,6,1,1,1,2,1,0,16,3,0,4,0,0,1,2,0,1,9,0,4,0,1,4,0,3,4,0,3,4,3,7,0,0,0,13,2,0,8,2,1,2,21,0,5,1,0,0,15,1,3,2,4,0,1,0,0,1,0,3,2,4,1,0,4,0,0,0,5,1,1,3,0,6,0,1,3,2,2,0,3,0,2,2,3,0,4,1,0,1,4,8,5,1,0,0,2,0,4,0,2,0,0,2,0,2,1,1,0,1,1,0,0,4,0,0,2,3,1,5,2,6,0,1,0,0,0,0,0,2,1,5,0,1,1,9,2,0,6,0,3,0,1,10,3,1,4,9,0,0,2,0,2,0,2,0,1,4,3,7,7,1,0,0,1,0,0,1,0,0,0,0,0,0,0,1,1,1,0,2,3,0,0,1,4,1,0,0,2,23,3,5,9,4,11,2,0,7,1,7,1,3,0,8,3,0,5,12,0,1,3,0,3,1,0,0,0,0,1,5,2,0,1,0,2,0,5,5,0,4,5,1,0,0,9,0,2,5,5,0,1,17,0,0,5,1,1,1,0,3,1,2,2,0,1,1,2,1,2,0,0,2,2,0,0,3,2,0,0,0,1,6,3,0,0,0,1,1,0,0,0,1,2,1,4,4,2,1,1,0,0,7,0,2,0,1,7,2,0,3,3,2,8,9,0,1,1,5,14,3,1,6,1,1,1,1,7,1,6,1,2,3,1,0,0,0,0,0,1,2,1,2,1,0,1,0,1,1,6,5,14,2,10,0,0,1,4,3,1,0,0,0,1,0,5,4,3,6,0,0,1,5,2,1,0,6,1,1,1,0,1,0,0,3,0,1,0,0,0,4,0,5,0,0,0,2,5,0,11,2,1,1,0,0,0,2,1,5,7,1,0,0,2,8,1,2,3,1,2,0,0,1,0,2,7,0,4,1,0,1,0,0,0,1,2,2,1,2,4,1,0,12,0,3,0,3,1,1,1,0,1,0,1,0,2,7,4,0,1,0,1,0,5,3,5,3,2,0,0,4,0,1,2,0,3,0,0,1,3,2,1,7,1,2,2,2,2,1,62,0,2,10,4,0,0,0,9,8,1,0,1,7,3,0,0,0,2,1,0,3,0,0,1,0,2,5,2,2,1,2,3,0,0,3,0,0,0,1,0,3,0,0,5,3,0,3,1,0,2,0,0,1,0,0,4,2,1,2,0,1,6,0,2,0,4,0,1,1,0,3,3,1,0,0,0,9,1,0,0,1,2,0,1,0,1,1,0,13,2,1,0,4,0,0,0,2,3,1,1,8,2,0,3,1,1,1,1,1,0,1,4,3,1,2,1,1,1,6,3,0,0,0,3,11,3,1,1,0,1,0,0,1,2,3,3,2,1,0,3,2,1,0,1,1,0,2,5,2,1,5,7,0,2,0,4,2,3,2,0,1,1,0,1,2,5,1,0,3,0,0,2,0,2,3,0,0,4,1,0,10,1,6,0,2,6,0,0,0,9,1,0,1,0,0,3,0,2,2,7,0,0,0,2,0,0,0,0,0,0,3,1,0,2,0,0,0,4,4,2,1,4,1,1,0,6,9,0,0,2,0,3,2,0,0,0,0,0,3,1,0,1,1,4,0,1,0,0,3,1,1,2,1,5,1,2,2,0,1,5,2,0,2,0,1,1,4,2,0,2,2,3,0,0,1,3,0,0,1,4,2,0,2,2,0,0,2,0,0,0,0,2,0,1,2,5,2,1,1,0,1,1,1,0,2,0,1,1,1,0,2,0,1,0,0,0,2,2,2,0,0,8,2,0,1,2,1,2,1,3,0,0,1,0,0,7,1,10,0,1,0,4,0,4,3,6,0,0,3,3,1,1,0,1,1,1,0,3,0,1,2,0,1,1,3,2,1,3,1,7,1,0,0,4,2,3,1,2,0,3,7,1,3,0,1,8,9,2,11,0,0,3,2,0,0,0,0,10,3,1,0,2,0,6,0,2,1,0,0,2,0,2,1,0,4,0,4,1,0,3,9,2,3,0,0,4,1,0,0,5,4,0,1,1,0,0,1,0,0,0,0,1,5,0,2,0,0,0,0,0,0,5,1,3,0,1,0,2,4,0,0,0,0,7,2,1,0,0,2,0,2,0,1,0,5,0,1,0,0,0,0,0,0,2,0,3,1,3,7,1,1,5,0,0,0,1,0,1,1,1,4,0,1,3,1,0,0,3,0,1,2,4,1,0,2,1,4,1,2,0,3,1,3,1,1,2,1,2,0,1,1,1,0,0,0,2,0,0,4,2,2,0,0,1,3,0,0,2,4,0,0,0,4,7,1,0,0,3,0,0,0,2,9,3,3,0,0,1,3,0,0,1,0,3,5,3,2,4,2,23,0,0,2,7,3,6,0,1,0,2,0,0,2,0,2,1,1,1,1,1,0,0,1,2,0,2,1,0,0,1,4,3,7,5,0,1,6,0,5,0,1,0,0,3,2,1,0,8,3,4,0,0,3,0,0,0,4,0,0,3,0,2,1,3,1,6,1,0,0,0,0,0,0,3,0,1,1,2,0,0,3,0,1,0,0,5,5,2,0,0,2,7,0,7,1,0,0,0,0,1,3,4,7,3,0,1,2,0,6,4,1,0,0,0,0,0,0,2,2,1,1,0,0,1,0,1,3,1,1,3,0,1,0,3,4,1,0,3,1,5,0,8,0,3,0,4,3,0,7,0,0,1,2,0,0,1,0,3,0,2,2,1,1,1,0,1,1,3,0,0,0,0,1,1,1,0,0,2,0,1,1,2,0,1,2,0,6,2,1,0,5,0,0,0,0,2,0,5,0,4,0,30,4,1,0,2,1,2,1,0,1,0,3,3,0,2,0,0,0,4,2,1,0,1,1,1,1,0,2,1,0,1,0,1,12,3,2,0,0,0,1,4,0,1,2,0,23,3,0,4,1,3,0,1,4,3,1,2,1,0,0,0,1,5,6,2,3,0,0,1,4,0,2,0,1,0,4,1,2,8,4,0,2,0,0,0,1,0,3,3,0,1,0,0,0,0,1,2,0,2,1,0,3,1,0,1,0,2,0,2,0,0,1,1,1,1,0,0,0,2,2,4,0,0,0,1,1,1,0,2,22,0,0,2,0,0,0,0,0,0,0,0,0,1,4,0,0,4,0,1,1,0,1,1,1,0,0,0,0,1,0,0,1,0,0,0,3,1,3,1,0,0,0,0,2,0,2,0,0,1,0,1,0,0,0,1,1,0,0,0,13,2,0,0,2,1,0,2,0,2,2,1,0,6,0,0,0,0,0,1,0,1,1,5,1,0,0,1,5,1,0,1,2,0,0,0,0,2,0,2,0,0,0,0,0,0,3,0,2,1,1,0,0,0,1,0,2,1,2,1,2,3,3,1,1,1,0,1,2,0,2,2,1,0,0,3,1,2,4,0,1,1,6,0,0,0,0,0,1,3,2,0,2,1,0,0,2,4,0,2,7,0,1,1,3,0,0,1,1,0,0,0,1,2,0,0,1,7,0,1,1,0,0,2,2,3,0,2,2,2,1,2,0,3,0,1,0,13,0,2,3,0,1,1,0,4,1,0,1,24,1,0,0,0,1,2,0,2,0,0,1,2,1,1,2,2,0,0,2,1,1,1,4,5,0,2,1,0,0,2,1,3,0,0,1,3,0,1,2,0,0,0,0,2,1,1,1,2,6,0,0,7,0,1,0,1,2,0,3,0,0,0,1,0,1,0,0,0,5,1,1,4,0,0,1,0,0,1,1,0,0,0,0,0,0,2,0,0,0,9,2,2,7,0,0,0,0,5,1,2,0,3,2,0,1,3,0,0,5,2,1,0,1,1,1,0,4,2,3,2,1,3,2,6,2,0,1,0,4,0,2,0,2,0,0,1,0,1,0,0,0,3,1,0,0,2,0,0,4,3,2,0,3,2,0,0,3,0,0,2,3,1,0,0,0,0,1,2,1,0,0,0,0,2,0,0,0,0,0,0,0,1,0,4,0,3,0,1,0,0,1,5,3,2,3,0,4,0,0,0,0,0,0,0,0,1,3,0,0,0,2,0,0,12,2,1,3,1,1,0,0,0,2,2,1,2,1,0,1,3,5,2,3,0,10,0,0,0,0,0,1,0,1,2,2,0,0,0,1,1,6,0,0,0,6,4,1,0,0,0,0,1,1,0,8,0,2,2,3,1,0,0,0,1,1,0,1,1,1,0,3,1,2,1,0,0,2,6,2,2,3,0,8,0,2,3,4,0,0,3,0,1,3,1,1,3,1,1,0,1,3,2,0,3,1,0,0,0,0,0,1,0,1,0,0,0,1,0,1,9,0,0,0,1,1,2,2,0,3,0,0,0,1,0,0,1,1,0,1,0,0,0,0,0,0,0,1,1,0,4,2,5,2,1,0,0,0,0,1,0,0,1,3,0,2,2,1,0,1,0,0,6,0,1,1,0,0,0,0,0,0,0,0,2,1,0,0,0,1,0,0,0,0,0,0,0,3,0,53,0,0,0,1,0,0,0,0,1,0,0,0,0,0,0,0,1,0,1,0,0,2,3,3,7,0,2,3,0,1,0,0,2,4,0,3,0,0,2,0,0,4,1,0,0,1,1,1,8,0,0,1,2,0,1,0,2,7,0,2,0,0,3,0,2,0,0,0,0,0,0,0,0,0,0,4,0,6,0,1,0,1,2,2,0,0,3,0,0,1,0,0,0,1,0,0,0,0,3,0,0,0,1,13,3,2,0,0,0,0,0,0,1,0,0,1,0,2,0,0,0,0,1,1,1,1,5,1,0,0,1,0,0,0,0,0,1,0,0,0,2,0,0,0,2,1,1,3,0,0,2,0,1,1,0,2,1,0,0,0,0,0,0,0,3,2,3,0,2,0,0,2,3,0,0,0,2,4,0,0,0,0,0,1,0,1,0,1,3,0,1,2,0,0,0,0,0,0,1,0,0,0,1,0,0,0,1,0,0,0,1,0,0,0,0,0,0,1,0,0,0,0,0,0,1,0,0,0,0,0,0,1,0,1,0,0,0,0,0,0,0,0,0,0,0,0,0,0,0,0,0,0,0,0
K09 Cujo,king,6384,3480,2761,2812,2356,643,2535,1846,2403,1956,802,1741,1535,1752,1361,964,1940,751,701,540,805,760,585,713,114,459,144,434,593,180,388,603,388,469,327,377,401,418,123,392,518,374,544,399,255,346,356,309,555,375,451,300,376,334,236,248,513,132,217,331,350,148,165,331,182,231,186,295,88,183,245,107,129,156,246,194,186,237,185,153,193,118,122,195,210,213,113,102,149,130,75,236,163,107,160,130,185,107,166,164,142,263,234,127,252,139,163,308,127,169,183,176,46,152,107,206,146,132,136,74,89,61,182,191,83,91,105,66,94,76,115,160,95,83,99,91,18,142,115,80,129,79,18,54,132,123,106,135,89,159,95,78,127,68,112,98,44,86,110,109,91,125,128,107,69,125,73,71,102,83,31,87,86,82,182,46,59,76,124,118,74,71,74,66,71,120,52,52,82,57,73,44,96,50,59,86,62,46,68,10,50,88,67,62,67,54,39,33,75,119,69,62,24,24,69,57,69,68,43,62,43,74,83,41,102,50,32,33,23,90,80,79,60,85,47,13,43,77,52,25,37,26,60,52,54,50,64,165,62,70,64,30,39,19,48,61,33,40,58,46,66,44,74,82,30,25,42,30,55,53,56,38,39,82,40,64,48,26,132,59,41,29,48,33,114,25,50,76,43,37,56,15,57,17,67,23,70,34,18,63,86,44,41,42,129,35,33,14,21,14,38,5,9,37,48,49,42,77,30,28,40,59,33,112,89,69,43,42,25,40,43,44,28,32,57,56,64,17,29,46,38,43,23,30,26,34,40,29,22,36,46,29,60,48,104,23,30,86,36,36,39,28,20,11,31,39,42,31,19,34,34,25,42,56,38,67,26,47,63,32,23,31,22,26,26,22,0,13,26,31,260,30,14,63,26,40,31,37,22,28,46,70,45,27,43,27,35,31,21,50,54,25,29,65,34,48,30,35,27,36,51,1,3,40,21,36,13,53,42,27,35,19,34,61,2,5,28,58,6,59,26,24,27,46,25,33,95,16,20,34,21,22,10,55,21,27,17,20,23,36,29,4,0,18,8,25,20,6,26,24,11,36,29,15,23,19,13,6,0,21,8,21,25,10,19,82,21,22,52,14,40,23,32,15,23,15,25,39,8,28,11,12,12,14,18,12,6,18,24,33,27,30,23,40,13,17,1,23,20,24,22,13,19,29,24,14,24,13,29,26,7,28,17,8,22,5,27,24,25,17,30,7,24,17,28,14,0,5,26,52,22,26,45,4,21,14,33,21,14,3,14,35,25,11,13,23,16,0,13,18,57,20,24,31,17,20,14,19,14,17,30,48,17,15,3,46,8,26,14,14,17,27,8,9,19,16,5,13,14,18,53,17,48,10,23,0,1,40,13,16,17,10,29,28,1,24,21,13,13,32,12,27,13,16,29,10,10,31,27,10,31,21,17,11,23,0,32,25,34,20,16,8,14,3,12,17,22,13,3,46,0,7,6,26,20,35,17,9,15,8,22,17,42,29,12,34,20,12,13,13,34,17,10,5,24,33,3,19,18,5,9,16,20,13,23,10,11,12,10,10,21,6,7,14,9,21,6,1,17,20,15,12,39,12,13,15,7,27,22,15,3,10,4,45,12,55,3,22,17,18,7,24,17,4,35,10,36,15,15,12,20,5,4,5,0,38,13,11,10,14,35,18,37,23,0,2,13,13,13,14,3,2,14,8,3,14,31,10,10,7,8,14,17,10,11,21,7,8,15,13,18,15,17,12,2,11,19,8,10,14,16,6,3,29,14,15,8,10,8,8,13,4,1,23,9,11,2,13,6,18,17,8,8,19,9,8,34,12,11,17,7,15,14,8,18,7,6,1,14,40,11,7,10,15,14,17,5,9,13,18,7,21,7,13,10,13,26,17,0,4,32,10,6,5,52,2,6,0,16,2,9,11,3,1,6,6,5,18,4,19,10,4,18,10,8,24,8,1,10,14,11,18,9,11,0,6,9,14,7,16,18,11,32,12,5,13,22,12,15,17,25,7,18,12,20,29,11,0,5,40,9,6,23,13,12,11,26,12,19,19,10,0,17,1,1,19,5,2,10,18,15,1,12,7,10,4,1,0,60,0,21,10,7,0,2,12,4,16,14,24,8,28,10,10,9,10,10,6,9,11,7,17,9,3,4,21,49,12,5,3,0,18,11,0,9,4,6,3,6,9,6,189,13,30,5,20,22,11,20,0,1,15,19,0,14,8,18,0,7,6,9,13,17,25,10,9,10,9,14,0,9,0,5,0,24,13,0,0,6,50,2,0,6,5,16,11,12,1,3,13,1,7,7,6,6,2,8,20,15,6,12,18,12,4,4,9,21,15,12,42,0,3,0,7,14,6,18,10,15,9,3,15,6,7,2,0,5,10,2,12,5,22,0,14,1,1,9,3,0,0,1,3,10,10,10,9,7,0,12,12,8,3,9,13,4,4,3,10,4,1,13,0,8,7,0,9,10,18,21,12,10,12,13,7,7,6,19,6,12,1,11,15,6,18,0,3,5,1,18,31,9,21,9,4,8,6,13,14,6,0,5,41,7,2,4,38,22,9,6,10,28,0,6,9,9,4,6,3,12,2,10,4,8,4,6,1,0,4,4,12,4,9,7,17,3,2,7,13,0,5,14,2,19,8,6,14,5,2,2,0,14,2,3,4,17,24,6,2,104,0,15,15,0,5,3,2,5,12,9,13,24,0,13,2,63,3,1,5,15,15,0,5,7,6,7,1,0,4,4,10,8,7,6,0,8,13,7,20,4,3,3,11,1,14,8,0,4,15,3,37,2,2,10,0,2,7,0,3,4,6,4,8,15,12,3,0,7,8,0,7,18,0,7,14,1,8,6,1,10,18,0,3,8,2,0,8,8,16,0,27,29,20,22,6,10,13,3,22,8,3,0,7,4,3,9,5,5,13,4,35,8,17,8,5,8,13,6,10,4,1,5,0,4,6,5,15,20,26,6,11,25,12,1,4,22,6,7,13,1,7,1,4,3,4,30,11,11,2,13,7,8,17,13,0,2,26,1,21,8,15,5,6,2,2,14,1,10,7,1,6,1,6,6,0,7,1,24,7,17,15,1,5,19,4,6,0,0,23,0,10,2,0,3,21,4,14,4,3,5,5,15,14,22,4,3,7,5,1,3,0,0,0,0,8,0,11,1,0,1,3,2,10,10,15,0,11,10,6,4,5,11,2,4,9,7,10,7,0,4,8,1,5,0,0,1,13,0,2,10,6,14,6,2,9,0,5,3,8,9,2,5,6,0,21,7,0,5,8,15,8,7,8,10,0,5,4,11,0,3,5,8,5,12,11,0,1,2,9,5,5,3,8,2,6,58,8,17,16,1,2,2,16,2,7,3,8,0,1,4,9,9,1,0,0,0,3,0,6,2,0,12,6,3,3,14,12,1,1,2,4,3,9,10,15,9,4,4,8,4,15,1,1,0,6,3,0,1,10,1,4,6,11,9,2,18,4,7,0,5,4,15,13,6,4,5,1,2,4,5,4,11,5,9,20,2,4,7,6,8,3,9,13,13,0,23,6,20,2,17,10,1,13,8,3,0,10,12,16,27,6,0,16,13,42,4,4,4,0,6,9,0,1,0,16,4,8,2,5,8,1,4,5,2,0,11,3,0,2,0,11,3,7,12,0,2,4,0,1,2,1,2,1,0,1,4,4,9,5,1,14,9,3,12,6,0,1,0,12,17,0,3,6,11,2,3,4,5,5,3,5,20,12,1,1,14,7,5,0,6,2,6,19,14,9,1,11,0,3,0,3,16,6,10,5,10,0,0,4,4,6,4,0,15,3,0,7,13,0,17,3,17,0,7,1,1,4,12,2,3,4,2,2,56,3,5,2,0,5,0,10,5,13,1,3,7,0,3,3,7,14,5,2,19,0,3,10,81,7,15,12,3,2,15,11,0,3,6,2,9,1,15,1,0,13,0,6,0,4,2,7,10,2,5,2,0,6,3,8,10,0,1,2,0,6,2,2,3,0,2,7,2,9,3,7,0,5,5,0,5,3,10,10,0,7,4,2,0,4,14,6,5,1,2,5,9,1,9,2,2,1,12,3,8,0,1,6,5,1,10,14,5,4,0,0,2,4,0,1,0,0,0,24,4,9,3,3,2,3,0,2,2,0,0,2,3,9,6,8,8,3,3,9,3,4,5,3,15,5,1,3,4,15,6,0,43,3,2,10,3,15,0,6,3,4,6,4,0,6,2,13,0,0,9,5,0,5,4,1,3,14,21,5,1,0,0,2,4,0,1,5,0,9,14,4,0,1,1,2,0,1,0,8,2,3,6,1,5,4,4,2,11,0,0,10,8,3,9,1,7,4,0,2,0,7,3,0,3,9,0,2,0,1,0,5,0,4,4,1,5,5,0,5,1,7,1,0,0,3,4,1,5,4,4,6,6,3,1,0,0,4,2,3,0,0,6,1,7,10,8,9,0,8,6,5,2,3,2,9,14,1,2,3,3,4,5,10,3,0,3,0,1,0,6,1,1,12,2,6,0,3,6,4,3,14,3,5,18,0,4,2,1,55,2,1,5,0,5,3,4,0,7,0,3,4,11,5,0,0,2,2,26,4,1,1,2,2,3,6,14,8,4,3,2,6,3,5,4,13,2,4,8,0,0,10,6,3,3,2,7,5,0,0,5,4,0,0,5,8,4,2,9,0,11,6,5,4,0,0,1,6,5,0,5,10,1,10,0,1,20,14,0,0,11,3,4,4,0,4,2,1,1,4,11,10,1,4,0,16,0,0,4,0,1,6,0,0,3,1,12,4,1,7,3,7,0,5,6,22,3,5,2,5,4,1,4,10,1,3,0,2,1,2,2,0,10,0,2,3,20,7,0,3,0,4,2,3,6,1,2,5,6,0,3,0,8,0,0,1,0,1,3,0,0,1,4,7,0,2,3,0,2,7,8,1,9,2,2,7,19,3,0,7,2,2,11,1,0,0,2,2,4,8,3,7,3,0,0,0,0,10,12,6,0,2,0,7,0,9,0,0,1,4,2,0,3,2,3,0,9,0,7,0,3,3,3,5,3,0,1,3,1,5,1,2,9,5,0,5,4,1,1,0,2,1,10,0,2,5,2,0,1,0,1,2,2,3,7,2,6,5,2,7,3,0,5,0,3,8,1,9,5,4,4,6,2,1,0,1,14,6,7,0,0,9,0,7,2,1,2,0,0,10,4,2,8,1,5,0,5,4,3,0,0,7,3,0,3,7,7,3,1,8,12,9,6,0,5,3,16,1,17,2,3,1,7,4,1,3,6,4,15,3,3,5,5,4,2,3,2,2,4,4,2,1,1,7,2,6,6,0,3,1,2,0,1,0,5,13,3,3,0,2,0,4,0,0,2,3,1,3,10,4,0,6,3,2,3,2,3,6,0,3,1,0,0,8,6,20,5,1,3,22,9,2,7,0,1,0,0,2,0,0,8,4,6,0,4,5,4,0,3,0,6,1,11,2,5,2,0,2,0,1,10,1,4,0,6,1,4,3,3,1,2,9,1,6,0,0,2,1,2,3,1,5,0,5,5,41,4,1,0,3,3,0,2,5,1,0,2,4,0,3,7,5,0,7,9,0,2,6,12,0,6,9,4,2,4,2,2,5,1,1,2,3,2,3,1,0,0,0,16,2,0,0,0,12,5,5,3,2,0,0,2,2,10,0,0,0,1,3,1,0,3,1,2,4,2,6,8,0,3,0,3,3,0,7,1,3,0,3,2,1,0,4,0,4,1,3,0,7,2,4,0,3,3,6,1,2,5,72,5,0,0,5,0,0,3,0,1,9,1,0,2,2,2,3,5,4,1,2,2,0,1,3,2,3,3,1,10,2,6,2,5,3,3,3,1,2,4,29,8,0,5,1,1,0,13,7,7,4,2,2,4,3,0,2,3,2,2,1,2,2,0,3,0,3,104,3,1,0,0,0,2,1,0,0,5,17,0,0,0,5,7,0,5,0,0,4,3,4,3,13,1,2,6,3,4,0,6,5,7,0,3,0,0,4,18,12,2,0,3,3,0,1,0,2,0,1,1,1,1,0,2,3,3,0,2,6,4,2,0,3,6,5,1,4,1,0,4,7,3,0,2,2,2,0,0,0,3,6,2,2,0,2,42,0,8,13,2,9,1,0,12,2,2,0,2,5,0,5,0,2,8,0,1,0,9,6,3,3,0,0,0,4,1,4,4,0,14,0,2,2,0,3,0,1,3,5,4,1,6,0,0,15,6,0,3,5,2,3,4,7,5,3,0,0,4,3,1,2,2,2,2,3,0,2,1,3,0,4,0,0,3,1,0,0,5,7,0,4,0,9,1,5,5,3,2,1,6,2,3,0,6,1,2,0,0,4,1,3,3,1,0,0,5,0,10,4,0,0,0,4,5,4,0,5,8,0,7,0,0,2,1,0,5,8,2,0,10,12,4,5,1,0,0,2,0,4,0,4,1,2,0,4,1,1,2,0,2,2,1,5,3,0,3,0,2,5,12,0,2,2,0,0,1,13,1,5,9,2,7,0,4,0,0,3,0,0,0,0,2,0,0,7,1,3,4,4,1,4,0,4,2,3,0,3,0,0,4,1,1,6,16,5,0,5,0,7,5,1,0,3,2,2,6,5,1,1,0,0,0,0,2,10,0,1,0,4,4,0,0,0,3,0,8,1,0,3,2,1,0,0,2,1,5,3,4,0,0,6,0,0,3,0,1,1,0,1,1,1,0,0,1,2,8,7,3,2,0,1,5,0,0,4,1,0,9,0,2,1,6,3,1,0,0,0,0,2,1,0,2,1,4,5,2,8,1,1,2,6,0,3,0,2,2,4,1,1,9,0,0,0,3,2,2,4,0,1,8,3,8,1,6,0,13,4,0,3,2,1,6,1,0,0,2,6,1,3,6,3,1,0,3,0,0,2,4,1,13,8,0,3,1,1,0,4,0,1,1,0,3,0,3,10,5,2,0,4,1,3,3,2,0,8,2,0,2,0,1,1,1,1,0,1,0,1,2,1,6,8,1,6,0,2,3,0,20,2,2,2,0,0,10,2,0,0,2,0,0,0,1,3,7,0,1,2,4,0,5,1,0,0,1,0,3,3,1,6,3,1,0,0,4,0,0,1,1,4,1,2,0,3,0,1,1,3,4,0,2,4,0,0,66,13,6,6,1,0,2,1,0,2,2,1,3,0,26,2,1,0,1,4,13,1,2,10,4,5,2,8,1,6,3,1,1,0,1,0,6,0,7,10,1,2,0,5,0,3,3,6,1,0,1,0,4,6,2,2,0,0,4,0,8,9,1,0,0,1,3,2,0,4,0,0,0,0,6,2,0,0,4,7,8,10,0,0,0,0,1,0,1,2,4,2,3,7,0,4,4,2,2,2,0,3,1,0,1,4,1,0,0,3,1,17,1,1,1,0,0,3,3,4,0,9,2,1,2,1,0,5,0,1,4,6,5,3,4,6,8,0,5,1,0,7,1,27,0,0,6,1,0,0,7,3,0,1,0,0,4,1,3,6,4,1,2,6,0,0,4,6,1,4,1,3,0,1,3,3,4,0,4,1,4,6,4,0,2,1,0,0,0,1,2,1,7,0,0,5,0,1,0,0,1,1,1,0,1,1,0,0,0,0,1,228,1,1,1,2,2,9,0,0,1,0,4,0,0,1,0,1,1,0,4,9,1,1,1,3,4,3,1,0,0,0,0,0,0,4,1,0,3,1,0,2,0,2,3,2,1,0,2,0,1,0,0,0,0,3,5,0,0,1,0,1,4,3,3,0,6,0,1,0,4,0,7,0,0,2,7,3,0,1,0,3,1,3,2,1,0,7,1,1,0,3,3,1,2,0,18,3,1,2,5,4,2,3,4,4,0,5,1,0,0,0,0,2,3,0,3,0,4,3,0,7,3,4,0,4,2,2,2,4,2,1,1,0,2,1,0,0,7,1,1,0,0,4,1,0,4,0,0,1,0,2,7,0,15,0,4,1,1,0,1,1,2,0,5,5,2,1,1,0,5,3,2,6,5,2,0,2,2,4,2,0,4,0,8,0,0,0,4,2,4,1,2,0,1,0,0,0,4,2,1,2,10,4,2,5,9,3,0,4,8,0,2,6,0,2,4,4,1,0,0,0,5,2,0,1,0,0,6,0,11,0,0,0,1,2,3,4,0,3,0,2,2,3,2,5,3,2,1,2,4,0,0,0,3,2,5,2,2,0,1,1,0,1,4,1,0,3,2,1,2,2,1,0,0,0,2,0,3,3,2,1,4,0,0,1,0,0,4,2,1,0,10,1,2,1,1,4,0,4,0,0,0,1,1,2,4,1,2,2,1,0,3,5,1,2,4,2,2,0,2,0,2,1,2,1,0,2,6,1,0,0,0,0,3,14,3,0,1,0,1,3,0,4,1,0,0,1,1,1,4,0,5,0,1,2,1,2,0,3,1,1,0,2,0,0,1,0,5,4,1,1,2,3,2,0,0,1,3,5,3,0,1,2,0,0,1,0,0,3,0,2,2,0,0,0,0,0,3,0,2,3,1,2,0,1,0,0,0,11,7,0,2,0,2,0,0,1,1,5,4,0,0,1,0,0,6,1,1,1,3,1,1,1,0,1,12,4,1,0,4,5,0,4,2,1,1,3,4,4,0,1,6,7,3,1,1,0,1,7,7,1,5,3,1,3,20,0,1,3,2,13,3,0,1,0,1,3,1,1,0,5,0,1,3,5,0,1,0,0,1,1,2,1,3,1,4,0,1,3,1,1,2,0,1,0,4,1,0,0,0,10,0,2,0,1,0,1,0,0,0,2,1,0,0,0,0,0,0,0,3,0,0,1,3,1,0,0,1,6,0,6,4,1,0,0,6,0,2,0,7,0,0,0,0,0,2,4,0,0,0,2,0,4,1,2,3,0,2,2,0,1,2,0,0,0,3,1,4,1,0,0,1,13,1,0,0,0,5,1,0,0,0,1,0,0,1,4,0,0,1,0,11,1,1,11,0,1,5,2,0,0,6,2,7,1,0,1,1,0,0,0,2,1,7,2,2,0,2,0,3,3,1,4,4,0,3,2,0,0,4,6,0,1,2,1,1,1,0,0,0,0,3,1,1,3,0,0,2,5,2,2,1,0,0,5,0,0,1,0,4,0,0,0,0,2,0,8,0,3,0,1,1,3,6,2,0,6,1,1,4,3,3,0,0,2,3,0,0,0,1,3,1,0,3,0,2,0,11,0,2,0,1,1,0,2,1,0,0,4,1,6,6,0,1,3,2,3,2,2,1,1,4,0,2,2,0,0,1,0,0,0,0,2,0,0,0,36,9,1,0,0,2,1,1,0,0,5,1,8,0,0,0,0,0,0,3,4,0,4,2,1,2,5,0,3,0,0,2,2,0,4,0,0,0,0,2,0,1,0,0,0,5,0,1,6,2,0,0,0,4,1,6,0,3,2,1,1,2,0,1,0,1,0,0,0,1,2,0,7,2,0,0,3,0,0,4,1,0,1,0,1,4,1,3,1,0,0,3,1,0,5,3,0,2,0,0,0,0,0,0,0,0,0,1,0,3,5,0,0,35,1,2,0,0,1,9,2,2,0,3,1,7,1,0,2,5,3,6,0,0,0,1,0,2,1,0,3,4,11,0,3,0,0,0,3,1,3,2,1,0,0,2,0,2,0,0,0,1,2,1,5,5,2,1,1,2,0,3,4,7,0,0,2,5,2,1,0,0,2,4,0,0,1,2,4,0,0,4,2,5,0,2,1,2,0,0,2,2,1,0,3,1,1,9,1,6,0,1,2,0,0,0,2,0,0,2,1,4,0,1,2,1,0,0,2,6,0,0,6,0,0,1,1,1,0,2,1,4,0,4,2,13,4,0,2,1,1,0,0,1,2,0,1,0,0,2,0,0,2,4,0,0,2,0,0,0,0,0,3,0,0,0,1,0,0,0,0,1,1,2,0,1,0,12,0,2,22,0,1,0,0,1,2,4,2,1,3,0,0,0,4,1,0,3,0,1,1,0,1,2,6,1,1,1,0,0,1,5,3,0,3,0,2,2,2,0,0,3,0,0,0,0,0,2,4,2,1,1,3,1,0,0,0,8,3,0,1,4,1,0,0,0,0,0,1,1,0,0,0,0,0,3,5,0,0,1,2,4,0,0,0,0,0,2,2,3,0,4,0,23,0,0,0,1,1,1,3,0,3,3,2,0,3,0,0,1,4,1,0,0,1,0,0,1,4,0,0,1,0,7,0,0,0,2,1,2,1,1,1,1,2,0,1,1,3,1,4,0,1,0,2,1,3,0,5,0,4,1,0,0,2,1,1,1,4,0,2,1,0,0,0,0,3,0,4,3,0,5,0,0,0,1,5,0,0,0,2,1,2,2,4,0,0,0,0,1,5,2,1,0,0,2,5,1,1,0,0,0,0,3,0,0,0,0,0,2,3,0,1,5,3,3,0,0,0,3,0,0,1,0,1,2,0,0,0,1,0,0,0,1,3,0,1,0,0,1,3,0,0,3,1,3,7,3,0,0,0,0,0,0,3,2,0,0,2,1,5,0,0,0,0,6,0,1,2,0,0,2,1,0,2,0,0,5,1,6,1,0,2,1,1,0,1,0,1,0,0,1,0,1,0,0,1,0,0,0,1,2,2,0,1,0,3,1,0,0,1,2,0,0,3,1,0,0,4,0,0,5,0,1,5,3,0,1,2,0,5,0,4,3,2,0,0,0,1,0,1,1,0,1,3,1,2,0,0,24,0,0,0,0,2,2,2,1,3,0,1,1,4,0,2,3,0,0,1,0,0,1,3,0,1,1,4,2,0,2,0,1,0,0,0,0,0,0,0,0,0,1,0,3,1,1,0,0,0,0,2,0,0,1,0,0,1,2,0,1,1,2,0,0,0,1,1,0,0,0,6,2,0,1,0,1,1,3,0,1,1,0,0,1,0,0,7,0,4,2,1,1,1,0,0,4,0,0,0,5,0,0,0,1,0,1,1,0,0,0,0,0,0,4,1,2,1,5,1,2,0,0,9,0,0,0,0,0,0,1,3,1,0,3,0,5,0,0,0,2,0,0,0,0,1,0,0,0,1,0,0,0,1,0,0,2,0,0,0,0,0,0,0,0,1,4,0,1,0,1,0,0,1,1,0,2,0,7,0,0,0,0,0,0,1,0,0,0,0,0,0,0,0,0,0,0,0,0,1,1,1,0,0,0,0,0,0,0,0,0,0,0,0,0,0,0,0,0,0,0,0
K10 The Running Man,king,3887,1956,1364,1939,1322,464,1267,965,1011,803,809,828,515,267,245,623,528,546,354,436,386,273,251,362,102,210,141,371,370,159,227,340,103,257,171,212,251,194,129,248,234,226,259,248,91,161,127,115,200,181,201,218,151,237,219,155,182,110,126,117,164,126,83,120,192,107,112,178,113,77,144,113,69,90,151,105,131,72,74,93,114,66,168,116,96,104,61,65,63,81,33,123,81,127,65,55,72,53,83,57,49,89,110,48,73,56,66,102,59,44,58,62,47,71,70,95,80,50,70,64,58,97,90,79,70,30,57,41,38,43,37,64,52,42,71,38,26,92,66,50,16,31,5,90,35,65,51,43,55,42,39,85,55,50,50,36,31,32,69,53,68,43,16,20,47,45,31,27,24,52,16,31,33,57,123,30,18,33,33,27,16,19,78,20,46,15,22,15,48,28,24,20,44,19,38,46,4,27,44,7,43,62,17,25,36,63,43,52,15,47,10,47,29,22,40,23,53,42,18,37,28,14,34,46,17,39,15,39,21,24,48,47,41,84,16,1,28,50,36,24,20,19,31,20,29,24,61,23,32,27,41,23,37,37,45,45,14,16,34,19,40,26,34,65,12,12,13,26,39,40,13,21,30,15,23,14,18,15,53,21,49,16,16,15,51,50,17,20,20,91,41,6,13,9,22,26,32,13,14,11,37,17,14,21,87,26,46,19,21,22,37,9,13,10,11,30,53,30,20,26,26,18,3,63,3,31,35,23,18,31,10,20,42,14,37,24,39,10,7,6,18,12,12,2,9,24,35,10,32,16,16,19,7,35,31,13,10,11,14,14,36,7,13,7,15,27,13,13,24,18,12,15,39,7,49,40,14,20,6,16,32,37,48,8,22,55,0,18,35,31,13,13,8,14,38,18,16,13,14,8,8,49,24,10,23,3,19,19,20,13,20,17,26,13,15,35,8,17,28,11,17,1,3,16,38,33,14,10,17,3,15,17,6,10,1,18,24,16,0,10,19,11,18,17,15,23,54,14,10,8,10,11,10,6,10,29,21,13,23,36,14,9,0,42,2,17,17,11,4,55,11,38,5,28,18,6,16,24,0,7,7,25,12,43,1,27,22,17,8,12,13,11,15,7,3,30,29,16,3,8,9,19,21,5,11,12,2,6,16,19,26,18,3,13,11,8,0,19,18,3,17,11,32,6,17,4,39,6,14,4,6,15,13,26,2,5,10,11,10,9,28,8,3,18,16,28,0,1,27,26,11,11,8,10,9,3,44,9,4,5,11,14,11,26,6,6,16,7,12,15,3,4,14,20,1,36,9,2,7,0,18,8,5,16,5,11,12,10,13,11,13,28,19,4,15,6,1,22,3,14,15,3,5,5,4,0,0,8,17,10,5,5,7,6,0,75,35,5,3,18,7,27,0,8,13,10,15,26,13,6,9,12,11,8,17,0,11,25,4,27,13,5,6,2,6,18,10,14,37,18,0,4,7,5,10,11,12,6,15,3,3,11,14,9,3,9,17,15,10,17,9,18,7,5,3,13,3,15,8,3,24,2,9,6,18,4,1,4,2,20,5,5,4,26,9,17,3,8,4,18,8,12,9,17,16,5,6,21,3,8,2,6,2,24,12,33,4,22,7,5,12,2,21,4,15,8,11,0,4,13,10,11,6,4,0,11,5,5,14,15,15,17,11,23,0,0,3,10,11,7,2,2,8,8,3,16,11,8,9,12,7,13,8,21,17,9,6,3,5,7,5,5,14,13,0,6,18,3,2,7,27,6,8,3,11,13,11,11,4,14,7,6,0,19,7,8,0,6,0,11,3,3,5,8,4,10,4,2,9,4,13,9,11,10,12,14,7,0,8,6,3,7,15,4,12,19,4,8,25,16,2,1,9,9,0,12,10,10,1,2,18,4,8,20,9,7,10,0,14,11,8,17,0,0,2,2,0,15,0,17,13,3,9,3,13,25,3,0,0,20,5,8,7,8,0,6,24,16,6,11,9,0,7,8,1,21,7,5,5,2,11,7,5,2,5,5,3,0,7,10,3,15,6,2,7,12,3,1,7,19,3,0,14,0,2,5,7,10,9,7,6,0,3,6,9,1,1,0,13,8,6,4,6,0,6,4,3,19,7,14,4,3,28,2,9,7,10,4,8,17,7,10,9,9,0,12,0,2,1,3,0,20,7,1,5,3,2,2,13,12,4,1,2,6,0,4,6,0,4,5,0,17,5,0,7,13,7,0,5,11,12,20,2,11,1,4,0,8,3,0,2,0,5,0,3,12,0,0,21,8,5,1,3,1,9,6,2,0,4,7,3,23,9,1,0,1,1,0,10,10,7,9,6,2,2,11,5,2,2,7,13,2,2,5,21,3,4,6,41,5,5,12,0,2,3,0,29,12,5,5,2,4,0,0,2,3,10,5,0,0,0,2,7,3,36,5,4,0,4,55,20,2,1,10,7,4,5,4,1,0,3,0,3,0,7,2,5,6,6,4,8,4,4,6,4,3,6,1,6,3,4,2,2,5,0,0,1,15,8,10,4,1,2,5,12,1,11,16,6,0,7,12,8,0,1,19,12,9,5,2,4,0,7,3,10,1,1,6,7,2,12,0,5,8,2,2,4,2,12,7,2,12,4,14,0,1,1,8,1,0,0,9,1,7,8,8,0,1,13,0,4,4,2,9,7,20,0,2,11,0,4,3,0,6,1,3,6,12,0,2,16,0,1,4,6,4,5,0,2,16,0,1,6,3,25,0,0,7,22,0,9,6,15,2,10,2,2,18,1,6,5,2,1,2,4,0,1,2,4,3,4,2,15,0,0,3,0,3,4,0,3,4,6,9,8,1,5,4,0,6,6,0,13,1,0,14,9,1,9,1,0,8,55,3,12,2,7,4,0,1,13,5,3,3,15,3,6,1,4,11,0,6,9,0,2,3,3,5,1,6,5,5,9,4,4,20,5,3,4,2,0,1,0,1,7,4,4,15,2,4,6,3,27,8,3,3,3,3,2,2,2,3,5,3,11,8,6,6,4,5,8,6,3,0,2,0,8,7,11,13,3,2,3,1,5,1,4,4,7,1,0,18,5,0,3,10,2,5,14,5,1,4,4,0,4,0,0,2,0,30,0,0,2,4,3,5,2,9,6,7,2,0,17,2,1,28,4,0,2,9,0,0,0,3,0,7,2,0,2,0,0,4,1,5,0,6,22,4,0,1,8,5,1,1,3,1,8,7,10,4,7,1,0,0,2,8,3,11,6,7,5,0,0,1,9,3,5,6,3,0,1,16,0,0,1,0,4,2,4,0,0,8,5,0,4,0,6,0,6,3,3,1,5,7,0,1,6,5,2,7,6,2,1,3,3,4,3,17,1,2,7,3,1,7,3,2,0,1,2,3,2,0,1,0,0,1,0,0,7,0,8,0,12,0,4,8,5,0,1,1,0,11,4,4,5,1,0,5,1,4,0,5,25,7,3,0,0,2,1,0,5,2,1,2,9,3,0,0,8,4,5,3,17,2,0,1,2,0,5,2,9,6,2,0,4,5,9,6,3,2,6,7,5,0,8,3,5,1,12,6,1,16,5,5,2,0,1,1,0,6,0,2,14,0,1,15,15,0,1,19,8,1,0,5,3,7,1,1,3,3,0,7,1,2,2,0,0,4,0,5,12,8,5,0,2,3,0,1,0,4,4,0,3,3,3,4,0,5,1,2,0,0,6,3,1,1,0,2,7,2,4,2,5,1,6,10,2,6,1,1,4,2,2,0,0,4,10,0,4,1,11,1,4,4,3,8,2,0,3,5,3,1,5,0,10,2,11,4,3,6,7,0,3,3,0,1,9,1,4,1,15,1,4,0,1,2,19,12,5,6,10,1,0,1,3,8,5,1,0,8,8,2,9,2,4,2,13,3,4,0,1,2,9,0,3,3,1,0,10,5,6,1,8,22,0,6,5,4,7,3,2,3,4,18,1,3,0,3,1,15,5,1,0,1,8,0,7,6,0,2,0,1,1,2,1,27,0,6,5,2,3,4,3,3,2,11,6,3,4,4,5,5,0,0,1,1,0,0,6,1,0,0,3,0,0,1,0,2,2,2,1,2,9,4,5,10,2,0,2,3,4,5,0,0,2,3,0,2,0,0,0,29,0,2,0,10,6,2,0,1,0,1,0,7,3,3,11,2,2,0,9,8,3,4,1,8,5,5,8,3,0,2,1,0,2,4,1,3,1,14,0,6,0,2,2,1,0,3,6,6,0,1,5,5,4,1,1,1,0,2,6,4,0,1,7,2,3,0,0,2,0,1,2,10,0,4,4,2,2,5,0,3,1,0,2,1,2,2,5,3,1,0,0,4,2,1,4,1,3,3,0,12,0,1,6,0,1,2,0,3,1,1,0,4,0,1,5,1,9,0,4,7,6,4,2,0,1,0,0,3,4,2,4,2,2,1,1,0,6,6,1,0,0,0,2,1,5,3,1,8,1,1,2,7,12,3,4,0,3,3,1,8,3,2,2,0,3,0,3,2,5,0,0,5,8,3,8,4,1,5,1,7,0,3,4,5,6,1,0,1,4,2,4,2,5,0,2,1,3,0,9,0,1,2,1,3,3,1,1,0,9,7,0,0,2,2,3,0,7,12,8,6,2,1,8,12,8,7,0,2,7,2,0,6,4,3,1,2,2,7,0,0,3,0,0,1,3,4,1,2,5,3,7,3,0,6,0,0,2,3,2,2,5,6,3,17,0,0,2,3,1,0,1,1,1,1,0,0,2,2,4,0,5,5,0,2,1,2,0,0,9,0,1,1,0,0,1,1,8,4,1,2,2,0,0,0,2,11,5,4,0,1,3,0,2,6,3,0,0,0,0,1,4,0,6,0,1,0,8,5,0,5,0,0,6,2,4,2,0,5,8,1,5,0,3,0,0,3,0,2,0,0,0,0,1,2,15,1,1,1,1,13,1,0,2,2,0,6,16,2,0,8,1,0,2,7,0,0,3,2,2,1,3,0,2,1,3,0,0,7,0,1,1,0,1,3,1,2,3,0,4,2,1,5,3,3,0,0,0,0,1,6,2,1,4,1,2,2,3,1,5,0,0,3,3,6,1,3,1,0,0,1,1,2,2,4,2,16,1,0,6,0,1,2,2,0,2,3,1,1,3,5,2,0,1,1,0,4,1,4,3,6,0,6,2,2,4,5,15,3,4,3,3,2,0,3,1,3,3,2,2,2,2,1,1,2,1,0,4,1,0,0,0,0,9,3,2,1,2,3,0,8,3,2,0,0,2,4,8,5,0,0,4,4,4,0,3,2,1,3,8,2,5,4,5,2,1,3,0,0,5,2,0,1,1,8,1,15,0,1,0,0,8,0,0,40,3,18,4,2,0,1,1,1,2,0,0,4,0,0,1,1,2,2,2,1,0,10,0,14,3,10,0,0,0,2,1,0,4,1,0,0,0,1,5,0,0,2,0,3,3,2,1,1,0,0,1,1,0,0,0,1,3,2,8,1,2,12,3,3,0,5,4,1,5,0,3,1,0,3,3,0,3,5,0,0,10,1,1,2,0,1,1,1,0,0,2,34,7,0,0,4,6,1,0,7,1,2,0,1,2,3,8,8,0,2,3,0,0,2,2,1,1,7,0,0,2,1,2,0,0,1,1,2,1,4,0,0,0,2,0,0,0,0,0,0,3,3,2,2,2,0,3,1,4,1,0,1,2,1,0,3,4,3,6,0,0,2,5,0,4,0,0,4,1,4,9,1,1,5,1,2,0,0,0,2,4,1,0,5,2,0,1,10,0,4,0,2,4,0,5,0,0,4,0,0,1,6,0,1,0,4,3,1,0,2,0,0,0,1,0,2,0,0,4,1,0,0,0,1,0,0,2,3,5,0,2,2,1,0,4,0,4,5,2,2,3,0,3,2,4,0,4,3,1,1,2,0,4,2,4,0,0,15,1,1,0,0,1,0,2,9,0,6,0,0,2,2,0,0,1,0,2,1,2,10,1,2,3,2,4,6,1,4,2,3,1,3,1,11,1,1,1,0,1,0,3,1,1,0,0,0,0,4,0,5,0,1,0,0,0,0,2,0,0,0,0,3,0,2,0,1,54,7,0,0,2,0,1,0,3,11,8,1,5,0,0,0,1,0,0,1,10,3,0,0,1,0,1,1,3,0,3,2,1,0,4,2,0,0,5,0,5,0,1,0,1,8,2,4,0,0,0,5,1,0,0,0,6,0,10,3,1,1,0,0,1,25,5,4,2,0,0,10,0,0,1,0,2,0,0,2,4,1,0,0,4,1,5,3,2,1,2,1,1,2,1,5,0,8,0,1,0,8,0,0,1,7,2,4,0,4,0,1,3,0,1,0,5,2,0,4,2,0,5,2,0,1,2,0,5,0,0,0,3,3,2,1,1,0,0,3,0,0,0,5,0,2,1,0,0,2,0,1,5,2,2,1,3,6,1,3,2,0,0,5,0,4,4,0,0,3,1,6,1,0,1,0,0,1,8,4,0,0,0,0,1,1,0,0,1,3,0,0,2,1,2,5,8,2,1,1,0,0,0,3,0,0,0,1,2,1,2,2,3,1,6,1,4,2,0,0,1,1,0,4,1,0,17,1,0,9,2,2,1,3,1,1,3,1,0,3,0,2,9,20,4,4,0,2,1,0,0,5,0,0,0,3,0,0,1,0,2,0,6,0,0,0,1,0,0,1,5,2,0,2,5,0,0,1,0,0,0,0,2,2,0,1,0,4,0,0,0,1,2,5,4,1,0,1,1,0,0,2,2,0,0,0,2,2,6,2,6,2,0,1,0,0,1,1,7,3,2,4,0,1,3,1,0,0,0,2,0,1,5,6,2,0,2,0,0,5,1,4,1,2,2,7,2,3,2,0,1,0,2,2,1,1,1,1,1,0,0,2,3,0,3,2,1,0,2,0,4,1,1,0,3,1,4,1,0,1,2,2,6,0,0,0,2,0,1,0,1,3,2,1,1,0,0,3,2,0,1,3,1,1,1,0,2,0,0,0,0,3,0,0,2,0,2,3,1,0,2,1,0,0,12,0,2,5,0,3,0,1,0,2,1,0,0,1,4,2,0,1,3,1,2,0,0,0,2,0,2,0,2,4,0,3,0,4,0,1,2,3,0,103,0,2,0,2,1,3,0,2,0,5,0,2,1,4,2,0,4,3,9,1,1,0,1,2,1,5,3,2,2,6,0,0,5,1,0,0,2,1,2,4,2,8,1,3,3,4,4,0,0,1,0,0,0,0,4,0,0,0,2,2,1,0,2,3,0,0,0,0,4,2,2,4,0,0,1,0,9,6,2,5,1,1,0,2,0,3,0,0,0,6,2,0,1,0,0,4,4,1,2,0,2,0,1,2,0,1,0,0,3,4,0,1,2,2,1,2,0,5,1,1,2,1,0,1,0,0,0,2,1,1,2,0,3,0,1,2,1,2,1,2,0,1,0,5,0,1,0,3,0,4,5,4,5,0,0,2,0,0,1,3,0,2,1,2,7,0,4,2,0,2,1,0,0,0,1,0,0,0,1,1,0,0,0,0,1,6,4,4,0,0,1,3,2,1,0,0,1,3,1,1,0,0,1,0,2,0,1,2,1,0,0,5,0,0,4,1,0,0,3,0,0,1,1,1,0,0,0,2,1,0,1,9,0,7,0,0,2,2,5,0,3,5,0,2,0,1,2,1,1,3,4,2,1,1,0,0,1,0,2,0,0,3,3,0,2,1,0,2,2,3,4,3,0,2,0,0,2,0,0,0,0,1,1,2,0,0,1,1,0,6,1,0,3,0,2,0,0,0,1,1,3,0,4,3,0,2,1,1,0,0,1,1,0,1,7,3,0,3,0,0,0,0,0,2,0,1,6,0,2,1,0,3,0,0,1,0,0,1,0,0,0,0,4,0,2,0,0,1,6,0,0,0,1,1,2,4,0,0,0,1,1,3,1,0,2,0,0,0,0,1,0,1,6,1,0,0,5,4,14,0,4,0,1,0,0,0,0,0,4,0,4,0,0,1,3,0,3,0,0,2,1,0,0,0,1,5,2,0,1,0,4,1,0,1,3,5,2,0,2,1,2,0,0,0,2,1,4,3,1,2,1,1,0,0,0,0,8,0,1,0,0,0,1,4,1,0,0,0,1,2,1,0,0,2,0,6,1,0,0,0,0,0,0,3,0,2,1,1,0,0,7,2,3,1,0,0,0,0,0,1,1,6,1,1,0,4,0,1,0,1,3,1,0,0,2,1,0,2,3,0,0,0,1,1,1,3,0,0,1,0,1,3,0,1,0,3,0,1,2,2,1,2,3,5,0,3,0,0,0,0,5,0,2,0,2,1,1,0,0,4,0,1,2,0,1,0,2,0,1,1,2,1,2,2,0,5,0,1,0,0,3,0,3,1,3,0,1,2,0,2,3,0,0,0,1,2,2,0,2,2,1,1,1,0,0,1,2,0,0,0,5,2,0,0,2,1,5,0,0,2,8,0,0,0,0,10,0,0,0,1,0,0,0,0,0,0,0,0,0,1,0,0,0,0,1,2,0,4,0,1,0,3,0,1,0,2,1,0,3,1,0,0,0,0,0,5,1,2,0,1,0,0,0,0,0,0,0,0,0,0,0,0,0,1,1,0,2,0,0,2,0,0,1,0,1,0,1,1,0,0,2,0,0,1,4,1,0,0,0,1,2,0,2,0,0,2,1,0,0,0,0,0,0,1,1,0,1,1,1,1,1,7,0,0,0,1,2,1,2,0,0,2,0,0,4,2,0,2,2,0,1,1,2,2,2,0,2,6,0,1,4,4,0,1,0,0,1,3,0,0,0,1,0,0,0,0,0,1,3,0,0,1,0,0,1,1,6,0,5,0,1,0,0,0,2,0,1,0,1,0,0,0,2,4,0,0,1,1,1,5,0,2,0,1,0,2,0,2,1,1,8,0,1,1,0,2,0,0,0,1,1,2,0,0,3,1,0,4,0,0,0,3,0,8,1,0,0,0,1,0,2,4,3,2,0,1,1,0,3,0,1,0,0,3,1,0,1,0,0,0,4,0,0,0,1,0,0,0,0,3,3,0,3,1,0,1,0,2,1,1,0,1,2,0,0,1,0,0,0,1,1,5,0,0,4,2,2,1,1,0,0,1,0,0,3,0,4,2,0,0,1,0,1,6,0,2,0,0,0,0,4,2,0,0,0,1,8,3,1,1,0,4,1,0,1,1,1,3,1,1,4,0,6,0,3,0,4,3,5,0,2,1,1,1,0,0,2,0,0,0,2,0,3,7,0,1,1,0,0,0,2,1,0,0,0,0,0,2,0,0,0,0,1,1,5,1,0,1,1,1,1,0,1,2,0,1,0,1,0,1,0,0,0,0,0,1,0,0,16,2,1,0,0,0,0,0,1,2,0,0,0,0,0,0,0,2,5,0,4,2,1,3,0,0,0,0,2,5,1,0,2,0,0,3,6,0,2,0,1,0,0,1,1,0,2,4,0,0,0,1,0,1,0,0,0,0,0,0,0,0,1,0,1,0,0,1,1,1,0,0,2,1,0,0,0,1,0,2,0,1,0,0,2,2,0,0,0,0,1,0,0,3,1,0,0,0,2,0,0,0,2,6,1,5,0,0,0,2,0,1,5,0,0,1,1,0,0,2,4,0,1,1,1,3,1,1,0,0,0,0,1,0,0,1,0,3,1,7,1,0,0,1,0,0,6,1,1,0,1,2,3,0,5,0,0,4,0,0,0,1,0,0,0,1,0,1,0,0,0,1,1,0,0,1,1,2,0,1,2,4,1,2,5,1,1,1,0,0,0,0,3,0,1,0,1,0,0,0,0,0,0,3,3,0,0,0,0,1,0,3,0,0,1,0,1,0,2,0,2,1,0,0,2,6,1,0,0,1,0,2,0,5,0,0,0,4,2,1,0,4,0,1,4,2,1,0,0,0,2,0,0,0,0,0,1,0,3,0,1,3,10,0,1,0,3,0,0,3,2,1,0,0,0,2,0,1,1,1,1,0,1,0,0,0,1,0,0,4,0,1,1,0,1,9,3,1,0,1,0,4,4,0,1,1,2,0,0,0,0,0,3,5,3,0,1,0,0,5,0,1,1,2,1,0,4,3,0,1,0,0,2,1,0,0,0,0,0,0,2,0,2,0,3,0,0,0,2,0,0,0,2,1,0,0,0,0,3,2,0,0,2,0,0,2,0,0,1,2,1,1,0,7,0,0,3,0,1,1,0,0,0,1,0,1,1,0,1,1,12,2,0,0,2,0,0,0,1,0,0,0,0,25,1,2,0,10,3,1,1,0,1,0,4,0,0,1,0,0,3,2,0,7,0,1,0,2,5,0,1,0,0,0,0,0,5,0,1,2,1,0,0,2,0,0,1,1,2,5,0,0,0,5,1,1,0,0,0,0,1,0,0,0,0,8,0,1,1,0,0,0,4,0,2,0,1,1,1,0,1,0,3,1,0,1,1,0,3,0,0,1,1,3,2,0,0,0,0,0,0,0,4,2,1,1,0,0,0,1,1,0,0,0,0,0,0,0,2,3,0,0,0,2,1,1,0,0,1,0,0,0,2,2,3,0,1,0,1,0,4,0,1,1,1,9,0,0,0,1,0,0,0,0,1,0,0,0,0,0,0,1,0,0,3,1,3,1,0,0,0,0,0,0,0,0,1,0,0,0,4,0,0,2,0,0,1,0,0,3,0,0,0,2,1,2,0,0,0,0,0,22,0,0,0,6,3,0,3,2,1,2,0,0,0,2,0,0,2,1,1,0,2,1,0,5,0,0,0,0,0,3,1,1,1,0,0,1,1,1,2,0,0,0,0,0,1,0,0,1,0,1,2,1,0,0,1,2,1,0,1,1,0,1,0,0,2,0,0,0,0,0,3,0,0,0,1,1,0,1,1,0,0,0,0,7,4,0,0,0,0,1,1,1,0,0,0,1,3,1,0,0,2,1,2,4,1,1,0,1,0,0,0,0,0,0,0,3,1,0,1,0,0,0,0,0,2,1,0,0,0,0,9,0,3,5,0,0,2,0,0,2,0,0,1,0,1,37,1,0,1,0,0,0,0,1,0,0,0,0,0,0,0,1,1,1,0,2,0,0,4,0,0,0,0,0,0,0,0,0,0,0,1,0,0,0,0,0,0,0,0,0,3,0,0,0,0,0,0,8,0,0,0,0,0,1,0,0,1,0,0,0,0,0,2,0,0,0,0,0,0,0,0,0,0,0,0,0,0,0,0,0,2,0,0,0
K11 Rita Hayworth,king,1926,1104,947,1175,995,818,741,712,638,627,545,366,740,26,41,330,354,233,308,154,220,254,258,214,168,131,169,189,206,163,120,190,151,147,109,272,152,178,49,177,192,165,192,119,136,138,206,127,150,107,88,128,123,86,80,91,151,83,84,155,90,72,129,50,106,128,72,79,80,82,145,45,74,41,114,72,81,76,92,49,44,63,125,55,64,27,53,92,66,37,47,69,53,33,85,81,55,37,65,47,72,69,79,77,28,40,33,35,44,48,35,55,35,24,38,12,50,32,23,31,32,40,61,28,16,70,61,33,43,51,26,51,64,34,28,46,20,26,25,32,14,32,37,42,59,40,33,43,45,71,52,36,29,31,18,13,30,45,71,26,46,17,36,38,24,11,32,15,36,23,41,90,68,36,13,18,39,31,23,35,43,28,19,34,28,13,23,23,28,41,9,13,42,29,11,23,2,29,11,5,30,17,28,26,22,11,18,14,20,65,1,23,32,16,16,19,30,3,43,4,13,35,13,14,15,12,18,32,13,23,9,30,5,9,14,0,5,16,6,22,6,30,27,10,30,32,38,27,17,17,22,14,13,20,16,22,14,23,18,20,37,32,13,34,27,2,24,27,40,29,10,16,27,17,15,18,32,7,21,31,5,3,15,32,36,4,8,5,13,5,0,5,0,18,6,18,9,24,1,15,31,11,5,21,14,37,34,7,3,28,6,19,16,24,18,10,10,36,14,4,7,25,11,11,1,6,14,16,17,7,16,26,15,4,8,17,14,1,11,22,9,5,4,12,9,1,5,42,9,4,15,6,12,12,9,14,19,13,22,40,34,5,10,10,9,12,4,9,9,18,12,9,26,0,39,6,7,29,16,5,41,4,25,1,10,10,0,13,9,3,9,10,31,10,10,19,1,9,18,21,9,3,7,7,22,13,6,34,4,7,1,6,14,13,7,1,6,8,8,10,8,1,2,25,7,8,10,8,10,15,7,4,2,17,1,2,10,5,0,10,4,5,2,12,4,9,7,17,9,22,0,9,5,17,13,7,2,7,9,10,12,4,0,2,5,18,4,15,1,9,1,2,18,4,5,11,3,4,0,17,11,10,1,15,1,7,2,0,40,11,6,9,4,11,11,2,11,9,7,3,11,6,6,5,9,3,3,7,7,0,6,4,5,4,18,17,0,3,5,8,10,12,2,11,6,4,16,7,6,16,1,2,6,10,7,0,11,12,2,14,6,2,9,2,2,3,0,2,30,15,2,7,23,12,2,7,0,14,6,1,9,5,9,0,12,7,8,0,3,5,10,8,3,8,14,2,5,4,4,20,1,15,7,4,4,10,1,13,3,16,9,20,0,21,3,11,1,6,3,7,0,5,20,3,0,0,1,3,2,5,5,1,6,17,4,30,6,3,8,10,2,4,0,10,4,6,16,3,10,5,4,1,2,2,2,0,11,0,4,6,8,2,4,0,12,8,10,1,0,15,0,2,7,6,2,3,4,7,6,4,6,6,4,19,2,9,5,11,9,1,1,7,0,2,8,1,1,5,9,4,9,4,7,8,4,7,1,10,2,14,7,4,6,7,1,23,5,2,9,4,13,1,3,4,5,2,1,2,3,7,5,2,8,5,9,12,1,6,15,2,1,6,5,0,0,3,22,0,3,2,3,10,0,7,0,15,5,4,7,9,7,11,2,3,0,0,0,9,4,8,4,2,7,2,5,2,5,1,1,1,1,6,6,6,7,3,2,3,5,3,6,3,4,0,0,5,5,2,2,3,2,7,3,4,0,4,2,5,2,13,10,1,1,1,5,7,0,6,4,1,10,0,1,4,2,5,14,5,1,13,2,6,4,8,4,10,1,0,5,7,21,2,2,3,8,11,5,2,8,4,3,0,2,10,0,4,4,2,0,5,3,1,4,3,2,15,1,0,4,2,7,6,2,1,0,3,3,1,5,7,5,5,0,3,2,3,6,0,1,8,10,6,5,1,0,2,5,12,6,8,2,7,1,0,1,4,3,8,2,3,8,0,4,2,1,8,1,0,1,2,6,0,12,3,15,8,5,2,1,5,3,0,3,1,4,0,4,7,11,0,5,0,1,0,3,6,1,0,26,8,1,2,0,1,5,1,7,2,7,1,4,6,4,6,3,3,3,0,4,1,6,5,5,0,1,7,1,5,10,0,0,2,8,11,7,5,5,3,1,1,7,0,5,2,2,3,3,10,5,0,1,4,3,1,4,1,2,0,4,4,3,2,0,1,4,5,0,0,7,0,1,0,4,1,2,3,0,2,1,5,4,0,10,4,3,5,4,0,2,0,5,3,2,2,1,0,2,30,5,2,1,12,2,8,3,4,5,3,1,0,2,5,45,0,0,2,1,6,20,3,1,6,0,2,7,0,9,6,0,2,4,0,0,2,3,1,15,2,0,0,0,0,4,1,7,1,3,0,2,2,0,1,4,1,5,2,1,5,1,4,2,0,2,1,11,5,5,4,6,2,4,1,2,5,6,3,3,2,4,3,2,2,0,0,0,0,1,1,8,1,3,5,2,5,1,1,6,11,1,11,2,0,3,1,0,1,7,2,1,1,8,4,12,1,2,8,2,3,1,1,1,2,2,3,0,0,3,1,2,4,0,2,0,5,0,6,2,5,0,1,0,1,0,0,1,5,0,0,3,0,5,1,0,6,2,0,0,1,1,0,9,5,0,2,0,1,0,0,1,2,3,0,5,11,59,0,0,3,1,9,0,0,3,3,1,0,0,2,0,4,6,1,3,0,2,3,0,17,1,4,4,3,1,2,16,0,2,3,6,1,2,4,1,0,5,1,0,2,7,4,3,2,0,1,1,2,1,1,0,3,0,0,1,3,0,0,7,4,13,4,0,3,1,0,0,0,1,0,0,1,0,1,1,14,0,3,4,13,2,2,0,2,3,0,6,1,4,8,0,0,5,3,6,3,5,0,13,2,1,0,0,0,0,3,0,8,3,5,3,5,3,0,0,0,5,3,0,2,1,1,0,0,0,1,2,4,1,3,0,2,3,3,4,0,0,2,5,2,2,2,0,2,4,0,1,0,0,10,1,18,0,8,3,0,1,0,1,4,1,13,8,0,0,2,2,0,0,3,0,4,0,0,4,2,1,1,3,6,7,1,3,3,3,0,2,1,1,0,1,2,0,0,0,7,0,1,0,0,4,0,1,1,4,5,0,0,3,4,5,0,0,0,1,1,2,0,2,76,4,1,0,1,0,0,2,2,0,3,4,6,0,3,1,5,4,1,2,4,3,3,1,1,0,9,1,0,0,3,1,0,1,4,2,0,13,3,4,0,3,2,1,1,2,1,0,0,1,2,0,1,4,6,2,3,2,1,0,6,2,0,0,6,1,0,2,2,0,33,6,2,2,0,0,0,0,2,0,0,0,2,1,0,1,0,3,3,4,0,4,0,0,1,0,0,2,4,4,4,2,1,0,1,1,2,1,0,2,1,2,2,6,1,3,0,1,2,4,0,2,1,4,0,9,3,1,0,0,1,0,2,2,1,0,2,2,3,4,0,2,5,3,0,3,0,1,0,3,2,2,8,3,2,3,4,5,1,0,1,0,0,0,1,5,5,1,0,3,0,6,0,0,1,0,3,0,0,0,1,2,3,0,5,1,0,2,0,0,0,1,0,0,1,2,0,0,4,0,0,6,1,3,2,0,0,1,0,2,3,0,2,1,1,3,3,0,0,0,0,2,1,0,0,0,3,2,1,0,2,2,0,0,4,1,2,0,1,2,0,4,3,0,4,6,0,0,0,2,3,0,0,0,0,1,1,1,0,3,4,6,1,6,0,0,0,0,0,0,0,2,6,1,1,0,0,1,11,0,3,1,0,0,1,0,11,1,3,0,1,0,2,1,2,0,1,1,0,7,1,2,1,3,0,1,0,3,1,6,0,4,0,3,6,2,3,0,2,3,0,3,0,1,3,1,2,1,0,0,0,0,0,2,1,1,0,1,2,4,0,2,0,0,0,0,1,0,0,0,0,8,0,1,4,0,0,1,3,3,2,3,0,0,3,0,2,7,0,0,3,3,6,1,0,6,1,1,0,0,2,0,1,4,0,0,0,0,3,7,0,0,4,4,0,0,0,4,2,0,0,0,1,0,1,2,1,0,2,2,2,0,1,1,1,1,1,0,0,2,3,3,0,0,0,1,1,6,26,0,2,0,1,1,0,2,1,0,0,0,0,1,1,0,0,3,2,0,0,0,0,1,2,0,0,0,0,27,1,1,2,2,3,0,3,0,3,0,0,4,0,1,1,0,9,0,4,0,0,1,0,0,2,0,1,2,0,0,1,1,1,5,1,1,0,0,1,0,0,2,3,4,0,0,0,0,1,2,0,3,4,0,0,3,2,0,0,0,1,6,0,8,0,1,0,1,1,0,0,0,3,0,0,1,2,0,7,7,3,0,2,1,1,0,0,0,0,0,0,2,5,1,4,0,3,6,0,2,2,0,2,0,0,2,1,3,1,0,0,0,0,1,1,3,0,3,5,2,1,2,1,1,0,0,0,0,7,18,2,0,0,1,2,2,0,1,0,0,0,3,2,2,0,1,0,0,0,0,0,3,1,1,0,2,2,3,0,0,0,1,4,0,3,5,2,0,2,2,0,1,0,4,0,0,1,2,2,0,4,0,0,1,0,0,0,2,5,0,1,0,0,4,0,1,3,2,0,0,1,0,0,0,0,0,0,3,0,1,1,0,1,6,2,5,2,3,2,0,1,0,0,0,2,3,2,0,0,2,4,0,1,0,0,0,0,2,0,0,0,1,0,4,1,2,3,2,1,0,2,2,2,0,2,0,0,0,1,0,3,0,0,0,0,0,2,0,0,1,0,0,0,0,1,0,1,0,0,2,1,1,2,0,2,0,0,1,0,2,0,0,2,0,0,2,13,0,0,1,0,2,0,1,0,1,3,5,0,7,1,1,3,6,6,0,3,2,1,8,3,0,0,0,2,0,1,2,3,3,0,0,0,0,0,0,7,1,0,3,1,0,0,11,0,0,1,1,3,1,0,3,0,0,0,1,3,1,1,0,1,0,5,0,2,0,0,0,1,1,0,0,1,0,0,0,0,0,0,0,0,2,22,2,0,0,0,0,0,0,7,1,1,0,0,0,1,0,0,0,0,1,7,0,2,4,1,2,0,0,0,1,0,0,0,0,0,0,5,0,0,3,4,1,0,5,1,1,3,0,1,1,1,0,0,0,0,0,3,0,11,3,1,0,0,2,2,3,0,0,0,0,0,1,1,3,0,0,2,1,4,1,1,8,1,0,1,2,0,0,0,2,1,5,8,0,0,3,1,0,1,3,3,0,0,1,0,0,0,0,0,3,1,2,1,0,3,0,3,3,0,0,1,1,2,8,0,1,2,2,0,0,2,0,2,0,0,1,0,0,0,1,0,0,1,0,8,1,0,0,2,0,1,0,0,1,1,0,0,0,0,2,0,4,2,0,2,1,0,0,3,0,1,1,0,0,0,0,0,0,0,0,2,1,0,0,0,6,0,0,0,2,0,2,3,0,0,0,1,1,0,0,3,1,0,0,1,0,3,1,1,0,0,3,7,0,2,0,3,0,1,0,0,0,0,4,0,1,1,0,2,0,3,4,0,0,0,0,1,0,0,0,0,1,0,0,0,0,1,0,1,0,0,0,2,2,0,0,0,1,1,0,2,0,0,3,1,0,1,0,3,0,1,5,3,3,0,1,1,1,1,1,2,0,0,2,1,0,3,1,0,0,0,0,0,1,18,5,0,1,1,0,2,7,2,0,0,0,2,0,0,1,0,0,0,0,1,1,2,8,4,1,1,1,2,2,2,3,2,3,9,0,0,0,1,1,0,0,5,0,2,0,2,0,7,3,0,1,2,0,2,4,1,1,1,1,1,5,1,0,0,0,1,4,0,0,2,0,1,0,0,0,0,0,0,0,0,1,0,0,0,1,1,0,0,0,3,0,2,2,0,2,0,2,1,3,1,0,1,1,1,2,0,2,1,1,0,0,0,0,0,1,0,1,0,1,0,0,2,0,10,0,0,0,0,2,0,3,2,4,0,0,0,0,0,1,0,2,2,0,0,0,0,0,1,1,7,1,0,1,2,1,1,0,0,1,1,0,0,0,0,1,0,0,1,0,0,5,0,0,0,0,0,0,1,0,1,0,7,0,0,6,1,0,3,0,0,0,4,0,3,1,0,4,0,0,1,0,0,0,2,0,20,2,0,0,1,0,5,0,0,2,0,0,0,0,0,2,1,0,1,0,0,3,0,2,1,0,1,1,1,0,1,0,1,0,0,0,0,0,0,1,0,0,1,0,0,2,3,1,0,1,0,0,0,3,1,2,4,2,3,1,1,1,1,2,1,0,0,3,0,0,0,0,0,0,2,0,1,0,4,1,0,1,0,0,2,0,1,1,1,0,0,0,1,0,0,0,0,0,0,0,0,0,3,1,3,0,2,2,1,0,0,1,0,0,4,1,0,3,1,0,0,2,0,1,3,0,0,0,0,1,2,1,0,1,1,0,0,0,5,0,0,0,0,0,0,2,0,0,0,1,2,0,1,0,2,4,0,0,0,0,4,1,3,0,1,0,3,2,1,0,0,0,1,0,0,3,0,5,5,1,0,0,0,0,0,0,0,3,0,1,1,0,0,3,0,1,0,2,1,0,1,0,1,0,0,2,1,0,1,4,0,0,1,0,0,0,0,0,0,0,0,0,1,0,0,0,1,1,0,1,0,0,0,2,0,0,0,0,1,0,0,2,0,0,0,0,0,0,0,0,0,0,1,1,1,0,2,1,1,0,2,0,1,0,0,0,0,0,0,0,1,1,0,0,1,4,1,3,4,1,0,2,4,1,1,0,1,0,0,0,0,1,1,2,1,0,2,4,1,0,1,1,0,1,0,1,3,0,0,1,0,0,0,0,2,0,2,0,1,0,0,0,5,1,0,0,4,0,0,0,0,0,1,0,2,0,3,0,0,0,1,1,1,0,0,0,1,0,0,1,4,0,0,0,0,0,1,0,0,0,1,0,1,0,1,0,1,0,0,0,0,0,0,0,1,1,23,0,0,0,0,4,1,0,0,1,0,2,1,0,1,0,0,0,0,1,0,0,3,1,0,0,6,0,1,0,0,1,0,0,0,1,2,1,0,1,0,0,2,2,0,2,0,1,0,1,0,2,1,0,0,1,0,0,0,0,5,2,0,2,2,0,0,1,0,5,0,0,0,16,0,0,1,3,0,0,4,0,0,0,1,0,7,1,0,2,0,2,0,1,0,0,0,1,0,1,2,0,0,0,5,3,0,0,0,0,0,0,1,0,5,0,1,2,0,1,0,1,0,1,0,0,2,0,0,1,0,2,1,0,0,5,0,2,1,0,1,0,0,0,0,0,1,1,0,2,0,2,1,4,0,1,0,5,0,0,1,0,0,3,12,0,0,0,0,2,1,0,0,1,1,2,0,4,0,0,0,0,1,0,6,2,0,2,0,2,0,0,0,3,0,1,0,0,2,2,0,0,0,0,0,0,0,0,4,0,0,0,0,0,1,0,0,2,0,0,0,0,0,1,1,2,1,3,3,0,0,1,0,0,0,0,1,2,2,0,2,1,0,2,0,1,0,0,0,0,0,5,1,1,1,0,2,0,0,0,1,3,0,0,0,0,2,1,0,0,4,1,0,2,1,0,1,0,0,1,0,1,0,0,1,1,0,0,0,0,0,4,11,0,6,0,0,2,0,0,0,0,0,1,0,3,0,0,0,0,2,0,0,0,0,0,0,6,0,0,0,1,0,0,0,0,0,1,1,4,0,0,0,1,1,0,1,2,1,0,0,1,0,4,0,0,0,1,0,1,1,1,0,0,2,0,0,0,0,0,0,0,0,0,0,0,0,0,1,0,0,0,0,0,0,0,1,0,2,0,0,0,0,1,2,0,1,1,0,0,5,2,1,0,0,0,0,0,0,0,0,0,1,0,0,1,1,1,0,1,0,1,0,3,2,0,0,1,0,0,1,0,1,0,0,1,2,1,0,3,1,1,0,0,1,0,3,1,0,0,0,0,0,0,0,0,0,0,0,0,2,0,0,0,1,0,1,0,0,0,0,0,0,0,1,0,0,1,0,0,2,0,0,0,0,0,0,24,0,0,3,0,0,0,1,1,0,0,0,0,0,0,0,0,1,1,1,0,0,1,0,0,2,1,0,0,3,2,0,0,0,0,3,0,2,9,3,0,1,1,0,1,1,0,0,0,1,3,0,1,0,2,0,0,0,0,0,1,5,0,1,0,0,5,1,0,3,1,8,0,0,0,0,1,0,1,2,0,0,0,0,0,0,0,0,0,0,0,0,0,0,0,0,0,0,5,0,0,0,1,3,0,0,2,0,0,0,0,1,0,0,0,0,1,0,0,0,1,0,1,1,1,7,0,0,2,0,0,0,2,1,0,0,0,0,1,0,0,4,1,0,0,0,0,0,0,0,3,2,0,0,0,1,0,0,1,8,0,0,1,0,2,0,0,1,0,0,0,0,0,2,1,0,0,1,0,2,1,2,1,0,0,0,0,0,0,1,0,0,1,0,1,0,0,0,0,1,0,0,1,0,0,1,0,0,2,0,1,10,0,0,0,1,0,0,1,0,0,0,0,0,1,1,3,0,0,1,0,0,0,2,0,0,1,2,1,0,0,0,5,4,0,0,2,0,0,0,1,0,0,2,0,1,0,0,0,0,0,1,0,4,1,0,0,3,18,2,1,0,0,0,1,0,4,0,0,1,0,0,0,0,0,0,2,0,0,0,0,0,0,0,9,2,0,0,0,0,0,0,0,1,0,0,1,3,0,0,0,0,0,0,0,0,9,0,0,0,0,45,0,1,0,6,1,0,0,0,3,0,0,2,0,1,1,0,0,0,1,1,0,0,0,1,0,0,1,3,2,0,0,0,1,0,0,3,1,0,0,0,0,9,3,6,0,0,0,0,0,0,0,0,0,0,3,1,4,0,2,0,2,0,1,1,0,3,0,3,0,0,0,0,1,0,0,4,1,0,0,2,0,1,0,1,0,0,0,3,0,0,0,2,1,0,0,0,0,0,0,0,0,2,0,0,0,0,0,0,0,1,2,0,1,2,0,0,0,1,0,0,0,1,0,0,0,0,0,0,1,2,0,0,0,1,1,0,0,1,0,0,0,0,0,0,1,0,0,0,0,1,1,2,1,0,1,2,0,0,3,0,1,1,0,1,1,0,1,0,1,0,0,20,1,0,2,0,0,0,3,2,1,0,0,0,0,1,0,0,0,0,0,1,0,0,0,0,0,0,1,0,0,0,3,0,0,0,2,2,0,0,7,0,0,0,0,0,0,0,0,1,0,2,0,1,2,0,0,0,0,1,0,0,1,0,0,0,1,0,0,2,0,0,0,3,0,0,0,0,0,0,1,0,1,0,1,1,0,1,0,0,0,3,0,0,0,0,0,0,1,1,1,0,1,0,0,1,1,3,0,0,2,0,2,0,3,0,0,0,0,0,0,0,0,0,0,0,0,0,0,0,0,0,0,0,0,1,0,1,0,0,0,0,0,1,0,0,0,0,0,0,0,0,0,0,0,0,1,1,0,1,1,0,0,1,0,0,0,0,1,1,0,1,1,0,1,1,1,0,0,0,0,0,1,0,0,0,0,0,0,0,0,0,1,0,0,0,1,0,1,1,0,0,0,0,0,0,2,0,0,0,0,0,2,2,1,2,1,1,0,0,0,0,0,3,0,0,0,0,0,0,0,2,1,0,1,0,0,0,3,2,0,0,0,0,1,0,0,0,2,1,0,0,1,0,0,0,1,5,0,0,0,0,0,0,0,1,0,0,1,8,0,0,0,1,0,0,0,0,0,0,0,1,0,1,0,1,0,0,0,2,1,0,0,0,0,0,0,1,0,0,0,0,0,2,0,0,0,0,1,0,0,0,0,0,0,0,0,300,0,0,0,0,0,0,0,2,0,4,0,0,0,1,0,0,0,0,0,0,0,0,0,1,0,0,4,1,0,1,0,2,0,1,0,1,1,0,0,0,0,0,0,0,0,0,0,0,2,0,0,0,1,1,0,0,1,0,0,0,0,1,0,0,0,0,0,0,0,2,0,0,0,0,0,1,1,0,0,0,1,0,0,0,0,1,0,4,1,0,0,1,0,0,0,1,0,0,1,0,0,0,0,0,0,0,2,0,0,0,0,0,0,0,0,0,0,0,0,0,3,1,2,1,3,0,1,0,1,0,3,2,0,0,0,0,0,0,2,1,0,1,1,0,0,0,1,0,1,0,0,0,0,0,0,1,1,1,0,0,0,0,0,1,0,0,0,0,0,0,1,0,1,0,0,0,0,1,0,0,1,0,4,0,1,10,0,1,4,0,0,0,1,0,0,1,3,0,0,0,0,1,0,2,0,0,0,0,0,0,0,0,0,1,0,0,0,0,1,1,1,1,1,0,0,0,0,0,0,0,1,0,1,0,0,1,0,0,0,1,0,0,0,1,1,0,0,0,0,1,0,0,0,0,0,0,0,0,2,0,0,1,0,0,6,0,0,0,0,0,1,0,0,0,0,0,0,0,0,1,0,1,0,0,0,1,0,0,1,1,0,0,0,0,0,0,1,0,0,0,0,3,0,0,0,1,0,0,0,0,0,0,0,0,0,0,0,1,1,5,2,0,1,0,0,0,0,0,0,1,0,1,0,0,0,0,1,1,0,0,0,0,3,1,0,0,0,0,1,0,1,1,0,2,0,2,0,0,4,0,0,1,0,0,3,2,0,0,0,0,0,1,0,0,2,0,0,0,1,0,1,0,1,0,0,1,1,0,0,1,1,1,0,2,0,1,0,0,0,2,2,0,1,0,2,0,1,3,0,0,0,0,0,1,0,2,0,0,0,3,0,0,0,0,0,0,2,0,1,0,0,0,0,1,0,0,0,0,2,0,2,0,0,0,0,0,0,0,0,0,0,0,0,0,1,1,3,0,0,0,0,1,0,0,0,0,0,8,1,0,0,2,0,0,0,0,0,0,0,0,1,0,0,0,1,0,0,0,0,0,0,0,1,0,0,0,0,0,1,0,0,0,0,0,0,0,1,0,0,0,0,0,0,0,0,0,0,0,0,0,0,0,0,0,1,0,0,0,0,0,0,0,0,1,0,0,0,0,0,0,0,0,1,0,21,0,0,0,1,0,0,0,0,0,0,0,0,0,0,0,0,0,0,0,0,0,0,0,0,0
K12 Apt Pupil,king,3679,1921,1455,1755,1417,876,1909,1114,1213,1056,858,1315,859,137,140,566,912,433,468,445,521,471,337,413,213,321,190,286,306,245,241,319,229,279,263,276,233,315,110,264,272,244,274,273,172,214,224,187,311,224,197,221,228,188,201,149,259,148,132,164,207,127,157,169,209,157,103,157,140,128,118,51,110,77,131,115,119,110,120,95,103,67,178,124,108,141,63,75,98,72,60,85,107,67,114,101,80,67,81,84,85,108,86,86,131,71,109,124,68,79,113,226,32,69,84,62,73,90,91,46,56,113,88,124,45,67,74,56,46,84,54,98,70,69,81,87,21,91,56,46,50,55,19,44,59,86,52,80,36,71,59,92,52,50,64,47,52,47,57,80,18,67,49,41,38,61,62,30,67,59,24,75,77,53,10,49,56,23,94,69,60,40,81,45,42,58,34,36,28,44,28,28,51,48,42,64,58,37,14,10,28,48,49,53,33,87,35,25,26,21,40,44,30,27,27,30,44,14,46,30,33,40,42,41,41,21,26,36,22,66,69,36,35,46,24,4,36,39,37,32,28,33,26,57,49,33,53,42,26,33,37,17,13,16,28,36,24,18,33,31,40,29,52,52,24,12,22,39,39,37,34,15,58,26,23,20,44,20,44,33,30,57,26,35,70,18,20,37,18,17,30,12,19,29,17,28,18,22,7,26,60,20,30,19,56,20,9,22,5,22,27,10,32,18,45,19,39,16,21,11,28,26,37,206,4,16,40,22,67,27,27,30,25,20,2,28,41,9,19,24,20,33,12,12,16,22,33,30,8,15,38,18,25,16,33,6,12,36,10,56,23,18,22,10,22,36,18,20,12,12,18,17,23,57,31,33,21,24,30,21,14,16,27,19,5,11,0,15,18,25,14,18,23,19,15,16,14,20,23,23,63,34,26,11,26,20,17,17,15,35,25,14,19,15,12,50,28,20,13,26,14,58,4,11,7,8,19,40,17,12,19,13,15,10,9,4,14,17,9,25,12,11,7,31,6,13,31,28,17,11,10,5,10,24,17,11,13,21,19,16,24,2,0,15,9,22,8,12,3,12,11,22,12,2,23,26,10,3,0,22,13,56,10,11,9,23,20,10,31,10,26,12,9,11,11,20,15,22,34,19,9,13,13,14,5,5,4,6,10,7,9,20,15,19,34,11,0,12,17,7,10,19,20,13,8,9,17,10,16,21,2,14,8,12,13,1,14,26,8,28,19,7,12,12,9,8,0,2,19,13,5,8,22,8,18,21,12,11,14,0,7,38,14,9,8,14,10,3,14,13,35,1,10,13,8,5,13,0,12,12,11,29,9,18,4,8,14,15,5,8,20,16,3,10,10,7,3,7,9,9,3,5,17,7,7,0,3,23,12,6,11,7,13,6,0,13,14,5,12,13,8,7,2,7,16,18,46,14,4,3,6,9,4,16,6,0,17,11,26,21,7,5,8,8,16,28,6,5,15,17,0,16,17,7,5,36,7,9,12,26,19,12,18,10,19,10,24,16,13,5,26,11,2,11,17,7,1,8,12,5,3,23,10,16,29,6,2,9,10,6,15,7,4,18,3,10,5,0,22,5,9,11,22,15,15,18,8,5,7,22,0,16,1,6,4,28,7,6,6,4,6,3,5,0,11,13,6,32,8,13,15,7,7,6,0,12,9,4,3,13,12,22,0,23,2,1,8,9,5,2,5,8,18,23,3,8,6,5,5,5,5,3,8,6,8,22,4,3,26,16,15,4,0,24,1,5,11,14,3,4,6,5,1,7,13,28,14,10,6,8,24,15,0,8,7,19,1,7,4,7,10,3,3,2,8,7,27,7,5,3,3,8,12,4,8,5,2,1,9,16,17,6,10,9,15,10,7,3,5,5,8,1,0,8,5,7,4,7,0,8,22,4,11,3,7,4,2,0,13,6,6,13,2,1,4,1,2,7,3,7,4,6,10,4,5,17,5,0,11,9,17,13,12,3,0,6,4,16,3,8,10,8,10,11,4,5,7,7,8,10,12,4,59,3,14,10,4,3,10,23,10,6,20,4,16,2,11,2,18,7,4,0,4,0,1,3,6,1,12,6,6,1,3,4,12,5,17,0,27,2,9,11,10,0,8,5,5,11,11,8,7,20,12,5,3,3,2,8,18,10,4,13,5,8,41,10,2,0,3,11,0,4,7,2,6,17,3,5,3,11,4,0,7,13,8,8,3,9,5,1,1,7,6,4,3,5,9,1,3,15,7,8,5,9,12,0,0,1,10,0,2,0,4,10,2,23,0,0,12,8,5,1,10,0,3,4,9,1,1,5,0,9,3,5,4,2,3,8,3,4,2,16,18,3,5,6,4,12,9,16,7,7,0,2,4,10,6,10,8,3,1,13,14,6,2,0,2,15,2,12,5,2,0,4,2,20,3,5,0,0,0,4,8,5,33,3,2,0,2,9,2,1,9,6,15,0,4,9,4,1,3,0,9,6,3,10,3,7,11,6,4,2,3,5,3,5,9,4,3,6,4,4,3,3,0,3,5,0,11,3,9,5,4,5,6,6,8,8,1,8,6,7,8,5,4,7,7,6,3,6,6,1,13,11,2,5,2,1,15,1,19,0,6,13,3,3,0,5,1,11,8,9,2,16,0,6,2,8,1,0,0,2,11,3,1,8,11,0,1,0,8,3,4,2,3,6,0,4,3,0,10,5,0,6,9,3,7,4,2,5,23,0,4,4,7,7,0,1,8,8,0,3,11,0,11,0,0,2,4,3,2,3,6,3,4,3,7,6,3,7,3,3,0,0,7,0,2,1,3,5,3,2,8,0,2,3,8,0,2,4,20,6,3,11,2,1,11,3,0,4,7,0,11,15,0,1,5,1,7,12,0,1,2,1,0,0,5,1,0,37,1,7,4,2,23,7,10,1,5,13,0,17,5,5,8,5,2,8,0,10,4,17,6,4,5,11,2,2,14,1,0,0,1,6,1,8,12,10,1,5,10,6,2,7,6,10,7,11,3,2,0,2,1,19,3,10,7,2,1,4,6,5,15,0,7,22,3,7,4,27,7,4,13,0,6,5,4,8,2,1,1,9,3,0,2,0,10,5,1,4,3,6,15,0,9,0,0,9,0,0,4,0,7,8,4,1,2,4,11,1,5,4,9,1,10,2,3,0,7,2,0,0,0,0,0,4,0,0,2,5,2,10,2,6,0,4,10,3,6,2,0,2,3,5,8,5,1,1,7,6,1,4,0,0,2,3,0,3,8,5,3,5,4,4,0,7,0,4,3,9,0,6,0,3,6,0,3,6,14,3,5,7,6,0,4,5,4,0,7,1,3,1,8,2,0,12,2,10,1,4,6,3,4,3,14,5,6,7,1,2,3,2,7,8,2,2,0,0,0,3,4,0,2,0,0,3,0,0,4,0,4,0,4,9,36,3,0,0,3,0,0,3,4,7,9,7,0,1,0,7,4,0,9,1,2,88,3,0,18,4,2,8,5,6,4,3,4,0,11,1,4,9,10,0,18,1,3,0,2,2,6,4,3,1,2,12,0,1,3,5,5,5,6,0,3,2,13,5,15,4,1,10,9,5,7,5,5,5,1,13,0,15,4,0,3,2,10,0,3,4,3,3,0,2,2,4,9,3,0,9,3,6,2,6,3,2,0,0,0,4,1,1,11,0,1,4,2,1,0,0,1,4,2,3,1,4,4,4,2,3,5,2,2,6,0,1,2,3,0,2,3,0,5,0,1,4,2,10,0,6,0,12,1,1,6,6,5,0,2,1,6,7,6,4,2,6,0,2,1,2,2,1,3,0,6,0,1,2,5,0,1,0,2,1,0,0,12,2,8,4,2,1,4,0,0,4,4,0,2,1,1,1,5,4,1,7,6,4,0,5,6,4,12,3,2,0,5,0,4,2,4,13,16,0,6,4,7,3,6,2,1,0,6,3,0,12,1,3,5,2,4,0,5,19,15,2,0,2,2,1,4,8,2,4,5,2,4,3,13,0,0,0,1,1,0,2,0,3,1,2,2,5,1,3,2,5,2,0,2,1,2,4,0,7,6,2,2,4,13,4,0,4,9,2,4,6,1,2,1,1,2,2,3,4,2,6,3,0,4,1,4,3,0,0,2,4,0,0,0,0,0,5,1,4,2,3,3,0,0,4,10,4,0,0,0,7,10,10,3,0,5,0,7,3,2,9,7,3,6,0,8,1,6,0,2,0,34,1,0,5,0,5,2,1,2,2,1,2,4,2,0,0,2,0,2,4,2,4,1,4,16,3,0,7,0,0,3,2,8,0,0,9,6,3,0,1,2,2,7,2,0,9,3,0,4,0,0,3,2,2,3,0,0,3,4,1,0,0,3,3,0,1,0,3,27,0,1,6,0,2,5,0,0,2,3,5,1,0,2,2,0,5,4,1,9,2,1,0,3,3,8,2,8,7,5,0,3,1,5,6,3,3,0,0,0,0,0,5,4,4,0,6,13,2,1,0,2,2,4,1,0,2,1,2,2,5,6,0,0,0,4,0,3,7,2,4,4,6,1,1,1,5,2,2,4,0,8,2,0,7,11,0,2,2,3,0,1,1,1,0,53,1,0,2,2,4,3,0,2,0,18,7,0,0,2,4,2,2,5,3,3,6,13,1,5,7,5,7,2,3,3,2,2,1,2,3,2,1,0,4,0,0,1,4,0,2,3,2,2,1,7,2,2,3,1,4,1,0,0,1,5,2,1,2,0,11,0,0,2,2,1,1,2,2,0,0,0,0,2,1,2,3,7,5,1,0,2,4,0,0,4,0,2,4,0,0,3,2,3,6,0,5,2,0,0,0,4,8,3,2,0,3,1,0,1,4,0,1,0,1,0,3,0,0,0,0,7,0,11,3,0,5,1,1,1,1,1,1,4,1,10,0,0,0,4,0,0,3,0,2,1,0,0,0,0,2,1,0,1,0,1,6,2,2,3,2,0,0,10,0,0,2,1,0,5,4,0,0,4,5,1,1,5,2,1,0,2,3,1,1,2,0,3,14,3,4,1,4,3,3,7,1,1,3,2,3,3,0,3,0,0,1,4,0,8,0,3,0,7,2,12,1,0,4,1,0,0,1,4,1,4,1,2,0,3,6,1,3,3,1,11,0,1,2,0,1,6,2,4,6,5,1,8,2,1,0,1,2,0,1,3,9,1,4,4,0,1,2,8,2,4,2,2,6,0,10,2,1,1,0,2,2,3,4,2,3,4,1,6,2,3,5,0,9,1,2,3,1,2,1,0,2,2,1,0,0,2,1,6,0,3,0,3,0,2,0,4,3,0,0,12,4,0,2,0,1,2,3,0,0,6,0,1,1,4,4,5,2,1,0,2,0,0,2,2,0,4,2,2,2,0,5,1,3,2,0,1,1,2,0,3,0,0,3,2,5,0,0,7,3,6,5,1,0,2,9,2,3,3,2,4,9,3,3,0,0,1,0,0,0,3,2,1,6,3,0,0,12,2,0,2,3,3,2,8,0,1,0,1,0,0,5,0,2,2,0,2,2,7,1,1,0,2,0,0,3,4,0,1,2,2,3,3,0,3,0,1,1,0,0,0,3,2,0,4,5,0,0,1,1,1,4,1,1,0,4,5,0,1,3,2,0,2,4,2,1,2,8,0,2,1,2,1,4,1,3,0,0,6,0,0,4,0,1,0,5,3,1,3,1,0,4,1,0,6,1,0,0,2,2,1,0,1,4,3,0,3,7,6,1,2,0,0,1,0,0,1,2,0,5,1,7,0,0,0,5,1,4,0,0,0,0,3,2,1,1,2,2,0,0,5,0,0,2,0,0,2,3,0,2,1,5,0,1,11,0,5,0,0,2,0,3,2,0,0,2,1,0,2,1,1,1,6,5,0,0,1,3,5,1,3,0,1,0,5,1,3,0,0,3,1,1,9,0,0,2,0,0,1,0,0,0,0,0,1,3,0,0,0,0,2,1,0,0,0,2,3,2,0,0,0,9,4,0,7,4,0,2,3,1,4,2,0,1,7,3,7,2,5,1,3,0,0,0,1,2,1,2,2,0,0,3,1,0,0,11,0,1,2,0,0,0,0,2,2,0,1,2,1,1,2,2,4,9,0,2,0,0,8,5,2,2,1,3,2,1,0,0,0,4,0,1,2,2,0,2,1,0,0,4,1,0,3,1,0,0,0,4,1,5,2,2,0,1,2,0,1,5,2,4,0,0,0,0,0,2,0,0,0,2,0,2,1,2,2,1,0,12,3,1,1,1,0,25,0,0,4,4,2,2,1,2,1,1,0,0,1,1,1,0,2,3,1,0,0,2,1,3,2,1,0,2,2,2,0,0,4,1,0,5,0,4,3,2,3,3,2,0,6,4,2,5,2,0,1,0,0,0,0,1,3,1,1,2,3,1,4,2,0,0,1,1,1,2,0,3,2,1,3,0,0,0,0,0,2,4,1,1,2,3,6,2,0,23,0,0,0,3,1,2,3,0,1,4,4,1,1,0,1,0,1,8,0,1,1,2,1,0,4,0,1,2,0,0,0,0,0,1,0,1,1,0,3,0,1,0,0,0,6,0,0,0,0,1,0,0,0,3,0,1,0,6,1,5,0,0,0,4,2,0,1,3,2,2,0,2,0,4,0,3,0,1,2,1,3,3,0,0,1,0,2,3,2,0,0,1,3,2,0,0,0,0,1,0,3,1,0,2,1,2,1,0,5,3,2,2,2,3,0,0,0,0,2,2,0,0,1,0,1,3,1,0,0,2,5,1,4,1,0,0,1,0,0,0,0,1,2,0,0,2,2,0,4,8,0,0,0,2,2,1,1,1,1,2,0,1,1,1,0,7,0,3,0,2,0,2,1,0,3,1,1,0,1,2,2,1,8,1,2,4,4,1,4,0,2,0,0,0,2,1,1,1,0,0,0,9,1,1,0,0,0,0,1,2,0,3,0,2,4,5,1,2,0,4,2,0,2,0,0,0,0,1,1,8,1,0,2,2,1,4,2,3,2,1,1,1,0,2,0,2,1,6,0,2,0,0,0,1,0,0,0,2,0,2,2,0,9,4,1,0,0,1,0,1,0,2,3,13,0,1,1,6,2,5,3,0,1,0,3,7,1,0,0,0,0,0,0,1,1,0,0,0,0,1,1,3,4,7,1,2,1,3,0,3,0,0,0,0,0,0,1,0,7,5,1,0,3,0,0,1,2,5,1,1,1,0,1,1,1,1,6,0,4,2,2,2,3,1,2,11,1,1,2,0,1,4,0,0,3,2,6,2,0,2,4,6,3,2,2,7,5,0,0,0,2,6,1,2,2,0,1,0,19,5,2,0,0,1,1,0,0,1,0,0,0,1,18,4,4,0,3,5,2,10,0,0,1,2,1,1,0,1,2,0,5,4,0,0,1,1,5,2,5,0,0,1,0,6,2,0,0,2,3,0,1,2,5,0,1,0,2,3,1,5,2,0,1,1,0,8,0,1,0,1,2,0,0,0,5,0,2,3,5,3,1,1,0,0,2,1,0,2,1,1,0,0,1,0,0,0,1,1,4,1,0,0,0,0,3,0,2,3,2,0,0,0,0,3,0,0,1,0,0,1,1,2,0,2,2,0,1,1,2,0,3,6,0,4,0,1,1,0,0,0,2,1,0,1,0,0,3,2,0,0,0,0,1,1,0,5,0,0,0,0,0,1,0,2,0,6,0,3,1,0,2,0,0,1,1,1,4,2,1,0,2,0,0,1,1,0,2,1,1,0,2,4,3,1,3,1,2,0,1,1,2,0,4,2,2,2,0,0,1,1,1,4,0,0,2,6,5,1,1,0,0,6,3,3,2,1,0,0,0,4,0,1,12,2,0,5,0,2,0,2,2,1,5,1,0,9,0,1,4,0,2,0,0,4,0,4,1,0,0,1,0,0,0,0,0,0,2,1,3,4,3,1,0,0,0,2,0,4,1,2,0,0,3,1,1,2,3,0,0,0,1,1,0,2,3,2,0,0,0,2,2,0,0,0,4,1,0,0,2,1,0,0,2,1,7,0,3,2,7,2,0,1,0,0,1,6,1,1,0,1,1,0,3,0,0,2,0,4,1,1,0,0,0,0,1,0,1,3,3,2,1,1,0,0,2,2,0,0,0,0,1,3,0,0,0,1,0,1,0,0,2,4,0,0,0,0,5,2,9,2,0,0,0,1,1,0,0,1,0,2,0,1,3,0,2,1,0,0,0,1,0,0,0,0,0,1,0,1,3,0,0,1,0,1,0,2,0,5,0,2,1,0,2,0,0,0,1,0,1,0,1,0,0,2,0,0,1,0,1,1,1,1,1,0,2,1,1,2,0,0,0,2,0,0,0,1,3,2,0,2,6,2,0,0,0,0,0,0,0,0,3,1,4,2,8,0,3,0,0,1,0,0,3,0,7,1,3,0,1,1,0,1,2,3,0,2,0,1,1,0,3,1,0,0,2,3,1,2,0,0,1,0,1,1,0,0,0,4,2,0,0,4,0,0,0,4,1,3,4,0,0,1,0,0,1,1,2,1,0,0,1,1,0,0,0,0,3,0,0,0,1,0,2,0,5,0,0,1,3,1,1,0,3,0,0,3,1,7,0,0,1,0,0,0,0,3,1,0,2,1,1,0,2,1,1,1,0,3,1,1,0,4,1,1,1,0,0,0,0,0,4,2,2,0,0,6,0,3,3,2,0,0,1,3,6,4,0,1,1,0,1,4,0,0,0,0,0,0,0,1,0,1,1,2,0,1,0,0,1,1,0,2,0,0,0,2,0,0,2,0,0,3,0,2,1,0,2,0,0,3,0,11,4,1,0,0,0,0,0,0,5,0,0,0,3,0,0,0,0,0,0,1,4,0,0,2,0,1,0,1,0,1,1,0,1,0,1,0,0,0,0,0,0,0,1,3,0,0,1,1,3,1,0,6,1,1,5,1,0,0,1,1,3,0,3,1,0,1,1,0,3,3,1,0,0,0,2,0,1,6,2,2,0,0,1,1,0,0,0,0,6,0,0,2,1,4,2,0,0,1,2,1,0,1,0,1,2,0,3,0,0,0,5,1,0,0,0,1,1,0,0,7,3,0,0,4,0,0,6,0,0,0,0,0,2,1,1,5,6,5,1,1,0,2,4,0,1,3,2,0,1,1,0,1,0,0,2,0,0,0,0,0,1,0,0,5,0,1,0,2,0,4,1,1,0,4,2,1,0,0,2,0,0,0,3,0,2,0,0,2,0,4,0,2,3,0,2,4,4,1,0,0,0,0,1,1,0,0,3,10,2,0,2,1,0,0,2,0,6,0,0,0,1,3,0,0,0,0,0,1,0,1,0,0,0,2,1,2,0,1,1,2,2,0,4,0,1,2,0,0,0,0,0,0,0,0,0,1,1,1,1,1,2,0,0,1,3,0,0,2,0,0,1,0,0,0,3,1,0,0,1,0,0,0,3,0,0,0,1,0,1,0,4,2,0,1,4,0,0,0,1,0,0,0,0,0,2,29,1,1,0,2,2,1,0,3,0,0,0,0,0,0,0,0,1,1,0,1,1,0,0,0,2,2,0,1,1,1,0,0,0,0,3,1,2,0,1,0,0,1,2,0,0,1,9,1,0,1,1,0,0,0,1,2,0,5,0,2,11,0,1,1,0,1,1,1,1,3,3,2,1,0,0,1,0,1,4,1,0,5,1,0,0,0,0,0,2,0,0,2,0,1,0,1,1,0,0,0,1,0,0,3,1,2,0,2,2,9,3,0,1,3,0,2,0,0,3,0,1,0,0,1,2,0,1,7,0,2,2,2,0,0,7,3,2,0,2,1,1,0,0,1,0,0,3,1,2,0,0,1,0,4,1,3,5,1,0,0,1,0,1,0,0,0,0,1,1,3,1,1,5,4,1,0,2,2,0,0,1,4,2,0,0,0,1,0,0,1,2,1,1,0,0,0,1,1,0,0,0,0,4,0,0,0,0,0,0,0,5,1,0,1,0,0,1,0,0,0,0,1,1,2,0,3,5,0,0,2,0,0,0,2,0,1,1,0,1,0,0,1,3,0,1,0,0,2,0,1,0,1,0,4,2,0,2,0,4,0,0,0,0,1,0,0,0,0,0,0,1,0,0,2,0,2,0,1,6,1,0,0,1,0,1,2,0,1,0,1,1,1,1,8,6,0,0,0,3,0,0,0,0,0,0,0,0,0,1,0,2,1,0,0,1,0,1,2,3,4,0,1,1,4,0,0,0,0,1,3,4,2,0,0,1,3,0,0,2,0,5,0,0,1,1,0,1,0,2,1,1,2,0,1,1,0,0,3,0,3,1,0,0,4,0,0,1,0,1,0,4,1,0,1,1,2,0,0,0,3,2,0,3,2,0,2,0,1,5,0,0,0,0,0,0,1,0,1,1,0,1,0,0,0,1,2,1,1,0,0,0,3,0,2,0,0,0,1,0,1,3,0,0,0,0,1,1,3,0,1,6,1,0,0,0,0,1,1,1,0,0,1,2,0,0,0,0,2,1,0,0,0,1,1,0,2,0,1,0,0,1,0,3,1,1,0,0,1,0,0,0,1,2,0,1,3,0,0,0,1,0,0,0,0,1,2,1,0,2,0,0,0,2,2,3,1,3,5,4,1,0,0,0,3,0,1,5,0,1,2,1,0,3,0,0,1,0,2,2,0,0,1,0,0,0,0,0,0,0,0,1,1,0,0,0,0,0,2,0,0,0,0,0,0,0,0,3,3,0,0,0,1,2,1,11,1,2,0,1,0,3,1,1,0,0,0,1,0,0,2,0,0,1,1,1,0,1,0,0,0,0,0,6,3,1,2,1,0,0,0,1,0,1,0,0,0,4,0,1,0,0,0,1,1,2,2,0,1,0,2,1,0,3,3,1,3,3,2,0,1,0,1,0,1,2,1,0,1,0,0,0,0,3,0,0,0,0,0,1,0,0,3,0,0,0,0,0,0,0,2,0,1,2,2,0,1,0,1,0,0,1,0,0,0,0,0,2,8,0,8,3,0,2,0,2,0,0,0,0,0,1,0,0,0,3,2,2,2,0,1,0,2,0,0,0,0,2,0,0,1,0,1,3,0,0,0,0,0,0,0,5,1,0,0,0,0,0,1,0,0,35,0,6,0,1,0,0,0,0,0,0,0,0,0,0,0,1,0,0,0,1,0,0,0,0,0,1,0,0,0,0,0,0,0,0,0,1,0,0,0,0,0,0,0,0,0,0,0,0,0,0,0,0,0,0,0,0,0,0,0,0,0,0,0,0,0,0,0
K13 The Body,king,2887,1955,1307,1328,1200,1175,857,832,995,869,649,729,695,142,154,515,446,359,288,369,400,349,284,320,419,135,301,238,345,153,198,384,203,187,147,193,232,265,398,215,255,267,232,167,187,200,216,158,163,210,219,140,155,171,100,135,164,101,91,210,222,88,101,101,150,103,87,148,84,83,148,46,76,118,145,89,97,101,105,45,118,73,76,125,133,97,73,60,88,75,61,128,89,78,88,69,108,66,58,74,85,83,95,52,69,70,107,85,47,51,96,92,126,66,65,25,81,39,61,33,61,27,84,79,34,46,63,74,42,58,47,75,78,50,64,45,95,72,36,43,31,32,33,44,67,46,31,39,58,84,46,23,52,31,38,35,47,41,57,34,34,29,42,29,47,49,37,39,45,68,29,41,57,30,31,17,19,28,40,45,54,37,9,29,30,40,32,36,50,39,24,13,30,30,36,42,33,18,4,10,29,45,27,24,30,12,21,20,32,55,31,53,5,17,35,35,42,24,49,26,9,43,35,34,31,25,16,16,3,57,42,19,39,33,29,2,33,27,34,18,20,18,23,16,24,31,42,35,13,45,27,62,27,31,48,25,35,16,42,20,39,39,33,29,16,14,16,27,43,30,28,18,19,19,30,29,23,6,19,21,5,9,27,18,72,18,27,23,17,20,17,42,6,14,23,21,14,19,11,20,30,26,34,23,54,21,22,9,6,8,19,22,8,13,15,20,14,15,22,21,33,33,27,30,3,8,30,19,16,10,38,19,35,15,29,28,28,1,7,31,19,18,6,4,13,41,21,29,21,8,26,9,18,23,31,8,8,21,10,34,25,15,11,3,16,8,11,22,15,31,6,15,32,5,24,35,9,11,24,17,5,11,17,10,7,4,0,15,25,19,17,13,37,55,14,27,21,8,18,16,32,15,17,10,10,10,21,28,8,12,43,9,13,30,10,12,8,24,9,7,10,2,10,13,6,12,7,5,18,18,27,11,4,10,3,15,15,19,4,11,19,5,25,8,10,2,26,10,8,20,8,10,8,14,15,16,11,12,6,19,11,39,1,14,3,2,17,13,0,12,2,13,7,28,19,8,12,9,0,28,9,13,16,9,1,26,13,9,33,10,10,6,17,7,10,11,12,12,5,14,11,9,3,9,7,11,10,13,2,2,11,10,8,14,7,7,0,6,13,31,17,16,22,4,10,4,16,7,13,22,11,13,6,4,4,0,17,13,3,7,14,1,13,12,26,11,0,2,20,39,6,2,14,7,19,31,9,9,6,3,11,12,6,11,3,12,10,11,8,4,7,22,14,8,4,9,12,2,10,5,6,12,5,12,9,8,5,22,13,9,5,18,6,6,10,8,3,10,5,18,15,12,23,4,1,0,1,6,5,13,4,2,5,7,1,6,27,7,4,14,4,3,0,10,11,20,7,14,24,1,4,7,6,10,2,0,12,8,7,11,6,3,23,1,38,10,11,12,9,13,1,15,5,10,19,10,8,28,18,4,0,4,14,7,5,12,10,6,6,6,6,5,2,6,5,21,6,10,10,6,2,11,2,12,10,12,0,10,13,6,10,4,6,6,2,9,5,0,6,20,18,8,13,14,4,7,0,8,7,9,1,7,34,4,4,75,1,13,11,6,23,7,7,0,12,8,7,8,3,5,9,4,28,2,0,26,3,6,1,7,13,5,2,9,0,1,6,5,4,11,4,11,12,11,1,9,3,7,4,2,11,8,9,15,1,37,7,5,3,4,6,6,62,2,0,1,2,5,13,8,8,7,3,8,6,9,7,4,10,5,14,2,0,7,6,10,0,11,56,6,5,0,5,8,4,3,28,7,2,7,3,7,7,0,8,25,19,3,6,27,4,5,6,13,10,8,5,4,8,12,3,1,25,16,2,9,11,3,310,8,11,2,14,3,14,7,0,0,6,11,3,12,9,3,0,2,12,9,8,11,8,10,4,6,2,7,9,20,6,11,16,11,12,2,0,3,3,20,9,6,3,6,10,9,6,5,9,5,5,8,5,1,0,1,15,7,2,6,7,9,3,3,5,0,7,42,10,2,9,6,8,0,6,0,0,6,5,1,9,4,17,1,1,0,5,3,0,9,16,4,30,5,5,1,1,10,7,15,2,3,0,20,8,6,2,1,2,10,9,8,7,9,8,5,1,5,15,9,7,8,0,6,5,9,2,5,5,42,3,1,2,2,3,2,3,16,12,5,8,0,3,10,8,0,6,13,6,0,10,7,4,3,7,18,11,7,2,6,14,0,2,0,3,0,7,12,0,1,1,28,3,0,4,5,6,4,3,0,2,4,3,3,4,4,0,2,3,3,11,2,5,1,6,5,5,1,3,8,5,8,7,0,0,1,2,26,9,9,9,4,0,16,4,9,6,0,9,5,2,1,1,10,0,2,7,3,2,4,0,0,0,0,3,5,9,5,1,0,2,10,0,2,3,16,6,2,2,1,2,1,0,0,6,2,2,4,4,1,25,7,5,5,2,4,8,9,10,2,1,1,3,3,16,5,0,0,3,4,3,11,7,11,29,6,5,2,8,7,1,3,8,28,4,5,6,7,2,7,1,1,5,0,3,8,6,4,5,1,3,3,1,0,9,4,12,1,0,0,2,8,4,2,2,5,0,1,3,8,0,2,1,1,2,3,3,20,4,0,4,0,1,4,6,3,16,3,0,5,1,0,8,9,0,3,9,5,0,16,27,6,12,0,6,3,48,9,0,3,5,9,0,2,3,5,5,0,0,3,1,1,5,1,8,1,2,7,5,3,3,5,9,0,1,2,10,0,1,2,2,5,2,2,2,0,0,1,0,1,1,4,5,1,4,7,0,0,12,1,0,10,12,0,0,2,0,2,7,1,6,6,0,3,1,1,0,2,3,11,0,53,8,5,17,5,10,3,11,8,2,3,0,2,2,16,7,2,2,7,0,1,7,3,5,2,6,1,6,1,2,1,7,2,0,4,1,5,11,19,6,6,7,5,0,0,7,1,2,7,0,2,2,5,4,3,0,2,4,6,3,5,6,6,15,17,5,13,3,6,4,0,2,1,2,4,3,0,2,10,4,0,0,6,3,0,7,0,2,2,2,5,0,1,4,1,3,0,0,1,0,7,0,0,5,18,4,4,11,8,13,4,4,17,7,1,0,1,1,0,12,1,0,1,0,5,4,6,1,0,3,0,2,1,1,2,0,1,11,8,0,0,4,0,1,0,1,3,0,1,2,10,0,1,0,0,8,4,2,1,3,7,0,0,0,2,40,2,3,7,1,0,4,4,0,8,3,0,2,4,3,0,5,1,1,0,7,1,4,0,3,8,3,1,3,2,0,0,8,10,2,2,4,2,4,3,2,12,1,8,1,6,1,7,0,0,9,0,0,0,2,0,4,0,0,0,0,3,0,5,1,2,3,2,1,0,4,5,0,0,2,0,1,4,3,7,3,3,5,2,1,1,0,2,8,3,1,7,2,0,0,0,7,1,2,4,5,6,3,2,2,1,4,3,14,0,6,0,2,4,2,6,1,8,3,2,2,3,1,10,2,7,3,6,3,0,6,5,2,1,10,1,3,15,8,6,0,2,0,1,4,1,0,7,8,4,1,5,8,0,2,7,1,0,0,2,1,1,1,0,3,2,1,4,2,0,2,2,0,5,0,2,0,1,4,0,2,3,0,1,3,1,3,0,1,0,2,35,6,4,0,4,1,0,4,1,18,0,2,0,4,0,2,1,5,3,4,3,1,1,1,12,4,5,3,5,0,4,2,0,0,45,5,2,6,4,1,2,0,1,0,1,13,2,7,4,6,0,0,0,0,2,3,0,3,4,1,0,0,0,7,2,8,1,3,0,0,1,2,1,6,0,3,1,8,2,2,2,0,0,0,4,1,7,3,8,8,0,6,6,4,4,0,2,2,0,3,2,7,0,13,0,1,3,5,2,0,3,4,2,3,1,0,1,0,11,0,3,0,5,0,13,2,0,3,0,0,5,0,5,0,0,1,0,0,1,0,1,0,0,3,3,12,2,0,1,3,1,6,0,2,2,3,9,0,8,1,3,0,7,10,8,5,1,4,1,0,0,0,1,4,1,1,4,2,1,2,6,0,0,1,4,4,1,0,0,2,2,0,2,0,0,0,20,3,2,1,7,9,0,0,0,1,5,2,3,1,4,7,2,2,1,2,1,2,0,1,1,7,1,2,0,2,1,1,0,3,2,1,1,2,3,1,0,0,1,1,0,2,4,2,5,0,1,1,1,0,1,2,0,0,1,7,1,0,4,4,0,0,0,4,3,0,1,1,0,0,0,1,0,0,0,0,6,1,0,1,0,2,2,3,0,4,0,0,0,3,0,0,0,4,1,0,2,0,1,2,0,0,4,0,0,0,2,0,0,1,4,1,1,2,0,0,3,1,7,1,1,1,0,0,1,2,3,1,7,7,0,1,8,1,4,1,4,0,0,2,1,0,7,3,4,0,2,4,2,5,0,5,1,0,0,0,0,0,0,0,1,3,0,0,0,0,0,0,3,0,2,4,2,0,1,2,1,0,9,0,0,2,0,0,1,5,1,4,0,2,0,3,0,0,0,6,0,1,2,5,1,8,0,2,0,7,2,1,0,2,3,1,0,4,14,3,4,0,4,2,7,8,6,4,2,1,0,1,3,2,0,0,2,4,3,0,1,2,1,0,1,9,4,1,1,17,1,1,4,0,3,0,0,0,2,3,1,2,1,1,5,0,1,6,1,0,0,3,6,3,0,0,1,1,0,8,1,1,7,2,1,6,2,0,1,3,0,0,2,0,0,0,1,9,1,2,5,6,3,0,0,3,3,4,7,0,2,1,1,11,3,0,0,0,4,0,1,14,0,2,0,4,0,5,1,0,8,0,0,10,1,7,0,1,0,4,1,1,2,2,1,0,1,1,0,3,0,0,0,0,0,0,1,1,0,0,5,2,0,2,3,1,1,9,3,1,5,1,0,4,3,0,0,1,1,0,2,0,2,2,0,0,5,0,7,1,1,1,0,0,4,3,3,2,1,0,0,1,0,1,0,3,0,0,0,1,0,1,0,2,0,0,1,1,0,1,2,0,1,2,0,4,10,1,0,1,0,4,2,3,0,3,4,0,0,1,0,0,2,0,0,1,1,3,4,0,0,2,2,4,0,0,2,2,9,2,3,0,4,2,3,3,0,11,3,2,0,3,2,0,2,0,1,0,0,2,7,1,2,2,1,0,0,3,1,1,2,0,4,5,3,4,2,1,1,0,11,0,3,0,0,5,1,1,1,3,0,2,0,1,0,0,3,0,3,9,4,1,4,0,1,0,1,2,0,2,2,0,6,0,2,7,1,1,0,1,0,3,0,2,0,1,1,1,0,0,2,0,2,2,0,0,1,0,0,1,0,0,1,0,0,0,4,0,3,1,2,0,0,1,9,0,0,2,0,0,10,2,1,6,0,0,0,0,0,2,0,0,2,1,0,0,0,0,0,0,2,2,0,4,0,2,1,1,0,0,5,0,1,3,0,3,0,9,1,1,1,1,3,0,0,1,1,7,1,1,1,2,3,6,0,0,3,0,0,0,3,0,2,0,3,1,3,0,0,1,4,3,1,0,3,2,0,1,1,5,0,1,4,1,0,2,1,2,0,0,0,0,2,1,2,0,0,3,2,0,0,0,1,0,1,1,4,2,1,3,1,1,1,1,1,0,0,2,2,0,0,5,2,1,2,0,0,2,0,1,0,0,0,5,1,2,0,1,0,2,1,0,0,4,3,0,1,0,1,1,0,1,4,0,2,0,0,1,64,3,0,0,2,0,0,1,0,0,1,1,1,3,0,3,0,1,0,0,0,1,1,1,1,3,0,0,0,0,0,2,40,2,2,0,1,4,2,2,0,2,15,3,3,0,1,2,0,0,3,0,3,0,1,0,0,1,1,1,4,0,2,0,0,0,1,0,0,1,0,1,56,1,0,5,7,3,5,0,0,1,1,1,1,10,0,0,3,3,4,0,2,1,2,0,1,1,0,0,6,3,0,0,0,0,0,3,0,2,0,3,0,2,0,2,5,0,6,3,0,3,0,3,0,1,0,0,0,3,0,2,0,1,7,2,2,0,0,2,1,0,1,2,2,0,2,0,0,1,3,3,1,2,0,0,1,3,0,1,2,2,0,3,0,0,0,1,2,0,2,3,0,1,3,1,0,3,4,3,8,0,0,0,0,0,0,2,0,0,0,1,2,0,0,0,0,2,1,1,0,0,0,0,6,0,0,8,3,1,0,0,1,1,1,6,0,1,2,0,0,1,1,1,2,3,0,0,2,0,5,1,1,0,2,0,0,5,1,1,3,0,12,1,3,5,3,0,0,5,3,2,3,3,2,0,1,0,3,0,2,2,1,1,0,4,0,4,2,0,0,0,2,8,1,0,2,0,0,1,2,2,0,0,0,3,0,2,1,0,4,4,1,1,2,0,0,0,2,2,0,0,0,0,4,2,2,0,0,3,0,0,1,1,0,2,1,3,0,0,0,6,0,1,0,0,1,2,2,0,1,0,0,0,0,1,3,0,0,0,0,2,1,0,1,0,0,2,2,3,3,1,0,2,0,0,2,0,0,11,0,3,3,2,2,0,0,1,1,0,5,0,4,2,1,3,6,1,1,4,0,0,2,0,1,0,0,0,3,0,0,3,1,2,0,1,0,0,0,0,0,1,1,4,3,2,0,0,21,0,0,0,0,2,0,0,3,0,2,0,2,2,0,0,2,1,10,3,0,0,0,1,0,0,0,0,0,0,0,0,1,1,0,2,1,1,0,0,0,1,0,1,3,1,6,2,1,0,0,1,3,0,2,0,2,3,1,5,1,0,2,0,0,2,0,2,6,3,0,1,8,2,0,6,0,4,2,1,0,6,0,1,0,0,0,0,3,1,2,0,3,0,0,0,4,0,0,0,0,5,3,0,0,0,0,1,0,0,0,0,0,2,0,3,2,1,0,0,2,0,2,1,1,3,6,7,3,0,0,0,0,0,0,0,0,0,0,0,2,0,1,0,2,0,1,0,3,14,1,2,1,0,1,0,0,0,0,3,3,0,1,3,0,1,0,1,0,4,1,1,6,2,3,0,1,0,1,0,2,3,1,0,0,0,2,2,0,5,3,5,0,0,3,0,0,2,0,2,0,3,9,5,0,1,0,4,4,1,0,0,3,4,1,1,0,3,1,0,1,1,0,8,1,0,1,2,1,1,1,1,2,1,1,2,0,2,1,2,0,0,2,0,0,0,1,1,4,0,1,2,0,0,0,0,0,1,5,0,4,0,0,0,0,1,7,2,1,0,2,2,2,0,4,0,0,0,1,4,1,0,1,1,0,3,0,1,0,3,0,0,0,0,2,3,0,2,0,0,1,2,2,0,1,8,0,0,1,0,1,3,0,2,1,0,2,1,0,2,1,1,1,1,0,1,3,0,0,0,1,17,1,0,2,0,2,1,1,0,0,0,0,2,0,0,1,0,7,0,0,1,0,1,2,6,0,0,1,0,0,1,1,1,0,1,4,0,3,0,0,0,2,0,6,0,2,1,0,0,1,1,0,1,0,1,0,0,3,0,1,0,0,2,0,2,1,0,0,0,2,0,1,0,0,1,0,1,0,0,2,4,0,2,0,0,0,3,1,2,0,0,11,0,1,1,1,1,0,0,1,0,0,0,0,4,0,2,0,1,1,2,0,1,0,0,0,6,0,2,4,4,0,1,1,0,0,0,3,1,0,0,3,0,0,4,2,0,0,0,1,1,0,0,2,0,2,0,0,2,0,1,0,0,0,1,0,0,1,5,4,0,5,1,0,2,3,2,1,3,2,0,1,9,1,0,2,4,1,0,0,1,0,0,0,2,0,3,0,0,1,0,0,1,0,0,0,0,0,2,0,1,0,0,0,1,2,1,0,2,0,1,0,0,5,1,0,0,1,1,1,0,0,0,0,0,0,1,0,1,0,2,0,1,0,0,2,2,0,10,0,1,0,1,0,2,2,4,1,3,2,1,1,2,1,2,1,0,7,1,0,0,0,0,1,2,0,3,0,2,0,1,2,1,1,2,1,0,0,0,0,1,0,4,0,2,5,2,0,1,0,0,0,0,0,0,0,0,0,0,0,0,2,1,6,6,0,0,2,0,0,0,0,1,1,3,0,0,1,1,0,1,0,0,1,0,1,0,2,2,2,5,1,0,0,0,0,0,1,2,0,2,3,0,6,1,0,0,0,2,1,3,2,1,0,1,1,0,0,0,0,0,1,4,7,0,0,1,0,1,0,0,0,2,0,1,0,1,2,1,0,8,4,2,2,0,0,0,0,3,1,1,0,1,1,4,1,3,0,0,1,0,0,2,0,0,1,1,3,2,0,1,0,5,4,1,1,0,0,0,0,6,0,1,1,1,2,0,2,7,0,1,1,2,0,1,2,0,0,0,0,0,1,0,4,1,2,1,0,0,1,0,0,6,2,3,1,10,2,1,0,0,4,0,1,0,0,0,0,0,0,0,0,1,0,0,1,1,0,0,1,0,0,5,0,1,0,0,0,0,1,0,0,2,1,3,0,1,0,1,1,0,1,0,3,0,0,0,0,3,2,0,0,1,0,2,0,0,0,0,1,0,1,1,0,4,2,1,2,0,1,0,0,1,0,2,0,2,1,1,0,1,0,4,4,0,2,0,2,1,1,8,2,0,0,3,7,0,1,0,0,1,1,3,0,0,0,0,0,2,0,0,0,0,1,0,0,6,2,0,0,0,2,0,3,0,0,1,0,0,1,4,5,0,0,0,0,0,0,0,0,0,0,0,0,0,1,1,0,0,0,0,0,1,0,3,1,0,0,0,0,0,0,1,2,5,2,2,0,0,0,0,0,4,0,0,1,2,0,1,0,1,0,2,1,2,0,1,0,0,1,0,2,1,0,32,0,1,0,1,0,1,0,0,2,0,0,0,1,1,2,0,0,0,1,0,4,0,0,0,1,0,4,0,0,0,0,6,2,3,6,0,3,0,0,1,0,2,2,1,4,0,3,0,0,2,0,3,0,2,0,1,0,0,1,5,0,0,3,0,0,0,0,0,1,3,2,0,0,1,0,1,0,0,0,2,1,2,0,2,1,0,3,1,0,3,0,0,0,0,0,0,5,1,0,0,0,0,0,2,6,2,2,0,0,0,0,0,0,1,1,0,6,1,0,1,0,2,0,1,0,0,0,0,0,0,4,1,3,1,2,4,0,2,1,1,0,0,1,2,2,2,1,0,1,5,11,1,1,0,0,0,1,2,2,0,0,0,0,0,24,0,0,0,0,0,0,0,0,0,0,0,0,1,2,0,1,0,0,0,0,1,0,1,1,0,0,0,0,0,0,1,2,0,0,1,4,0,0,1,0,0,0,1,0,0,0,2,0,0,0,0,0,0,0,0,0,1,9,0,1,1,2,1,1,1,2,0,0,0,3,0,0,1,0,0,0,1,0,0,1,1,1,2,4,1,0,1,1,0,1,0,1,0,0,0,0,1,0,1,0,0,0,1,1,0,3,2,0,0,1,2,0,1,0,0,0,0,0,6,0,0,2,0,0,0,0,2,0,0,0,3,0,0,1,2,2,27,0,0,1,0,1,2,0,0,0,1,0,0,5,0,1,1,2,0,1,4,0,0,2,1,2,0,0,0,1,2,0,0,0,0,1,0,0,0,1,1,0,0,1,0,1,2,0,1,0,0,2,0,1,0,1,1,1,0,0,5,0,0,1,0,4,1,0,0,0,2,2,0,2,0,3,0,0,0,0,0,0,1,0,2,0,0,1,0,0,0,4,1,0,0,0,1,1,0,0,0,0,0,2,2,0,1,0,0,0,0,0,0,0,1,0,1,0,0,1,3,4,0,1,1,2,0,0,1,3,1,1,0,0,1,0,0,2,0,7,1,1,0,0,1,0,0,0,0,0,0,6,0,12,0,0,0,0,1,0,1,0,5,0,4,0,1,0,0,0,0,2,0,0,3,1,0,1,0,0,0,1,1,0,1,1,0,1,0,3,1,2,1,0,0,3,2,0,0,1,0,0,0,1,1,0,0,0,1,0,0,0,1,1,1,0,0,0,0,0,0,1,1,1,0,1,1,1,0,1,0,0,0,1,1,3,0,0,1,0,3,1,2,0,1,0,1,0,0,1,0,1,0,3,0,0,0,0,2,1,0,0,0,15,0,2,0,0,2,0,1,1,0,0,0,0,0,1,4,1,1,0,0,2,1,0,4,0,2,2,4,0,1,0,1,1,0,0,0,2,0,0,0,1,0,0,0,2,3,0,0,2,0,1,4,0,0,1,0,0,0,0,0,2,0,0,0,0,2,0,0,0,0,3,2,2,0,0,0,3,0,0,0,0,0,0,0,0,4,2,0,0,0,0,0,3,0,0,0,0,0,3,0,0,0,0,0,1,1,0,0,2,0,0,1,2,0,0,0,0,2,0,1,2,2,0,0,0,0,1,2,0,0,2,0,0,0,0,1,0,1,2,2,3,0,0,0,0,1,2,4,8,0,0,1,1,0,0,2,0,1,2,8,0,0,3,0,0,0,0,0,0,4,0,0,1,0,0,0,0,1,0,2,0,1,1,0,1,0,0,0,1,0,0,0,0,1,0,0,0,1,0,0,1,0,1,1,1,0,0,0,0,1,2,0,0,1,0,0,1,0,0,0,0,0,0,0,0,0,0,0,0,0,0,0,0,0,0,5,1,0,0,0,1,0,0,0,0,0,3,0,0,0,0,0,0,0,0,2,1,1,0,3,0,0,1,0,0,0,0,0,1,0,0,1,0,1,1,0,0,0,0,0,0,0,0,1,0,0,0,0,0,0,0,0,0,0,0,0,0,0,0,0,0,1,1,0,1,0,0,0,1,1,1,0,0,0,0,0,0,1,0,0,0,0,4,3,0,0,1,1,0,1,0,0,0,0,0,0,0,2,0,0,0,0,0,0,0,0,0,4,0,0,0,0,0,1,0,4,1,0,0,0,0,0,0,0,0,2,0,0,0,5,0,0,0,0,0,0,2,0,0,0,0,0,0,1,0,3,0,3,0,0,0,0,0,0,0,0,1,0,0,0,0,0,0,0,0,0,0,1,0,0,0,0,0,0,0,0,0,0,0,0,0,1,0,0,0,1,0,0,0,3,0,0,0,0,0,0,0,0,0,0,0,0,0,0,0,0,0,0,0,0,0,0,1,0,0,0,0,0,0,0,0,0,0,0,0,0,0,0,0,0,0,0,0
K14 The Breathing Method,king,1192,719,547,652,620,825,151,373,433,384,187,117,414,277,294,192,258,161,149,121,170,180,203,32,213,149,153,57,92,118,97,66,54,101,78,121,78,93,55,107,99,68,114,92,46,83,91,61,86,89,51,37,54,60,86,85,91,33,39,42,41,34,59,51,29,52,43,41,50,54,17,27,28,30,15,50,45,16,47,23,25,45,30,32,46,42,24,36,35,20,23,19,41,37,41,32,24,19,33,27,29,26,23,40,28,69,46,50,10,33,36,17,23,25,38,35,24,25,26,20,41,33,24,59,23,46,25,14,13,19,43,32,15,16,24,32,18,25,23,35,1,12,0,13,21,18,14,31,16,4,31,20,22,20,15,2,24,37,22,5,27,26,11,36,16,24,24,10,15,22,8,36,37,15,4,13,13,12,18,21,22,7,22,22,7,6,11,27,8,17,10,8,22,18,26,16,2,15,54,4,10,28,13,19,9,11,18,10,5,7,11,8,15,8,5,9,14,10,18,9,13,25,7,11,11,23,17,22,9,18,29,21,8,8,17,1,6,24,5,20,6,19,6,6,18,9,14,11,6,7,10,0,3,12,14,10,5,10,14,15,10,3,12,8,16,10,10,12,14,6,16,13,20,5,11,9,14,4,14,13,8,3,10,23,32,17,7,6,11,6,4,0,2,26,15,10,3,5,2,0,7,7,0,10,26,6,8,4,6,20,15,23,21,11,42,12,7,8,6,0,16,3,10,6,9,5,11,8,12,9,4,27,8,6,0,3,7,5,16,21,4,6,9,4,1,16,5,1,8,3,11,6,8,6,18,2,5,16,8,15,11,8,7,22,8,8,8,11,2,6,10,4,12,3,14,10,5,7,15,2,4,0,3,2,4,0,0,9,6,6,1,6,28,0,6,11,4,4,7,1,5,13,7,2,7,7,2,4,5,3,1,1,12,2,8,39,5,5,4,10,4,0,38,7,2,1,4,6,4,1,9,0,3,16,4,13,3,3,16,4,5,3,1,6,4,3,12,10,9,9,4,4,4,14,11,7,6,14,13,4,7,0,0,7,0,3,2,12,3,4,2,7,10,0,7,5,0,9,0,4,3,8,2,0,15,6,2,6,2,3,2,5,4,1,7,1,2,4,13,11,3,2,8,3,4,1,0,10,9,2,12,1,5,1,4,5,0,3,9,1,6,4,5,3,8,4,6,5,5,10,3,3,7,9,4,0,4,29,2,11,7,8,8,4,2,2,0,1,10,0,2,14,4,7,2,9,7,7,8,4,4,4,6,30,5,2,0,1,32,7,4,0,2,2,4,1,3,2,1,5,4,13,6,7,0,5,5,10,7,2,3,8,3,5,3,4,2,4,4,3,4,9,10,2,0,0,3,3,1,4,4,8,13,6,0,1,3,3,4,7,0,3,2,5,2,2,4,7,0,4,0,1,4,0,2,0,3,1,1,1,1,4,1,5,0,4,4,1,15,5,0,4,3,9,2,5,5,0,5,4,2,1,4,4,16,4,14,2,5,5,8,1,0,1,6,1,0,3,5,5,1,4,7,1,7,2,0,8,0,10,1,5,2,2,1,5,4,0,3,3,4,0,5,7,17,3,0,3,0,8,0,5,0,5,3,3,3,2,4,3,0,2,0,0,2,4,2,0,3,5,9,7,0,7,0,1,13,4,0,3,4,2,16,4,0,0,0,0,4,0,9,0,5,7,1,0,7,4,3,0,1,2,3,0,3,0,4,1,3,16,5,3,0,0,0,3,3,1,5,2,1,1,2,12,0,2,3,10,2,0,4,4,0,4,1,6,0,7,0,2,3,8,1,7,3,2,16,2,4,0,1,13,9,1,2,0,0,0,2,0,6,2,1,3,7,4,1,2,4,6,0,0,2,1,0,2,0,4,0,4,6,1,0,3,5,0,1,0,4,2,4,3,0,1,0,0,2,0,1,4,1,1,1,1,0,3,1,0,2,2,2,3,6,6,0,5,2,1,1,1,4,0,4,2,2,0,0,0,1,3,4,4,0,5,5,3,3,0,2,4,1,4,4,1,19,1,12,1,5,1,4,0,0,0,3,0,4,6,5,0,2,0,2,1,1,3,0,7,8,0,0,2,1,0,3,5,2,1,2,5,3,1,1,0,1,6,2,5,1,0,2,4,0,3,0,2,0,1,7,0,0,6,4,0,0,4,1,2,4,0,3,3,0,1,4,6,2,2,3,0,0,4,0,0,0,0,1,0,2,3,1,1,2,2,4,3,0,1,2,0,0,0,1,0,0,1,0,0,1,0,0,2,1,7,0,3,3,0,0,3,1,0,0,0,1,0,3,0,4,1,2,1,5,2,4,8,6,7,0,5,1,1,0,0,1,10,0,0,8,1,1,1,2,0,1,0,1,4,0,7,3,0,0,2,0,1,2,3,0,0,0,0,4,8,4,1,1,7,4,6,0,4,0,1,2,0,0,11,1,0,1,0,1,1,0,10,1,0,1,0,2,0,1,0,2,4,1,3,2,4,3,3,1,2,0,0,1,1,5,2,1,4,4,0,2,5,5,4,10,5,2,0,9,0,3,7,8,4,1,6,3,0,1,1,1,0,3,2,1,1,5,2,3,3,0,5,0,3,1,2,2,7,3,1,0,0,0,4,0,0,0,2,3,3,3,7,0,2,1,0,1,1,0,0,2,1,0,3,3,0,1,3,0,4,1,2,1,2,0,3,0,0,2,0,0,0,1,2,2,0,0,4,2,1,2,0,0,5,3,3,1,0,0,0,2,0,0,3,5,6,2,2,0,0,1,0,0,2,0,1,3,0,3,0,1,0,0,1,0,1,1,2,35,1,0,0,0,6,1,2,2,0,3,2,0,2,1,3,2,2,0,2,0,0,0,0,1,1,0,0,8,0,1,0,11,2,0,1,1,3,0,0,4,1,6,3,1,2,0,3,0,3,2,2,1,9,17,0,0,1,3,0,1,1,3,5,0,3,1,1,7,1,1,0,1,3,0,1,2,2,1,1,6,0,0,2,1,0,1,0,1,1,1,0,1,1,0,1,4,0,0,0,2,1,0,2,3,0,6,1,0,3,1,0,2,0,8,0,2,2,0,2,6,0,1,0,0,5,0,0,2,0,3,1,1,2,3,0,0,1,2,0,3,0,27,0,7,0,1,0,0,0,0,1,0,1,0,0,1,0,1,1,1,1,0,0,0,0,2,3,0,0,12,1,2,1,4,1,2,0,1,4,0,0,1,0,3,0,2,1,3,7,6,1,0,4,4,0,0,3,1,1,0,2,0,0,0,4,3,6,2,4,1,0,0,1,0,0,1,0,0,2,0,0,0,0,0,1,2,0,0,0,0,5,0,0,1,1,4,0,1,3,6,1,1,0,0,0,0,0,4,0,0,0,0,0,0,2,0,0,0,2,2,9,2,0,0,0,2,0,0,3,0,1,1,4,1,1,0,1,1,1,1,0,0,0,1,0,0,0,1,0,4,1,1,1,3,0,1,0,2,0,5,0,0,0,0,0,2,0,0,0,0,3,1,1,1,0,3,0,1,4,6,0,1,2,2,0,6,0,3,3,1,0,2,1,0,0,2,1,0,0,1,13,1,0,2,0,1,0,0,0,0,3,3,1,1,2,4,1,2,0,0,0,2,0,0,1,0,0,0,2,3,0,5,1,1,1,0,0,1,1,3,0,0,1,0,4,1,1,2,0,1,4,1,1,7,4,1,1,0,0,2,2,0,0,0,1,0,5,1,7,2,0,0,1,3,0,2,1,1,3,1,1,3,3,0,2,0,0,0,1,0,0,0,0,0,1,1,0,0,0,0,0,0,0,3,0,0,2,1,3,0,1,0,0,2,0,0,0,0,2,0,1,0,0,0,0,0,3,0,3,0,0,2,0,2,0,1,1,6,0,9,0,1,4,1,4,8,0,1,1,7,1,0,1,0,1,2,1,1,1,0,1,0,2,0,0,0,9,0,1,0,0,5,1,1,1,0,0,0,0,0,0,3,0,0,1,0,0,0,0,0,0,0,2,0,10,0,0,0,0,0,2,0,0,5,1,2,2,1,1,2,2,1,0,1,0,0,0,2,1,3,0,1,0,3,0,1,3,2,0,0,0,0,0,0,0,0,0,0,1,1,1,0,0,2,1,0,0,1,0,0,0,0,2,3,1,1,0,3,0,3,3,1,13,4,6,2,0,1,2,1,1,1,0,1,0,0,5,0,2,6,3,6,2,0,4,1,1,0,0,3,8,0,3,3,4,1,1,1,0,0,1,3,0,1,0,0,1,0,1,0,0,0,1,0,0,0,3,0,3,1,0,0,2,0,2,0,0,0,0,0,0,1,0,0,0,3,1,0,0,0,1,0,0,2,0,0,2,3,4,0,0,0,0,0,0,4,0,0,1,0,0,0,0,0,0,0,1,1,0,0,0,3,0,1,0,4,4,1,0,0,0,0,0,0,0,1,1,0,2,0,1,0,2,0,4,2,1,0,0,1,0,0,0,0,0,0,0,1,0,1,1,0,0,2,0,0,6,0,1,0,2,1,1,1,0,0,1,1,0,1,0,0,0,0,3,0,0,1,0,1,0,0,1,0,0,0,0,2,1,0,0,0,0,0,2,0,0,1,0,2,0,1,4,4,0,0,0,3,2,19,1,0,0,0,1,0,0,0,0,0,0,0,0,1,1,1,5,1,1,1,3,1,1,1,0,0,2,3,0,0,0,1,0,0,0,1,3,0,0,0,1,1,2,0,0,0,2,1,4,0,2,1,1,0,0,0,0,1,0,0,2,0,0,1,7,2,8,0,1,0,0,0,2,0,0,0,1,1,0,1,0,1,3,0,0,0,1,0,4,1,0,0,0,1,1,3,1,0,0,1,1,1,0,0,0,6,0,2,0,0,0,0,0,0,1,1,0,8,0,0,0,0,2,1,6,0,0,0,0,0,1,0,1,2,0,4,4,0,1,0,0,1,0,0,0,1,0,0,3,2,2,1,0,0,0,0,0,2,0,0,0,3,0,1,2,0,3,0,0,0,0,1,0,1,17,0,0,1,2,0,1,0,2,0,0,0,0,0,0,1,1,0,1,3,0,0,0,0,0,1,0,1,0,1,2,2,0,2,1,0,1,0,2,1,0,1,0,0,0,1,3,0,1,1,1,1,2,0,1,0,1,0,0,0,2,3,4,0,0,1,5,4,4,1,3,0,1,0,1,2,0,0,0,2,0,0,0,1,0,0,0,4,0,0,1,1,4,3,2,0,0,0,0,3,0,1,0,1,0,3,0,0,0,1,0,1,0,2,0,0,3,0,3,0,0,0,0,0,2,0,3,0,0,0,0,1,0,1,0,2,1,1,0,1,0,1,0,0,0,0,0,0,0,0,0,0,1,1,0,1,1,1,2,1,0,0,2,0,2,0,0,4,0,0,0,1,0,0,1,1,0,0,0,0,11,0,0,1,0,3,3,1,0,0,2,2,0,0,0,1,0,1,0,1,0,0,0,0,0,23,0,0,0,0,1,0,1,1,0,0,0,0,1,1,0,1,2,0,0,1,0,0,2,0,2,1,1,0,1,0,0,0,0,0,0,1,5,1,0,1,3,0,2,0,0,0,3,0,0,2,0,0,5,1,0,0,0,0,0,0,0,0,0,0,0,0,0,0,2,0,0,0,0,0,0,6,0,0,0,0,0,2,0,0,0,1,3,0,1,0,0,1,0,0,2,1,0,3,0,1,0,16,2,1,0,0,0,0,0,0,0,3,0,0,0,0,2,2,1,2,1,1,0,2,0,0,1,0,0,0,1,0,0,1,0,0,1,0,3,0,1,0,5,0,0,0,2,0,1,0,1,0,1,0,3,1,0,2,0,0,1,0,0,0,0,2,0,0,0,1,0,1,0,0,0,1,0,0,0,0,0,0,2,1,0,0,0,0,0,0,1,0,0,0,0,1,0,0,0,0,1,0,0,2,0,0,0,0,0,0,0,1,0,0,0,1,0,1,6,0,1,0,0,0,1,1,0,0,0,1,0,0,2,0,0,0,0,0,2,1,1,0,0,0,1,0,0,1,0,1,0,0,0,0,0,0,0,0,1,0,3,0,0,0,0,0,2,4,0,1,1,0,0,0,0,4,0,0,1,1,0,0,0,0,0,0,1,0,0,2,0,0,0,1,3,0,0,1,0,0,0,0,0,0,9,0,0,0,0,0,1,2,3,0,0,0,0,0,0,0,0,0,0,0,7,0,0,0,0,0,1,1,0,1,3,0,0,0,0,2,1,0,0,0,0,1,0,0,0,0,2,0,0,0,0,0,0,0,2,0,0,0,0,0,2,0,1,0,0,3,1,3,1,2,0,1,0,0,0,1,0,0,3,0,0,2,0,5,0,0,0,6,1,1,0,0,0,1,2,0,2,0,1,0,0,0,0,0,0,0,0,0,1,0,1,1,0,0,0,0,3,0,0,0,0,3,0,1,0,2,1,0,3,0,0,0,0,1,4,2,0,0,2,0,0,0,0,1,1,0,0,0,0,1,0,0,1,0,2,0,0,0,0,0,0,2,0,1,1,0,1,0,2,2,0,0,0,0,1,0,0,0,0,0,0,0,1,0,0,1,3,0,2,0,1,0,0,0,0,3,2,0,0,0,0,0,0,3,0,1,0,0,1,1,1,3,1,0,0,0,0,1,0,0,0,1,0,0,0,2,6,2,2,0,0,0,1,0,0,0,0,0,0,0,1,0,0,1,0,0,0,0,2,0,0,0,0,2,0,0,0,0,1,1,0,3,0,2,0,0,0,0,0,0,0,0,2,3,0,0,1,0,0,0,0,0,0,0,7,0,0,1,1,1,0,1,1,1,0,0,1,0,0,0,0,0,1,0,0,1,0,0,0,0,0,1,0,0,0,0,0,0,11,0,1,1,0,0,0,0,0,0,2,0,2,0,3,0,0,0,0,0,2,0,0,0,0,1,0,3,0,1,1,0,0,0,0,4,2,3,2,0,0,0,0,4,0,0,0,0,1,0,0,0,0,1,1,0,0,0,1,0,0,1,0,0,0,0,0,0,0,0,0,1,0,0,0,0,3,0,0,0,0,0,1,17,1,0,2,0,0,0,0,0,0,0,0,0,0,0,0,0,1,0,0,1,0,5,1,0,0,0,2,1,0,0,0,0,0,2,0,0,0,0,0,1,0,4,0,1,0,1,0,0,0,0,0,0,0,5,0,0,1,0,0,1,0,0,0,1,0,0,1,0,0,0,0,2,0,0,0,1,0,0,2,0,0,0,0,0,0,1,2,1,1,1,0,3,0,0,4,1,1,0,2,0,0,0,1,0,0,0,0,0,0,0,0,2,2,3,0,0,0,0,0,1,2,1,0,0,0,0,0,0,1,4,1,0,1,0,1,1,0,1,0,0,1,0,0,0,0,0,1,0,0,0,0,1,0,0,0,0,0,0,0,0,1,0,0,0,1,0,1,0,1,1,0,1,0,0,0,1,0,0,1,0,2,0,1,0,0,0,0,1,0,2,0,0,0,1,0,0,0,0,0,0,0,0,0,1,0,1,0,0,0,0,0,0,0,1,0,0,0,0,2,0,0,0,0,0,0,0,0,0,0,1,0,0,0,0,0,1,0,1,0,4,0,1,2,0,0,1,0,1,2,0,0,0,1,3,0,2,0,0,0,0,0,0,0,2,0,1,0,4,1,0,0,0,0,1,0,1,0,0,0,1,0,2,0,0,0,1,5,0,0,1,1,0,0,0,0,0,0,0,0,0,1,0,0,0,0,1,0,0,0,0,0,1,0,1,0,3,4,1,3,1,0,0,2,1,0,0,0,1,0,0,2,0,0,0,0,0,3,6,1,0,1,2,0,1,1,0,0,0,0,0,1,1,0,0,0,0,0,0,0,0,0,4,0,1,0,0,0,0,4,0,0,0,0,0,1,0,0,1,0,0,0,2,1,0,0,0,3,0,0,4,0,0,0,0,0,0,0,0,0,1,0,0,0,0,0,0,0,0,2,1,1,0,0,2,0,0,0,0,0,1,0,0,1,0,0,0,0,0,0,1,2,0,1,0,0,0,6,0,0,0,0,0,0,2,0,0,0,0,2,0,1,0,0,0,0,0,1,0,1,0,0,1,0,0,1,0,0,0,2,0,0,0,0,0,3,0,0,1,1,0,0,0,1,0,2,0,0,0,0,0,0,0,0,1,0,0,0,0,11,1,14,0,0,0,0,0,2,0,0,0,0,0,0,1,0,0,0,0,0,0,0,0,0,0,0,0,0,0,1,0,0,0,0,1,0,2,1,0,0,0,0,0,0,0,0,0,0,0,0,0,0,0,0,0,0,0,0,2,0,0,0,0,1,1,1,0,0,0,1,0,1,0,0,0,0,1,0,1,0,1,0,0,0,0,4,0,2,0,0,0,0,1,0,2,0,1,0,0,0,0,0,0,0,0,0,0,0,0,0,0,0,0,0,0,0,0,2,0,0,0,0,6,0,0,0,1,0,0,0,2,0,1,1,0,1,0,0,0,0,0,0,0,0,1,1,0,0,0,0,0,1,0,1,0,0,0,0,1,0,0,0,0,0,0,2,0,0,0,0,1,0,0,0,3,0,0,0,0,0,0,0,0,0,1,0,0,0,0,0,0,0,2,1,0,0,0,6,4,0,0,1,0,0,0,0,0,0,1,0,0,1,0,0,0,0,0,0,1,0,0,0,0,0,0,1,1,1,0,0,0,0,0,0,0,0,0,1,0,1,0,0,3,0,1,0,0,0,0,0,0,0,0,0,0,2,0,1,0,0,0,0,0,1,0,0,0,0,0,0,1,0,0,0,0,1,0,0,0,0,0,0,0,0,1,0,1,0,0,0,0,0,2,0,5,0,1,0,1,0,0,0,0,2,0,0,0,0,1,0,3,1,0,4,0,0,0,0,0,0,1,0,1,0,0,0,0,1,0,0,0,0,0,0,0,0,0,0,0,0,1,0,0,0,0,0,2,0,0,0,0,0,2,0,0,0,2,1,1,0,0,4,0,0,0,0,1,0,1,0,0,0,23,0,1,0,0,0,0,0,0,0,0,0,1,0,0,0,0,0,0,0,1,0,0,1,0,0,0,2,0,2,1,0,1,0,1,0,0,0,0,1,0,0,0,0,0,0,1,0,0,3,0,1,0,0,0,0,1,1,1,0,1,0,0,0,1,0,0,0,0,0,0,0,0,1,1,0,0,0,0,0,1,0,2,0,0,0,0,0,1,1,0,0,2,2,0,0,1,0,0,0,0,1,1,4,0,0,1,0,0,0,1,0,0,0,0,3,0,0,0,0,0,2,0,2,0,0,0,1,0,0,2,0,0,0,0,0,0,1,1,1,0,0,0,1,1,0,0,0,0,0,1,0,0,0,0,0,0,0,1,0,0,0,0,1,1,0,0,0,0,0,0,1,0,0,0,0,0,0,0,0,0,0,1,0,1,0,0,0,0,0,0,1,0,0,0,0,0,2,0,1,0,0,1,0,0,0,0,0,0,0,0,0,0,0,0,0,1,3,0,2,0,0,0,0,0,0,0,0,1,0,0,0,1,0,3,4,0,0,2,0,0,0,0,1,0,0,1,2,0,2,0,1,0,1,1,2,0,2,0,1,0,0,0,1,0,1,0,1,0,0,0,1,0,1,2,0,0,0,0,1,0,0,0,0,0,1,0,0,0,0,0,1,5,0,1,0,1,0,0,0,0,0,0,0,0,0,5,0,0,0,0,0,0,0,2,1,5,0,0,1,0,1,1,0,0,3,3,1,1,0,0,0,0,0,0,0,0,0,0,5,0,0,1,1,1,0,1,0,2,0,1,0,0,0,0,0,0,0,0,0,0,0,0,0,0,0,0,1,1,0,1,0,0,0,0,2,0,0,0,0,0,0,2,0,0,0,2,0,2,0,0,0,0,0,0,0,0,0,0,0,0,0,0,0,1,0,4,0,0,0,0,0,0,0,0,0,0,0,1,0,0,1,2,0,0,1,0,1,0,0,0,0,0,0,0,0,0,0,0,1,0,9,0,0,0,3,0,0,0,0,1,0,0,0,0,0,0,0,1,1,0,1,0,0,0,0,0,1,0,0,0,1,0,0,0,0,0,0,0,0,0,0,1,0,1,1,1,0,0,0,0,0,0,1,0,0,0,0,0,0,0,0,2,0,1,0,0,0,0,0,0,0,2,0,2,0,0,0,12,0,0,0,1,3,0,0,1,1,0,0,0,0,4,0,1,0,0,1,0,3,0,1,0,1,0,0,0,0,0,2,1,0,0,0,0,0,0,0,0,0,0,0,0,0,0,1,1,0,0,2,0,0,2,0,0,0,0,0,2,0,0,0,0,5,1,0,0,0,0,0,0,2,0,0,0,0,0,1,0,0,0,0,2,0,0,0,0,0,0,0,0,0,0,0,0,0,1,1,0,1,0,0,2,2,0,1,0,0,0,0,0,1,0,0,2,0,1,1,0,0,1,0,0,0,0,0,0,0,1,0,0,0,0,0,0,0,0,0,0,2,0,0,0,0,0,1,0,0,2,0,0,0,0,1,0,0,2,0,0,1,0,0,2,0,5,0,1,0,0,0,0,0,1,2,0,2,0,0,5,2,0,0,0,0,0,1,0,1,1,0,1,0,0,1,0,1,0,0,0,0,0,0,0,0,0,0,0,0,0,0,0,0,0,1,0,0,0,0,0,0,0,0,0,1,1,0,0,1,0,0,0,0,0,1,0,0,0,0,0,0,0,0,2,2,1,0,0,0,0,0,1,1,0,0,1,1,0,0,0,0,0,0,0,0,1,0,0,0,0,0,0,0,0,0,0,0,1,0,0,0,0,1,0,1,0,0,0,0,0,0,0,0,0,0,0,0,0,0,0,0,0,0,0,0,1,1,0,2,0,0,1,0,1,0,1,0,0,0,0,0,0,0,0,0,0,0,0,0,0,1,1,0,0,0,0,0,0,0,1,0,0,2,0,0,2,1,0,0,0,0,0,0,0,0,0,0,1,0,0,0,0,5,1,0,0,0,0,0,0,0,0,0,0,0,0,0,0,0,0,0,0,1,0,0,0,1,0,0,0,0,0,0,0,0,0,0,0,0,0,0,0,0,0,0,0,0,0,0,0,0,0,0,0,0,1,0,0,0,0,0,0,0,0,0,0,0,1,0,0,0,0,0,0,0,0,0,0,0,0,0,0,0,0,0,0,0,0,0,0,0,0,0,0,0,0,0,0,0,0,0
K15 Christine,king,8825,5798,4285,4399,3880,4509,3399,2746,3542,3277,2179,2119,2749,1362,1427,1596,2388,1151,1191,1482,1374,1273,885,988,1248,691,944,576,1036,486,560,890,775,682,530,674,591,839,402,641,852,760,731,542,543,505,563,447,607,656,729,387,517,473,431,328,684,439,477,566,481,426,284,446,420,450,231,486,248,310,422,261,297,254,467,346,270,446,308,174,315,285,180,388,392,397,198,221,295,236,198,293,295,227,361,233,310,186,283,237,232,409,383,256,339,154,246,412,290,311,240,272,162,137,242,200,208,207,166,120,250,333,293,302,91,174,201,185,160,179,172,268,256,109,177,211,101,257,183,146,125,119,51,186,217,208,137,173,118,280,167,137,186,117,166,113,81,173,156,100,187,198,199,190,187,135,124,94,174,174,94,127,154,184,596,58,100,71,168,216,131,109,154,88,109,155,140,87,156,76,131,72,119,112,111,134,147,79,24,34,100,210,102,112,91,109,66,62,106,145,131,131,17,72,77,82,145,124,132,114,61,84,126,114,88,97,54,60,45,255,118,70,94,206,118,16,64,75,82,35,108,86,79,71,75,101,79,170,65,93,103,26,82,59,47,75,90,80,73,63,149,176,100,86,63,90,94,58,97,62,100,54,104,47,60,76,66,64,128,89,50,27,66,100,200,91,74,60,48,47,95,33,60,42,81,85,80,98,60,112,94,78,115,52,127,51,46,82,41,34,42,81,39,87,50,71,43,95,41,21,90,83,58,57,44,73,66,62,47,56,125,87,53,49,66,114,123,13,44,111,51,52,49,57,75,50,62,79,63,41,75,24,91,86,123,46,34,121,53,96,97,47,50,4,25,64,33,57,30,51,40,25,65,29,58,119,48,32,88,46,39,57,35,36,32,43,0,40,53,59,18,48,36,130,61,76,29,52,48,72,159,48,54,40,49,45,53,101,35,49,67,41,106,36,40,49,37,31,29,49,73,7,8,54,23,43,40,94,39,47,59,35,33,86,9,26,48,25,8,49,51,40,29,41,57,21,161,66,39,48,31,31,17,77,54,24,50,23,27,75,49,55,0,18,26,56,31,21,16,35,16,65,54,23,64,27,28,23,0,40,31,47,32,15,8,42,42,19,105,48,25,33,45,12,30,14,48,53,21,55,42,60,23,19,35,17,7,37,37,28,27,24,36,35,77,39,0,28,72,64,36,46,46,25,29,18,40,22,27,69,7,30,20,50,9,1,86,60,27,33,53,16,24,28,37,21,0,4,36,85,28,28,57,12,20,42,44,40,19,0,31,40,42,27,25,60,29,8,13,42,75,42,22,56,34,58,30,27,18,32,46,59,23,36,12,49,13,43,31,9,26,36,13,24,30,51,4,12,19,25,71,66,54,14,6,0,0,44,32,31,17,51,37,37,6,18,32,8,34,47,14,91,25,43,47,50,17,43,23,5,37,29,20,32,36,3,64,44,15,11,18,15,24,4,56,34,31,27,13,60,0,21,31,30,27,82,22,17,30,18,20,11,42,24,33,37,45,38,32,27,49,35,11,17,29,28,11,31,56,8,43,20,24,20,49,18,5,22,15,21,31,16,9,21,4,32,16,7,25,32,27,10,25,23,17,12,19,43,29,21,6,27,0,32,17,104,11,17,25,28,25,24,5,0,25,30,62,38,18,18,27,17,12,9,0,67,40,26,2,31,45,27,27,20,2,6,19,28,25,25,25,10,25,22,8,17,16,29,10,9,19,13,16,29,13,65,18,11,20,21,39,2,17,15,177,7,19,28,28,15,26,15,10,15,42,41,23,15,23,15,31,7,4,49,9,17,1,45,3,19,24,0,10,28,17,5,48,23,7,39,14,52,33,2,26,22,5,0,14,40,23,15,24,24,29,56,16,17,34,29,4,4,3,27,4,20,24,13,0,48,24,9,21,12,61,10,6,0,18,31,19,22,3,5,4,10,10,1,5,36,44,5,33,15,7,14,8,0,18,43,30,30,42,8,0,10,7,34,18,24,24,13,32,10,9,25,15,23,13,25,24,18,9,14,31,22,8,2,11,59,6,26,24,22,32,35,60,18,24,22,23,0,35,0,7,2,13,10,10,16,35,2,5,5,7,13,12,1,78,10,42,22,17,3,8,14,6,34,38,44,13,68,91,22,10,7,13,11,23,25,20,24,19,17,4,27,9,12,17,11,0,31,19,1,8,17,16,2,10,18,17,0,12,12,7,47,23,30,16,1,0,60,23,7,37,20,14,0,12,8,10,11,20,12,32,5,0,10,29,0,14,0,7,1,7,33,0,0,4,63,8,4,18,163,10,23,25,0,10,12,3,18,64,10,9,7,7,12,57,17,35,26,22,10,12,7,18,8,13,54,46,7,4,5,22,8,23,3,32,38,7,32,13,6,29,0,14,21,7,14,17,77,0,9,7,31,21,8,0,0,0,2,9,15,20,14,6,0,8,18,5,4,29,17,12,8,4,8,18,4,1,0,12,6,5,17,10,22,33,6,23,6,22,12,12,9,18,9,7,14,8,28,10,26,0,0,5,6,31,12,12,31,11,12,11,13,21,17,31,4,12,62,7,3,10,33,33,41,7,7,49,2,14,16,3,5,27,7,6,5,34,2,13,21,12,4,5,4,6,8,5,20,7,24,0,5,10,30,2,1,0,7,22,7,15,32,7,1,25,2,13,33,15,4,34,74,0,7,21,0,17,13,0,9,2,15,11,22,1,22,20,0,12,20,27,36,15,6,19,22,0,14,18,4,31,0,0,9,14,12,26,7,6,4,16,12,2,19,8,17,9,8,1,15,15,0,23,7,4,17,10,9,16,0,3,20,2,1,9,13,8,27,5,16,1,4,17,19,0,15,30,0,13,20,4,41,10,3,12,15,0,6,24,3,0,1,13,7,0,91,121,12,18,13,21,21,24,32,7,6,0,14,8,8,9,12,6,18,2,38,14,28,13,8,17,23,16,17,8,7,2,1,5,17,2,15,19,34,18,10,24,10,0,1,21,18,15,13,4,8,2,10,10,9,1,35,10,2,15,19,14,14,57,395,9,31,5,8,8,32,13,2,21,5,11,0,12,20,10,7,4,11,15,0,11,1,9,7,11,10,9,9,22,3,11,0,0,18,0,30,5,0,9,23,5,11,12,7,45,6,28,27,21,6,70,4,6,0,5,3,0,2,0,13,1,4,4,0,7,6,6,20,20,4,0,7,20,2,10,19,10,42,5,8,11,23,8,6,5,9,9,8,0,0,8,21,14,6,3,11,4,8,0,21,2,8,15,17,14,7,1,21,0,14,16,0,2,11,8,4,4,8,8,0,16,15,10,1,11,6,14,3,3,9,0,1,10,22,9,8,8,11,8,20,167,5,30,19,5,20,7,25,14,10,8,4,0,1,3,7,19,0,1,0,0,0,0,10,7,1,9,4,6,6,36,14,5,0,3,5,0,7,9,3,16,14,4,14,2,6,1,3,44,7,13,3,6,1,16,4,19,12,11,12,18,2,9,0,9,11,19,5,30,6,13,8,4,1,10,4,16,8,19,7,8,8,8,17,15,12,27,15,10,0,14,15,8,2,34,20,4,14,13,9,6,9,14,11,4,7,1,14,25,30,4,10,14,0,5,20,0,4,0,17,5,7,5,8,12,6,16,8,3,9,11,4,0,7,0,16,6,15,10,0,4,14,2,3,1,6,8,0,5,6,18,5,10,15,7,15,9,1,31,7,0,1,2,10,14,0,8,13,8,5,4,8,6,8,0,5,22,21,7,5,32,7,14,0,12,15,6,23,16,14,7,16,13,5,0,9,16,10,23,2,4,0,5,14,7,6,11,0,5,5,0,6,20,2,12,6,13,11,4,4,2,3,12,3,21,32,9,6,32,6,5,3,10,5,0,12,1,7,10,9,4,0,13,7,5,12,2,9,28,0,13,8,0,1,29,6,2,11,12,21,0,6,1,21,11,4,16,7,2,11,0,14,4,8,10,25,19,3,24,8,5,12,2,16,18,0,3,4,35,9,14,2,2,2,4,4,8,29,2,5,14,14,3,2,3,12,9,11,0,8,6,2,4,3,21,22,2,2,2,2,8,2,8,7,6,0,15,24,9,2,2,13,5,0,5,27,20,12,0,0,7,6,1,0,0,0,0,42,10,7,2,7,12,5,0,9,9,13,0,2,2,10,26,5,16,1,8,4,9,7,9,5,27,14,6,2,12,4,1,6,5,2,1,7,4,14,1,5,2,5,0,6,2,10,13,10,1,2,15,2,0,4,2,3,10,12,12,5,0,5,0,0,1,1,13,7,0,22,7,4,0,5,4,4,2,13,0,16,2,2,8,1,5,11,8,5,4,0,0,1,20,38,1,1,13,2,1,6,0,3,4,0,4,8,0,2,6,2,0,8,2,5,7,17,8,5,1,8,4,6,6,3,0,3,0,25,4,9,10,15,10,1,10,4,9,7,12,6,0,0,4,3,3,15,12,8,0,22,11,14,7,4,0,11,1,4,1,2,7,3,4,4,7,0,3,9,8,0,5,8,10,7,7,4,3,10,3,1,3,22,15,7,10,1,5,5,9,0,3,3,6,0,23,2,5,0,21,4,0,11,9,5,12,2,6,3,28,43,2,0,0,10,4,0,8,4,12,8,6,7,3,32,25,18,0,2,17,4,1,2,7,2,4,4,4,5,0,4,4,5,0,2,25,11,5,1,28,5,27,13,3,8,0,0,5,3,3,2,3,12,2,16,1,3,3,16,2,1,5,6,3,4,0,1,7,6,8,2,206,8,10,1,8,3,0,13,6,0,7,5,0,0,1,7,3,11,12,12,4,6,0,10,3,21,11,5,1,2,7,0,9,13,5,3,0,8,2,1,3,0,7,0,22,2,13,5,0,7,0,0,10,3,7,2,2,2,3,4,14,2,9,0,0,3,1,0,16,0,0,0,3,2,23,3,3,0,4,8,9,3,1,7,2,11,10,8,0,2,13,2,7,0,0,0,5,3,2,7,2,3,9,0,1,4,2,7,5,7,3,0,0,8,3,18,11,1,0,5,0,5,7,6,2,0,4,0,3,9,9,7,3,12,6,6,6,6,3,5,1,0,8,8,4,12,15,3,3,4,12,0,8,1,8,22,9,0,6,1,1,0,2,8,14,7,10,5,3,6,9,7,4,1,5,5,2,7,14,5,7,12,3,2,2,5,35,12,5,3,5,4,2,11,1,17,1,4,2,4,8,9,10,5,5,6,6,5,3,4,0,4,2,0,8,5,4,3,24,10,10,5,13,1,4,3,42,1,27,1,10,3,5,2,2,1,4,4,23,3,5,10,2,0,10,8,1,1,15,3,5,3,8,6,10,3,1,2,4,0,23,0,3,0,11,19,4,6,0,3,1,16,0,0,0,12,0,3,34,2,1,5,1,4,1,4,1,22,3,11,4,0,0,10,5,13,6,0,2,5,17,3,20,0,2,1,0,3,4,0,1,7,2,0,5,11,22,0,6,7,5,1,11,25,16,7,7,3,0,5,12,2,4,0,4,4,12,0,5,0,1,2,1,8,6,1,4,2,5,10,12,0,1,14,58,2,1,0,0,2,1,8,6,2,0,4,1,4,2,6,14,10,0,8,4,0,3,4,6,0,11,10,7,3,8,0,9,1,1,3,0,9,2,10,0,0,3,0,1,2,0,1,0,17,1,1,4,2,0,2,1,2,2,4,1,1,3,6,3,0,10,8,5,14,4,8,13,3,14,0,0,3,4,24,8,2,2,2,6,2,0,7,2,9,0,1,0,14,5,0,4,6,2,8,1,0,4,0,2,0,0,9,1,0,8,5,0,5,2,3,2,3,9,5,5,5,1,4,1,2,2,6,4,5,33,2,4,5,5,5,6,8,4,4,0,2,3,3,6,1,14,2,4,10,9,4,15,17,0,1,9,0,3,8,2,7,2,3,0,1,0,22,5,5,1,0,0,1,3,3,2,2,1,1,5,7,2,0,0,6,5,7,7,2,0,4,9,4,4,18,0,8,5,4,5,1,9,13,12,1,1,0,4,4,2,4,4,1,1,6,2,3,1,20,12,0,5,2,3,0,2,2,5,0,8,1,13,6,2,8,13,15,2,4,0,2,11,5,0,6,8,3,1,7,0,4,2,6,9,6,12,3,1,4,9,2,0,6,2,0,19,3,1,0,8,6,6,6,0,6,9,8,4,0,7,6,3,7,0,0,0,7,2,1,4,0,8,1,3,5,0,3,0,2,2,6,2,8,4,1,0,38,1,0,8,4,0,1,0,7,9,2,0,0,10,1,6,0,1,2,4,4,8,0,4,7,0,2,4,1,0,4,0,0,8,4,1,12,1,6,3,7,10,4,5,1,16,3,7,2,7,7,4,8,0,2,0,4,7,0,1,3,8,1,15,3,1,0,2,3,0,2,0,7,3,2,4,4,0,0,2,2,5,2,2,4,4,7,1,4,1,5,0,1,0,2,3,2,6,2,1,4,4,1,4,0,7,1,0,7,0,1,6,3,4,0,10,0,7,3,2,1,0,6,1,7,4,7,5,3,2,0,0,5,0,0,1,1,1,3,9,2,1,0,7,3,7,5,0,2,10,4,0,4,1,8,1,1,1,13,6,4,0,4,1,10,2,2,0,6,0,5,2,7,1,3,2,0,6,2,1,0,0,0,2,5,5,1,1,1,3,0,5,12,0,3,1,1,0,1,22,5,8,16,11,0,0,2,0,0,2,2,0,1,2,1,2,6,2,0,0,3,6,3,6,1,0,0,4,0,0,4,7,2,3,0,1,5,12,9,1,6,2,1,0,4,1,1,2,3,4,2,1,8,1,2,1,15,0,13,1,4,7,5,8,2,2,0,2,11,5,3,1,10,5,0,4,4,8,5,4,1,3,4,3,0,14,1,4,1,0,1,3,4,2,4,5,1,4,0,2,4,0,1,2,4,24,23,11,4,0,2,1,0,1,0,1,1,1,0,4,4,4,0,0,1,2,3,7,6,3,14,1,0,0,6,3,2,0,1,0,1,0,0,0,0,1,2,1,3,1,0,0,0,21,7,8,6,0,5,1,4,0,16,6,3,0,4,3,2,6,1,2,2,2,5,5,3,2,6,0,0,1,3,0,8,0,1,421,2,0,22,2,3,5,6,1,7,0,1,0,1,4,8,6,0,6,0,1,0,8,26,49,4,4,0,4,16,17,8,2,2,8,0,0,2,3,0,20,0,10,1,4,5,2,3,2,13,7,6,6,1,2,5,2,1,5,0,11,6,0,0,1,8,3,4,9,4,2,0,2,0,9,9,2,9,2,0,3,0,3,22,3,0,0,4,2,1,0,5,1,0,0,2,13,5,1,5,2,15,8,8,4,0,2,3,0,0,0,1,2,1,24,8,0,0,13,1,0,3,1,0,1,2,1,5,8,1,9,1,2,55,5,2,5,0,0,0,6,4,3,2,3,0,0,1,1,6,0,3,0,3,10,2,13,15,14,0,2,2,0,0,1,5,0,0,9,3,1,1,10,0,0,1,1,0,7,1,3,0,5,2,1,2,0,0,4,4,4,2,1,4,2,2,0,3,0,0,4,0,4,9,2,4,1,6,0,0,4,0,2,3,1,5,1,6,1,2,1,0,1,1,6,1,0,1,4,0,5,1,1,3,9,0,0,4,1,14,0,1,9,0,6,1,0,3,0,1,1,0,5,2,3,6,4,2,0,2,8,0,2,0,2,0,5,2,1,0,1,8,0,2,1,9,3,1,3,2,0,1,2,2,1,0,1,2,4,2,0,0,2,0,0,2,3,0,2,0,2,0,12,0,6,2,8,1,9,7,2,3,5,5,4,3,1,1,0,13,3,1,1,2,6,1,7,1,9,3,1,2,3,1,9,2,1,3,0,2,2,0,0,0,0,2,3,0,2,0,3,1,2,3,2,3,2,0,1,3,1,9,0,1,1,1,1,4,2,1,7,0,0,3,4,3,1,0,7,2,0,4,11,5,11,0,5,0,3,1,3,0,5,6,51,1,4,13,0,0,9,4,4,1,1,3,3,1,0,1,3,3,5,8,11,0,2,0,1,3,5,52,8,0,0,1,1,0,1,0,11,3,1,10,12,0,1,2,2,3,5,2,10,0,0,11,0,0,4,1,5,0,0,0,4,0,2,1,0,3,2,0,14,0,0,3,1,1,0,5,0,3,0,1,1,4,6,2,9,0,0,3,6,1,0,0,5,3,2,4,1,0,0,1,1,2,1,8,1,11,1,0,3,3,8,0,2,0,1,1,5,1,1,0,2,1,2,5,0,4,6,1,3,2,8,2,4,0,5,3,2,4,0,0,0,0,4,2,2,0,1,0,4,1,1,3,1,5,0,0,4,0,4,0,1,2,2,1,2,1,4,1,2,1,0,0,1,0,14,1,1,0,2,13,1,2,4,5,1,1,8,2,11,0,5,1,0,0,0,9,1,3,2,0,1,0,6,5,0,0,3,6,1,0,1,8,0,0,0,6,2,8,1,0,0,2,0,0,7,0,2,4,0,6,7,0,0,0,0,0,10,2,12,6,1,1,0,3,3,1,1,35,4,0,1,1,3,1,0,1,3,7,1,0,0,3,2,2,0,4,1,1,6,1,2,2,0,1,1,8,1,0,2,2,0,4,2,3,4,0,0,0,4,0,10,7,1,1,4,4,1,1,0,4,0,3,2,1,2,0,1,6,7,0,0,0,0,0,2,0,2,2,0,7,5,1,1,7,1,2,0,0,2,3,2,1,1,5,16,4,3,6,3,3,0,2,0,3,1,5,6,0,0,4,0,4,9,1,0,0,1,2,0,1,2,1,0,0,7,1,1,1,1,2,0,0,2,0,0,0,1,3,2,3,20,1,5,0,0,0,5,0,7,4,1,0,2,1,3,8,17,2,2,4,5,2,6,2,2,1,5,5,0,2,0,0,7,3,6,6,0,4,2,0,3,4,2,1,5,0,5,0,0,4,7,5,0,2,3,11,0,0,0,0,9,1,11,3,6,2,3,1,0,1,1,2,5,1,1,4,0,0,0,0,0,0,9,4,2,0,3,5,5,6,1,3,6,0,1,1,7,1,7,3,0,0,3,0,5,1,1,0,3,15,3,0,2,1,3,1,1,4,4,18,4,0,1,25,0,3,5,1,7,0,1,0,0,4,0,3,0,3,0,1,3,0,1,9,0,8,5,2,8,8,2,0,0,1,3,0,0,3,4,6,3,4,3,0,4,0,13,2,4,0,0,0,0,1,0,0,1,1,5,1,5,0,6,0,10,2,3,6,1,0,2,0,1,16,0,0,1,1,0,4,0,8,1,0,0,1,2,1,0,4,0,4,6,1,1,3,2,8,0,0,0,1,0,1,1,2,0,6,5,4,3,1,1,0,1,1,2,1,0,3,2,0,2,0,2,0,1,0,0,6,5,3,0,11,5,0,1,2,4,1,3,0,3,2,0,1,6,0,1,4,3,0,2,2,2,2,3,1,3,0,1,4,1,2,5,41,0,0,3,2,5,0,1,2,2,0,0,1,0,4,0,1,4,1,0,1,0,0,0,2,0,1,3,0,1,9,1,0,0,0,2,1,0,3,5,0,2,8,5,0,4,0,0,4,2,2,0,1,1,0,3,2,1,18,2,5,6,0,1,0,2,1,0,5,0,9,6,5,1,0,1,1,2,0,0,1,0,0,1,7,3,1,0,1,4,0,7,3,0,0,0,5,2,2,7,0,4,2,2,0,2,2,0,1,2,1,2,2,0,0,1,0,11,3,13,1,5,0,2,1,3,2,12,6,9,0,2,1,1,0,0,1,1,2,0,0,6,1,1,0,0,1,6,2,12,1,0,0,1,0,4,2,0,1,2,1,1,0,1,6,17,0,1,3,4,1,1,0,0,8,2,1,1,0,3,0,0,2,0,2,4,5,1,0,1,0,1,0,0,0,1,1,0,0,0,0,0,1,4,0,2,1,8,0,1,2,4,0,0,3,0,4,5,0,1,2,0,9,0,9,0,3,4,2,1,0,4,1,1,14,4,4,12,4,0,7,3,5,1,0,0,7,1,1,0,0,2,0,0,1,0,2,4,8,1,0,7,0,3,0,0,1,6,11,0,0,17,3,1,0,1,0,4,2,0,2,0,0,3,0,9,6,1,0,1,2,4,0,1,0,0,0,2,4,0,0,4,3,3,0,2,0,1,0,0,5,1,4,4,1,1,2,0,0,1,0,3,1,1,0,4,0,3,2,2,3,16,0,3,3,5,3,1,3,1,0,2,2,0,0,0,0,1,1,0,3,2,5,2,0,6,1,0,0,2,2,0,2,0,3,3,1,3,11,0,3,0,1,3,1,0,3,0,1,2,0,4,0,4,0,1,4,0,1,3,0,1,1,1,1,0,0,0,5,1,5,1,2,0,2,0,4,1,0,0,0,0,1,4,3,0,2,3,1,2,7,0,0,2,1,5,1,6,4,3,3,1,0,1,4,6,0,0,1,1,0,0,0,2,0,1,41,2,8,4,0,0,0,3,2,3,5,1,0,0,1,0,0,0,2,2,0,1,1,0,0,1,1,0,0,3,0,2,1,0,5,5,2,0,0,5,1,2,0,4,1,3,0,0,0,0,6,1,0,2,0,2,0,0,0,4,3,0,2,0,0,11,0,0,2,0,4,2,1,0,0,0,0,0,2,0,6,0,2,0,2,3,0,0,4,1,0,4,3,1,10,0,0,2,4,3,1,2,0,0,3,0,1,0,1,3,3,0,0,0,1,0,1,1,1,4,5,0,1,1,2,0,3,2,3,5,2,3,2,5,0,0,0,0,5,1,7,5,0,0,0,4,1,0,6,0,0,3,1,0,0,5,3,0,1,0,0,0,0,1,2,0,2,1,0,0,1,2,4,0,2,0,2,0,0,12,1,0,0,0,7,11,0,1,0,1,0,6,0,1,1,0,0,0,1,1,5,1,0,0,2,2,0,5,0,0,0,0,0,1,1,0,1,4,2,1,1,3,2,0,0,6,1,4,1,0,0,6,2,3,3,0,19,9,8,0,2,0,0,9,0,8,0,0,0,5,0,0,0,0,0,0,7,1,0,0,1,2,2,1,3,3,5,0,0,3,0,0,3,0,0,0,0,0,0,2,0,0,0,2,0,6,0,7,0,3,0,1,0,0,1,0,0,0,1,0,0,0,0,0,0,0,0,0,0,11,0,0,0,1,2,0,0,0,0,0,0,0,0,0,0,0,0,0,0,0,0,0,0,42,0
K16 Pet Sematary,king,7412,4542,3218,3245,2979,1165,3513,2081,2671,2356,1270,2042,1847,1014,1083,1197,1795,938,831,982,925,995,701,839,237,678,304,550,599,314,461,739,464,542,521,455,428,595,203,516,518,511,644,419,344,415,497,356,558,524,541,335,432,435,300,309,499,230,302,387,386,273,217,343,248,301,204,410,166,296,243,154,175,184,281,212,193,166,227,240,210,205,155,266,257,239,192,142,216,173,102,268,242,187,204,163,229,144,167,183,167,238,255,149,314,205,156,316,181,244,249,248,51,148,160,123,161,172,141,117,131,110,195,213,124,124,138,114,109,102,196,205,127,109,157,129,42,152,102,89,145,88,38,87,162,195,89,140,108,131,154,132,141,87,68,64,71,135,103,184,64,181,96,117,79,187,120,87,106,116,37,89,137,86,74,70,62,108,148,89,57,86,113,90,114,102,71,77,114,51,55,54,104,69,84,116,60,44,24,25,52,175,95,89,45,24,66,62,48,112,58,120,25,41,75,44,92,94,88,77,51,76,66,89,63,99,58,64,52,148,134,85,90,116,77,15,54,67,54,34,59,43,44,50,103,73,67,126,39,164,58,29,63,64,88,47,44,41,80,54,76,52,109,64,54,46,47,49,65,59,97,49,70,94,45,41,63,39,158,62,33,26,47,83,185,58,56,128,34,32,65,45,33,34,56,56,58,36,48,48,90,50,59,49,159,41,11,34,56,47,44,14,30,42,68,64,52,37,40,27,61,61,37,53,25,37,97,42,27,59,63,49,43,47,109,54,46,41,34,47,45,32,19,25,27,76,54,15,43,44,58,27,65,58,104,41,18,40,30,50,48,55,37,7,24,43,28,44,19,51,42,22,62,60,41,87,81,59,62,28,26,39,30,22,36,12,0,36,31,42,53,37,27,33,30,31,60,67,44,50,46,40,44,34,46,22,35,43,31,87,44,23,55,21,46,108,29,68,27,32,44,0,7,13,22,31,25,29,25,19,56,22,29,75,4,35,38,30,23,57,31,23,18,40,37,17,88,24,14,33,42,37,9,39,35,24,33,22,32,35,62,15,0,9,7,19,30,14,6,16,11,46,47,28,31,29,81,9,0,48,25,18,35,5,26,36,32,33,64,21,77,20,45,27,22,23,39,28,20,44,29,37,4,26,29,18,11,30,25,19,23,37,34,37,24,25,0,21,39,30,27,71,23,18,24,27,27,26,46,48,3,17,23,18,16,0,41,39,27,22,62,9,44,26,18,22,0,2,20,23,70,26,33,3,39,26,31,17,18,8,66,24,28,30,31,24,26,47,31,26,81,39,25,34,23,10,27,18,12,13,26,38,29,41,4,37,18,52,17,20,19,37,15,17,26,12,3,28,17,20,31,87,29,28,11,1,0,22,7,13,18,41,21,20,242,19,13,7,14,23,15,27,14,21,31,25,17,23,19,3,12,18,14,16,19,0,39,21,47,19,22,5,33,18,5,24,26,20,45,26,0,15,21,21,22,42,17,13,33,12,14,14,25,13,9,41,25,19,19,23,48,10,14,9,20,28,9,15,31,13,24,22,15,12,64,9,2,23,20,16,26,11,14,23,17,23,10,0,7,13,20,11,27,23,28,28,50,26,12,27,4,19,13,18,13,42,2,36,35,13,15,34,13,5,17,26,17,26,15,12,14,9,9,18,0,39,30,17,26,20,30,38,3,30,1,2,14,19,16,31,10,35,14,15,5,11,21,17,17,8,14,12,10,25,14,41,11,3,34,21,12,4,28,40,3,10,11,27,4,10,20,8,8,32,26,21,15,14,22,3,15,5,1,23,15,7,0,19,4,18,29,16,9,20,26,9,62,8,10,74,20,43,30,3,21,16,3,1,18,24,9,3,10,23,16,15,10,16,14,26,6,9,60,50,3,24,20,14,0,10,31,8,12,10,22,4,8,0,30,9,18,18,1,4,16,2,3,9,6,21,11,4,30,14,7,12,4,0,10,45,26,23,26,14,0,24,14,28,11,22,31,23,28,9,8,17,14,11,9,14,16,15,6,7,13,38,14,0,21,57,4,3,21,12,23,12,46,10,26,3,14,0,33,0,9,11,8,8,17,10,12,0,6,12,13,14,4,0,52,17,17,13,9,0,2,10,13,13,23,48,11,19,14,9,8,16,6,23,13,16,7,10,9,19,1,22,35,13,22,6,0,23,18,0,16,12,12,14,5,8,7,0,12,11,7,19,6,19,6,2,1,30,16,4,13,20,17,0,7,13,7,22,14,24,9,5,0,7,24,0,6,1,6,4,32,21,0,0,1,46,5,5,3,11,24,11,9,0,6,16,9,16,7,0,8,7,12,6,10,11,13,5,10,10,11,14,14,13,12,31,28,3,3,17,27,9,11,28,8,13,8,17,9,2,12,0,16,18,9,23,7,27,0,3,12,2,17,6,0,0,0,0,27,8,7,8,1,0,2,9,11,1,10,5,1,4,3,9,2,2,1,0,15,16,6,14,15,10,44,38,5,17,9,6,3,18,4,18,4,14,19,11,10,8,0,2,8,0,18,8,17,20,28,12,9,3,13,13,6,6,12,9,16,2,7,47,33,7,9,6,29,0,7,22,3,3,9,3,9,9,5,0,23,8,7,5,3,15,1,11,4,11,0,19,0,3,27,14,1,0,0,15,18,9,9,25,4,1,5,0,10,7,11,8,25,11,0,2,15,0,15,24,0,7,2,8,6,9,2,12,26,0,11,12,23,12,5,6,24,19,0,6,26,3,4,0,0,5,10,12,9,7,5,4,21,15,3,20,10,11,4,8,1,8,5,1,2,4,3,12,11,6,16,0,1,5,0,4,9,10,1,15,13,17,0,60,9,17,11,8,15,0,10,9,0,6,12,0,10,17,0,7,4,2,0,9,15,14,0,27,9,26,7,8,14,19,8,0,8,5,0,4,7,1,6,12,8,20,2,20,8,8,5,10,16,14,3,16,5,4,3,2,3,14,13,8,18,42,6,15,19,7,0,26,11,16,6,12,13,3,2,8,13,12,3,10,8,2,3,13,13,13,17,0,9,29,4,27,2,12,8,25,3,13,24,1,11,11,2,0,6,13,7,1,9,17,6,2,15,9,3,11,28,7,0,1,0,26,0,5,2,0,5,26,3,6,7,8,10,7,21,46,16,5,23,14,6,1,5,4,0,0,0,5,19,33,2,0,4,8,2,22,17,17,2,10,13,2,9,21,10,24,6,8,8,5,3,0,7,4,9,10,0,0,1,9,5,1,11,6,10,6,20,7,0,6,7,21,16,7,7,10,0,13,9,0,10,9,20,8,6,9,8,0,7,7,6,0,9,2,9,1,10,6,0,0,2,8,8,8,12,6,1,7,38,3,3,34,7,11,5,12,1,6,9,13,1,0,4,6,22,0,0,0,0,8,0,7,2,12,6,1,0,7,33,9,5,0,4,1,0,11,30,12,18,11,5,6,1,12,2,10,6,8,5,1,5,12,13,5,3,5,4,4,7,8,7,0,4,3,13,4,21,1,151,6,8,7,15,6,21,1,5,3,5,4,1,10,9,7,11,31,9,0,9,7,8,1,26,8,4,10,5,5,3,6,7,9,0,7,0,14,32,25,4,7,8,0,8,2,0,0,0,16,3,4,5,3,14,2,8,10,3,12,10,1,0,7,0,8,2,8,20,0,3,7,3,23,4,1,5,0,3,3,19,32,18,5,3,17,12,3,6,7,2,0,2,11,11,0,3,5,18,3,2,5,5,11,1,15,9,19,3,1,21,0,14,0,2,17,4,19,7,2,2,15,2,2,0,11,5,5,13,0,9,0,2,6,5,13,2,0,15,1,0,0,20,1,38,3,15,4,6,0,2,1,14,2,4,12,6,3,19,2,7,5,3,10,0,8,10,0,5,6,6,1,13,12,23,16,4,12,21,0,1,4,21,6,40,7,7,6,23,6,0,35,3,4,14,6,5,5,4,8,1,9,3,6,2,24,9,3,3,2,3,5,8,20,3,0,4,2,0,3,21,0,9,6,10,0,7,5,2,4,2,10,5,6,0,3,4,46,7,8,4,1,3,7,13,14,7,2,2,7,4,1,4,3,3,0,22,12,12,4,2,9,1,0,11,8,4,7,0,0,9,2,0,0,0,0,0,29,2,2,0,3,6,4,1,7,0,1,13,8,2,11,16,5,2,4,7,10,8,7,4,0,11,4,1,1,12,0,6,1,68,0,1,7,2,16,0,8,5,11,11,6,2,7,12,19,0,2,7,3,0,4,4,4,4,31,10,6,0,10,3,1,6,0,13,12,0,21,2,7,0,4,3,2,5,5,0,4,4,2,5,0,5,2,3,5,8,1,0,4,13,13,1,0,7,3,0,2,0,5,2,0,4,6,0,3,5,3,0,15,0,12,2,61,3,4,3,5,2,2,1,7,0,10,2,7,5,7,83,15,16,4,3,3,2,9,1,3,1,0,3,1,6,12,16,7,1,11,7,9,10,4,10,4,4,0,0,4,2,4,2,3,3,0,3,2,12,0,4,7,7,4,3,5,1,0,3,4,0,14,8,11,10,2,2,2,13,1,1,1,4,0,7,5,6,0,8,0,5,5,11,8,7,0,5,1,18,7,0,0,4,4,6,1,5,13,6,7,7,5,3,16,8,10,2,4,12,2,1,9,6,6,2,4,5,0,0,3,1,2,0,0,8,3,3,3,5,1,2,4,6,11,0,0,0,10,3,2,13,10,1,19,10,1,7,7,0,0,8,2,1,5,0,1,5,2,4,2,3,7,4,12,3,7,0,0,9,0,6,4,0,0,2,2,2,12,3,5,7,5,0,2,3,15,3,3,2,2,10,0,14,3,2,3,0,1,11,7,0,0,6,0,9,0,21,4,0,6,0,1,7,6,4,2,0,6,5,3,3,3,10,0,0,6,0,1,14,1,1,0,1,1,3,6,4,3,1,8,7,6,11,5,8,7,5,4,0,4,27,13,3,0,0,0,4,3,1,9,2,10,5,0,0,4,1,6,10,3,0,0,1,4,3,12,4,3,6,5,2,4,3,3,4,0,16,0,0,3,10,1,13,10,1,1,2,2,1,6,3,5,4,3,3,4,4,0,1,1,1,1,6,3,1,7,3,1,4,0,1,1,0,0,14,5,8,5,1,5,2,3,4,3,5,5,0,7,7,11,7,5,0,3,4,2,37,12,5,0,2,7,8,10,6,4,5,1,8,5,2,3,5,14,0,0,9,4,0,1,0,2,7,8,1,2,5,1,4,5,2,5,6,34,1,2,6,6,16,4,7,0,2,1,1,5,6,0,22,2,3,5,1,1,0,6,0,0,12,1,1,1,9,2,6,12,5,1,1,1,4,1,4,0,10,10,0,12,1,2,0,3,1,0,0,3,1,14,10,2,0,5,2,9,0,2,0,5,0,11,1,0,0,9,2,35,3,2,3,6,4,3,6,1,0,0,0,0,1,2,1,6,2,0,1,8,7,0,0,3,8,0,8,2,10,4,2,3,0,7,1,6,4,0,15,2,9,2,3,3,2,5,0,8,10,0,2,3,5,4,4,0,0,1,1,7,2,2,0,7,4,2,4,7,0,2,1,5,3,3,3,2,0,4,4,0,2,4,5,0,1,2,1,0,3,2,4,7,0,1,0,3,1,2,0,0,1,1,3,2,0,2,0,3,1,26,7,2,1,1,7,1,0,0,0,1,4,3,5,0,2,1,5,3,6,1,13,0,2,0,3,3,4,8,2,2,1,0,1,0,0,4,2,3,1,4,0,3,1,1,3,4,3,9,3,0,4,0,7,0,0,4,0,0,5,2,2,6,0,8,0,3,5,2,2,1,0,1,13,5,0,2,4,7,0,6,5,2,4,5,7,0,2,4,7,2,5,3,5,1,16,0,11,2,6,0,5,3,0,3,5,3,1,5,4,2,1,9,0,5,0,0,1,4,0,2,0,0,0,1,22,12,0,3,9,6,3,0,0,7,9,5,4,2,0,0,5,0,1,9,1,3,1,0,8,1,10,5,2,4,1,0,2,0,7,15,2,0,2,3,4,1,0,3,0,3,3,1,2,0,3,4,7,0,2,14,5,0,5,3,1,17,4,1,15,0,1,8,0,0,5,1,2,9,0,3,3,2,1,3,4,20,0,0,5,4,1,6,18,1,9,3,4,0,6,13,1,3,4,0,0,1,1,0,3,3,3,9,0,0,3,3,4,2,1,0,2,5,2,10,0,1,0,1,6,2,3,7,0,0,0,23,3,0,7,4,1,1,2,2,4,2,5,1,5,2,7,1,2,2,10,0,3,2,1,7,1,3,2,5,3,0,0,0,4,4,1,3,0,16,3,4,5,2,6,0,5,1,7,1,4,2,9,2,1,3,0,5,3,0,0,0,8,2,4,1,0,0,2,1,3,2,1,8,3,1,8,33,0,0,4,0,8,4,5,4,4,7,3,10,4,3,0,0,0,2,2,8,0,1,1,0,3,1,1,0,4,3,1,13,1,1,2,8,4,4,5,0,3,1,0,0,1,2,2,8,1,2,3,0,4,0,0,1,0,0,2,1,0,6,0,6,2,2,0,8,1,0,0,0,6,7,0,3,1,7,1,1,0,6,1,4,0,2,1,3,4,4,0,8,0,1,4,1,1,0,1,0,2,0,0,2,1,0,1,7,0,0,1,1,1,0,7,4,1,1,1,0,0,0,3,1,8,11,6,6,0,5,0,0,4,0,2,1,3,3,1,10,1,0,3,2,5,7,4,6,0,2,0,0,0,3,1,2,8,0,0,7,6,1,1,3,6,2,0,2,0,0,3,2,4,3,3,6,1,2,4,5,0,6,0,0,6,3,2,1,2,0,0,3,1,8,3,4,0,1,1,6,7,2,8,0,2,3,0,4,3,1,0,0,0,2,2,13,5,13,3,2,3,0,1,22,0,0,0,4,15,10,7,0,0,1,1,4,1,2,2,0,0,11,6,16,3,2,0,1,1,9,13,3,7,3,4,0,0,1,2,0,1,3,0,8,0,1,1,2,0,1,0,6,1,2,4,0,23,4,0,5,0,0,0,1,5,2,0,5,0,1,2,7,2,1,1,0,0,6,2,3,0,4,0,0,5,8,0,4,0,1,0,5,2,3,1,0,11,1,4,8,1,2,0,2,3,6,3,1,8,7,0,0,8,5,3,16,2,0,5,14,8,0,0,0,8,0,1,4,2,2,3,0,1,1,3,6,1,3,1,15,3,7,7,0,4,9,6,0,3,3,5,12,13,0,2,3,3,2,1,3,0,0,2,0,4,0,1,3,2,0,1,0,7,25,3,0,0,1,4,2,0,4,0,0,0,5,4,5,0,0,2,6,6,4,6,0,1,0,2,1,1,3,5,1,4,3,0,3,9,4,4,6,1,1,0,0,5,5,1,1,0,1,0,7,2,1,0,0,1,0,6,0,3,6,0,2,1,0,0,11,0,5,2,4,8,4,9,2,10,0,6,5,1,0,6,2,0,7,8,2,3,1,6,0,0,5,2,1,5,1,2,0,2,0,2,4,0,0,3,8,0,1,2,3,4,0,0,3,2,0,0,0,3,2,1,0,2,2,2,0,3,3,0,0,5,1,1,3,0,1,1,1,0,1,1,2,12,2,3,3,6,3,0,1,1,2,1,6,4,9,0,0,7,2,0,2,0,1,0,0,1,1,6,1,7,3,2,4,4,2,2,0,5,0,0,0,0,2,2,0,7,6,0,4,1,5,5,1,0,2,1,3,2,3,0,0,5,2,6,2,0,0,4,1,1,0,3,0,4,1,5,0,6,1,11,4,1,1,2,3,0,0,5,5,2,6,0,0,3,5,5,3,0,6,2,0,4,0,7,4,1,3,7,0,10,1,0,4,0,0,3,2,0,2,0,2,3,0,3,1,1,0,1,0,3,1,1,1,3,5,2,2,1,1,1,2,2,1,0,5,7,0,1,0,2,0,0,1,1,0,0,2,0,3,7,1,1,0,4,0,3,0,2,3,7,0,4,5,8,1,4,3,6,2,2,6,2,1,0,1,1,4,1,1,4,0,7,0,2,3,8,6,3,0,0,1,0,0,5,0,7,2,2,4,10,1,1,5,3,1,2,5,2,0,1,10,0,0,9,7,1,2,0,1609,5,6,2,0,0,0,4,2,4,2,0,1,4,2,3,2,0,3,1,4,5,1,6,8,6,2,0,1,1,2,0,9,1,0,6,1,1,3,1,0,0,3,0,1,2,3,17,5,3,3,1,0,0,0,0,11,3,5,1,2,2,0,2,1,0,0,19,1,5,0,9,2,20,2,1,4,1,4,0,0,0,0,2,1,4,0,1,1,2,3,6,8,4,0,0,0,0,0,0,0,3,8,3,0,0,4,2,2,0,2,5,0,2,0,5,0,1,0,0,1,0,3,5,0,0,3,7,0,3,0,5,0,0,1,2,7,0,4,5,0,0,2,3,1,0,0,3,5,6,1,0,5,3,0,1,1,4,12,0,0,2,0,0,0,2,2,2,0,0,0,6,0,0,0,0,0,3,0,5,0,3,0,1,7,0,5,1,1,4,0,0,1,1,0,0,2,0,3,0,0,0,1,0,2,0,0,5,1,3,0,0,1,0,0,10,2,4,0,3,1,0,0,1,1,2,1,2,1,3,0,7,8,8,3,5,3,1,1,0,2,0,0,2,4,2,2,1,0,6,6,0,1,1,0,0,0,1,3,4,4,1,0,0,4,1,2,0,2,0,1,2,0,2,6,0,4,1,3,0,3,0,0,0,0,10,3,1,0,2,3,0,3,5,2,0,0,0,3,0,4,1,0,1,0,1,2,0,1,8,0,0,0,1,0,0,0,1,3,1,3,1,1,2,0,0,0,3,0,0,2,1,0,2,0,3,1,0,0,4,6,3,4,0,2,4,0,3,3,0,1,0,1,4,0,2,1,5,3,5,0,0,4,0,1,3,0,4,2,0,1,10,1,0,4,2,3,2,0,0,0,4,2,6,5,2,2,4,2,3,0,7,0,1,0,0,4,2,0,5,0,0,1,5,4,1,0,2,2,6,3,1,4,0,0,0,1,1,1,3,15,1,0,1,0,2,3,1,0,4,3,2,0,3,2,4,0,3,7,5,6,6,0,1,8,0,8,1,0,1,0,1,0,1,2,2,3,0,2,0,1,2,3,5,0,2,2,1,0,5,8,2,2,2,5,3,0,1,0,2,6,1,2,4,0,1,0,3,1,5,0,2,0,2,3,0,1,0,0,2,7,2,0,1,2,3,0,6,3,4,1,3,0,0,0,0,0,0,0,0,5,0,0,0,0,0,4,2,7,0,3,1,1,9,1,2,0,2,5,1,1,0,1,0,0,1,2,0,3,2,82,2,4,1,0,0,1,4,3,0,2,0,0,2,0,2,0,1,0,1,0,2,0,0,6,2,0,0,0,5,0,1,0,8,0,0,0,0,0,3,1,0,0,0,0,1,1,2,9,5,0,2,11,0,0,0,7,0,0,1,0,3,0,4,0,0,1,0,4,0,2,1,0,3,0,1,0,2,0,0,3,0,1,0,0,3,3,1,0,0,1,1,2,0,5,11,1,0,0,2,1,2,0,0,15,8,3,2,4,0,1,4,2,1,8,0,3,0,0,3,0,0,1,0,1,0,6,0,3,2,0,7,1,0,0,0,2,0,3,1,1,1,0,1,2,1,0,4,5,0,0,0,2,1,7,0,0,3,0,0,0,1,0,2,1,1,0,6,0,0,4,0,0,2,16,3,5,0,3,0,3,0,2,6,5,4,0,3,0,1,1,0,3,1,0,0,3,7,17,4,3,1,0,2,2,2,0,0,0,0,0,0,1,0,1,2,3,4,0,0,0,4,2,0,0,4,2,7,0,1,2,2,1,2,0,0,1,0,6,2,2,0,1,0,0,6,2,4,3,5,0,4,2,2,0,0,0,1,0,4,3,0,1,8,1,0,1,1,0,0,2,2,1,2,1,1,1,0,6,1,4,0,5,2,1,2,0,1,0,1,5,1,2,2,1,0,2,4,0,0,2,0,5,2,0,2,0,0,2,2,1,0,0,2,0,0,2,1,0,3,1,0,0,3,5,0,1,6,1,0,1,2,1,1,1,0,1,0,0,0,2,7,3,1,0,3,0,1,0,0,0,0,0,0,3,2,0,1,0,1,2,0,0,2,0,0,3,0,3,1,1,2,1,0,0,4,0,4,0,0,1,1,4,3,2,1,0,2,0,7,2,2,1,0,3,6,0,11,1,3,6,0,1,2,0,1,5,0,1,4,0,1,5,0,2,2,1,0,1,0,1,1,3,3,12,0,0,0,0,1,1,0,4,0,2,0,0,2,0,0,1,1,0,0,0,1,3,2,2,1,1,0,1,0,3,1,1,0,0,0,0,1,1,2,0,0,0,0,7,0,0,0,2,1,0,5,3,0,2,2,0,48,0,0,2,1,2,2,0,0,1,1,2,2,1,0,0,0,0,1,0,1,1,3,15,1,0,0,3,0,2,0,3,1,0,0,1,0,0,0,13,1,1,1,0,11,2,0,3,0,2,2,0,6,3,1,2,2,2,0,4,10,3,2,0,3,4,1,1,3,0,0,6,1,2,1,2,4,0,0,0,0,0,1,1,4,2,6,1,0,1,0,1,1,0,0,1,1,0,0,1,0,0,0,4,0,0,2,0,0,4,1,0,1,3,0,6,1,0,4,3,2,0,0,3,1,2,0,0,2,3,0,0,0,0,2,3,0,0,2,0,0,2,2,1,0,2,1,2,1,0,7,0,1,1,3,0,4,1,2,0,0,1,1,0,0,0,0,0,1,0,1,2,0,0,0,0,0,1,0,0,1,0,0,0,2,2,0,2,2,0,2,1,1,0,0,1,1,0,0,0,1,0,0,1,0,4,2,1,1,0,1,0,6,0,5,0,0,0,0,1,1,3,0,2,0,5,0,0,0,0,0,0,1,0,3,0,0,0,1,2,2,1,0,1,0,1,3,1,3,2,1,0,6,0,6,1,0,10,2,0,0,0,0,0,6,1,1,2,1,0,6,0,0,0,3,0,0,0,3,0,0,0,0,0,0,0,1,1,0,2,1,0,0,1,0,0,0,0,0,0,0,0,1,0,0,0,0,0,1,0,1,0,0,0,0,0,0,0,0,0,0,0,0,0,0,2,0,0,1,0,0,0,0,0,0,2,0,0,0,1,0,0,0,0,0,0,0,0,0,0,0,0,0,0,404,0
K17 The Eyes of the Dragon,king,5500,3053,2331,2339,2415,797,2670,1604,1842,1499,888,2003,1330,291,273,589,1489,654,679,444,727,879,689,668,284,707,210,390,341,286,385,271,269,604,479,502,408,485,107,422,477,243,364,326,177,351,302,315,645,305,218,284,292,249,182,269,439,153,248,151,187,98,254,317,204,218,177,200,165,319,74,48,98,152,45,233,154,80,136,119,79,58,128,120,158,187,123,84,216,100,86,146,215,78,154,147,93,101,140,194,166,173,45,191,220,214,133,184,52,111,172,152,35,146,132,104,91,168,149,69,91,175,116,180,106,96,165,92,184,103,128,124,28,84,92,149,24,125,89,85,38,74,4,24,151,101,106,190,81,17,98,213,81,65,87,34,71,130,112,116,36,98,33,92,47,121,114,40,110,58,11,122,94,54,0,80,52,59,92,51,104,81,89,76,74,46,31,90,61,42,19,61,104,51,57,78,231,48,24,20,29,93,45,81,44,4,46,32,33,26,47,52,41,38,43,70,60,53,95,56,31,100,59,45,25,63,73,53,25,102,108,51,76,82,63,2,35,64,87,61,16,36,58,29,59,59,55,59,25,42,63,45,18,16,63,36,28,43,36,25,62,10,35,46,69,45,35,127,61,80,51,17,88,42,22,35,61,27,69,66,28,16,40,35,122,1,29,61,41,31,41,17,0,67,38,36,37,17,8,27,67,27,0,29,90,9,18,17,21,88,56,14,46,51,110,56,24,23,40,8,128,29,27,180,5,48,18,27,33,31,12,62,30,23,8,13,39,10,21,39,13,45,37,0,9,18,16,0,31,19,45,25,36,41,49,24,20,35,26,45,44,24,21,12,17,27,54,26,5,31,28,10,32,6,28,51,34,23,73,12,47,12,51,13,30,0,0,25,21,32,52,11,21,0,25,39,24,53,44,8,0,56,43,12,43,9,21,13,14,99,42,24,69,0,42,99,27,40,28,36,47,0,1,22,16,20,33,54,27,0,20,26,29,29,0,70,20,26,0,40,18,12,19,51,16,13,35,30,23,22,36,18,27,39,14,31,13,11,36,17,33,32,0,13,19,11,16,26,8,35,16,28,17,3,12,39,16,5,0,15,13,25,13,0,15,34,28,24,13,15,57,23,35,18,41,16,17,11,4,48,22,39,28,21,31,6,5,37,23,0,24,19,8,21,35,29,0,28,26,9,30,35,13,5,15,17,48,10,24,27,1,21,23,15,23,0,15,37,41,28,49,15,20,15,3,27,0,50,13,0,10,28,26,3,16,10,17,17,45,4,3,16,18,3,25,8,13,1,11,23,65,9,12,23,26,2,28,4,11,12,32,41,16,12,0,18,24,15,9,3,23,18,16,13,9,7,6,11,14,18,16,52,19,10,12,0,0,30,5,10,5,6,34,17,8,11,43,12,10,18,6,3,35,9,28,7,38,22,13,10,3,15,6,16,8,0,18,19,22,19,18,6,7,12,0,0,22,13,22,16,0,9,27,5,18,37,12,2,19,0,1,16,25,8,1,16,22,14,19,15,12,6,13,12,13,21,3,21,13,3,3,8,11,6,10,5,18,26,14,18,22,8,6,5,13,18,7,3,36,8,16,0,24,18,7,34,2,10,10,19,7,34,1,21,24,4,1,10,17,5,0,1,5,3,38,18,8,4,18,13,11,13,6,48,0,4,7,6,17,13,27,1,0,12,0,0,1,14,8,7,27,3,16,11,2,11,4,5,18,0,13,13,31,0,5,0,7,20,18,18,13,6,0,13,0,7,20,23,6,8,4,1,6,4,37,25,24,6,1,7,5,5,0,9,17,10,0,18,0,16,10,6,14,17,17,4,69,19,4,10,24,33,33,0,15,9,1,0,6,9,8,5,5,16,21,3,6,5,17,12,11,0,5,5,0,6,13,11,0,6,6,4,4,35,20,24,5,0,7,4,26,20,0,7,4,0,3,0,3,10,3,11,10,10,17,32,14,0,3,14,23,18,19,11,0,5,1,11,7,18,34,12,7,25,4,13,16,3,8,31,12,5,8,1,9,25,25,0,6,27,6,2,26,7,21,0,18,9,23,0,18,0,17,0,11,29,14,13,7,21,10,0,5,6,13,6,9,0,13,16,0,0,9,0,5,5,18,21,1,21,6,0,0,7,6,9,14,37,11,0,12,11,12,0,0,6,0,4,5,19,0,3,12,0,1,7,19,1,23,5,4,0,22,50,10,19,7,17,16,0,391,9,9,12,0,2,8,0,9,1,6,31,5,13,17,6,0,7,4,0,11,0,1,0,0,12,0,1,0,8,7,12,40,62,1,9,13,0,2,5,0,14,0,0,15,0,22,2,0,13,1,9,31,3,8,5,14,15,9,28,7,5,11,19,12,25,6,6,0,2,21,7,51,0,10,0,11,13,8,17,8,15,0,1,8,5,5,1,0,0,0,0,11,8,0,9,1,0,12,21,0,6,8,6,3,2,0,9,5,26,7,0,10,12,29,6,8,9,18,3,10,16,3,4,11,14,4,11,10,7,20,19,5,7,0,1,2,3,21,16,8,15,7,5,8,3,28,7,0,681,2,1,17,82,10,23,8,4,2,2,43,0,1,16,4,5,36,8,8,4,1,0,17,14,11,8,23,8,1,12,78,9,3,1,0,26,0,14,1,0,0,6,23,6,8,16,5,0,5,0,12,15,5,3,6,2,0,2,10,0,9,11,0,8,2,1,7,5,4,8,2,0,5,8,14,2,3,6,21,8,0,7,11,5,2,0,0,9,12,10,5,0,0,0,11,2,2,8,5,9,38,4,5,10,4,0,2,9,12,7,3,1,11,0,1,2,0,0,4,3,1,9,0,5,0,1,4,4,0,3,11,0,1,16,0,2,6,0,21,6,0,1,0,4,0,16,28,11,0,10,0,19,8,3,15,11,1,0,4,2,0,4,6,5,6,8,1,28,0,0,5,9,11,23,4,10,1,8,9,0,1,0,4,24,4,7,23,41,15,2,16,12,0,0,2,11,6,11,6,2,1,2,2,7,0,9,0,1,2,4,6,17,0,373,9,0,2,0,1,0,16,4,2,2,19,9,10,9,4,0,0,6,2,0,7,2,6,2,11,8,17,14,9,0,1,0,0,4,0,0,8,0,2,15,12,6,2,4,1,10,3,8,3,2,0,0,30,0,2,1,0,0,0,5,0,18,1,0,2,4,5,11,12,11,0,3,5,0,5,7,14,1,4,1,4,4,0,9,5,5,7,3,0,0,1,13,12,2,6,7,4,5,0,4,0,14,2,1,9,2,3,7,0,11,10,0,5,0,6,11,3,11,4,0,15,2,4,0,1,4,13,1,6,13,0,0,22,0,2,1,3,8,1,13,0,6,7,0,3,12,1,10,0,7,6,1,0,33,7,3,17,0,0,0,0,1,0,6,3,0,14,4,5,0,20,1,0,0,0,0,1,8,4,0,13,41,0,6,0,9,0,13,0,0,7,0,2,3,14,8,10,18,9,8,6,7,12,0,13,8,7,2,8,0,3,4,18,4,5,13,1,6,11,0,0,0,0,4,4,3,8,15,18,0,2,2,22,5,30,13,7,15,6,15,4,2,5,1,1,9,0,4,21,0,2,2,10,0,10,0,0,0,0,10,5,4,5,9,16,6,4,14,0,0,4,8,0,2,0,1,1,10,10,0,5,9,2,2,22,2,6,0,3,0,18,2,2,11,0,5,6,3,9,5,0,0,0,7,4,0,0,0,3,45,2,2,1,6,0,12,2,11,9,2,4,10,3,0,5,2,0,20,1,9,5,5,0,6,0,1,0,1,5,6,8,1,5,3,2,2,1,0,5,4,0,17,6,0,12,3,15,1,4,2,0,26,6,2,1,0,1,5,0,0,4,4,1,1,0,11,4,6,6,6,11,0,6,1,2,9,3,1,14,0,3,4,2,3,12,0,3,5,16,8,0,0,1,1,13,6,0,3,18,7,0,6,0,6,3,4,5,0,1,0,1,5,10,8,3,0,5,2,0,2,8,0,2,2,0,2,2,6,2,1,1,3,5,3,9,4,1,4,0,15,0,0,0,4,7,3,2,0,0,1,4,2,1,5,266,1,7,4,13,1,4,9,9,0,5,7,9,5,0,0,0,0,0,2,0,0,0,23,18,1,16,2,4,2,0,13,0,2,0,4,3,4,23,14,1,1,8,5,4,3,3,1,19,5,13,1,5,6,1,0,1,1,0,3,21,13,1,4,0,8,8,6,4,0,7,0,0,5,3,0,36,4,4,0,2,0,3,3,0,0,1,0,4,0,0,8,0,11,4,2,0,4,4,2,3,0,0,9,7,0,9,1,5,2,10,17,11,0,0,0,24,9,11,0,2,4,0,7,0,2,0,0,12,2,0,5,0,1,0,6,1,10,0,2,0,0,1,5,0,10,0,1,0,5,37,2,0,2,4,2,3,2,3,2,3,8,1,2,0,0,4,4,4,7,2,6,0,8,12,2,0,0,0,3,4,0,6,0,3,22,0,0,1,0,1,0,0,0,1,3,0,8,1,1,1,0,0,4,0,5,0,17,5,3,2,2,1,1,4,8,3,0,0,2,2,0,0,1,0,2,1,4,15,1,4,0,9,2,0,0,9,0,3,0,9,6,2,4,5,0,9,12,7,10,2,5,4,5,9,4,6,0,10,4,3,6,0,4,0,4,0,0,2,1,0,1,1,0,0,6,10,14,0,0,0,2,1,3,0,3,2,4,0,0,8,10,2,1,6,4,2,2,0,0,0,0,7,6,0,6,1,2,0,1,0,0,1,0,3,1,0,0,0,2,8,2,7,4,3,3,0,8,4,18,1,0,0,1,6,0,10,9,0,15,0,1,3,2,0,0,5,0,8,0,15,3,0,19,0,0,7,3,7,3,0,2,4,1,0,0,1,0,0,0,0,20,18,0,0,0,0,7,0,0,3,4,0,3,3,0,10,5,0,5,3,1,0,2,0,0,2,28,0,0,8,14,5,1,5,8,11,0,0,2,2,3,14,6,5,0,0,1,1,1,3,0,1,2,0,1,1,0,3,0,2,0,2,0,1,0,0,2,14,7,1,4,3,7,0,5,2,4,0,4,2,0,2,1,1,0,3,2,0,14,2,1,0,0,0,2,0,2,6,0,8,0,0,6,0,2,6,0,3,1,2,2,2,1,1,2,1,0,0,2,9,5,2,1,2,8,2,8,1,3,0,2,1,3,1,2,1,1,6,2,5,5,0,4,0,0,5,1,2,1,2,2,0,2,0,2,0,0,0,0,4,2,2,0,6,1,0,0,8,3,0,0,6,2,0,1,9,2,2,2,2,8,3,5,2,0,0,5,0,0,0,0,5,1,0,0,0,0,10,4,5,3,0,2,0,1,17,0,0,0,2,0,5,1,0,6,0,1,0,0,0,1,0,2,5,0,0,6,3,4,4,0,12,0,0,0,0,4,0,1,0,0,5,0,3,0,0,0,4,3,0,0,2,3,11,2,4,3,1,7,1,0,0,1,0,0,4,0,3,8,6,0,3,0,4,12,0,1,7,0,0,1,5,3,1,2,1,1,1,0,2,0,0,2,11,1,3,14,0,4,1,7,0,2,0,2,0,1,3,0,4,4,8,0,5,7,3,4,8,3,12,5,1,3,0,1,0,3,0,0,0,0,0,3,0,1,0,1,0,7,2,0,0,0,0,3,1,1,0,0,2,2,6,0,1,0,3,0,0,3,5,0,3,0,2,1,2,9,4,2,1,4,1,0,0,2,0,6,1,2,0,0,7,2,0,6,6,7,0,0,1,108,2,0,0,3,0,0,9,0,0,1,0,14,5,0,2,0,5,0,0,2,60,2,2,7,3,4,0,2,4,3,5,2,2,4,2,1,0,6,4,0,6,1,2,0,4,1,8,0,3,2,1,4,4,0,0,4,1,2,0,0,1,4,0,0,1,3,0,1,3,0,0,0,0,0,0,2,8,1,0,0,0,6,9,0,6,0,0,3,1,3,2,16,1,6,4,1,0,1,4,2,0,0,2,0,7,0,3,9,0,0,2,12,6,3,0,0,0,8,5,1,4,0,5,1,6,0,2,0,3,4,1,1,2,11,1,11,0,3,0,4,6,0,16,0,1,1,0,0,5,0,0,0,4,6,0,1,7,0,0,0,0,0,14,1,1,0,0,5,1,0,11,0,0,4,1,3,25,4,3,2,0,0,5,4,7,6,4,0,0,0,1,2,1,2,0,1,0,14,5,3,3,2,0,17,1,0,0,10,0,1,0,0,6,5,0,2,3,4,1,0,4,0,0,0,2,0,5,3,0,4,4,0,3,2,0,0,1,2,1,1,0,0,4,6,4,2,0,0,3,0,1,0,3,0,3,7,1,0,2,2,4,0,4,0,13,2,12,2,0,0,0,1,5,2,0,1,2,3,4,0,0,0,0,1,3,6,0,0,7,0,7,3,1,3,0,0,0,3,6,13,0,0,7,3,2,4,1,0,2,1,0,12,2,0,0,9,1,1,0,0,0,1,0,0,1,1,2,3,3,2,2,1,1,0,0,0,0,0,0,0,0,0,2,1,0,0,2,0,0,0,0,1,9,3,0,5,1,1,1,1,0,1,2,10,1,6,2,4,6,2,0,0,0,1,14,0,4,0,0,0,3,0,0,2,27,2,0,0,0,0,2,0,5,0,1,0,0,0,2,0,0,0,0,2,3,4,1,0,0,0,0,0,0,0,1,1,6,2,0,2,2,0,0,1,0,6,2,0,0,1,3,0,0,0,1,3,6,0,0,2,8,3,1,0,0,0,0,6,2,1,0,13,2,0,0,9,1,7,1,4,0,9,0,0,1,5,0,1,1,0,0,0,0,1,4,2,4,4,4,14,3,3,0,0,0,0,2,0,0,0,0,1,0,1,1,0,0,1,0,2,0,0,0,1,0,1,1,5,0,13,0,1,0,0,0,3,0,9,0,0,0,0,2,9,2,0,0,1,2,11,4,7,0,9,3,0,0,0,1,0,1,0,0,2,0,0,3,2,1,3,0,2,1,0,0,0,10,10,0,4,0,3,0,1,1,3,1,0,0,0,1,6,9,2,0,4,1,2,22,0,0,0,8,2,5,0,0,1,2,1,0,0,2,1,0,0,0,2,1,3,0,1,0,0,7,2,1,1,2,1,1,0,6,0,0,1,2,0,5,4,1,0,1,0,5,0,0,3,4,3,0,0,2,0,6,9,1,2,0,11,0,3,2,0,0,0,1,0,0,6,2,5,0,2,0,4,0,2,5,2,0,0,0,0,0,1,0,4,2,0,2,0,21,29,1,0,0,1,3,0,0,1,0,0,0,1,1,15,0,0,1,10,11,0,3,0,0,0,0,0,0,1,2,3,6,9,0,0,0,0,3,3,3,4,0,0,1,0,0,2,3,0,1,12,3,1,0,1,0,0,6,6,2,2,0,0,3,2,0,1,0,0,0,0,1,1,1,0,5,0,1,2,3,5,0,0,0,0,6,0,2,0,6,0,0,3,13,0,1,0,5,0,1,1,0,0,0,0,2,3,4,3,0,5,0,0,1,19,2,1,1,31,0,5,1,0,1,0,2,0,0,1,1,1,1,2,0,3,0,3,0,1,0,0,1,0,1,0,11,1,1,0,0,2,1,4,12,0,7,8,0,0,2,1,0,0,0,1,0,0,0,0,10,3,2,1,2,3,0,4,0,0,3,0,2,6,0,7,1,0,2,7,0,0,0,0,3,0,0,0,0,1,0,4,1,0,1,3,1,0,0,0,1,0,3,0,4,0,1,0,0,0,0,0,1,7,1,0,1,2,0,5,1,9,2,8,0,0,0,3,2,4,1,0,3,0,0,0,93,11,0,0,4,0,1,0,0,0,0,0,0,0,0,2,0,0,0,0,0,0,5,1,2,2,8,1,1,5,0,0,2,5,1,3,0,0,6,2,1,4,2,0,4,0,0,3,1,7,0,3,0,2,0,4,6,0,0,0,3,4,0,0,0,2,0,1,7,10,0,6,2,2,6,8,1,2,1,0,0,2,0,3,2,0,1,0,0,0,1,0,14,0,2,1,0,0,0,0,1,0,7,0,7,3,2,0,1,6,5,0,0,0,5,0,0,4,0,1,3,4,1,0,0,0,3,0,2,0,6,0,14,2,2,2,0,1,3,47,2,6,0,2,1,2,6,2,4,0,0,1,0,2,2,0,0,4,0,0,1,3,1,0,3,0,2,2,3,8,0,2,0,6,2,0,1,0,1,0,0,2,1,0,7,0,8,0,1,5,0,1,0,0,1,0,4,4,1,0,7,3,3,0,0,0,0,4,1,2,0,0,0,1,3,0,1,0,0,6,0,1,0,6,5,0,2,1,5,0,0,1,4,1,0,1,2,0,1,0,7,0,0,0,2,1,0,2,0,3,0,0,9,2,5,0,0,6,0,0,0,3,0,7,2,0,2,3,0,0,0,0,2,0,5,0,0,9,0,0,1,3,0,4,0,0,0,3,0,0,3,0,2,1,0,0,1,0,0,1,0,0,1,0,0,0,0,0,0,1,0,0,0,0,0,0,2,0,2,0,0,2,2,4,1,0,1,0,0,0,1,0,4,1,2,0,0,2,1,0,1,5,2,2,1,1,1,0,0,0,0,0,2,2,1,0,4,2,0,4,3,0,1,0,1,6,0,3,3,5,2,0,0,1,10,6,0,2,0,0,0,0,1,0,0,3,0,0,0,1,0,0,0,0,0,5,8,0,3,0,13,2,0,3,0,2,0,1,0,0,2,1,2,0,2,6,0,0,1,0,0,0,0,5,0,3,2,0,0,0,0,4,1,1,1,3,0,1,1,0,0,0,0,2,2,0,4,0,0,0,0,0,0,0,0,3,2,0,3,1,4,0,0,1,2,2,5,1,0,1,1,0,0,0,0,1,1,1,0,0,0,1,0,0,1,0,0,3,0,0,1,0,5,0,0,2,1,0,0,0,0,3,0,0,0,0,3,3,2,3,2,1,0,0,0,0,37,1,6,0,0,4,0,0,1,0,0,0,5,7,1,0,0,0,8,1,0,1,2,0,3,3,0,3,2,0,0,0,2,1,0,1,0,0,3,0,0,0,0,7,0,1,4,3,7,0,0,4,0,0,0,0,7,0,7,2,1,0,3,1,0,3,1,7,0,0,2,1,1,2,3,0,2,0,4,2,0,1,2,10,9,0,0,0,3,0,5,0,1,0,1,0,3,0,2,1,4,0,0,1,1,0,0,1,3,4,2,0,0,47,0,0,0,1,2,0,1,0,0,0,0,0,0,0,0,2,0,1,0,1,0,1,0,1,1,5,4,2,5,0,0,0,5,2,0,0,0,0,0,1,0,2,0,2,1,2,0,1,2,1,0,0,2,0,0,0,0,0,0,0,1,0,1,2,0,0,4,35,0,8,1,0,3,21,4,1,5,0,0,1,0,0,2,7,0,2,2,0,0,0,1,0,2,3,0,0,0,3,0,0,0,0,0,2,2,9,0,0,2,0,1,0,3,1,0,0,0,0,1,2,0,0,0,1,0,1,0,1,2,2,2,3,1,1,0,0,4,0,0,3,4,1,0,0,2,2,0,0,0,9,0,0,0,0,0,0,0,0,0,3,3,0,2,8,0,0,0,0,0,0,2,7,2,4,0,0,5,0,2,0,0,2,0,1,0,3,1,1,0,1,5,0,3,0,2,0,0,0,5,2,1,0,2,0,1,0,1,1,0,0,3,0,5,2,0,0,3,0,1,0,4,1,2,3,0,5,0,1,7,3,6,0,1,4,1,0,0,0,0,0,6,8,3,1,0,4,0,0,0,4,7,2,0,0,2,0,0,4,0,0,3,1,1,16,0,2,10,0,0,4,2,3,4,0,2,3,1,1,0,1,3,1,0,4,1,3,0,0,0,0,2,0,3,0,0,0,0,1,0,0,0,0,0,0,5,0,1,4,4,0,0,7,0,0,0,6,1,3,0,0,1,0,0,6,0,4,0,1,0,0,0,1,1,0,0,0,0,2,0,5,0,3,4,2,0,6,0,6,2,1,0,3,2,1,2,1,0,0,7,0,0,0,0,2,1,0,0,0,1,3,0,2,3,1,2,1,1,0,0,2,1,0,0,0,0,0,2,6,0,17,1,1,0,0,0,0,0,2,0,1,0,0,2,3,5,3,1,0,2,0,3,3,0,1,1,0,1,0,3,0,11,0,1,1,1,0,2,1,1,0,0,0,3,0,12,1,9,0,2,0,2,3,0,3,0,2,0,0,6,0,7,1,0,0,0,0,0,0,1,0,1,2,0,1,0,1,0,3,0,1,0,1,0,0,1,1,0,1,0,4,2,0,0,0,0,0,0,0,0,0,0,2,3,0,3,1,0,28,0,1,0,0,3,1,0,3,1,0,3,0,0,0,0,1,1,0,0,1,1,7,3,4,0,0,11,0,1,1,7,0,0,1,2,2,0,0,2,1,2,0,0,0,0,0,0,0,3,0,0,5,1,0,0,1,1,0,0,4,0,0,2,0,0,0,0,6,0,2,0,0,2,1,0,1,0,1,5,0,0,0,0,1,6,1,2,1,2,0,2,0,0,2,0,2,1,0,0,2,0,0,0,11,2,0,0,0,0,0,1,0,1,3,0,0,0,0,0,2,2,4,0,1,0,0,0,0,4,0,0,2,1,2,0,0,0,4,2,20,0,1,0,6,0,0,1,7,2,1,0,2,0,2,0,4,8,1,0,1,0,0,1,1,0,3,2,6,1,2,2,1,0,0,0,2,1,3,0,1,0,0,1,0,3,3,2,0,1,5,0,0,0,1,1,0,1,1,3,1,5,0,0,0,1,0,0,0,0,47,2,0,3,0,0,1,0,0,3,2,5,5,0,0,0,0,0,6,1,0,0,5,0,0,1,0,3,0,1,0,2,1,1,0,0,0,0,1,1,2,0,3,0,2,0,0,0,3,0,0,0,0,1,4,0,0,0,2,3,4,0,2,0,2,9,0,0,1,0,0,7,0,0,0,0,8,0,0,0,0,0,0,2,1,0,238,2,4,2,0,0,0,1,0,0,0,0,0,0,2,0,0,3,0,1,0,0,0,0,0,1,64,0,0,0,0,0,0,0,0,0,0,0,0,0,0,0,0,0,0,0,0,0,0,1,0,0,0,0,0,0,0,0,0,0,0,0,0,0,0,0,1,3,2,0,0,0,0,0,0,0,0,0,0,0,0,0,0,0,0,1,0,0,0
K18 Thinner,king,4766,2653,2167,2383,2078,1041,2231,1509,1471,1362,1313,1397,1117,533,534,799,1103,578,593,616,641,648,478,616,219,393,315,434,459,322,353,452,367,319,364,368,325,411,153,376,377,388,375,338,222,277,312,217,254,331,330,255,197,222,224,154,326,201,208,307,217,207,185,254,252,174,129,166,159,185,163,153,130,149,184,186,193,133,181,123,160,148,247,166,188,189,114,156,118,118,85,138,135,92,144,122,127,102,128,115,109,142,172,126,230,102,126,174,168,130,126,296,31,91,116,59,96,125,81,90,91,91,101,165,59,91,78,99,71,110,127,97,138,69,156,114,32,112,95,59,16,89,37,94,128,104,85,101,98,95,89,117,86,72,59,85,53,87,130,103,82,100,71,68,49,66,61,61,80,68,38,56,75,71,81,55,36,44,96,72,59,57,98,62,56,51,35,58,54,45,55,46,77,71,89,64,10,31,57,11,58,69,72,47,29,23,45,35,33,53,19,56,35,46,30,33,54,51,43,50,28,55,45,46,56,46,28,38,35,95,112,36,61,86,69,4,29,42,66,38,58,57,48,40,48,45,64,90,52,38,50,16,41,50,29,58,45,28,48,33,46,49,46,43,47,26,43,34,41,45,44,26,44,51,32,32,69,15,98,48,11,22,44,25,133,25,30,26,18,21,44,45,32,43,29,31,25,34,28,37,45,25,54,29,64,30,17,37,27,32,18,13,28,39,36,34,17,29,17,16,40,42,11,23,13,19,27,23,27,45,32,63,54,38,65,45,31,22,25,42,15,19,27,21,26,23,33,47,19,34,42,19,48,28,49,10,26,46,22,22,45,27,30,23,19,20,37,38,23,18,44,23,28,15,42,47,11,59,37,24,9,29,45,32,18,24,0,27,27,19,25,24,17,38,26,40,24,25,16,28,18,41,35,14,27,23,19,30,24,46,16,12,22,105,31,25,24,27,13,25,36,0,11,45,27,23,18,26,15,27,14,14,25,26,4,30,23,15,8,36,14,15,17,28,26,19,50,40,11,34,19,11,20,44,18,19,18,14,23,22,24,6,0,18,11,13,21,11,5,22,8,39,14,15,18,17,17,6,0,16,15,29,22,10,13,21,14,8,33,10,22,10,19,7,30,11,31,19,4,28,15,23,23,15,21,12,5,17,16,16,16,33,19,27,40,29,0,14,40,24,26,9,20,5,22,15,20,11,12,30,12,12,23,32,26,1,21,32,18,21,30,4,25,19,28,7,0,5,34,33,8,19,46,7,18,24,25,27,14,2,37,11,15,4,15,30,8,3,7,9,3,12,8,15,6,23,15,5,16,10,23,26,15,7,3,13,18,32,11,16,18,19,11,10,14,23,7,21,9,20,27,10,28,15,13,0,0,8,15,22,10,11,15,12,2,15,44,8,13,14,22,27,2,23,20,16,9,20,10,53,18,25,5,4,13,0,21,13,22,15,18,4,18,15,28,21,25,10,16,14,0,54,20,24,3,23,14,6,19,4,9,10,23,15,2,17,24,25,13,20,31,15,5,7,17,26,9,8,9,6,14,5,18,14,25,9,1,20,8,13,17,7,10,34,14,24,5,0,14,19,22,7,15,11,24,20,27,21,15,7,1,11,1,11,15,26,6,9,19,13,4,4,8,4,24,9,24,3,12,20,19,16,5,4,0,29,14,5,11,5,14,13,25,11,0,1,37,20,12,14,12,11,12,15,13,5,14,4,14,14,6,8,12,10,4,21,9,7,29,15,16,5,25,5,19,21,5,40,2,6,13,10,6,7,17,14,7,18,14,6,24,8,1,12,6,8,7,14,766,14,5,4,10,11,10,7,40,13,10,15,4,28,13,4,19,12,6,0,9,29,6,6,5,7,22,8,8,8,16,18,7,8,9,15,5,8,12,3,0,3,15,9,7,5,16,2,8,0,27,11,17,10,10,5,3,3,0,3,4,12,3,4,18,12,11,14,5,0,11,7,12,14,18,13,0,23,4,14,4,17,15,7,11,9,7,9,4,7,9,9,7,6,7,10,7,21,2,0,5,26,8,16,14,8,12,15,28,14,31,9,6,0,19,0,3,22,8,10,13,9,8,6,7,1,19,4,3,0,24,0,24,9,3,28,8,5,7,10,12,18,7,34,28,5,5,8,10,5,5,8,7,13,14,10,5,12,5,10,6,2,0,13,14,0,12,7,7,5,4,5,7,1,8,6,3,15,5,16,7,2,0,13,5,1,36,11,10,0,4,11,10,7,5,5,10,11,0,7,10,0,6,0,9,0,10,11,0,0,3,32,5,1,6,1,24,4,2,0,2,6,5,5,8,4,11,1,6,16,5,9,16,11,6,4,12,19,9,2,12,22,21,3,0,5,17,0,10,12,16,5,8,8,2,2,6,0,16,14,4,20,7,7,0,5,13,19,12,7,0,0,0,8,16,4,7,4,4,0,6,11,7,2,13,2,2,5,4,12,7,13,12,0,13,14,3,10,8,12,10,8,5,19,15,9,7,6,7,5,4,14,74,12,2,7,0,4,4,3,11,4,14,19,24,10,6,4,9,4,4,1,8,6,17,0,3,13,9,5,3,5,10,1,10,10,3,3,16,2,8,3,19,2,3,9,3,1,11,4,3,9,1,3,5,38,0,14,1,10,3,1,0,4,7,5,7,15,19,4,5,0,0,3,1,2,3,16,0,4,6,0,13,9,0,13,2,3,9,20,2,12,19,0,8,9,12,6,0,5,14,7,0,4,9,2,10,0,0,8,8,2,7,7,7,2,8,26,10,23,0,6,10,5,1,6,19,0,4,10,2,5,2,1,6,0,1,2,0,6,9,4,1,12,4,7,3,6,7,10,1,16,19,0,12,6,0,2,5,2,7,4,0,6,6,1,0,1,7,4,0,8,4,17,21,1,14,6,13,6,7,12,0,3,1,6,3,3,3,11,0,14,6,10,5,3,6,8,11,1,5,3,1,3,3,4,6,11,9,15,2,6,15,8,2,0,9,14,4,8,3,2,0,3,2,11,4,4,15,5,10,4,11,15,8,0,3,14,2,18,4,3,8,1,4,11,9,1,2,7,9,14,1,8,5,2,2,1,3,2,7,30,4,9,17,4,3,0,0,11,0,28,0,0,5,11,1,6,6,3,8,3,22,19,11,1,4,5,6,0,5,2,2,0,0,3,0,4,0,0,2,0,1,8,5,7,0,6,3,8,1,6,11,16,12,5,3,4,5,0,6,5,7,3,0,0,3,13,3,4,5,3,5,3,4,4,0,22,5,6,5,2,3,18,0,10,5,0,2,1,6,4,2,4,4,0,8,7,16,0,17,3,19,3,1,4,0,5,2,4,4,7,10,4,2,12,3,20,20,21,0,5,5,2,2,6,3,3,0,1,2,2,18,0,3,0,0,2,0,0,8,0,5,12,3,2,14,11,2,1,4,1,6,5,9,5,13,7,4,4,5,15,0,8,5,7,2,1,8,1,11,5,10,5,5,7,5,3,4,0,7,6,9,24,10,2,4,1,7,1,21,2,6,7,0,1,4,3,7,6,6,13,22,7,7,0,6,4,6,0,11,6,1,18,5,5,11,4,3,7,2,1,0,6,14,2,2,4,8,0,6,2,0,0,0,7,1,1,5,5,9,12,3,7,5,0,7,1,0,1,0,5,0,5,6,0,4,5,2,4,2,1,2,0,2,0,3,1,3,2,2,9,11,6,8,5,0,0,5,6,0,1,2,5,24,1,2,4,1,2,6,2,5,14,2,0,7,2,3,0,4,0,5,10,7,13,5,8,4,3,0,4,11,12,10,2,7,1,1,7,2,13,0,0,1,15,0,5,9,0,11,5,13,0,9,2,2,1,1,9,1,5,4,0,6,5,7,4,5,1,0,6,2,23,3,7,6,0,4,0,1,12,0,10,8,0,0,4,5,2,8,9,1,1,8,10,0,1,0,1,8,0,4,2,1,4,0,1,0,3,2,5,2,1,1,4,3,13,5,10,10,0,5,0,1,3,5,0,1,9,5,1,4,1,3,5,2,6,2,5,7,1,6,5,0,1,3,2,2,5,15,14,2,8,0,2,8,6,3,0,5,4,5,10,5,3,0,5,1,0,0,3,4,3,0,0,7,3,0,0,0,1,1,21,4,2,1,4,3,2,0,10,0,14,2,12,0,5,6,2,4,0,2,2,5,3,2,2,12,3,2,0,4,3,0,1,18,8,1,1,0,9,0,2,0,3,3,2,0,6,0,6,0,0,7,2,1,0,3,4,4,12,0,5,0,0,6,0,4,1,1,10,0,11,20,8,0,8,3,3,2,12,0,2,4,1,5,3,3,2,3,1,6,2,0,3,7,3,1,5,2,2,0,0,0,1,2,0,0,5,0,1,2,1,0,2,0,5,5,2,8,3,0,4,2,8,1,5,0,5,2,3,8,3,3,11,13,10,7,1,0,7,1,6,0,0,2,1,6,8,5,1,0,3,8,3,1,0,0,4,2,1,3,0,0,0,5,2,12,1,2,1,6,0,2,6,7,11,1,5,1,0,2,3,2,1,0,5,4,2,0,3,0,7,2,4,1,0,7,5,1,0,4,2,0,3,11,1,1,1,3,2,12,3,0,0,0,5,1,3,5,6,1,4,9,1,5,9,14,8,2,4,5,0,1,1,1,1,0,1,1,2,0,0,5,7,0,0,10,3,3,1,12,4,5,0,4,2,0,0,6,4,1,3,3,3,0,7,5,1,5,8,0,0,5,10,4,1,26,1,6,3,1,7,6,4,7,8,0,2,0,0,6,0,4,6,0,0,4,1,5,4,9,24,4,1,0,8,3,10,3,3,2,5,3,0,2,5,1,0,0,2,2,7,1,0,4,0,6,5,9,4,0,8,0,0,4,5,5,3,13,4,1,0,2,0,2,0,0,1,0,0,5,71,0,0,9,3,12,2,3,7,3,4,9,3,1,6,2,2,8,2,0,3,4,0,13,0,0,0,3,7,0,3,0,10,3,0,0,4,0,56,4,1,0,0,2,5,1,6,2,1,1,3,2,0,2,0,2,0,1,0,1,2,4,2,3,4,3,2,0,1,1,1,105,0,6,4,0,4,2,7,0,5,3,0,6,4,1,18,6,0,1,0,2,1,0,4,3,1,6,1,10,1,5,2,1,0,2,8,1,2,0,7,8,10,3,1,0,2,9,6,4,0,3,13,4,5,2,8,3,2,5,7,5,0,4,2,0,3,4,2,0,15,0,6,2,0,4,4,2,7,4,2,10,2,23,0,1,0,4,1,6,2,7,2,3,2,3,1,5,0,19,1,0,1,0,1,2,0,0,3,8,0,2,8,3,2,3,6,1,0,0,55,4,1,3,0,4,5,2,4,0,0,3,15,0,0,0,2,1,2,4,9,1,3,4,0,2,0,2,1,1,3,1,0,0,3,2,3,4,4,3,1,2,0,6,17,0,1,0,1,4,1,1,4,5,0,0,3,5,17,3,9,6,2,2,0,6,2,1,0,0,1,5,0,3,0,4,1,5,0,1,2,3,5,0,1,4,0,5,2,2,0,2,10,0,1,0,1,1,1,0,2,1,3,2,8,0,0,3,2,1,1,5,2,0,8,5,0,3,4,4,1,3,8,3,3,4,2,1,1,1,0,1,6,2,4,0,0,0,0,1,4,0,1,0,5,2,1,12,4,1,1,0,3,7,0,1,3,1,6,5,0,3,1,2,4,0,3,5,1,4,0,0,4,3,8,3,1,2,3,2,1,0,8,1,2,2,1,0,3,5,2,2,2,0,5,0,1,1,0,0,0,0,5,0,0,11,3,1,3,2,11,2,1,3,2,3,0,3,0,1,0,0,1,4,1,4,1,2,1,2,63,2,0,1,1,3,0,1,1,6,2,7,0,3,0,3,0,2,1,0,4,1,1,4,2,2,2,3,4,0,2,0,6,0,4,0,1,1,0,1,0,4,1,1,1,5,7,0,0,0,6,1,0,4,2,0,1,6,3,6,2,4,4,6,3,6,0,5,0,2,1,2,1,3,1,0,0,3,0,3,8,1,0,0,11,0,1,1,0,1,0,1,1,3,0,0,8,4,0,1,1,6,8,2,1,1,0,7,4,2,0,4,1,1,0,0,3,1,5,8,1,1,0,0,0,3,4,1,2,1,0,6,3,1,0,2,7,3,3,0,1,24,4,1,0,2,4,2,3,0,0,0,3,1,1,2,0,0,3,1,9,0,3,0,2,2,0,3,1,8,0,0,12,3,0,3,2,0,0,5,5,5,1,2,0,5,1,2,0,6,3,2,0,7,2,2,4,0,6,1,1,3,1,0,0,0,1,2,5,1,6,4,6,4,2,2,0,4,2,3,0,4,2,3,2,0,6,0,1,1,1,2,1,5,1,2,0,1,0,1,2,1,3,0,5,0,0,1,0,0,1,0,1,4,1,2,0,2,2,4,3,0,7,0,0,0,6,1,3,1,0,3,3,3,1,10,0,1,0,1,11,0,2,0,2,2,0,1,0,3,4,3,0,1,3,1,4,2,6,5,2,5,0,0,4,0,0,1,0,2,0,4,1,5,3,2,2,6,3,1,3,6,4,0,1,1,4,1,2,1,4,7,6,0,4,0,7,2,1,0,4,4,4,4,8,1,2,0,1,4,2,0,0,0,1,1,4,0,0,1,1,3,0,4,4,0,7,0,4,0,1,3,4,3,2,4,0,0,3,0,0,1,1,0,0,0,1,0,1,0,0,0,4,2,3,7,5,0,0,4,0,0,2,3,0,3,0,1,0,3,1,2,0,0,2,0,1,0,0,7,1,0,4,2,3,1,3,0,10,0,9,0,0,4,3,8,3,2,0,3,14,2,0,2,6,1,0,0,2,2,2,3,0,5,5,1,2,9,2,0,2,0,2,5,0,0,2,3,2,0,0,0,1,4,3,4,2,0,5,0,0,0,4,0,0,0,1,1,0,0,0,1,3,5,0,0,2,1,4,3,1,2,1,2,2,0,0,2,2,1,1,0,0,0,0,2,2,3,5,2,1,0,6,4,0,7,2,1,14,0,2,0,0,1,0,9,2,0,0,7,0,5,3,1,0,2,2,6,2,0,0,0,0,3,1,0,3,1,5,0,2,2,2,3,0,0,2,3,0,0,2,0,7,1,1,5,0,0,1,3,0,1,11,6,4,6,0,5,6,4,3,0,7,7,0,1,3,3,0,5,0,8,0,0,1,0,0,2,10,4,0,12,1,2,3,2,0,2,0,4,8,1,2,0,1,0,1,1,1,0,0,2,0,3,4,2,1,1,0,5,0,2,16,5,2,0,2,1,0,0,4,0,0,0,3,5,3,0,0,1,4,6,1,1,0,0,1,0,6,3,0,4,1,4,3,0,1,3,2,2,13,0,0,0,1,2,5,2,0,1,0,1,8,1,3,1,0,0,3,2,0,2,2,0,0,2,5,0,3,0,1,0,2,5,0,1,3,7,0,1,7,1,7,0,9,0,3,2,1,1,1,1,0,0,0,1,0,2,2,3,0,7,8,1,1,0,0,0,1,1,10,1,0,2,0,0,0,1,1,6,2,1,11,0,1,0,3,0,0,1,0,0,0,0,0,0,1,0,3,0,2,3,0,1,1,1,3,1,0,1,4,0,0,4,0,0,44,0,8,2,0,4,2,1,2,1,1,0,1,0,0,2,0,3,0,3,1,1,1,2,0,2,1,0,0,3,0,3,0,1,2,0,0,2,0,0,0,1,0,1,1,0,1,0,0,0,1,2,0,0,0,1,0,0,0,0,0,1,0,2,0,2,0,6,1,2,0,2,1,2,0,1,1,0,2,0,0,0,2,1,1,0,4,2,0,3,0,3,14,0,1,3,0,2,3,0,1,0,0,0,0,0,0,127,1,1,0,0,0,1,0,0,2,2,2,0,1,0,0,0,6,3,2,1,0,0,10,1,1,5,2,0,0,0,0,1,1,0,0,0,0,0,2,4,1,9,0,3,0,3,0,29,1,3,0,6,1,0,1,1,0,4,5,0,3,0,0,1,0,2,0,4,0,2,0,4,0,0,0,0,3,3,1,0,0,5,0,0,0,2,1,0,1,5,7,1,3,7,0,0,4,8,0,0,7,0,3,2,2,0,66,0,1,2,3,0,0,0,0,5,0,1,1,0,0,2,0,0,1,0,3,1,7,0,1,3,1,5,0,0,1,3,0,0,1,4,0,0,4,1,4,2,0,1,5,0,3,1,2,2,1,1,0,1,0,1,0,2,0,3,0,0,1,0,2,1,0,0,2,2,4,0,0,5,2,4,1,1,4,1,1,0,0,0,1,3,0,1,3,1,0,2,0,2,3,3,0,2,1,3,0,0,2,1,1,0,0,1,1,0,2,4,0,2,0,3,2,3,0,2,0,1,0,1,1,2,0,1,0,0,0,8,0,2,1,12,1,0,4,1,1,2,1,0,1,1,1,0,0,3,5,3,3,6,2,0,0,1,5,10,4,0,0,1,1,0,0,0,1,3,0,0,0,0,0,0,0,0,0,5,0,5,1,1,0,1,3,2,1,0,3,2,0,1,0,2,0,0,1,0,2,1,0,1,1,0,0,2,1,0,2,5,0,3,0,0,1,3,3,0,1,1,2,0,1,0,3,0,5,2,0,0,1,3,0,1,1,3,2,0,0,0,3,0,1,2,5,5,0,1,1,7,1,0,0,0,0,2,0,1,1,0,1,0,0,2,3,0,0,0,0,0,3,2,0,1,1,0,8,3,0,0,4,2,0,0,1,0,2,0,0,1,5,0,1,1,0,0,0,0,1,0,0,0,1,0,1,1,0,0,3,3,0,2,0,1,0,0,0,1,1,3,3,0,0,7,0,1,0,2,0,1,5,2,13,0,0,0,5,2,0,0,1,6,4,10,1,0,0,6,0,0,0,0,1,0,0,2,23,2,2,1,0,0,2,0,1,3,0,1,1,0,1,1,2,0,0,0,3,0,0,0,0,3,1,2,11,0,1,0,3,0,0,5,1,1,1,0,3,0,0,1,0,0,2,3,2,0,0,1,1,4,1,1,4,3,0,0,2,1,1,0,0,1,0,0,0,2,1,3,0,1,1,1,0,0,2,0,0,2,3,1,0,1,1,1,4,0,2,2,3,2,1,0,0,1,20,0,0,1,0,0,2,0,2,7,3,0,3,0,0,4,1,2,1,1,1,2,0,0,0,1,0,0,4,2,2,1,0,2,0,5,0,0,1,3,1,2,1,0,1,1,1,1,0,2,2,4,0,2,1,1,1,2,0,2,0,0,187,0,0,0,1,0,1,0,0,3,1,3,1,0,0,0,3,6,2,0,1,1,8,1,1,0,1,1,2,0,0,0,0,3,0,0,0,0,0,1,0,1,1,1,2,2,0,0,0,0,0,2,0,1,0,2,0,0,3,0,2,2,1,2,2,2,0,3,0,0,0,1,1,2,2,3,0,1,0,2,2,1,1,0,0,1,2,0,2,0,3,0,0,1,0,1,0,1,0,0,0,1,2,1,6,2,2,3,0,0,0,0,1,0,1,0,2,0,0,0,1,5,0,0,0,4,1,0,1,6,0,11,1,0,3,1,0,1,1,0,3,0,0,0,0,1,2,0,0,0,2,1,1,1,0,0,2,0,2,4,1,2,2,0,0,4,1,0,0,0,0,1,3,0,0,6,1,1,0,0,0,2,1,0,0,0,2,0,2,5,0,0,6,0,0,3,0,0,6,3,1,1,0,6,1,1,0,0,0,2,2,41,1,0,1,2,3,4,0,1,0,1,1,0,6,1,0,0,0,0,1,1,3,1,0,1,4,0,3,2,0,1,1,0,0,1,1,0,0,0,1,1,1,0,1,2,0,0,5,2,1,1,0,1,1,0,1,0,1,0,0,0,2,0,2,2,1,2,0,1,1,0,0,1,0,4,8,0,0,0,0,3,1,3,1,0,1,5,1,0,0,0,0,0,2,1,2,1,1,0,1,1,1,3,4,0,5,0,1,2,1,2,0,1,4,2,1,2,0,0,0,1,0,0,4,0,3,0,3,1,0,17,1,1,1,1,0,2,1,2,0,0,0,2,0,0,0,15,1,3,0,2,1,1,2,0,0,2,0,2,1,0,0,0,1,1,2,0,0,1,0,1,0,0,0,0,1,0,2,11,0,4,1,1,0,0,0,1,0,2,2,3,0,2,0,1,1,2,0,2,2,2,0,1,0,0,2,0,2,2,0,4,1,4,1,0,2,1,2,5,0,1,3,0,2,0,0,1,0,0,0,0,12,2,0,0,1,0,1,0,0,2,1,2,1,2,0,0,3,0,0,0,6,2,0,0,2,0,0,1,0,2,0,0,0,0,3,0,3,1,4,0,4,0,3,0,3,0,2,12,2,0,2,0,1,1,2,0,2,0,5,0,1,1,0,0,1,2,0,2,1,1,0,2,1,2,1,0,1,0,7,1,0,1,0,3,0,0,1,0,0,0,0,1,0,0,1,1,0,2,0,0,2,1,0,1,2,0,0,2,0,0,2,0,2,0,2,0,0,0,9,0,1,2,0,3,0,1,0,1,1,1,6,1,0,0,0,1,0,1,1,2,3,1,1,0,0,0,0,3,0,2,0,0,0,0,1,1,1,0,1,1,1,0,0,0,0,1,0,0,0,0,0,0,0,0,0,0,3,0,2,1,0,0,0,0,0,1,1,1,7,0,0,0,4,0,1,1,1,1,0,0,0,0,0,0,0,0,0,1,1,0,3,9,3,1,0,2,1,1,0,0,1,0,2,0,1,0,0,1,0,2,1,0,0,4,1,0,0,1,0,1,0,0,0,0,0,1,1,0,0,0,3,0,1,0,2,0,0,2,0,0,1,0,0,2,8,3,0,0,0,0,1,0,1,0,1,0,0,0,2,1,0,0,1,1,0,2,2,0,0,0,1,1,2,0,0,1,0,12,1,0,0,3,5,1,0,0,0,0,0,0,0,1,1,1,0,1,0,0,0,1,1,3,0,4,1,3,0,2,0,3,2,0,1,0,1,0,0,3,0,0,0,0,0,9,0,0,0,0,0,0,0,0,1,0,0,0,0,1,0,0,1,0,1,1,0,1,0,0,0,0,0,0,0,0,0,0,0,0,0,0,0,0,0,0,0,3,0,0,0,0,0,0,0,0,0,1,0,0,0,0,0,0,0,0,0,0,0,0,0,0,0,0,0,0,0,0,0,0,0,0,0,0,0,0,0,0,0,0,0
K19 It,king,22687,13398,8755,10482,9834,4003,9063,6722,7797,7305,4242,6611,5534,3071,2947,3439,5091,2607,2206,2714,3084,2912,2554,2527,879,1787,1040,2207,2126,1098,1554,2155,1482,1428,1481,1336,1674,1956,806,1837,1666,1737,1958,1193,925,1256,1509,1186,1562,1490,1588,1579,1305,1275,897,993,1506,736,835,1173,1425,737,867,1133,769,842,743,1012,527,721,757,420,612,727,800,698,602,610,760,766,668,586,384,793,729,1036,600,496,561,547,382,679,717,501,647,545,684,505,525,560,461,756,604,494,868,753,630,1022,450,676,641,555,283,595,497,345,594,432,424,247,528,321,572,777,255,355,383,456,352,338,654,544,381,301,581,420,88,628,371,350,223,253,86,293,592,358,271,463,269,462,418,302,395,294,252,161,258,250,361,332,223,553,314,347,295,879,319,215,334,447,102,331,441,304,115,210,168,283,396,384,257,243,294,228,247,309,203,317,345,156,238,126,319,271,345,421,290,124,119,71,211,398,278,306,166,361,190,302,194,483,277,343,108,126,293,255,250,345,253,169,146,232,264,239,145,281,109,141,105,429,383,210,274,548,265,20,233,224,191,123,149,120,240,143,274,219,230,374,173,252,215,357,206,171,297,171,152,117,241,141,255,168,319,224,203,172,176,153,229,209,211,170,160,105,113,143,144,148,301,157,163,104,250,261,503,410,157,116,97,140,159,254,62,81,215,150,150,165,47,129,228,178,182,109,401,141,70,134,102,117,117,42,85,179,188,177,90,211,136,127,184,152,105,280,82,140,237,197,123,137,173,168,138,130,49,154,202,108,62,257,101,95,76,43,92,155,166,79,129,83,149,81,168,163,323,22,52,172,100,163,203,149,82,37,84,115,95,137,69,102,127,67,142,60,131,286,75,63,261,102,93,243,113,117,46,73,0,101,102,126,43,103,135,176,113,143,132,106,100,98,227,301,174,61,122,66,93,171,78,154,254,80,136,201,138,214,119,156,80,104,127,22,38,70,63,99,63,121,83,59,176,73,74,171,14,116,144,94,36,111,73,71,90,111,60,52,362,97,76,120,110,85,41,177,76,114,87,158,104,179,63,90,3,97,40,64,78,261,28,172,24,132,97,60,105,78,90,72,0,88,62,107,128,31,69,150,114,80,158,56,78,66,132,54,87,64,96,87,34,119,102,155,79,64,89,44,30,94,52,30,71,140,101,81,79,79,0,64,157,108,151,106,132,51,94,55,112,61,82,133,32,119,61,57,61,3,119,135,73,86,193,46,104,86,145,87,0,8,58,126,85,75,93,25,126,165,127,95,54,30,41,91,75,144,29,67,53,51,74,96,96,84,66,75,69,65,95,11,47,34,123,124,51,93,16,158,51,114,67,34,62,66,40,41,121,57,26,67,51,92,146,103,128,37,19,4,2,90,55,95,54,70,72,55,31,45,114,39,52,88,57,48,57,63,102,108,71,111,80,58,41,107,72,191,40,1,100,98,129,79,44,22,84,23,121,98,49,82,29,119,6,84,61,70,91,173,80,30,82,26,51,55,93,37,64,102,126,54,64,96,161,49,38,27,49,86,44,92,51,26,42,58,45,50,141,55,55,88,49,61,89,19,45,120,25,133,37,6,65,54,73,35,125,81,65,84,14,77,88,77,34,54,44,66,57,252,17,78,52,60,36,44,31,13,98,85,48,42,38,67,62,27,80,44,0,181,42,30,27,50,121,121,40,58,4,7,42,57,48,48,60,58,64,46,7,47,34,39,42,89,34,89,71,72,33,251,38,38,27,53,54,31,101,47,16,26,29,60,46,29,38,19,26,54,72,86,109,50,40,36,87,55,41,84,32,78,4,58,35,40,56,30,38,45,114,23,205,30,28,64,38,134,91,11,51,56,12,11,47,147,62,28,33,53,77,33,22,92,49,61,23,8,22,60,7,50,40,27,20,20,121,27,71,27,115,28,26,1,49,38,44,95,7,23,20,28,18,23,34,48,51,14,31,64,55,89,36,0,59,128,71,60,96,14,0,55,174,73,24,63,69,38,77,46,17,51,43,58,47,52,41,28,26,18,59,97,38,1231,62,101,26,93,48,24,47,45,158,35,80,36,42,0,51,1,33,14,15,27,67,27,83,27,24,11,33,45,37,0,99,21,57,27,52,26,18,29,39,83,30,60,16,82,44,42,41,16,17,27,29,52,25,47,42,44,20,59,59,61,34,80,0,47,31,9,49,21,32,32,9,42,22,11,93,35,16,80,48,50,48,3,3,83,61,1,11,92,42,2,40,48,28,87,31,59,25,45,4,17,78,0,27,0,33,0,51,84,0,5,132,156,27,6,29,25,63,60,33,1,45,31,9,46,21,1,41,8,33,20,52,38,31,18,52,26,43,19,43,43,30,106,55,15,4,24,66,43,96,68,48,31,36,44,66,18,38,0,33,50,51,52,15,53,0,15,36,60,31,36,0,0,0,5,45,26,48,32,13,0,33,76,33,15,34,76,72,51,17,41,31,3,11,0,20,24,6,36,29,52,75,55,23,29,43,24,20,32,48,37,33,52,54,42,24,32,0,0,12,9,60,32,38,59,2253,55,60,8,49,55,32,36,42,65,47,10,31,125,55,39,33,37,73,1,21,62,33,23,69,22,30,6,18,7,48,23,29,11,45,24,17,42,10,19,18,92,0,17,11,42,6,14,16,15,65,219,31,112,6,6,50,0,26,14,27,34,77,50,2,12,47,0,31,52,0,37,16,27,21,91,6,53,69,0,41,20,96,23,11,11,26,43,0,13,50,31,39,0,0,41,21,22,88,17,52,7,50,64,20,116,18,35,31,16,9,17,35,0,7,13,2,15,26,16,52,6,8,15,0,6,16,12,17,21,39,48,62,60,82,21,5,25,59,0,29,60,0,28,17,10,26,27,1,104,32,8,0,21,48,28,1,82,27,26,42,31,54,36,48,19,19,42,0,27,16,92,13,21,21,25,3,34,41,39,36,21,25,42,53,17,18,4,16,3,23,41,51,29,47,126,16,53,65,30,4,173,30,25,30,31,9,14,9,40,32,22,8,63,12,21,107,29,36,65,22,3,32,78,18,77,13,35,45,15,16,36,21,12,23,55,11,3,7,96,54,4,19,21,7,23,56,28,6,19,110,24,32,2,0,23,0,16,10,0,20,80,9,27,13,28,48,17,61,53,63,12,21,28,8,2,26,3,1,2,1,34,8,37,10,0,19,6,14,61,39,12,0,19,50,39,21,19,54,9,14,12,22,35,14,9,37,13,19,16,0,0,9,72,21,15,23,17,18,15,10,20,1,59,21,75,35,12,13,42,5,84,46,0,90,38,64,14,10,29,33,0,18,34,34,94,24,39,31,14,13,33,1,12,27,71,17,13,20,19,13,30,30,31,31,60,7,24,24,46,16,26,27,4,0,10,10,8,76,4,2,0,0,58,0,10,10,5,8,25,36,23,44,64,6,0,9,15,10,29,21,46,44,24,65,16,20,24,11,11,194,14,13,7,19,6,9,13,34,25,13,19,30,17,18,2,30,12,44,65,75,7,13,1,19,8,54,16,35,49,29,11,18,17,16,38,37,53,24,61,52,2,24,18,46,22,52,21,5,54,25,35,12,20,17,24,6,12,15,21,32,200,15,33,27,0,27,29,3,7,0,32,13,27,12,24,37,18,35,44,7,2,29,16,3,19,0,73,2,56,19,0,14,24,17,13,4,7,19,1,12,6,43,56,27,13,12,33,17,6,33,19,23,3,2,24,27,1,25,20,41,6,12,31,9,14,4,52,39,34,16,9,37,10,32,0,36,26,60,62,51,17,8,38,0,9,3,33,79,36,65,17,146,5,10,22,13,16,18,0,22,12,0,16,48,1,25,13,26,6,22,9,6,16,35,11,22,9,9,15,12,5,15,20,15,12,0,67,6,13,22,24,19,2,21,15,29,33,38,32,61,0,8,35,25,17,83,10,15,15,56,40,22,165,15,14,38,5,26,6,6,47,3,24,3,13,10,54,24,14,13,13,12,20,4,32,12,2,10,3,30,12,10,8,10,8,14,6,22,37,7,25,11,38,29,9,28,9,19,40,0,41,9,5,8,42,34,38,39,12,36,6,25,5,25,11,12,11,33,24,34,10,32,21,2,4,22,18,35,27,0,0,14,13,2,6,0,1,0,194,21,19,3,27,20,7,0,19,14,20,1,20,7,25,59,23,8,2,20,43,17,19,9,151,91,18,15,8,30,6,16,804,58,6,1,11,2,75,3,10,0,28,7,6,7,63,25,26,7,11,30,18,3,11,6,12,15,19,14,22,4,26,8,4,24,1,6,16,0,31,28,13,0,6,5,6,145,20,0,36,11,3,20,10,22,29,22,10,27,16,0,13,22,50,28,1,36,12,4,26,0,29,7,0,4,14,0,18,18,5,0,26,10,21,2,5,39,8,7,16,16,21,14,9,0,15,6,28,29,2,22,36,31,5,16,13,4,26,7,12,0,0,2,15,20,26,11,29,1,22,32,22,19,10,7,14,11,1,8,13,5,21,7,18,31,2,2,5,18,0,7,19,7,18,12,14,3,22,5,21,14,45,61,17,16,4,7,10,71,24,18,13,16,0,14,11,5,0,30,3,7,25,7,14,35,2,13,8,44,24,40,0,6,15,10,4,6,31,13,11,21,14,9,82,23,51,6,5,53,7,9,9,10,5,10,15,42,8,0,4,12,12,0,1,43,26,11,11,83,2,9,32,23,34,2,6,0,10,16,7,29,17,5,58,0,7,23,29,7,0,21,36,6,4,3,0,8,10,32,15,21,27,13,11,23,20,0,9,18,0,6,25,0,0,5,10,17,18,22,22,28,8,0,12,34,57,17,13,12,15,18,1,50,34,1,9,0,4,15,9,2,0,34,0,49,3,60,27,0,40,10,1,43,14,7,3,26,7,19,7,13,3,13,28,0,7,8,7,26,0,1,0,7,11,7,7,5,2,6,28,15,10,20,33,8,22,20,17,1,13,14,9,22,24,0,0,17,23,11,15,7,22,15,0,3,12,2,29,36,8,33,1,3,14,8,9,15,5,9,9,4,21,26,7,1,0,16,0,6,22,17,8,23,14,13,4,9,9,7,7,18,13,18,28,18,20,7,0,4,2,5,10,8,14,9,39,14,3,57,8,3,11,9,17,31,18,31,17,7,35,26,15,8,1,8,7,13,46,26,18,7,23,3,14,13,7,123,23,19,6,9,30,8,22,10,3,5,6,8,16,21,19,10,6,3,5,18,13,2,30,0,35,8,75,10,27,14,5,2,40,13,24,2,13,10,24,41,13,34,9,25,11,12,5,8,7,27,8,87,21,66,28,1,4,8,23,4,8,29,7,8,22,10,23,23,19,29,2,13,7,5,5,27,0,26,47,6,30,1,21,0,7,6,0,1,2,9,6,17,6,8,36,6,7,7,27,11,29,9,39,5,0,18,17,8,3,15,15,12,28,11,2,12,0,16,29,0,24,2,4,6,19,1,0,10,26,11,0,10,13,12,3,17,7,15,28,15,4,0,13,29,0,14,0,31,9,33,11,20,6,4,16,0,17,17,14,18,6,9,13,20,8,18,11,27,25,4,0,0,23,33,12,9,8,3,8,2,6,5,13,18,15,0,45,26,0,10,15,24,13,11,25,12,10,24,18,8,33,2,4,2,12,13,8,0,1,9,2,20,15,0,2,0,10,6,20,10,16,5,7,1,8,17,4,7,0,3,7,5,2,22,5,12,15,51,21,29,3,15,0,4,5,11,18,23,7,3,15,17,2,0,13,6,6,6,28,0,6,21,6,6,4,5,12,8,11,3,3,15,0,0,24,1,0,27,12,0,15,4,31,8,3,14,7,1,5,1,2,14,11,5,10,8,18,5,3,9,14,17,5,13,4,4,56,26,14,13,13,18,6,24,8,22,6,18,1,10,18,6,4,7,9,43,7,8,10,23,13,2,17,0,3,3,10,4,2,8,0,7,27,6,7,15,7,31,25,38,0,0,18,10,5,15,9,3,16,14,6,10,21,0,14,14,15,22,0,12,13,13,1,2,1,4,1,13,14,6,3,21,10,6,10,3,29,2,9,9,0,10,0,5,10,8,0,8,16,33,4,16,8,18,58,4,3,1,0,67,13,0,13,33,2,9,27,0,8,10,17,18,7,11,8,1,6,25,6,3,52,11,1,32,10,5,0,9,11,5,13,10,9,824,7,8,0,5,26,15,17,0,0,2,10,8,4,19,1,10,15,15,23,3,6,37,6,8,66,8,10,5,4,0,72,7,0,42,15,4,4,7,1,16,2,4,2,11,8,11,6,7,8,13,1,22,2,10,19,3,16,3,7,11,4,0,0,16,17,5,7,5,19,10,15,15,13,8,0,28,7,22,6,13,1,31,3,2,22,7,4,6,20,8,5,17,4,20,11,3,0,4,19,26,6,1,15,6,6,14,2,62,0,6,1,20,18,7,2,12,9,17,16,9,4,0,4,0,12,6,28,16,3,7,34,16,2,1,0,5,9,3,32,4,7,7,9,15,3,5,0,10,4,3,0,0,8,2,26,3,19,9,3,15,14,0,18,0,0,1,1,5,6,4,3,4,7,5,10,5,11,0,9,49,6,0,5,2,13,3,5,16,24,2,12,1,13,9,37,18,18,0,17,11,7,20,17,2,3,6,1,4,18,4,12,22,1,16,20,5,0,7,2,5,1,7,4,10,16,2,1,0,0,14,5,34,21,9,8,0,3,0,0,14,3,3,8,5,6,1,14,3,0,2,3,21,15,19,4,0,1,15,0,0,3,2,0,11,0,1,14,20,5,10,1,3,4,0,8,2,7,3,3,9,9,5,14,4,7,3,16,0,18,0,1,16,15,16,7,10,4,7,7,19,27,3,18,9,9,8,32,19,3,17,0,17,11,2,8,22,9,1,0,0,9,11,10,7,23,5,16,4,0,5,16,1,8,5,7,45,31,3,5,1,10,10,4,5,1,19,2,1,0,17,31,9,0,1,3,2,13,13,4,18,12,5,6,4,2,2,1,2,7,0,20,0,0,2,5,15,12,1,5,1,10,8,1,56,6,7,5,0,2,0,4,15,3,4,96,0,7,19,11,40,6,6,9,8,3,16,9,7,3,3,2,2,7,1,12,3,5,0,3,1,7,4,4,21,12,9,11,6,21,0,19,11,23,9,1,9,68,8,0,59,6,9,14,4,0,19,3,17,32,8,17,33,2,17,8,4,6,13,0,10,2,15,28,10,11,4,27,8,7,10,3,16,12,8,1,13,0,18,24,22,5,6,24,9,5,14,2,1,0,2,3,15,13,8,14,5,0,16,0,29,54,11,6,6,2,15,12,0,6,3,0,0,10,37,12,7,5,10,12,24,25,13,2,4,5,6,5,9,4,21,5,25,26,0,8,26,9,23,11,6,2,5,11,7,9,8,3,7,4,8,13,4,6,2,2,1,1,6,11,13,10,9,9,3,2,6,13,0,13,82,12,8,4,10,10,30,0,4,4,2,7,2,49,0,12,13,8,7,5,19,0,1,10,9,1,13,5,19,4,8,9,1,19,0,0,7,15,2,17,6,46,2,6,5,7,4,1,12,1,13,25,5,5,3,28,6,1,207,10,7,1,3,2,2,3,0,9,8,0,7,9,8,5,10,0,13,1,11,2,3,3,8,4,19,34,7,44,0,10,7,9,4,3,0,4,0,3,4,1,20,1,11,5,35,6,5,10,4,1,2,0,16,0,1,19,6,0,7,16,2,5,10,16,7,3,18,12,5,6,18,27,4,0,8,3,6,0,0,2,18,15,3,5,10,0,19,14,19,0,6,0,16,4,6,4,15,4,10,7,6,11,6,11,11,5,0,7,25,10,2,11,8,3,18,2,6,5,1,11,21,4,2,4,0,5,0,4,7,0,0,3,1,2,11,0,7,0,3,8,5,20,8,11,2,2,1,2,3,12,6,2,1,7,5,16,1,9,19,0,3,0,5,20,4,7,22,6,8,4,9,6,19,0,26,0,20,7,3,0,41,6,12,5,19,20,12,6,12,3,16,7,2,9,8,3,0,20,0,7,16,4,21,0,34,1,4,5,12,4,4,1,2,23,3,2,2,0,14,17,16,11,22,3,4,14,13,8,2,4,1,2,3,22,0,3,16,24,5,2,40,1,12,15,2,3,0,1,13,2,28,6,1,19,5,2,7,7,0,3,0,16,9,9,30,7,26,12,2,0,5,2,0,12,2,5,8,0,3,3,3,0,3,4,0,11,12,6,12,19,4,3,13,1,1,0,9,10,16,13,3,1,4,1,3,4,0,6,28,5,19,3,17,13,7,1,43,8,2,2,0,0,0,7,14,4,4,2,2,6,9,1,17,52,2,4,2,3,2,2,10,6,8,7,2,4,10,10,23,8,3,10,5,0,10,4,33,6,5,2,4,9,1,8,7,3,0,6,14,4,18,2,10,7,2,3,1,10,7,11,7,2,1,1,1,6,0,0,12,1,13,5,3,21,13,0,0,13,0,15,0,0,5,1,0,0,2,2,1,6,0,5,10,2,0,3,1,0,7,4,16,3,2,5,9,0,2,5,2,16,19,4,2,9,3,3,0,1,7,21,10,6,18,6,3,3,6,8,1,2,7,0,3,0,2,26,4,7,16,1,25,5,2,6,2,2,4,1,9,2,3,3,27,11,3,2,2,3,6,28,6,20,0,3,6,3,11,4,5,4,6,2,1,2,4,0,3,2,8,9,0,6,2,4,4,14,3,0,0,0,11,8,13,6,12,3,3,23,17,8,2,3,9,3,1,4,10,7,20,0,0,30,0,3,14,0,0,0,4,6,1,13,9,3,1,4,3,7,1,1,5,2,0,4,3,4,0,2,1,11,13,15,9,4,5,1,2,0,20,0,2,3,4,3,8,2,1,9,6,3,7,14,14,16,0,7,9,1,46,0,0,6,4,1,4,1,1,3,4,5,0,0,1,6,3,13,6,0,15,16,1,5,4,2,0,8,9,5,3,0,2,0,18,0,18,20,6,62,6,4,4,1,24,9,10,14,8,25,8,2,6,0,7,2,29,15,6,0,1,7,22,7,3,11,15,0,5,2,4,1,19,22,0,6,3,7,12,6,7,4,8,11,4,1,19,9,5,1,3,6,6,8,22,5,2,3,0,11,12,2,3,0,0,0,1,21,4,19,0,6,2,4,10,9,25,6,5,19,4,10,6,8,5,3,7,6,4,2,3,2,1,21,6,13,33,6,11,3,19,1,10,13,0,0,4,8,4,7,1,2,9,85,8,0,3,7,8,8,3,12,7,6,4,0,7,4,0,0,5,1,0,10,0,2,2,35,0,8,12,19,0,9,4,23,10,2,10,4,8,12,1,1,0,1,0,1,0,8,0,6,6,1,44,1,18,2,0,1,8,4,1,5,3,0,6,0,3,0,2,3,1,0,10,2,5,14,2,0,1,4,3,5,7,0,9,5,0,4,11,0,7,5,3,0,0,6,2,6,12,47,8,0,8,9,0,1,1,12,0,5,4,6,13,5,10,7,3,1,7,7,64,11,15,7,9,14,1,1,3,4,0,6,0,3,9,8,1,17,2,21,2,0,6,3,0,14,19,2,2,6,16,5,65,1,0,14,18,9,2,0,1,2,4,6,3,20,2,8,13,5,6,6,6,2,0,11,4,8,15,11,6,10,7,1,1,0,0,5,2,2,5,3,2,6,2,2,3,1,9,1,2,0,1,4,7,18,9,6,1,13,2,3,14,7,5,5,3,3,8,3,1,5,6,1,10,4,5,15,6,13,4,12,1,4,25,13,27,0,3,14,6,10,2,14,3,0,2,5,12,2,7,4,1,0,1,18,28,2,1,1,1,0,3,3,2,0,9,0,2,0,7,1,25,14,0,14,11,9,7,0,2,9,5,1,1,4,7,4,0,9,7,9,1,5,0,0,7,3,1,5,0,0,6,6,0,1,0,0,2,0,7,1,3,9,33,3,1,8,6,0,0,5,7,6,11,2,3,4,0,18,4,6,0,5,13,1,1,2,4,1,2,15,14,12,7,5,2,15,8,1,0,4,0,12,6,8,1,1,2,0,6,2,5,2,12,18,67,5,7,1,6,0,0,3,13,13,1,5,21,4,3,5,1,0,0,7,7,8,0,0,1,3,45,9,1,0,13,0,1,0,3,1,0,16,87,5,7,1,21,0,13,5,2,1,7,3,2,21,2,3,5,0,4,2,1,0,7,1,8,2,5,1,2,3,6,14,2,1,9,0,31,2,15,2,0,4,13,1,10,3,7,0,1,4,4,171,2,16,8,17,2,0,5,4,2,5,0,2,0,5,7,5,2,8,3,21,0,1,0,4,4,2,1,3,1,6,13,1,11,0,0,3,5,4,0,1,1,8,1,2,9,2,0,8,1,8,8,5,2,2,3,3,4,5,1,1,0,3,0,10,13,1,0,4,4,2,8,9,0,8,17,4,4,1,35,1,2,15,2,4,1,1,8,1,2,2,1,3,0,2,13,2,2,11,13,40,5,2,0,0,2,2,13,23,2,0,1,0,0,0,1,9,3,8,12,3,14,2,0,9,1,2,0,0,12,0,3,5,5,2,1,26,15,3,15,0,9,11,5,5,7,1,3,9,1,0,7,1,8,8,2,0,6,5,1,0,5,0,14,1,0,0,0,2,1,6,0,3,1,0,0,0,4,9,0,0,0,4,3,0,3,37,1,0,2,13,1,14,0,1,11,3,2,2,1,3,0,5,0,3,3,23,0,2,0,1,11,6,9,5,9,8,14,5,7,2,2,1,0,7,3,1,4,6,5,7,6,0,4,1,0,10,2,3,1,0,1,2,8,0,4,3,30,2,0,1,0,2,3,3,0,1,3,4,1,0,5,12,4,2,6,0,3,15,8,2,0,5,57,13,0,0,4,2,0,1,0,2,12,2,5,12,5,1,5,7,5,1,0,0,1,4,8,5,1,6,3,10,1,3,1,0,10,0,0,1,4,3,2,7,8,4,5,7,1,4,0,1,2,0,14,2,2,0,25,1,199,3,1,14,1,3,0,2,0,0,8,0,13,1327,6,0,18,0,0,0,1,0,0,0,13,4,0,0,1,1,0,7,3,3,0,4,12,0,0,8,0,0,0,0,0,0,4,1,0,0,0,0,0,1,10,0,3,0,3,0,0,0,0,0,0,2,0,0,0,0,0,0,0,0,0,0,0,0,0,0,11,3,0,0,0,1,0,0,0,0,0,0,0,0,8,0,0,0,0,0,1,0
K20 DT2 The Drawing of the Three,king,7006,3160,2793,2921,2616,1156,2912,1680,2305,2009,1588,1698,1387,852,746,827,1597,766,744,680,764,1081,813,789,236,641,306,571,452,320,425,444,543,662,566,469,440,552,141,603,555,550,531,465,236,391,435,396,519,433,385,346,430,295,270,215,461,275,335,344,264,260,244,320,293,312,156,215,158,250,201,164,194,231,191,221,199,229,238,151,154,150,323,293,211,336,190,141,186,184,99,197,301,200,192,127,160,234,146,199,135,228,195,196,350,316,197,301,180,220,184,77,40,178,186,233,144,148,144,92,146,66,119,252,62,80,143,133,163,83,244,133,120,95,199,118,11,146,170,108,7,97,24,105,199,106,100,203,123,142,67,100,113,118,146,62,64,64,114,109,48,130,111,159,70,133,120,88,137,118,25,53,120,65,23,72,76,104,122,88,69,67,113,38,82,12,62,102,85,48,35,45,141,113,106,106,27,20,135,23,36,104,73,94,66,24,34,91,69,63,33,71,52,47,57,55,67,92,63,43,71,61,100,37,33,48,45,43,71,137,135,46,59,174,98,10,32,75,74,63,24,28,73,52,53,54,46,135,53,80,89,63,40,35,66,60,66,44,65,131,62,34,55,71,63,30,56,78,60,68,58,26,54,19,35,31,32,35,116,83,23,3,50,47,121,34,54,2,57,34,73,23,5,31,33,39,53,38,41,51,86,25,39,18,76,32,12,19,50,52,59,18,40,56,74,66,35,62,62,31,42,31,36,56,31,21,63,61,23,46,40,41,57,42,8,61,45,9,25,49,29,45,32,17,42,101,63,85,42,31,63,34,58,27,69,3,21,60,14,16,39,40,31,17,27,52,38,38,26,19,22,46,31,6,21,58,36,3,48,49,38,29,13,15,33,14,0,43,24,88,8,42,13,51,51,65,39,47,20,55,10,48,32,23,51,11,18,26,39,31,28,24,29,15,34,52,25,37,27,38,25,2,4,35,36,42,16,29,33,13,30,44,66,44,1,40,57,48,3,29,25,28,20,57,18,22,90,73,22,28,43,16,10,38,26,21,27,10,15,31,37,56,0,26,17,18,16,23,1,62,7,42,23,45,25,21,18,20,0,22,21,33,21,142,19,32,52,23,36,6,43,14,8,30,32,17,31,21,6,37,23,43,21,15,23,19,11,37,22,9,24,50,29,40,21,18,0,21,37,23,17,26,38,10,23,54,39,21,26,46,13,32,35,18,16,3,49,33,8,12,50,10,39,22,51,40,0,2,13,58,44,37,9,8,25,9,26,36,10,7,30,22,25,8,18,22,10,5,8,17,15,23,37,17,13,17,22,5,7,7,17,43,27,27,122,26,19,31,27,7,13,9,24,5,34,19,3,24,11,7,40,38,42,14,18,0,2,21,7,28,9,18,36,4,1,12,12,7,7,22,12,17,5,15,24,44,16,31,43,10,10,28,10,12,13,0,8,34,60,21,19,5,18,8,40,21,17,9,7,33,0,32,26,31,23,24,26,8,27,9,17,12,15,25,4,18,22,25,20,17,38,19,13,8,11,42,15,33,16,9,11,9,19,20,43,15,0,29,14,7,30,8,10,27,2,14,24,13,21,19,20,9,34,35,16,48,2,28,12,21,6,24,2,29,11,44,9,17,31,18,13,12,9,37,13,21,7,5,12,12,31,9,3,11,0,26,6,7,11,22,26,14,23,3,0,0,14,8,17,3,3,4,8,3,6,14,18,2,19,21,7,11,34,23,5,7,1,5,40,8,16,5,49,9,0,5,2,16,2,11,12,8,4,4,10,21,10,0,13,24,10,15,2,24,7,4,0,29,3,11,10,11,10,14,3,12,66,18,6,8,9,39,29,3,21,11,2,0,8,7,18,3,27,19,37,10,5,3,11,13,9,12,2,13,3,14,41,25,0,11,17,2,19,6,30,6,6,0,14,3,16,24,74,7,6,0,2,3,0,32,8,7,6,31,11,9,3,0,11,18,21,16,19,6,0,8,8,17,3,22,23,12,7,24,12,16,9,13,15,26,12,9,2,6,25,47,40,1130,11,28,4,7,18,9,12,38,29,7,16,14,29,0,19,0,5,9,25,10,17,6,4,10,12,9,7,9,5,33,22,5,46,6,12,13,5,49,12,15,6,12,12,40,1,6,17,9,4,8,17,5,16,20,16,13,1,5,0,17,10,13,0,12,10,0,28,10,1,27,2,11,6,0,36,1,7,25,5,14,13,1,1,27,13,2,5,13,10,0,17,16,10,9,18,12,12,7,0,26,13,0,8,0,5,1,7,18,0,0,6,24,12,10,4,1,39,8,9,0,15,4,8,10,4,0,17,0,20,0,8,6,5,11,10,11,15,9,17,9,8,13,6,8,4,3,25,4,17,6,5,4,18,29,4,4,11,0,4,8,1,8,4,12,0,1,5,36,9,3,0,0,0,8,17,10,17,11,9,0,21,6,15,6,6,16,2,1,2,6,9,5,4,0,23,9,22,5,7,14,29,2,17,20,32,10,6,13,7,11,12,15,5,22,5,17,0,0,3,6,19,12,13,14,4,13,12,0,17,8,19,4,8,3,10,1,8,30,8,10,4,5,9,0,7,17,3,12,19,2,6,6,3,1,8,8,10,15,1,7,1,13,2,6,2,28,0,4,1,15,2,0,0,10,10,8,3,13,0,6,14,0,10,13,7,6,7,5,0,6,9,0,20,10,0,14,5,6,5,70,0,25,8,0,10,7,36,15,1,4,36,4,0,12,2,6,11,0,0,2,14,4,5,36,31,5,20,4,2,14,10,5,5,6,0,11,27,0,4,3,10,12,3,2,4,0,0,2,0,1,6,4,5,8,11,13,5,2,12,15,8,7,9,0,13,11,0,7,11,3,7,4,0,6,11,2,0,1,24,14,0,9,1,6,15,8,12,12,3,8,11,7,0,10,8,21,14,8,0,5,1,2,10,14,13,11,16,5,6,3,2,4,1,1,4,6,25,10,15,26,2,4,16,7,0,2,13,4,11,6,10,2,1,2,14,2,1,14,1,8,14,6,5,10,3,1,0,11,1,2,7,12,6,5,4,14,18,1,50,4,6,7,0,5,19,0,6,10,19,2,9,3,5,19,22,1,2,0,0,1,0,24,4,0,1,15,5,16,0,11,3,7,13,7,24,0,0,21,4,0,13,2,0,0,0,11,9,30,1,0,5,0,7,18,3,0,2,3,9,8,7,6,7,4,4,6,1,11,1,4,8,6,3,2,0,0,2,10,7,21,9,26,6,5,2,10,3,13,14,7,13,5,16,9,0,7,5,0,11,3,8,4,2,19,12,0,4,4,16,0,3,9,20,4,8,6,0,8,2,20,1,6,8,1,5,2,0,9,6,28,3,5,2,5,0,13,18,3,0,0,0,3,11,0,0,0,0,4,0,4,2,1,11,7,7,0,7,7,4,0,2,11,2,14,7,5,11,0,6,9,1,9,0,8,8,4,7,0,8,2,3,1,6,5,3,9,1,3,3,0,13,2,11,11,15,8,16,0,5,0,1,8,1,2,5,3,4,4,50,23,9,8,22,8,8,0,6,5,4,0,18,7,3,6,7,30,7,6,1,6,7,6,0,10,7,65,7,13,26,1,12,5,1,7,0,7,7,2,2,6,15,6,16,8,1,0,9,1,0,3,0,5,3,5,5,0,3,2,6,2,1,5,5,0,3,1,6,0,2,3,1,4,3,2,17,14,0,7,4,10,7,0,9,0,12,52,5,5,3,4,0,7,0,12,9,3,0,7,10,0,5,9,3,16,26,9,5,14,6,1,2,19,15,5,8,3,6,0,2,13,3,6,2,0,6,2,0,1,6,0,21,2,12,1,6,1,0,3,6,1,5,1,1,8,0,0,4,5,26,10,0,17,13,2,11,8,2,0,7,2,8,5,7,3,13,0,1,16,1,6,45,6,3,1,18,17,0,4,5,3,10,1,5,3,2,25,1,2,0,2,5,16,7,0,4,7,2,6,2,12,7,0,1,2,0,12,9,4,0,11,0,4,6,0,4,27,4,6,9,4,11,5,10,12,1,7,3,0,1,7,11,7,0,1,3,2,7,1,4,0,2,10,10,18,6,5,2,5,3,0,3,9,10,15,0,0,3,2,0,3,0,0,0,53,24,5,1,2,7,3,0,6,0,20,0,5,7,3,9,8,6,1,5,0,12,7,1,1,19,4,4,0,6,1,19,181,2,0,0,2,2,8,13,5,0,3,4,6,2,8,3,1,0,9,9,34,2,0,1,0,5,0,1,1,0,2,1,0,2,0,2,4,0,22,2,2,0,2,6,6,0,13,0,9,4,0,13,6,5,3,15,1,6,0,0,19,15,12,6,2,9,4,0,7,0,5,4,0,0,2,0,0,3,1,0,9,1,5,1,0,6,2,1,7,3,2,4,2,0,5,0,4,5,6,3,6,10,2,0,11,1,4,3,1,0,0,1,6,9,6,4,6,0,9,12,18,12,2,2,2,1,0,14,1,3,2,1,1,5,0,1,0,5,0,5,11,10,5,5,3,1,8,0,2,2,13,3,3,3,3,2,1,9,1,8,3,13,0,3,10,1,0,6,2,0,4,0,6,5,10,4,0,6,2,5,0,1,2,6,7,7,8,6,15,7,1,5,20,8,3,1,4,12,2,1,3,4,2,10,3,4,4,0,1,11,6,0,0,17,2,2,3,3,2,3,9,14,5,0,6,1,1,36,8,4,5,2,12,0,6,8,9,0,0,10,13,6,6,0,0,1,4,17,5,8,8,3,1,5,6,0,6,3,0,1,5,0,0,2,1,0,8,2,5,7,2,0,4,3,7,2,1,2,5,6,0,5,2,3,0,0,0,5,1,0,0,8,0,5,3,14,5,0,13,0,0,10,8,7,0,2,1,5,0,5,0,2,0,0,3,2,3,17,0,0,0,5,7,3,4,2,0,1,10,3,0,1,5,2,8,14,1,0,4,0,0,6,2,0,0,6,10,2,2,1,9,3,1,1,0,0,11,7,6,1,0,4,16,1,2,2,0,1,2,2,1,21,1,1,0,3,0,2,0,8,1,6,4,6,3,1,0,1,2,3,5,18,12,3,8,1,1,0,4,2,2,4,1,8,7,2,1,4,1,3,7,1,1,11,1,6,3,2,7,3,3,0,0,2,4,3,6,7,1,6,9,1,4,3,3,19,3,7,0,5,3,2,1,0,2,1,4,3,8,4,6,1,3,0,3,4,8,1,1,0,0,0,16,2,11,2,2,2,9,1,5,1,0,6,5,6,5,5,1,0,4,1,0,2,3,0,0,17,8,3,10,1,2,0,3,3,1,6,2,1,3,0,7,12,22,11,1,1,0,1,0,1,0,10,2,3,3,0,5,4,2,77,0,0,0,0,4,1,4,0,5,3,2,2,1,4,7,2,5,6,0,0,3,5,2,6,0,5,2,2,0,9,0,1,0,0,2,1,2,2,2,0,0,4,2,4,0,1,3,10,4,1,29,2,10,3,3,0,8,10,0,1,0,8,2,6,2,7,2,4,6,0,6,3,4,3,3,7,0,0,0,0,1,13,1,0,0,0,3,2,3,5,5,0,0,0,1,1,4,8,5,0,7,18,0,0,8,5,2,6,2,10,2,9,4,0,18,0,1,0,7,4,12,0,0,1,1,0,4,0,0,0,0,1,1,2,4,1,3,5,3,1,1,0,0,3,6,1,0,1,2,2,2,0,0,6,0,3,0,1,3,0,10,5,1,0,4,1,0,0,3,0,3,0,0,0,1,5,5,1,3,2,3,1,6,3,1,2,0,0,1,0,0,5,3,0,10,0,8,0,5,2,1,6,2,2,1,15,7,1,8,2,1,1,1,1,3,2,2,6,3,1,7,3,5,3,7,5,2,3,3,5,6,5,1,6,1,0,0,5,4,0,2,1,1,15,1,4,3,0,0,1,2,0,4,2,0,2,28,0,3,2,0,5,0,0,0,0,2,0,12,5,2,2,2,1,3,2,5,0,0,1,3,5,0,6,6,5,0,1,1,8,0,1,1,3,2,1,1,1,0,0,4,0,1,5,0,1,0,2,2,4,0,2,4,3,5,6,4,1,9,0,6,0,1,0,0,1,3,10,0,3,7,1,0,9,1,2,1,6,1,1,1,13,0,0,1,5,0,13,4,1,0,4,9,0,7,4,0,1,1,6,0,1,7,0,3,0,0,0,2,0,0,6,0,2,1,2,6,1,1,0,0,0,1,2,0,7,0,0,20,2,6,7,1,1,12,3,0,6,6,1,1,0,2,1,0,2,1,3,0,6,0,4,7,2,4,3,1,9,0,0,0,3,3,0,1,0,4,13,4,5,1,1,0,4,3,3,0,8,1,5,1,0,0,1,1,7,2,0,0,2,1,11,4,0,0,0,2,7,2,1,1,2,2,2,0,1,0,4,1,4,4,0,1,3,1,7,5,3,0,0,1,0,6,2,9,0,1,1,10,3,2,2,0,0,3,4,6,0,2,0,2,6,0,7,0,1,1,0,0,0,8,1,7,2,9,5,1,2,0,1,7,0,0,4,0,0,1,0,8,2,2,0,1,8,6,1,2,5,5,0,5,1,1,3,0,0,2,3,2,0,6,0,5,5,2,0,0,2,0,2,4,1,0,0,0,0,2,0,4,28,0,4,2,3,0,8,0,8,0,3,1,0,0,2,0,0,1,15,0,8,3,8,1,0,1,0,0,2,0,0,1,1,4,1,5,1,0,0,5,1,2,4,0,0,0,14,0,0,0,2,2,4,0,0,16,5,6,2,0,0,0,0,9,2,5,4,0,3,4,2,2,2,0,2,10,0,9,1,3,4,3,4,3,4,1,2,15,1,4,3,11,2,9,4,2,1,4,4,1,2,3,1,8,8,2,1,0,0,4,4,3,2,1,1,4,2,0,2,1,0,2,1,4,3,3,2,1,0,0,25,2,3,1,2,0,1,0,0,3,4,3,0,1,0,6,6,3,4,12,0,4,0,0,0,4,0,4,0,1,0,0,1,0,1,1,0,3,1,1,2,0,9,2,5,1,0,2,0,3,1,2,0,0,0,0,1,1,29,1,1,3,2,1,6,2,1,0,0,0,0,6,0,6,0,2,0,0,6,7,1,0,4,2,0,0,1,8,0,0,3,5,3,2,4,1,0,0,8,3,0,3,0,0,10,1,3,3,1,1,2,0,1,2,2,1,10,0,6,0,2,1,0,0,6,10,5,3,2,0,5,0,0,0,3,1,2,3,3,2,1,3,0,0,3,3,0,0,2,1,3,0,4,5,1,0,2,0,1,19,0,0,0,4,2,6,0,6,0,0,0,16,1,1,0,3,4,11,9,1,5,1,0,0,0,0,1,3,6,0,2,1,0,2,3,1,3,0,5,1,1,7,3,0,0,4,4,0,2,1,1,7,2,0,2,0,6,8,3,0,0,3,0,0,0,7,0,6,0,2,1,3,3,34,4,0,3,3,2,4,1,3,0,4,1,0,1,0,4,2,0,6,2,0,3,5,3,0,2,1,0,0,0,0,1,1,5,11,1,5,2,0,0,0,1,1,2,0,2,4,4,0,4,18,6,0,3,0,0,0,3,0,21,0,1,0,0,1,0,4,0,2,0,0,0,0,5,2,2,1,3,0,1,0,0,2,2,1,1,3,1,1,0,1,0,0,2,0,5,0,4,0,3,1,3,0,0,0,2,1,4,0,0,5,0,0,0,4,0,15,1,0,3,0,1,1,0,1,3,0,1,0,2,1,0,1,0,0,5,1,9,3,3,0,4,0,7,1,0,0,6,2,2,4,6,7,11,1,1,3,2,6,0,0,0,2,0,0,0,4,5,0,3,1,9,2,1,2,9,1,7,0,0,1,0,4,3,0,0,0,0,2,2,0,0,0,0,2,0,4,3,1,2,0,1,2,0,6,1,0,0,2,2,8,3,0,4,1,0,0,2,6,1,2,3,4,0,1,3,4,3,1,1,0,3,2,2,0,0,1,1,0,4,2,13,4,3,0,1,2,1,6,3,0,0,0,2,4,0,0,3,0,1,1,4,0,24,1,1,0,0,0,2,0,1,0,2,9,0,1,2,0,5,2,2,0,1,0,0,0,0,24,0,3,2,8,3,0,4,0,4,3,2,1,0,2,20,0,6,2,0,1,6,1,5,9,0,2,0,0,1,3,4,2,9,1,4,0,0,0,0,0,7,9,3,1,2,0,2,0,1,0,0,2,0,1,2,5,3,1,2,1,0,0,0,0,0,2,7,0,2,2,2,2,0,0,3,1,6,0,6,3,3,0,6,3,1,1,0,0,0,2,1,1,0,0,2,1,2,0,2,1,3,5,0,1,1,1,2,0,1,2,0,1,1,2,2,1,0,0,0,0,2,0,6,0,2,0,0,2,0,2,3,6,0,8,4,0,3,0,2,2,1,0,1,2,0,1,2,0,1,0,0,4,0,0,1,3,12,1,0,7,2,0,0,0,1,1,0,0,3,1,0,0,1,0,3,1,2,1,6,0,0,2,0,0,0,0,4,4,0,1,0,0,2,0,1,0,1,0,1,0,2,2,0,1,1,8,2,0,1,2,0,0,3,1,1,0,4,1,0,0,0,0,0,0,1,0,1,1,0,3,0,9,1,0,1,0,0,0,3,5,2,2,3,0,0,3,0,0,0,8,3,6,0,0,2,1,8,3,0,1,1,0,0,0,5,0,0,2,1,0,0,1,0,2,0,0,3,2,4,0,1,1,2,0,12,4,0,0,0,2,0,3,3,4,1,0,0,5,0,3,3,5,0,0,0,0,0,7,2,0,0,1,0,3,0,0,3,0,4,0,2,0,0,0,0,6,1,5,7,1,1,2,0,0,4,0,0,3,2,1,4,1,1,5,1,2,0,1,0,6,2,2,2,0,1,2,0,6,21,0,0,0,0,2,0,4,2,0,0,3,1,2,0,0,1,1,1,1,0,0,0,5,1,0,3,0,0,0,5,2,6,3,0,3,6,1,2,1,21,3,1,2,0,0,4,0,0,0,0,1,6,2,1,0,5,2,1,4,0,4,2,0,1,0,5,0,0,1,1,0,2,0,2,3,1,0,4,0,0,0,1,6,0,0,1,0,7,0,3,2,1,16,0,2,5,0,4,3,0,0,0,2,0,8,1,1,0,5,2,2,11,1,7,3,0,0,1,2,1,0,8,1,2,0,0,0,0,4,4,2,2,0,0,0,1,36,2,4,0,1,1,1,3,13,1,1,4,18,11,0,3,0,3,0,0,3,1,4,3,0,0,53,0,0,0,0,0,2,0,2,0,1,0,2,0,8,0,7,1,1,1,1,0,0,2,8,0,0,0,3,0,5,1,3,0,1,5,0,5,3,1,0,0,0,3,0,0,2,1,0,0,0,1,0,0,0,0,0,4,1,0,2,3,0,0,0,3,0,3,0,9,1,0,2,3,0,3,0,4,0,2,1,1,3,5,0,2,0,0,0,0,1,0,3,0,4,2,3,2,0,1,0,0,0,0,1,0,3,3,0,2,0,0,1,3,0,0,6,0,1,1,0,2,3,0,0,0,2,7,3,0,1,4,0,0,0,2,4,3,0,0,5,2,2,1,0,0,1,5,3,0,2,1,1,3,0,1,1,2,0,0,0,0,0,0,6,0,0,0,0,0,0,0,1,0,0,3,1,0,4,1,0,1,0,1,1,5,0,2,0,5,2,4,5,6,3,1,0,0,0,1,1,1,1,0,3,0,0,2,0,0,0,0,2,7,3,0,0,1,2,1,1,8,0,1,0,0,0,0,0,2,0,3,0,2,3,1,0,0,0,4,7,4,1,2,0,1,0,2,0,0,0,3,0,5,33,1,0,5,3,0,0,1,1,5,0,1,9,1,0,0,0,3,0,0,1,10,0,1,1,2,0,4,0,1,1,0,0,3,2,0,0,0,0,2,1,4,0,0,19,13,1,1,10,3,0,0,3,0,0,0,1,0,5,0,1,2,0,0,5,3,3,1,1,2,0,0,4,0,6,12,7,0,5,2,1,0,0,0,4,3,0,1,2,6,0,0,0,3,0,5,1,10,0,0,2,3,0,0,1,5,4,2,0,7,3,1,0,2,1,0,2,2,2,0,0,0,1,6,2,5,0,2,1,4,0,0,0,0,2,1,1,0,0,3,0,3,0,0,0,0,1,0,3,0,2,0,0,2,0,0,0,1,0,2,1,1,0,1,2,2,1,2,0,1,0,3,1,1,1,1,2,0,2,2,1,1,1,2,1,0,3,2,2,0,8,1,0,0,0,0,3,0,2,0,0,17,1,1,0,0,4,0,0,0,1,3,0,1,3,0,0,2,0,3,0,1,1,0,0,0,1,0,0,0,1,0,0,0,11,0,7,2,1,2,2,0,1,3,2,0,1,0,4,0,2,2,0,1,0,0,3,0,1,0,3,4,0,4,0,0,0,0,3,1,0,0,0,5,2,1,0,1,1,0,0,0,0,0,2,3,5,2,3,0,0,3,1,1,3,1,0,2,2,0,0,0,3,0,5,1,5,4,1,2,4,0,0,1,0,1,1,2,0,3,0,0,1,0,0,1,0,2,0,0,2,0,0,0,0,0,0,2,0,0,0,1,0,2,1,0,0,0,0,4,0,0,1,1,5,0,2,2,3,0,0,0,1,0,0,0,1,2,1,0,0,1,0,1,0,0,0,0,8,1,1,5,1,0,1,0,1,0,0,0,1,0,4,0,0,0,0,6,2,0,0,0,2,2,2,0,1,1,0,0,2,1,1,2,1,0,4,1,0,0,0,1,1,1,1,2,0,2,1,0,0,0,1,3,5,3,1,0,2,1,0,0,0,0,14,0,1,2,1,1,0,0,0,0,5,4,1,0,2,0,0,0,0,2,0,0,0,0,0,2,0,2,0,6,0,1,0,0,0,0,1,0,2,2,4,0,2,1,0,1,0,1,0,0,0,0,0,0,2,0,1,2,7,1,2,0,1,0,1,0,1,10,0,2,4,7,0,8,1,0,2,0,0,0,2,0,0,2,0,0,0,4,0,2,0,0,0,2,0,0,0,0,1,0,0,1,2,0,0,0,0,0,0,7,0,1,0,0,0,0,0,0,0,0,0,0,0,1,0,0,0,1,0,2,0,0,1,1,0,0,0,0,0,0,0,0,0,0,1,1,0,0,0,0,0,0,0,1,2,0,1,0,0,0,0,0,0,0,0,0,0,0,0,0,0,0,0,0,0
K21 Misery,king,6147,3028,2419,2570,2654,1153,2914,1698,2133,1799,1176,1393,1267,1666,1165,795,1518,656,586,444,706,867,763,693,216,639,238,309,516,262,396,434,385,453,460,445,338,485,72,459,509,425,453,455,190,389,356,336,489,417,389,239,399,351,305,226,395,203,262,332,302,179,170,271,206,276,90,227,120,242,201,140,179,165,144,216,166,169,157,183,150,146,99,209,189,242,118,131,217,111,89,145,210,131,155,151,125,104,159,154,124,168,180,151,291,230,142,236,130,149,138,133,23,80,174,154,146,136,104,59,71,81,110,170,101,68,132,117,119,72,138,182,89,71,160,116,6,155,132,59,71,62,31,93,192,138,100,181,87,104,84,111,98,91,79,19,48,54,100,114,70,92,90,75,55,123,94,61,105,101,26,43,95,121,89,69,79,61,98,92,81,67,136,66,65,30,45,106,93,47,35,44,107,66,63,73,24,78,67,20,51,98,40,98,44,33,64,50,55,68,37,83,17,47,54,46,85,62,67,45,46,76,46,56,32,52,50,62,32,105,96,39,43,74,48,10,34,75,58,37,20,50,33,36,45,46,73,94,38,85,57,45,37,21,23,41,34,37,59,49,68,27,92,72,53,26,40,86,60,47,50,14,74,29,50,37,56,45,116,69,52,32,46,50,132,8,52,73,50,28,40,15,22,17,48,31,73,40,35,42,54,17,14,32,127,27,13,14,17,51,51,21,40,58,82,45,27,35,37,7,48,56,39,29,28,62,80,56,53,39,38,52,38,31,30,41,24,10,24,49,25,42,28,8,12,45,32,23,28,16,70,23,42,24,63,8,25,60,42,14,27,13,27,11,19,32,26,40,10,31,18,27,32,41,27,88,31,9,58,27,30,32,22,12,31,24,0,30,47,33,4,34,49,11,40,36,35,51,36,28,7,48,52,20,36,17,30,23,16,22,26,23,25,32,31,45,35,32,37,37,39,0,26,11,16,21,22,30,29,16,23,20,39,28,3,30,27,32,8,29,16,14,7,33,20,22,58,19,20,27,28,19,8,71,35,19,24,123,33,18,29,7,1,8,12,18,26,14,6,44,6,44,19,5,27,33,13,8,1,17,19,33,18,20,25,28,18,9,27,20,34,14,11,25,31,19,10,29,1,42,25,41,2,16,15,17,6,41,21,12,13,45,19,41,18,19,0,22,23,13,21,34,26,14,15,22,30,13,25,39,6,90,27,24,14,7,26,43,12,22,38,1,30,24,18,10,0,7,12,24,22,28,29,2,20,7,61,34,12,11,20,98,16,70,26,38,11,3,15,25,5,8,8,23,8,13,18,4,17,12,21,59,17,35,5,19,9,34,12,12,25,17,8,17,49,15,5,6,16,11,59,28,38,1,21,0,1,15,16,12,6,2,31,13,9,21,11,2,1,22,6,16,13,26,5,28,16,27,14,10,12,34,10,3,12,0,24,26,45,34,24,6,10,18,12,19,17,11,16,38,0,16,27,22,12,32,17,6,16,3,18,11,16,22,29,19,35,17,19,12,153,8,6,12,19,26,6,21,21,4,7,21,11,12,47,13,2,20,20,5,23,3,18,19,26,17,10,2,9,14,22,1,17,10,21,31,1,7,20,14,9,15,0,22,17,32,5,10,23,14,6,1,9,1,9,23,27,1,12,18,15,13,15,16,0,46,8,9,3,9,14,28,20,24,4,1,3,8,12,10,30,4,10,7,2,11,15,3,12,7,4,17,27,15,16,4,11,7,6,23,14,4,2,22,2,4,34,11,5,8,8,14,6,5,25,22,9,10,10,10,36,12,559,55,8,22,0,13,1,13,9,10,11,13,8,11,55,13,3,4,6,25,22,6,18,6,3,0,6,14,18,21,16,39,18,18,2,8,12,16,9,3,7,7,6,6,9,11,1,4,12,5,10,9,31,7,6,0,10,5,22,19,7,3,34,0,1,8,33,28,13,3,16,15,11,28,53,0,20,44,20,16,13,3,0,7,9,16,12,16,14,6,39,13,6,16,14,4,8,20,14,14,13,4,12,17,22,2,6,27,9,5,13,5,18,4,28,6,16,12,14,0,21,0,10,5,5,6,10,4,9,24,5,7,10,25,3,1,36,2,18,2,10,35,0,19,9,14,6,13,5,32,24,10,4,6,7,4,9,11,13,8,10,2,1,8,4,4,4,20,0,13,3,0,1,2,4,1,4,4,3,4,25,12,6,25,10,13,14,0,2,10,13,4,1,3,20,0,16,7,17,14,9,6,6,7,0,14,15,0,10,0,2,3,8,13,0,0,3,12,3,3,7,25,19,3,19,0,29,15,0,5,3,1,6,1,11,3,9,3,21,21,13,2,18,10,21,3,3,24,13,1,3,9,21,20,7,11,10,5,22,10,2,2,3,0,17,16,4,25,5,22,0,6,11,25,4,3,0,0,0,2,21,13,4,8,1,0,12,10,5,3,7,2,6,3,0,6,7,3,4,0,10,14,1,12,3,12,24,4,12,6,1,3,4,8,10,15,5,6,8,13,3,10,0,0,1,1,10,11,9,14,5,16,5,6,16,12,2,4,3,4,14,16,6,20,18,8,5,6,25,2,4,11,5,3,12,5,6,0,8,0,12,7,13,5,1,7,1,26,2,4,3,5,0,4,2,9,3,2,1,6,16,4,8,23,2,11,5,0,15,9,3,3,15,12,0,3,11,0,8,8,2,9,0,8,4,3,0,22,7,0,10,7,9,3,0,1,10,9,0,4,12,13,5,0,0,8,15,6,2,1,5,2,18,8,1,24,5,3,2,5,6,14,7,0,1,6,5,7,9,3,11,0,2,1,0,0,7,6,1,11,7,16,14,3,4,9,0,5,10,0,1,9,0,6,7,1,7,12,0,4,31,3,0,0,17,7,0,0,9,7,6,3,23,6,12,0,11,9,0,4,6,6,12,13,1,9,2,11,12,22,12,8,3,10,1,9,6,4,1,1,10,6,10,5,24,29,5,26,31,9,8,1,6,8,5,12,3,2,6,2,13,4,3,18,5,3,6,8,5,18,2,0,8,13,3,7,4,1,20,7,3,4,11,5,14,14,2,2,1,2,14,0,5,3,14,2,6,6,2,10,14,4,44,0,0,16,0,12,0,0,4,17,7,9,3,1,4,5,12,10,3,0,0,5,1,0,3,1,0,1,0,10,4,19,3,0,7,4,4,16,9,3,0,2,8,9,4,4,10,14,3,1,5,5,1,1,13,8,1,5,0,0,0,10,10,2,11,4,3,5,0,5,9,9,1,11,9,7,5,13,0,22,8,0,2,2,23,15,2,6,7,0,1,11,15,0,3,3,3,4,8,14,0,4,22,9,0,2,6,11,1,8,2,13,16,19,2,3,11,13,3,5,6,4,0,0,0,7,9,3,0,1,0,1,0,4,1,1,7,0,0,16,6,6,1,0,1,1,2,9,7,8,7,7,2,9,3,9,3,1,23,0,2,1,6,2,3,8,17,7,3,3,7,9,6,0,21,1,8,2,30,2,21,1,4,4,17,4,2,5,12,3,2,1,0,6,4,11,12,16,10,0,9,4,10,1,21,3,5,5,3,5,3,1,1,9,1,5,0,10,15,1,4,9,14,0,3,2,0,0,0,5,3,12,6,5,7,3,7,3,1,0,11,1,1,3,0,3,0,6,13,0,1,0,2,12,1,0,11,1,2,0,3,2,2,6,0,7,4,3,16,7,1,0,16,8,7,1,23,1,8,7,5,8,2,32,2,8,8,6,1,8,8,6,2,0,23,8,4,25,16,8,2,13,0,1,2,11,8,1,6,1,24,0,4,3,8,3,2,0,3,4,3,1,18,0,14,3,16,8,5,0,14,14,8,0,7,0,0,3,37,2,6,3,8,21,0,13,2,5,2,5,12,0,4,13,19,10,2,19,15,0,1,8,8,5,22,2,2,1,6,9,0,3,1,1,8,4,6,4,5,3,0,5,0,6,0,6,16,7,1,5,1,1,4,15,1,0,1,0,1,3,13,2,1,5,3,2,4,4,4,4,2,2,23,2,7,4,8,18,0,5,8,0,1,3,15,14,1,3,41,1,5,0,4,11,4,2,2,8,21,1,0,7,3,0,9,4,4,9,0,0,3,1,0,4,0,0,5,45,5,8,3,7,6,2,0,6,2,2,0,3,0,3,9,6,6,0,0,11,6,9,3,1,16,4,2,4,5,5,0,0,1,3,0,3,5,16,1,7,0,3,4,4,0,2,7,5,0,1,12,6,1,2,4,2,4,13,3,2,0,16,0,2,5,0,5,4,0,9,4,7,0,4,4,0,8,3,0,14,6,0,4,2,1,10,0,2,9,15,0,7,9,3,2,1,1,3,4,1,0,1,15,0,3,5,0,10,1,3,0,5,0,6,5,3,6,2,1,1,7,6,3,2,0,4,0,3,5,3,15,2,7,1,2,10,5,2,4,2,0,0,3,5,0,27,6,16,0,11,6,1,1,2,0,1,5,4,0,1,3,4,2,13,21,1,1,2,3,0,3,8,8,5,3,5,1,3,3,2,1,6,0,3,18,3,1,0,18,30,2,0,5,0,8,10,6,0,3,4,1,7,5,5,7,0,1,0,7,4,3,0,3,0,1,2,6,20,2,1,2,3,1,12,8,7,1,4,11,3,5,1,8,1,2,3,4,20,0,1,1,1,0,0,14,3,7,1,2,1,2,9,7,6,27,0,0,6,4,3,4,3,0,11,0,1,6,8,1,0,4,5,3,2,1,0,4,3,9,1,5,6,1,2,2,7,0,13,3,0,1,8,0,0,0,3,1,13,2,3,5,6,0,7,5,26,1,2,1,1,6,0,8,11,3,2,0,2,4,4,13,0,2,1,6,0,20,2,0,15,2,0,19,9,6,21,7,2,5,0,3,1,6,0,0,6,0,1,7,0,0,1,9,2,1,6,0,1,3,26,11,0,6,6,1,3,5,2,0,1,0,0,4,3,0,0,4,6,4,3,2,4,3,0,0,1,1,3,12,0,2,0,2,1,3,4,1,14,8,6,1,7,1,0,3,0,2,0,1,3,2,2,2,3,30,2,14,5,2,2,2,8,9,8,0,8,2,1,2,1,3,3,5,3,1,9,1,0,4,0,0,0,1,1,4,0,2,3,5,10,7,6,1,4,1,7,2,7,6,4,5,4,1,2,3,1,50,5,2,1,0,4,3,6,1,5,7,1,4,2,1,1,3,4,2,1,13,4,0,0,0,5,3,3,3,2,7,0,0,2,7,7,0,0,0,8,8,0,7,1,5,1,2,3,3,4,3,5,13,8,10,4,2,0,2,28,2,9,3,1,1,12,1,12,6,0,11,0,2,2,0,2,29,0,12,1,2,3,3,2,0,5,2,0,5,2,5,0,8,5,0,4,2,2,0,2,2,3,1,12,3,0,0,3,4,1,8,1,1,3,1,0,2,1,4,0,0,1,2,0,1,0,0,0,0,7,2,0,5,1,10,3,3,3,5,6,1,0,0,3,1,0,2,0,6,1,3,1,6,0,4,6,1,4,3,0,1,0,1,2,1,6,25,1,1,5,2,0,0,1,0,0,1,4,0,1,2,5,1,4,1,4,0,5,5,0,0,3,3,1,3,0,5,3,1,0,4,1,0,4,0,3,0,3,0,0,1,1,0,2,0,1,0,2,9,1,5,0,0,1,3,1,9,2,1,0,2,5,2,0,4,4,2,2,5,7,17,10,5,0,0,4,1,5,1,10,0,4,7,0,0,0,2,5,2,2,0,3,10,1,0,5,5,2,1,1,2,1,4,0,0,4,0,0,19,4,0,6,0,13,3,6,2,5,2,0,0,1,0,1,2,0,3,1,2,5,3,1,7,2,9,1,2,9,1,4,3,0,2,3,4,4,4,2,7,0,2,1,0,1,5,1,0,0,1,2,0,1,0,0,0,0,2,6,6,2,0,2,0,0,2,6,0,2,13,0,0,0,0,2,0,3,7,0,1,2,2,2,3,7,0,13,7,1,5,0,6,3,4,1,5,0,1,0,4,2,1,0,4,8,6,0,0,9,0,3,3,2,1,0,2,1,7,0,2,0,2,4,5,0,2,14,0,5,1,0,1,1,2,0,3,0,6,4,0,3,2,3,3,0,8,9,0,0,7,1,1,3,0,0,24,1,0,0,0,9,2,2,5,0,0,0,3,0,23,2,2,3,0,0,0,1,1,2,3,0,2,2,1,8,1,1,0,1,4,1,3,5,3,1,0,13,3,0,4,0,2,0,0,0,3,7,1,0,3,3,2,1,4,0,5,0,5,0,3,7,0,5,1,1,2,2,0,1,6,3,0,4,1,2,5,3,5,2,0,0,13,0,1,4,6,0,4,1,0,0,2,0,5,3,2,4,2,1,2,2,0,0,1,1,1,2,3,4,7,3,0,3,2,0,0,2,2,8,4,2,0,0,5,0,3,2,0,4,0,7,3,4,2,0,0,14,5,0,4,0,0,0,0,8,4,0,1,13,9,3,0,0,1,3,0,0,0,3,1,5,6,4,5,1,2,0,0,2,0,0,0,2,0,1,1,2,0,7,2,3,0,4,0,0,4,1,0,2,1,0,4,0,0,1,1,8,0,6,2,1,4,1,0,7,3,1,2,5,3,2,0,0,0,4,2,3,4,0,2,1,1,0,1,0,0,0,1,3,0,3,0,3,0,2,9,0,9,7,3,0,0,3,0,0,0,4,0,4,1,2,0,4,2,0,0,6,7,4,5,1,0,1,5,0,0,2,1,1,6,0,0,0,1,2,1,0,0,1,0,2,0,5,3,10,5,2,2,10,0,4,0,9,0,3,0,0,5,8,16,1,8,4,0,28,2,4,1,1,0,2,2,11,6,1,4,0,0,3,0,4,2,6,2,2,0,1,0,3,1,6,0,5,3,0,1,2,0,1,0,1,4,6,0,0,0,0,1,2,0,2,1,0,2,1,7,9,1,0,0,3,0,7,2,0,1,4,5,0,0,0,1,0,0,0,0,3,0,0,0,0,1,3,3,1,1,0,0,0,8,2,5,18,0,15,1,2,0,1,1,4,0,1,2,0,5,3,1,0,2,2,5,0,4,0,8,3,3,3,0,2,2,3,0,2,3,1,1,2,2,7,2,1,4,1,0,4,5,2,1,0,1,2,2,0,2,4,1,0,1,0,6,0,0,0,0,0,13,1,10,3,0,0,0,0,2,0,4,5,2,7,2,8,2,3,0,1,0,0,1,0,1,0,3,4,6,1,0,5,2,0,2,0,0,0,0,4,10,0,2,1,5,0,1,0,3,23,4,4,16,0,3,4,0,5,0,0,0,3,1,1,0,0,4,6,11,4,1,0,1,4,3,0,0,5,10,1,6,7,0,1,2,5,4,3,0,2,4,2,2,2,9,0,0,0,13,2,0,2,0,0,0,0,3,1,3,4,0,4,1,4,0,12,0,1,1,2,1,3,9,11,3,0,3,5,0,1,1,0,0,0,5,4,3,6,4,0,0,1,2,0,1,6,4,3,1,3,1,0,0,0,2,4,5,2,1,10,1,3,0,3,1,0,2,0,1,4,1,7,0,2,0,0,11,2,2,3,3,2,2,2,2,2,2,8,1,14,1,4,0,0,10,0,3,1,0,3,3,2,4,4,16,6,0,1,1,2,1,0,0,3,0,1,1,0,13,1,0,4,3,1,2,0,1,0,1,0,0,0,0,4,0,0,0,4,8,0,0,5,2,0,0,8,0,0,2,0,5,0,1,2,1,1,0,1,1,0,0,0,4,0,4,0,39,0,0,0,3,4,5,1,3,2,0,2,2,1,0,1,1,1,0,3,2,0,0,4,3,2,4,0,5,3,1,4,5,4,2,1,1,4,0,0,2,0,0,0,0,3,1,0,0,0,4,0,3,3,0,2,0,0,2,0,2,5,2,0,0,0,0,3,0,1,7,1,0,1,1,1,0,0,7,3,0,1,0,4,3,0,4,0,7,1,1,0,0,2,4,4,1,5,6,1,3,1,2,5,0,2,2,1,1,0,1,0,4,1,1,0,0,1,3,0,10,2,1,0,0,1,5,1,0,0,2,1,8,2,4,1,0,3,1,0,0,0,2,0,0,11,1,2,4,9,2,0,0,0,7,4,1,0,0,0,2,0,1,0,0,1,3,11,2,1,2,3,0,2,2,4,6,2,3,1,1,3,0,1,0,37,0,0,0,4,0,1,2,0,3,0,0,5,1,2,1,6,0,6,4,2,0,0,0,2,2,3,2,1,7,0,0,5,0,0,2,0,3,0,7,0,1,0,3,4,3,3,0,0,0,5,1,0,1,1,4,0,5,1,1,15,0,1,1,0,0,0,0,2,1,5,0,0,1,1,1,8,0,0,1,0,6,0,3,3,0,1,3,2,0,0,1,1,0,1,5,1,3,0,5,2,0,1,1,5,10,0,2,0,0,1,1,1,1,0,1,3,11,0,0,7,4,0,0,1,1,21,0,0,1,1,0,0,1,0,2,4,0,1,1,0,0,1,0,0,3,1,0,0,1,0,1,1,1,1,2,1,1,0,0,0,1,0,0,1,3,3,1,0,3,0,0,4,1,2,0,0,2,0,0,3,0,0,1,6,3,0,2,1,0,0,2,0,1,0,2,1,0,0,5,4,0,1,0,2,1,0,0,0,2,3,4,2,3,2,0,0,3,6,0,2,5,0,0,0,2,0,0,6,1,1,0,2,0,0,0,0,1,0,0,2,0,0,7,2,8,7,0,5,1,0,0,1,3,1,1,0,0,6,0,0,2,1,0,0,0,1,0,4,6,1,0,0,1,0,0,0,1,1,2,0,1,0,0,0,0,1,7,1,1,0,0,0,0,0,1,0,0,0,2,1,1,0,1,6,0,1,1,1,3,4,0,5,5,1,3,0,1,2,25,0,1,0,1,1,1,1,1,0,3,2,0,1,0,0,2,1,0,19,7,2,0,2,1,0,0,0,0,0,5,1,2,3,3,2,4,1,3,0,5,1,1,0,0,0,0,0,2,0,1,3,7,2,4,0,1,0,5,4,0,1,3,0,1,1,0,0,2,3,0,0,2,0,4,1,1,2,2,5,0,0,0,1,9,0,1,8,8,3,2,3,1,0,0,3,2,0,0,0,0,0,1,4,1,1,2,5,0,6,2,3,5,1,1,4,1,0,2,1,0,0,6,1,0,0,0,0,10,3,4,7,4,1,3,0,0,66,9,0,1,0,1,1,1,2,0,1,3,43,3,0,1,2,4,0,1,6,3,1,1,0,1,1,0,0,0,10,0,7,0,2,0,0,0,2,0,5,0,0,2,1,1,3,3,1,0,2,1,1,0,0,0,0,1,2,0,1,1,3,0,1,4,0,0,0,2,2,1,0,0,0,1,0,0,0,5,0,0,0,4,24,1,16,5,0,2,2,1,0,1,0,6,0,1,1,3,1,0,0,4,0,0,1,1,3,1,23,2,65,1,6,0,0,3,2,0,4,0,8,2,1,1,0,0,0,5,1,0,3,0,1,0,1,0,1,1,0,0,5,0,1,1,0,2,3,2,0,1,0,1,3,0,2,3,1,1,1,4,0,1,1,0,5,6,1,1,1,0,0,0,4,0,2,1,5,3,2,0,4,0,1,1,5,1,1,0,1,0,0,0,0,1,0,1,0,3,2,1,1,2,0,1,1,1,0,2,0,1,0,1,0,5,0,1,3,1,3,0,0,8,2,1,2,1,0,7,2,2,0,0,0,2,1,0,5,0,2,0,2,0,1,9,5,3,0,0,1,0,0,0,1,0,0,3,0,0,0,1,0,1,1,0,5,5,1,2,1,0,0,0,1,0,0,2,1,2,6,0,1,4,0,0,0,2,0,1,0,4,3,3,1,0,1,0,0,0,3,2,2,2,1,0,0,2,0,4,0,0,0,4,3,0,3,0,0,1,0,4,0,0,3,8,1,0,1,4,2,0,6,2,0,2,0,0,3,0,1,1,4,0,9,3,4,0,0,9,1,1,7,1,7,2,0,0,2,2,2,0,1,0,2,0,0,2,0,2,0,0,0,0,0,7,3,1,0,2,1,1,0,0,0,2,2,0,2,0,0,2,1,0,0,2,1,1,0,0,0,0,3,8,5,0,7,0,0,2,0,1,0,0,2,0,1,0,0,6,0,1,10,0,1,2,0,1,3,0,1,2,0,0,0,2,0,3,3,1,0,1,0,2,2,0,0,1,0,1,0,6,0,19,0,0,1,2,5,6,0,1,1,0,0,0,3,7,3,4,9,0,0,0,1,1,0,1,3,0,3,1,7,1,0,0,5,0,0,0,2,0,0,0,1,0,2,3,1,2,0,0,1,1,0,0,1,0,1,4,4,3,0,0,0,0,1,0,1,1,3,0,0,1,1,0,0,0,2,0,3,1,0,0,0,0,0,4,1,0,2,8,3,2,0,0,0,1,1,3,0,2,3,3,1,1,0,0,0,0,0,0,0,6,1,4,2,0,2,0,0,0,1,0,0,1,0,1,0,0,0,0,2,0,2,0,5,6,3,2,1,0,0,1,0,1,1,1,1,7,0,0,0,4,12,2,0,5,2,0,0,3,1,0,0,0,1,0,1,0,0,1,0,1,2,0,1,0,1,1,0,0,0,0,0,4,0,0,1,3,0,0,2,0,0,0,1,0,1,1,0,1,2,1,1,0,3,2,8,0,1,1,10,0,0,3,1,2,0,1,2,1,3,0,0,0,1,0,1,0,2,1,0,5,2,1,3,0,2,0,8,0,0,0,1,0,3,2,3,2,3,0,2,2,3,0,0,1,0,0,0,0,0,1,1,1,1,0,1,1,1,2,0,7,3,1,0,1,0,0,2,0,0,0,0,0,0,0,0,1,0,0,0,1,0,0,1,0,1,5,0,1,3,1,0,4,0,0,0,0,1,0,3,3,0,0,1,3,0,2,2,0,0,0,0,0,0,1,0,0,3,2,0,1,6,1,0,0,0,0,0,3,0,0,1,5,4,2,1,0,5,0,0,0,0,0,0,3,0,7,0,2,0,3,0,0,0,0,0,0,0,1,0,0,0,0,1,2,0,0,2,0,0,0,0,0,0,0,0,0,0,0,0,0,0,0,0,0,0,0,0,1,0,0,0,1,0,0,0,0,0,0,0,0,0,0,0,0,0,0,0,0,0,0,0,0,0,0,3,0,0,0,3,0,0,0,0,0,0,0,0,0,0,0,0,0,0,0,0
K22 The Tommyknockers,king,13924,6558,5791,6324,5798,1613,4624,4148,4721,4280,2207,2770,3024,2383,2126,2003,3457,1494,1410,1060,1697,1849,1512,999,276,1072,374,1291,1260,515,962,1159,908,989,984,889,985,1235,305,1008,975,1115,1064,912,540,718,824,694,972,787,787,702,757,769,567,577,1056,434,568,737,610,362,498,670,366,582,425,560,286,453,526,276,348,368,462,502,393,475,465,380,420,290,282,439,384,560,272,260,403,322,156,395,426,287,361,303,356,247,345,370,263,399,486,329,650,473,381,458,254,409,314,481,79,360,319,161,293,272,242,277,186,114,319,367,138,166,290,239,290,156,339,347,219,142,250,265,47,236,256,199,154,163,88,173,279,252,187,290,159,255,206,244,226,194,198,92,107,184,238,203,194,293,263,295,143,279,146,157,209,243,44,144,279,132,89,170,108,180,284,171,144,159,185,161,141,102,112,151,173,103,121,128,203,156,104,140,56,103,99,46,88,246,156,163,112,79,97,96,147,224,91,136,93,93,97,112,155,210,148,108,95,215,140,105,113,179,85,85,72,255,240,122,125,238,117,53,64,130,94,90,73,69,145,64,118,109,141,201,104,186,150,122,104,67,160,82,81,87,108,111,129,118,141,146,150,70,98,97,124,126,134,59,152,107,53,119,128,81,292,112,78,62,117,99,274,55,102,73,61,190,106,22,76,29,136,87,104,109,45,97,131,79,103,74,246,70,29,44,65,70,83,21,41,138,128,76,76,87,94,49,131,115,82,78,91,62,140,84,90,76,147,92,88,96,150,122,85,40,39,116,60,56,65,41,58,56,129,54,65,72,127,30,113,93,153,21,42,174,64,66,93,55,47,27,42,74,92,78,71,98,86,69,77,52,93,122,53,79,87,47,64,67,85,29,56,79,0,58,52,88,71,43,46,84,105,103,50,88,70,84,33,120,73,46,85,65,66,64,45,91,98,54,68,291,74,86,66,71,40,103,82,139,16,56,34,93,56,56,52,53,87,45,52,84,9,170,80,52,27,75,56,32,36,86,41,34,154,45,57,64,65,63,52,135,52,55,46,46,63,74,74,28,1,16,46,26,33,65,21,42,27,72,75,46,60,63,85,21,0,38,59,67,36,58,34,116,46,43,86,51,83,49,149,23,56,40,47,59,23,68,38,53,24,36,103,22,35,48,45,55,72,64,72,68,66,42,0,36,55,64,77,90,42,12,47,66,60,32,52,86,58,56,52,45,36,10,84,76,62,53,87,22,86,33,78,49,0,11,65,100,66,35,70,9,44,38,67,80,28,3,19,44,50,56,31,61,30,40,29,45,54,43,48,22,34,43,31,40,23,29,20,99,37,45,11,43,18,94,125,26,36,41,37,24,84,56,17,43,29,49,56,66,87,48,23,2,1,52,18,28,17,23,70,42,31,37,69,25,18,42,22,43,37,64,38,56,41,74,69,26,32,55,33,26,30,0,55,50,53,70,28,10,25,28,41,37,57,20,20,66,0,35,41,44,81,48,78,9,25,17,30,32,58,32,30,33,48,27,59,42,78,41,19,6,43,30,20,50,29,10,32,26,27,20,101,38,1,74,38,21,41,14,21,27,11,34,29,3,71,48,23,21,116,53,35,38,6,28,45,45,10,56,9,48,33,91,12,31,38,29,28,92,13,4,50,56,99,16,30,35,40,24,22,8,0,129,29,30,22,33,131,55,22,65,13,5,36,35,44,36,14,24,31,17,12,18,23,12,21,23,33,55,47,121,8,34,18,8,39,38,36,21,28,9,2,18,15,42,12,26,27,25,15,22,43,56,70,48,16,19,47,12,8,36,21,23,3,45,4,23,36,22,41,29,124,27,100,37,24,48,14,61,51,14,54,22,7,1,12,68,19,16,46,57,41,20,13,34,31,50,13,7,176,28,1,39,58,16,2,8,28,16,24,18,42,18,22,0,23,33,28,39,103,13,19,32,9,30,13,46,35,22,31,31,22,35,18,0,28,37,29,45,32,18,0,19,35,41,13,39,67,34,43,29,10,32,55,25,19,29,31,10,8,6,25,54,17,14,102,57,12,7,17,24,15,25,81,38,43,72,34,0,35,0,11,24,20,11,56,21,25,7,18,9,10,24,10,1,104,2,47,15,20,2,9,22,15,31,22,33,16,113,21,43,25,17,22,18,10,30,13,21,39,5,8,39,52,37,17,23,1,30,23,2,7,17,36,14,18,17,19,81,37,20,18,53,18,31,13,15,5,42,27,6,20,30,32,0,27,24,23,16,35,34,18,26,1,13,37,0,19,1,20,1,11,37,0,1,16,37,7,5,17,17,24,47,25,1,16,28,3,33,12,1,14,11,35,25,93,37,29,47,31,17,20,7,38,13,16,43,36,9,10,20,36,13,19,49,17,28,38,14,10,8,18,0,41,32,7,31,18,29,0,7,16,9,21,10,9,0,0,4,31,27,17,15,8,0,20,45,7,10,38,23,12,8,13,28,16,0,5,0,31,24,7,31,69,15,47,14,9,25,29,15,18,24,20,19,33,31,18,46,14,13,0,2,14,3,36,45,24,43,20,29,24,12,27,42,13,238,15,14,21,8,20,42,32,26,6,15,30,10,7,24,21,7,37,18,30,13,38,7,30,18,13,12,11,8,23,27,1,25,11,32,0,6,17,44,0,1,1,20,77,17,17,34,4,45,30,1,15,63,2,17,26,41,0,1,8,0,20,32,1,35,15,16,13,25,20,38,18,0,18,13,44,10,4,5,23,23,0,2,25,18,17,0,0,19,24,12,27,17,20,6,74,13,8,39,13,21,28,24,4,16,45,0,4,14,26,26,19,8,21,0,5,4,1,3,16,11,13,35,20,28,7,33,25,29,22,34,43,0,11,21,1,11,13,7,26,40,1,26,32,8,0,11,31,18,0,19,40,25,20,13,46,25,21,10,16,14,0,10,15,14,20,17,9,66,4,29,8,36,43,21,29,19,6,9,7,4,43,4,6,15,6,26,36,37,3,25,41,8,8,5,13,16,11,23,6,15,6,14,31,13,28,29,10,25,31,26,23,38,26,0,6,35,11,13,16,2,26,10,8,11,33,4,8,22,17,9,4,6,16,5,17,10,16,13,11,25,2,24,51,11,13,0,0,10,0,29,10,0,11,22,5,28,12,20,27,9,29,23,24,5,8,35,5,0,16,14,0,6,0,19,0,24,205,0,12,6,13,38,16,16,0,18,21,13,23,20,13,11,6,4,31,16,2,3,18,14,16,10,0,0,4,22,18,12,21,30,10,13,4,25,2,21,10,17,23,9,10,20,0,16,12,0,80,19,24,7,5,25,20,0,27,13,16,2,14,6,45,5,9,12,1,5,9,12,7,17,8,14,18,20,4,31,16,84,1,10,15,21,5,23,3,6,6,14,14,21,39,6,10,0,0,14,0,10,9,3,13,4,7,6,28,34,5,0,9,7,9,29,22,16,32,15,7,10,6,15,4,14,29,31,6,2,13,7,11,7,14,19,15,20,17,11,11,0,49,9,16,24,27,2,14,2,11,26,22,11,7,25,17,3,11,10,15,15,20,29,26,30,25,0,14,10,26,1,63,17,7,8,15,17,10,8,12,16,3,19,0,25,31,6,6,10,36,1,17,20,0,5,0,19,12,10,10,18,23,12,13,21,7,4,21,13,0,6,0,20,1,12,31,0,1,11,1,5,4,6,14,1,2,0,7,12,13,7,9,26,17,7,26,18,2,0,213,10,10,1,6,7,19,5,10,11,4,16,1,26,17,45,18,9,13,15,20,0,19,7,18,18,35,10,11,17,2,2,2,12,21,18,44,12,13,0,18,27,8,10,7,0,23,9,16,29,21,2,19,11,11,1,14,6,9,9,46,10,9,6,31,9,24,6,10,12,7,6,0,31,7,10,6,6,12,0,21,163,7,17,19,2,33,0,10,21,8,9,38,14,7,8,30,10,0,16,11,10,28,12,18,4,6,5,0,13,1,11,4,35,14,5,11,6,9,5,2,15,17,0,3,1,6,13,8,0,6,9,5,4,9,15,12,17,7,17,18,3,7,4,16,34,0,19,9,5,9,9,15,21,7,8,5,2,8,1,6,8,5,9,19,11,54,5,2,21,7,1,9,6,20,23,0,0,15,4,0,2,0,6,0,72,10,7,1,12,17,2,0,20,2,18,0,13,8,14,43,17,8,4,14,0,9,11,12,16,26,18,7,8,12,3,9,18,8,3,5,4,6,28,1,12,12,23,4,12,5,6,10,33,0,5,15,9,2,3,16,8,14,7,10,4,0,11,12,2,7,3,5,12,0,46,9,11,0,10,10,8,5,26,0,29,10,3,20,5,5,11,18,7,22,3,0,5,16,22,18,5,17,7,6,2,0,11,2,0,10,7,0,6,3,5,0,14,3,13,4,29,8,5,6,17,6,18,5,3,1,16,1,9,40,5,8,3,21,12,6,18,3,15,4,17,0,0,4,8,8,12,8,9,4,15,15,10,10,5,19,6,9,6,4,3,8,5,5,6,8,0,8,7,6,2,10,12,3,15,6,4,1,2,8,4,8,28,3,21,30,0,3,2,6,6,8,10,9,0,7,15,2,0,22,2,7,15,12,5,13,10,14,3,30,13,3,0,2,8,9,4,5,14,11,20,8,20,9,20,16,18,4,3,13,9,5,8,8,9,5,5,15,8,1,0,4,9,0,0,40,14,13,3,15,0,10,13,14,19,2,0,1,15,7,13,12,14,5,23,0,6,15,31,5,1,14,10,11,12,0,1,14,2,6,6,5,17,11,7,1,2,0,32,16,0,5,16,0,0,3,6,17,13,10,16,10,11,0,19,17,24,11,3,11,6,11,1,6,22,8,2,0,6,7,13,2,1,16,0,9,5,40,8,0,14,2,2,27,7,8,2,10,30,22,4,15,61,3,1,0,3,0,6,51,0,0,0,10,10,15,9,2,0,5,17,17,10,8,20,4,7,17,6,0,5,8,7,12,16,0,0,19,7,5,14,4,15,5,0,4,1,1,13,11,5,2,1,2,12,3,12,2,3,5,7,1,12,16,5,9,0,4,0,5,6,12,3,8,10,16,4,4,3,5,21,1,6,13,13,1,16,3,0,2,5,3,1,6,9,5,29,8,1,3,0,1,4,4,7,16,5,3,9,2,16,5,13,6,1,3,8,15,4,20,14,6,6,4,4,5,10,33,14,11,2,6,17,1,16,19,5,3,2,10,4,2,11,9,8,5,5,6,5,1,4,0,15,12,15,14,15,10,4,3,11,4,10,2,2,6,4,16,2,13,3,11,4,12,1,9,4,25,3,17,3,2,9,5,4,10,12,1,2,9,3,6,6,7,14,12,21,20,0,4,6,6,3,26,0,37,16,14,12,1,9,0,4,42,0,1,6,5,5,24,5,6,8,3,2,1,9,0,12,3,15,15,0,1,15,8,4,9,8,7,3,11,1,16,2,2,0,0,26,4,0,3,4,24,4,15,12,8,0,9,7,22,3,4,1,12,9,6,1,0,9,15,10,4,0,16,6,15,3,66,3,1,13,3,11,33,0,10,6,14,1,8,9,7,14,12,14,3,0,0,16,8,4,6,7,1,2,7,15,21,8,12,22,0,21,7,0,5,7,12,0,7,10,8,7,15,11,3,7,2,1,0,11,5,5,16,0,5,3,6,7,0,0,0,12,6,9,9,3,7,1,2,5,3,3,1,0,4,8,2,0,9,15,8,6,3,8,10,10,11,0,4,2,6,24,11,3,4,5,12,2,0,2,0,18,14,3,0,9,10,3,12,10,7,8,3,4,3,2,2,0,0,8,0,0,11,20,0,19,1,26,5,1,9,5,3,1,0,2,18,4,2,6,9,3,5,3,9,9,17,4,14,9,21,22,6,4,5,86,4,1,28,4,3,5,8,1,13,14,1,1,2,4,2,6,5,3,7,5,6,23,0,3,6,6,2,12,3,0,7,3,10,3,2,2,10,11,0,0,0,6,15,1,7,5,0,10,16,5,5,12,4,14,5,4,3,2,7,12,9,0,3,9,7,2,7,3,6,1,1,6,5,6,8,8,0,8,7,1,2,0,9,7,5,0,4,6,6,2,7,8,4,29,2,4,1,3,1,6,3,13,14,2,5,8,3,5,8,12,4,4,18,5,3,7,14,5,2,60,6,0,36,4,11,1,5,18,3,5,5,3,6,2,2,0,4,7,7,20,0,0,2,3,3,1,5,0,3,4,7,17,0,6,0,2,5,7,3,6,13,5,0,48,5,0,11,6,5,12,6,12,17,11,5,0,9,3,14,2,5,2,4,1,14,0,14,22,3,6,13,7,1,2,0,12,15,8,1,14,2,53,13,4,7,11,9,0,20,7,6,3,9,3,15,4,1,1,4,5,12,2,5,1,30,1,16,3,2,0,1,5,8,3,0,4,1,1,9,1,3,0,3,3,8,4,5,4,2,8,4,3,2,14,0,7,0,16,10,7,4,8,2,10,8,2,6,0,9,5,15,16,2,0,4,11,8,4,5,0,4,6,0,0,1,5,0,29,11,4,15,2,3,0,1,6,0,0,1,0,7,3,7,8,2,14,6,20,2,12,0,2,24,13,0,5,9,13,28,5,0,8,13,20,1,16,2,13,5,5,0,7,6,2,7,13,4,2,0,1,3,5,0,1,0,0,1,8,3,0,0,2,9,0,11,10,9,2,5,4,0,2,18,7,19,9,15,1,0,4,9,0,6,1,4,14,1,6,3,12,1,0,0,8,16,6,11,9,0,2,3,1,0,2,2,2,5,0,0,1,10,12,10,5,1,1,0,9,4,4,8,3,15,3,10,30,7,5,3,18,0,18,0,2,8,12,15,5,5,2,0,5,4,16,2,11,3,5,1,7,17,7,4,1,1,4,1,7,21,10,3,3,0,4,4,2,4,4,6,7,2,0,4,3,0,7,1,19,7,15,3,8,0,11,17,4,37,2,3,0,2,0,12,20,8,3,1,5,4,9,5,3,4,17,4,1,0,0,6,3,1,2,0,6,0,3,1,6,4,9,3,3,2,16,7,0,9,24,4,7,0,2,1,0,4,2,5,11,0,25,2,7,21,3,3,6,8,20,16,9,0,1,1,1,3,6,1,2,10,6,0,4,5,1,3,2,10,1,8,5,0,12,0,3,2,5,7,1,5,6,6,0,28,36,7,8,7,0,15,9,9,12,4,3,20,2,0,5,5,5,27,0,11,1,5,10,2,11,3,15,0,18,15,8,8,2,1,0,2,21,7,10,5,3,4,15,4,2,3,5,0,0,4,8,13,6,7,13,4,57,5,0,20,34,11,9,1,2,12,2,0,12,3,0,2,3,6,3,8,3,7,14,25,6,2,0,6,0,2,1,0,5,14,8,19,7,0,3,25,17,4,1,16,2,0,9,3,2,2,4,2,1,9,7,2,5,3,0,1,3,11,4,2,3,3,7,5,2,2,8,0,1,1,7,5,4,6,3,15,0,2,7,4,5,5,11,0,4,11,0,6,4,30,0,0,4,2,0,8,4,5,2,4,3,1,8,0,0,8,29,3,5,2,8,5,0,0,9,2,2,8,0,4,9,2,7,3,16,2,2,5,2,1,2,3,6,7,3,6,4,0,2,3,11,7,1,1,3,11,1,5,0,0,0,8,1,3,32,4,15,2,8,6,2,0,9,1,8,0,1,1,0,12,0,8,23,33,6,6,4,0,0,0,0,1,1,0,4,3,0,3,6,2,1,4,5,5,2,6,8,3,3,2,7,0,0,9,1,2,3,0,71,9,7,3,1,7,0,3,0,24,0,3,0,11,3,3,3,6,4,2,0,2,14,0,2,1,1,0,6,4,4,1,4,5,2,0,3,5,5,0,4,7,5,11,6,3,3,0,0,4,0,0,0,0,4,7,0,5,0,4,7,6,6,6,7,4,0,3,2,3,15,0,4,0,4,3,5,1,0,8,2,1,2,2,8,1,0,3,6,1,2,3,5,16,5,2,0,3,0,0,0,7,9,7,3,9,6,25,6,4,4,13,5,2,5,4,1,11,1,0,7,1,2,6,2,10,4,0,5,8,5,4,0,0,1,4,0,0,0,9,7,11,7,14,23,3,1,2,6,1,2,8,0,1,11,0,6,8,9,3,0,1,1,6,1,3,2,0,1,14,3,9,2,0,3,9,4,9,3,1,3,6,12,2,6,10,7,9,3,0,0,2,0,0,3,6,0,6,2,4,1,4,1,8,5,0,10,1,10,7,14,1,11,1,1,4,0,17,13,4,3,3,1,5,6,2,2,1,4,7,2,7,5,14,30,2,2,14,5,1,7,0,0,0,4,5,8,2,0,4,3,10,1,9,5,5,9,4,1,7,0,5,0,3,5,1,2,13,3,7,11,1,2,0,0,6,0,5,8,2,1,2,10,1,4,3,0,0,14,11,4,16,0,3,2,0,3,1,5,5,1,3,0,3,0,1,0,0,0,5,7,7,1,1,13,19,0,4,6,0,8,6,0,1,6,1,0,1,13,1,1,0,3,5,0,0,4,1,0,6,0,9,6,6,0,4,3,1,1,1,5,9,0,3,3,4,2,1,0,2,4,4,2,2,3,3,3,5,4,6,0,7,2,4,4,0,0,4,5,1,0,8,4,0,1,0,5,2,3,6,1,3,1,17,11,8,3,3,1,2,5,3,3,0,1,8,9,37,9,2,1,13,3,0,3,1,0,2,0,0,1,4,8,2,3,0,9,0,4,0,2,5,6,12,2,2,5,1,9,6,11,1,10,5,0,1,1,20,3,0,0,0,19,0,4,16,3,0,0,6,2,0,9,1,4,2,2,4,0,3,1,8,2,1,3,1,0,0,14,1,3,3,10,2,5,3,0,4,0,10,0,15,7,4,22,2,0,3,4,3,7,5,6,10,5,11,2,5,1,6,6,0,8,6,2,6,0,4,4,4,9,0,0,2,4,1,2,2,0,4,5,0,5,4,1,0,1,2,4,1,0,0,0,10,1,8,2,5,10,1,7,2,0,16,6,3,1,4,4,4,0,7,0,6,3,13,5,1,0,1,3,10,4,1,15,4,1,1,3,6,1,8,10,0,0,6,1,1,7,7,1,1,3,3,0,13,5,4,3,1,14,9,10,13,0,0,4,0,5,11,0,5,3,0,0,5,6,8,3,4,5,0,5,2,5,8,2,2,7,3,0,12,4,3,4,8,9,7,0,0,2,4,19,9,7,22,6,8,0,3,0,15,2,2,1,6,13,2,4,2,2,5,8,9,0,2,1,5,2,9,6,12,6,7,0,5,40,0,0,2,0,0,2,0,6,0,2,0,5,9,11,1,6,2,4,5,0,2,7,0,13,1,1,1,1,0,5,2,3,0,4,10,3,4,6,5,3,0,0,3,1,0,29,1,0,0,0,1,0,1,0,0,2,4,0,17,18,0,1,4,6,4,1,4,0,7,4,0,9,11,0,1,6,5,0,0,1,3,1,7,30,14,0,1,7,2,3,4,2,0,7,6,6,12,1,3,0,1,1,2,0,0,6,3,2,6,1,3,0,2,1,0,3,0,2,2,5,1,8,0,0,5,1,1,2,0,4,10,1,8,3,6,4,2,0,1,14,2,3,0,2,0,4,0,1,12,8,5,6,5,7,6,4,3,3,9,3,4,1,8,6,3,305,10,33,0,0,0,7,2,5,3,5,11,5,0,5,2,0,8,3,7,0,1,9,2,9,3,1,1,3,3,0,5,5,11,1,12,2,10,3,4,1,0,1,2,0,7,8,6,25,1,8,2,6,12,6,10,0,3,2,2,3,0,15,0,0,2,4,19,2,2,1,3,0,1,14,12,3,0,10,0,3,5,3,1,0,4,2,2,3,3,3,17,4,0,8,3,2,7,0,1,6,4,5,2,5,4,0,0,4,6,7,5,2,4,3,2,4,2,1,0,0,0,3,0,2,0,0,2,1,4,0,2,25,15,0,0,55,2,0,2,6,7,3,2,6,5,0,2,0,2,5,0,5,8,9,3,0,0,1,3,17,5,2,1,3,0,18,7,6,4,6,0,4,1,2,2,5,7,2,5,3,2,1,9,2,0,0,4,3,6,1,0,2,8,8,0,12,5,4,2,0,3,2,1,11,2,2,0,0,2,0,17,7,2,4,2,5,5,0,0,1,0,3,3,11,8,0,2,0,6,2,6,5,5,1,1,15,2,4,0,1,2,1,0,0,8,0,4,1,7,1,2,3,4,3,4,23,5,2,21,7,2,6,7,0,7,2,1,1,1,0,1,0,2,25,3,3,7,9,5,0,4,1,3,11,0,5,1,4,3,2,2,1,3,4,0,1,0,4,3,0,1,2,0,4,2,0,5,0,0,0,1,0,0,5,1,2,2,1,1,3,0,1,1,4,4,10,0,2,0,3,3,2,2,4,0,3,0,3,0,2,0,1,6,2,1,3,1,0,14,0,10,1,8,5,4,5,2,0,1,3,3,0,0,0,6,4,0,0,4,2,2,0,8,8,2,1,0,0,1,2,2,14,5,0,0,4,0,1,3,12,0,2,0,1,10,4,1,7,0,2,3,0,19,1,5,8,11,2,1,0,4,2,3,2,9,6,1,4,2,2,0,2,0,0,1,1,1,2,0,0,0,15,4,0,3,3,7,5,0,1,0,9,5,11,0,1,5,0,0,1,2,0,0,3,1,8,1,0,0,16,3,0,2,2,3,10,1,1,4,2,1,3,1,2,0,4,3,4,1,4,2,2,0,1,9,4,0,3,12,1,3,4,4,3,0,5,1,15,0,3,4,4,0,8,4,0,2,3,0,8,1,6,0,0,0,1,6,1,1,0,2,4,1,1,0,1,8,2,0,1,1,6,0,2,1,1,0,5,0,0,0,2,5,0,0,3,0,2,0,2,7,0,0,0,1,22,4,1,0,0,0,1,11,3,6,0,0,6,0,3,1,3,0,1,4,3,2,2,0,1,0,0,1,1,7,1,2,0,2,1,4,4,0,4,0,2,35,1,6,60,4,1,21,1,5,7,1,6,1,2,0,1,0,0,21,3,2,1,1,0,19,0,0,0,3,0,0,6,7,0,0,2,2,38,0,0,1,1,0,0,3,0,1,0,0,0,0,0,0,0,6,7,1,0,3,0,0,0,2,0,3,0,9,3,1,0,0,0,0,0,0,0,0,15,0,0,0,0,1,0,0,0,0,3,5,1,0,0,0,21,0,0,0,0,0,0,0,0,0,0,0,0,0,0,0,0
K23 The Dark Half,king,8224,3965,3724,3654,3338,1530,3926,2271,2744,2593,1651,1964,1689,864,825,1181,1792,928,822,879,1088,1177,856,854,251,838,357,712,641,482,537,627,682,714,656,678,615,644,192,685,796,533,624,419,417,495,502,399,602,450,452,490,473,428,339,284,536,404,465,515,348,324,388,361,292,323,223,267,303,368,259,233,213,208,236,271,270,366,216,232,183,203,301,336,287,310,203,176,267,195,131,180,283,138,307,176,176,208,196,196,152,283,241,200,340,373,220,309,213,208,168,163,61,166,216,149,130,172,149,142,190,128,154,176,108,130,141,143,157,164,178,161,195,103,237,160,28,155,176,142,130,133,82,140,228,133,141,231,122,158,76,220,150,121,102,117,83,73,111,190,112,153,181,170,88,119,164,90,117,135,43,73,119,96,98,90,74,113,138,149,81,114,162,86,86,57,89,93,121,49,61,50,117,129,65,79,9,72,53,37,62,150,95,119,80,71,52,90,74,87,20,113,49,63,58,59,93,82,73,59,60,83,133,73,133,67,77,101,70,156,127,88,43,202,63,17,52,65,64,43,56,61,54,43,72,73,51,91,82,138,76,31,72,46,61,72,70,51,78,61,88,51,70,84,97,16,75,49,45,63,70,45,97,52,47,52,34,50,155,98,50,44,68,57,166,15,75,35,45,39,59,45,90,12,45,56,72,87,17,61,97,49,87,40,160,61,24,14,32,70,66,27,52,98,54,58,51,31,46,44,54,85,44,38,22,50,63,97,63,69,66,118,82,61,56,53,55,25,59,81,24,30,31,76,50,45,48,81,47,46,125,19,62,36,121,20,48,80,38,34,37,46,56,4,38,29,51,49,49,56,30,34,41,43,34,63,28,94,44,61,68,44,32,34,24,131,0,35,51,41,22,35,61,28,41,84,34,31,39,47,14,76,38,78,41,21,39,52,30,29,40,37,41,46,47,50,47,42,25,70,38,2,3,44,31,74,29,27,49,26,64,33,32,60,18,17,70,64,45,53,23,17,20,67,38,74,73,50,35,40,42,17,16,91,46,49,23,64,32,30,43,20,0,31,22,25,27,15,22,25,17,63,40,14,33,30,16,29,0,24,19,29,34,35,11,30,35,17,36,9,31,15,19,13,39,20,37,41,3,43,28,48,47,24,20,28,8,38,61,25,31,51,35,24,20,48,0,24,36,30,58,19,47,21,41,26,34,50,42,58,18,18,29,22,18,3,45,76,20,29,37,7,46,27,21,27,0,6,30,34,21,66,27,10,31,18,37,58,22,41,11,47,39,45,22,50,39,16,16,13,30,27,28,32,13,14,10,7,13,22,33,47,21,17,21,24,16,61,18,17,24,20,24,12,39,38,4,15,23,21,36,19,39,17,6,0,2,36,23,27,12,23,24,21,2,25,20,20,16,22,9,27,5,16,19,29,15,31,18,4,23,26,16,11,25,0,21,11,23,27,14,6,15,18,17,32,38,19,24,24,0,31,30,40,27,25,27,4,13,13,21,18,27,13,19,17,21,22,24,21,32,17,19,8,15,8,23,33,34,4,19,24,23,13,52,27,0,24,22,18,40,8,20,36,14,14,16,1,11,22,25,11,31,28,29,14,2,14,12,19,11,32,3,15,13,16,19,25,26,18,5,49,10,2,27,30,88,11,26,30,17,23,4,6,0,58,13,11,14,9,48,28,55,45,1,0,14,30,24,5,9,8,15,13,13,29,28,6,15,8,16,5,30,35,12,45,20,9,24,16,25,6,22,20,3,20,5,27,6,23,20,13,7,2,23,10,20,13,11,14,25,7,0,23,11,39,15,16,0,8,12,7,13,26,2,11,66,27,21,22,8,42,30,0,19,16,6,0,12,50,19,61,29,22,31,15,10,8,3,16,10,3,14,37,17,20,9,26,0,15,19,4,14,14,38,11,13,0,17,22,23,14,2,9,16,2,6,8,82,41,23,8,10,13,16,23,68,0,20,26,22,13,26,19,0,10,6,17,16,22,23,23,28,13,10,11,12,17,12,34,19,10,14,12,16,48,13,0,15,42,5,7,16,20,32,13,45,10,15,58,21,0,15,1,11,4,8,14,34,13,12,2,17,10,6,11,6,0,44,4,34,7,4,4,5,18,10,19,11,23,18,32,30,10,6,12,18,15,10,12,16,18,22,7,5,33,2,13,16,13,0,30,8,0,24,13,18,3,2,3,24,2,11,20,9,18,3,19,22,11,2,41,11,14,16,20,25,1,14,11,12,9,28,5,3,13,2,8,28,0,7,0,10,1,15,23,0,0,11,17,7,6,44,1,15,9,18,0,2,18,1,17,13,8,17,7,20,5,18,7,8,14,10,13,19,13,18,6,6,17,19,6,2,11,34,7,15,16,6,16,13,10,3,9,6,0,18,17,5,30,11,18,0,9,13,14,14,11,1,0,0,15,22,15,12,12,6,0,10,11,30,8,1,7,9,8,0,13,10,4,22,0,23,8,11,9,26,14,22,10,18,3,24,11,6,12,11,13,12,20,14,30,2,22,0,0,4,1,24,9,10,14,7,16,8,9,14,28,8,1,12,3,20,1,13,21,12,7,9,3,18,1,1,18,8,8,22,7,14,9,13,12,15,9,17,4,23,6,2,60,1,10,18,12,0,4,2,9,1,2,91,4,29,5,6,15,1,3,19,0,14,5,3,7,12,19,0,1,13,0,15,18,0,15,9,8,8,4,7,25,19,0,16,5,67,6,1,5,21,10,0,6,20,4,8,0,0,9,12,6,9,7,11,1,17,18,12,51,13,12,18,17,1,12,12,0,4,6,2,15,3,0,10,2,1,4,0,8,12,14,6,20,8,12,7,9,11,6,2,11,9,0,6,18,0,6,13,4,16,14,0,15,27,8,0,9,12,16,0,1,15,10,4,14,28,13,9,10,8,12,0,4,15,12,6,5,4,14,1,109,9,13,9,10,11,25,2,8,6,3,2,0,3,17,9,7,9,27,1,7,11,8,2,0,11,3,16,7,13,7,1,4,38,7,1,15,5,7,8,8,5,23,5,0,8,9,3,11,4,2,4,9,13,14,8,1,16,11,6,1,1,3,21,4,11,3,23,5,10,14,20,16,20,28,24,0,0,30,0,50,0,0,4,23,7,8,3,4,5,4,15,18,25,48,0,3,3,1,11,1,0,6,0,13,0,9,0,0,16,12,6,10,7,1,0,6,18,4,6,10,6,16,3,7,1,13,19,0,13,6,8,5,0,0,2,8,15,7,2,12,10,22,7,9,1,14,3,12,12,5,5,6,3,24,4,0,6,16,12,13,5,18,8,0,4,6,8,0,8,7,18,6,8,13,0,2,5,11,4,13,14,10,4,7,14,5,13,20,6,18,9,8,3,15,5,5,0,0,3,9,16,1,1,0,0,120,0,4,7,0,17,2,2,8,17,17,4,0,1,9,2,10,9,4,11,8,1,6,6,12,7,11,22,3,4,0,3,3,45,7,11,10,14,3,11,2,3,1,5,4,7,7,9,9,8,0,5,1,10,8,26,25,3,5,6,7,3,8,13,16,14,11,18,0,14,5,7,11,16,7,8,5,8,9,8,9,13,9,18,11,0,16,11,289,4,7,18,0,10,11,2,10,0,10,8,7,7,12,10,6,3,19,5,11,23,5,0,4,1,7,1,13,15,0,2,13,3,8,2,6,6,17,9,5,2,4,9,9,3,17,10,0,11,17,0,14,3,11,7,2,2,2,28,0,3,7,4,16,5,12,5,20,6,2,6,4,8,0,6,12,8,11,31,19,4,12,2,6,1,4,3,8,45,1,32,2,2,5,4,22,4,0,2,5,0,5,11,1,10,11,4,5,6,2,2,3,8,8,5,1,2,5,35,1,6,4,2,7,0,32,11,20,1,5,7,0,9,10,5,5,2,11,19,0,3,9,6,6,9,2,14,2,13,14,0,8,2,3,10,2,7,4,2,1,1,7,1,6,10,18,3,3,9,2,0,2,2,10,5,0,2,2,0,4,4,13,3,7,2,5,2,7,4,9,3,13,5,4,6,6,7,17,0,5,17,3,3,2,16,16,2,6,12,5,9,4,8,2,0,1,3,15,8,10,1,12,4,1,7,5,8,11,0,0,3,5,0,2,0,0,0,33,8,6,1,6,1,3,0,4,2,25,7,5,0,7,14,2,6,4,7,12,5,7,8,3,11,14,4,5,5,2,5,21,3,4,0,3,1,16,3,4,0,3,4,7,5,1,4,17,0,4,5,1,2,14,6,4,9,14,17,11,0,3,3,1,2,0,6,13,0,25,2,8,0,3,3,3,10,9,0,7,8,0,8,1,5,9,2,4,9,1,0,5,14,12,7,6,14,6,2,1,0,3,9,0,5,5,0,34,9,2,0,22,0,6,7,0,1,0,2,11,9,3,2,3,0,3,2,11,13,6,13,6,12,2,3,9,13,24,2,2,0,0,6,5,4,11,12,8,1,9,14,23,7,1,2,4,3,1,2,6,3,6,8,4,6,0,3,2,2,1,1,5,3,9,6,6,4,10,5,8,1,12,0,8,35,2,4,2,12,26,6,5,5,0,3,9,7,0,3,1,3,0,5,3,3,0,6,4,21,4,0,0,0,9,2,12,3,10,10,10,14,8,6,16,9,21,1,0,22,3,8,11,5,1,1,6,9,3,0,2,5,7,0,0,23,2,1,1,7,1,7,10,5,3,0,0,1,5,5,0,2,10,1,8,1,1,4,13,0,0,6,4,7,3,0,0,10,3,7,1,11,2,8,0,2,2,0,0,11,0,9,5,0,0,5,3,7,9,3,15,8,7,0,12,10,21,5,2,2,4,5,0,17,10,2,9,0,5,1,1,0,0,9,0,9,4,18,5,0,16,0,1,9,8,4,3,8,20,2,1,4,0,8,1,0,3,2,4,6,0,0,0,2,13,3,4,4,1,2,12,7,1,7,0,13,4,2,5,0,6,14,1,11,10,0,0,6,13,2,2,3,9,7,0,0,2,0,3,10,1,0,0,2,4,2,4,3,7,4,0,6,5,2,2,7,3,2,0,4,2,2,2,6,3,9,8,12,4,3,6,67,2,3,7,1,6,1,0,1,0,1,3,5,3,4,20,3,3,6,2,3,3,3,0,18,10,8,36,9,8,22,2,1,4,6,2,1,14,7,3,4,9,4,5,0,8,23,12,2,10,4,14,31,10,6,7,0,10,6,4,4,5,7,7,3,2,5,8,3,1,0,17,7,1,6,3,4,0,0,4,4,11,0,0,1,3,10,0,7,4,7,5,9,1,9,6,2,5,18,4,12,2,0,6,3,10,0,2,6,1,8,9,3,9,5,4,4,2,3,0,1,7,24,0,19,10,3,7,0,1,2,2,0,0,0,3,2,8,5,1,11,7,1,4,3,0,3,7,1,11,4,0,0,5,11,10,4,8,8,4,7,5,11,3,0,5,0,3,3,2,2,4,0,0,4,12,2,0,0,9,12,1,8,2,12,2,1,6,0,4,13,0,2,0,14,2,14,2,2,2,1,7,0,15,4,0,0,4,1,3,3,7,24,2,2,5,9,0,0,14,12,8,3,1,1,0,2,8,5,2,9,3,0,10,4,0,3,1,3,0,6,3,6,4,7,3,5,7,1,0,1,9,1,3,0,0,5,0,1,5,0,2,0,6,2,2,4,1,2,3,2,13,3,6,1,1,3,8,3,6,0,1,6,3,1,0,7,14,4,0,5,6,2,7,2,7,0,2,2,2,0,3,4,12,4,2,2,3,4,1,3,5,3,5,1,0,4,78,0,0,0,3,0,0,14,3,0,5,4,6,2,2,3,0,2,3,1,0,1,5,4,3,7,12,2,3,5,6,7,3,6,0,3,3,1,16,6,2,2,11,5,0,3,4,2,11,5,1,0,2,2,4,2,6,3,1,2,1,1,12,0,0,1,2,0,2,5,1,3,2,5,21,0,0,13,2,0,0,0,4,7,9,2,10,0,6,1,0,7,2,0,2,1,12,4,1,3,5,10,1,1,7,0,4,3,1,3,0,3,4,10,0,0,12,58,7,1,2,3,0,2,0,4,0,3,2,4,2,4,4,1,17,3,1,0,2,2,0,1,2,13,22,2,1,0,0,4,0,9,5,8,2,3,6,2,2,1,3,3,1,11,6,1,0,2,9,8,10,0,5,13,5,5,0,5,1,2,7,0,0,0,5,2,0,2,0,0,2,2,5,0,0,0,3,5,21,13,3,9,0,0,23,9,0,3,5,5,0,4,2,3,5,0,2,0,1,3,2,11,0,5,0,2,7,5,1,0,6,6,2,0,4,0,0,5,3,3,2,0,3,8,1,4,6,7,0,1,6,2,1,3,0,2,2,0,1,1,3,8,2,3,0,0,0,5,6,4,0,3,6,4,2,0,6,9,1,6,20,0,0,3,4,6,6,4,5,1,3,8,5,4,0,0,1,0,4,1,0,1,2,2,8,3,4,7,0,7,2,0,4,3,2,4,10,4,2,1,0,1,1,6,0,0,2,2,5,3,2,6,3,5,0,0,3,0,0,6,0,2,1,1,4,8,1,2,3,7,1,0,0,8,4,0,0,1,7,2,1,0,3,5,6,0,2,0,4,4,7,0,3,7,1,5,1,0,1,0,0,0,0,2,7,0,0,1,4,2,0,4,0,4,0,4,4,1,9,4,5,0,4,6,0,7,3,13,2,0,2,0,0,2,1,1,2,7,5,0,5,0,0,0,2,1,3,4,5,0,1,7,0,0,2,0,2,4,0,3,3,14,4,2,1,0,2,0,4,1,3,4,3,12,3,7,4,1,4,3,10,0,35,0,2,9,4,6,6,5,4,0,2,0,3,4,10,6,2,1,7,5,1,10,0,3,4,1,2,4,2,1,2,0,3,3,1,2,3,3,5,1,0,16,10,0,1,1,2,6,14,1,2,2,2,2,7,1,0,1,0,3,0,3,5,5,2,0,1,1,8,1,1,4,8,4,4,1,0,8,2,2,1,0,2,0,2,3,1,4,10,0,2,2,11,11,0,12,2,4,2,0,6,0,4,0,1,2,2,0,0,0,5,5,3,2,0,4,1,4,1,3,1,0,0,1,1,0,7,1,2,0,0,3,0,2,5,2,1,1,2,2,6,0,0,1,6,5,1,7,3,2,0,13,11,5,8,0,0,4,2,7,0,0,26,2,7,0,2,3,3,0,0,3,1,4,6,3,63,0,26,2,5,6,2,6,2,2,0,5,1,3,6,0,1,1,4,2,0,3,1,1,7,5,1,3,0,6,7,8,0,0,0,4,21,1,2,0,1,1,9,0,4,1,0,0,4,1,5,0,0,1,9,10,6,1,2,3,0,0,2,1,3,9,6,4,2,0,0,2,2,1,2,0,0,2,1,4,1,1,4,0,0,10,10,2,5,1,0,7,2,4,3,9,5,0,2,1,1,0,11,0,2,0,2,3,1,2,4,5,0,0,8,5,0,5,3,0,6,1,1,0,1,8,0,0,4,4,0,3,5,2,4,3,14,1,3,0,0,1,5,3,2,1,2,3,2,0,1,1,3,7,1,2,4,5,3,3,1,8,0,3,0,3,1,5,3,3,3,0,0,1,2,2,1,2,1,0,3,3,0,0,2,1,0,5,4,3,4,0,10,1,7,0,5,0,0,0,6,0,1,0,1,3,1,9,5,7,4,5,2,1,0,3,0,2,0,0,2,0,0,4,1,4,0,1,3,0,2,2,20,0,1,8,2,2,0,1,1,0,6,0,1,2,0,0,3,1,0,5,0,4,0,0,0,10,3,5,2,4,2,0,0,2,5,0,10,1,1,0,3,1,4,2,5,2,1,9,0,1,2,0,8,5,1,2,6,0,3,0,1,2,0,0,2,2,1,3,0,0,0,0,8,9,3,1,5,5,1,0,4,0,4,0,0,1,3,3,4,2,1,1,2,0,1,0,4,3,0,0,3,0,2,1,2,3,5,8,0,2,2,7,0,2,1,4,0,5,3,5,2,0,1,2,5,0,1,1,1,7,8,0,5,0,2,3,0,6,1,3,2,3,1,25,0,3,2,10,28,5,0,2,1,3,2,4,0,1,1,2,6,0,0,4,0,2,10,0,1,0,2,1,0,2,0,6,2,9,2,2,1,2,2,12,3,0,2,0,0,1,0,3,4,0,2,2,1,6,1,6,3,1,0,3,1,0,3,6,0,4,1,1,2,0,1,0,4,10,6,0,0,0,10,2,5,3,0,0,0,7,3,7,1,3,1,1,0,4,2,2,1,0,3,8,0,5,9,4,1,4,6,2,4,0,0,0,1,1,1,4,8,5,2,2,1,2,11,3,8,0,2,1,0,0,1,8,1,3,2,3,2,3,1,5,0,0,0,2,4,4,1,2,0,0,2,0,0,1,0,0,2,5,5,4,0,2,0,0,1,1,3,9,2,5,0,0,0,0,4,0,0,0,8,4,0,0,5,0,0,0,4,4,5,0,0,1,5,0,0,4,0,2,3,0,1,4,0,0,0,1,0,2,1,2,1,1,1,7,1,0,1,0,3,1,0,0,7,5,1,0,1,5,4,2,1,10,5,0,1,2,2,0,2,13,2,0,1,0,0,11,1,1,1,3,5,2,0,2,3,0,0,0,1,6,0,8,3,4,1,1,0,0,2,0,5,14,6,2,2,3,1,1,2,8,0,0,0,0,0,0,0,2,1,1,2,1,3,0,3,0,0,0,1,2,9,2,3,1,3,2,2,0,0,3,2,0,47,70,3,4,4,1,0,5,1,0,1,8,1,0,0,0,3,0,4,1,0,1,0,2,1,2,3,2,4,1,1,0,8,0,1,1,2,1,1,5,2,5,1,0,0,6,0,0,9,0,0,1,0,1,1,0,0,0,3,1,5,3,5,3,0,2,2,1,0,0,0,1,1,1,0,1,4,4,0,0,4,0,2,2,0,2,0,0,7,0,0,0,1,3,2,0,0,0,0,3,0,0,1,0,3,7,3,0,0,2,4,0,2,1,1,3,0,7,0,8,1,8,2,2,0,4,0,1,2,0,8,0,1,1,0,0,0,1,2,0,1,5,2,1,5,10,0,1,1,0,1,1,2,26,0,0,4,6,1,10,1,1,0,0,1,2,0,6,3,0,0,2,2,3,6,2,7,0,1,3,4,17,5,1,9,4,0,1,3,2,5,0,3,5,1,3,3,2,6,5,3,3,2,5,0,2,0,8,0,2,0,2,3,0,0,2,0,2,28,2,0,0,1,2,0,4,7,4,0,3,0,2,1,0,0,0,3,0,4,0,0,0,0,4,0,6,2,0,4,0,2,5,3,1,45,0,8,5,1,1,0,0,2,1,2,0,1,4,1,0,0,1,2,0,1,1,1,1,11,2,4,2,0,3,0,3,4,1,0,1,0,0,2,4,0,3,1,4,0,4,0,6,1,3,1,0,0,1,1,3,0,3,0,0,3,0,3,6,0,1,10,1,8,1,3,0,7,0,1,0,0,2,0,1,0,4,5,1,7,1,0,2,0,0,7,2,0,0,3,0,3,1,0,1,0,3,0,0,1,2,2,0,2,14,0,0,1,2,10,12,0,0,3,0,7,2,1,2,0,93,18,0,4,0,9,3,0,0,5,0,0,0,3,1,1,0,0,0,0,0,0,2,0,0,3,1,1,0,2,2,2,0,1,1,0,2,2,0,0,3,2,0,6,3,1,0,2,4,0,2,3,6,1,2,1,6,1,0,0,0,2,0,3,0,0,0,4,0,2,3,6,7,1,3,0,0,0,0,1,2,2,1,0,0,6,0,0,1,1,1,0,1,5,3,3,1,0,0,1,6,0,0,0,1,1,4,0,0,0,7,2,1,1,5,3,1,0,3,6,4,5,1,5,4,3,0,4,7,3,1,4,0,0,4,0,0,2,0,0,3,4,0,0,0,0,1,0,0,3,0,3,8,0,0,4,1,0,0,5,1,1,1,1,1,1,2,3,1,1,7,4,1,5,0,2,0,0,2,5,3,2,4,3,0,5,0,4,0,0,0,3,1,1,3,0,0,2,2,1,0,0,5,6,0,2,9,1,1,6,0,0,1,11,0,1,3,2,2,3,1,2,3,5,0,0,0,0,1,0,4,5,0,0,2,0,3,0,1,0,0,0,0,1,1,0,1,0,9,3,0,0,2,0,0,2,0,1,2,0,5,0,0,0,3,1,0,1,0,2,0,0,2,1,3,0,2,0,11,1,9,0,2,2,3,1,0,0,0,3,0,1,1,2,5,0,1,2,3,0,0,0,0,2,6,3,0,0,4,5,2,3,1,9,0,1,0,1,2,0,1,0,0,3,7,1,0,0,0,1,0,2,0,0,2,2,2,0,2,1,0,1,0,4,7,0,1,2,0,2,1,1,2,2,0,1,0,0,2,0,2,2,3,4,4,2,0,2,8,2,2,0,1,1,2,2,0,0,0,2,4,0,4,0,2,1,0,0,1,0,5,0,0,1,4,4,0,0,1,0,1,5,4,0,0,0,0,0,2,4,1,0,0,2,3,1,1,1,0,2,2,0,4,0,1,4,4,1,1,3,8,1,3,0,2,3,3,1,2,0,0,4,1,0,0,1,2,4,1,0,0,1,0,1,0,1,0,0,0,0,0,6,3,1,0,0,1,0,0,2,0,0,0,3,0,3,2,0,1,3,2,0,2,1,1,13,1,2,4,4,0,0,0,2,0,0,6,0,4,11,0,0,0,0,5,0,2,1,7,3,2,2,0,0,0,7,0,11,2,2,2,5,0,0,3,0,1,1,0,1,1,6,1,0,40,2,1,0,0,0,1,1,1,4,0,0,0,10,1,0,6,0,2,0,2,0,2,1,4,0,0,3,1,1,0,2,1,1,0,0,2,1,30,0,0,2,4,0,1,0,1,2,1,3,9,0,0,1,0,0,1,0,2,0,2,1,2,1,0,0,2,0,0,0,0,2,2,30,1,0,0,4,5,0,0,0,1,4,4,0,0,0,3,0,1,1,0,8,6,1,0,1,0,0,1,1,2,0,3,0,3,0,0,0,1,0,0,11,5,0,0,0,0,1,0,0,0,0,0,0,1,1,0,0,0,0,0,0,0,0,6,0,1,0,0,0,0,0,1,0,1,0,6,0,1,0,7,0,0,1,0,0,0,1,0,0,0,0,0,0,0,0,0,0,4,4,0,0,0,0,0,0,0,0,0,0,0,0,0,0,0,0,0,0,7,0
K24 The Stand,king,24155,14148,11023,11175,9857,4214,9731,7019,8014,6642,4576,5789,5590,4456,3957,4048,6302,3063,2590,2662,3045,3193,2242,2849,791,1693,1053,2382,2154,1297,1509,2347,1615,2024,1570,1641,1754,1962,1104,1636,1894,1810,1848,1407,1064,1280,1277,1194,1775,1339,1532,1545,1264,1179,1078,1114,1857,966,1014,1430,1374,885,891,1211,825,866,710,1297,679,665,931,622,667,714,883,714,773,714,783,650,787,668,1199,880,860,882,579,653,581,546,433,781,705,489,712,557,748,477,696,540,500,787,872,531,866,508,646,824,571,564,702,687,355,504,506,303,565,557,533,615,402,451,685,702,253,306,529,371,339,351,388,622,529,291,559,453,195,625,413,328,271,378,99,339,480,553,330,467,372,443,416,459,449,335,304,384,263,433,455,414,274,462,362,382,337,425,344,254,376,415,134,191,448,338,190,190,250,300,475,434,275,312,379,260,277,208,173,175,261,183,169,167,335,210,302,360,136,163,309,76,240,455,219,237,216,89,250,258,235,333,384,276,223,181,263,205,278,230,263,260,177,295,243,231,148,206,188,201,120,345,286,275,228,367,230,60,178,200,479,184,205,142,194,164,206,182,215,457,255,389,290,181,220,203,256,152,145,151,226,219,288,195,271,287,163,173,172,167,251,250,293,181,153,250,139,198,249,119,279,207,168,114,152,165,380,147,163,158,150,163,155,122,35,116,278,149,168,165,134,200,254,165,202,162,477,198,51,150,95,137,141,52,155,156,145,186,123,189,143,215,216,180,130,263,190,144,397,125,197,86,134,184,154,159,274,203,267,65,81,151,128,119,127,56,100,162,185,142,147,132,180,93,190,166,284,48,85,246,102,115,215,175,117,80,109,126,122,134,159,145,108,97,151,66,157,228,126,55,137,101,76,156,136,128,106,39,0,132,149,173,122,110,54,157,116,135,111,139,129,110,101,137,116,118,169,97,154,166,91,135,145,97,235,245,103,118,162,139,113,113,172,90,33,91,91,95,94,117,103,71,169,91,78,188,10,173,119,139,32,101,99,91,130,156,120,61,222,101,78,121,96,90,92,177,124,80,97,94,109,132,170,30,1,95,85,106,120,142,42,96,56,157,88,124,96,98,68,47,1,155,68,134,147,98,63,148,75,57,241,74,171,58,110,60,72,91,124,110,30,108,107,86,40,53,79,55,40,83,100,60,145,135,102,165,42,82,0,76,66,84,150,177,106,89,73,42,120,69,76,127,62,105,62,81,53,8,105,113,66,59,176,76,83,82,89,90,0,36,86,113,82,73,94,18,112,58,87,55,39,51,102,83,61,30,93,100,48,22,226,119,37,103,81,120,61,57,90,14,72,72,76,148,64,78,25,131,62,139,39,75,71,86,42,55,51,68,37,67,46,79,92,110,103,76,58,0,20,183,52,67,60,31,96,93,27,182,93,45,62,74,58,79,34,79,81,96,54,115,132,38,58,51,39,39,66,0,134,79,75,80,42,34,94,16,74,108,83,67,65,117,1,65,54,48,137,147,68,39,82,32,51,60,100,72,50,102,83,71,56,100,93,85,27,47,80,88,55,67,87,45,53,66,56,57,130,39,7,62,44,80,78,25,73,89,40,92,34,35,53,128,65,61,76,80,82,107,23,103,49,80,56,58,28,94,44,214,16,81,67,89,99,84,67,20,120,68,86,18,62,46,44,28,70,74,1,104,67,38,80,43,115,47,76,76,11,10,106,64,38,34,34,38,97,67,17,43,60,26,50,25,75,32,78,97,56,56,46,44,104,72,69,36,90,58,0,55,72,44,39,50,68,31,21,69,107,96,50,37,49,29,73,35,30,78,35,34,5,81,58,59,64,46,69,44,147,42,111,66,73,68,38,60,72,24,71,55,52,0,72,95,62,98,63,78,92,61,45,61,51,66,14,24,18,60,4,70,135,32,9,49,51,38,43,31,103,19,25,0,52,48,52,83,31,16,25,48,39,27,33,90,57,20,76,65,217,117,46,0,43,97,69,73,58,42,7,39,55,82,18,69,84,29,54,61,23,49,58,35,40,78,55,29,32,19,39,31,60,6,52,156,33,59,70,38,44,51,97,38,64,44,39,0,78,4,24,42,36,20,68,53,58,8,16,31,50,27,11,24,137,24,69,44,62,84,24,42,49,62,10,91,22,68,87,34,43,137,22,46,52,45,40,39,26,43,10,87,83,43,70,57,0,48,63,12,35,39,71,16,36,44,29,231,41,45,11,86,58,17,60,16,3,50,68,4,46,65,37,3,28,41,29,71,29,47,21,45,2,26,77,0,48,2,37,4,58,83,0,1,15,103,32,15,23,74,31,47,41,5,15,35,23,45,36,5,13,8,28,40,44,77,42,67,44,21,45,17,49,32,26,114,66,16,58,28,55,19,38,47,41,52,11,47,19,27,26,0,50,58,26,69,11,117,0,9,27,67,14,38,10,0,26,3,37,26,22,30,21,0,29,74,18,19,59,16,31,41,21,16,20,140,15,0,44,14,46,28,40,69,50,32,41,40,20,37,18,44,41,30,29,46,37,64,36,33,0,4,7,52,61,72,67,64,40,43,55,1,33,64,26,70,53,58,29,73,19,76,74,53,26,16,64,4,21,47,22,15,51,137,28,17,95,8,35,18,40,19,11,24,47,54,31,34,31,51,1,30,8,46,13,36,38,34,51,35,24,30,36,2,43,0,38,21,47,27,33,73,0,14,40,0,67,55,0,24,58,31,22,28,51,33,57,0,37,49,99,73,2,15,75,48,2,18,72,26,16,0,0,17,23,16,55,18,41,6,47,53,19,58,17,32,34,32,9,29,40,0,5,23,27,38,26,14,55,2,11,10,0,29,28,20,17,26,25,19,15,14,37,29,17,50,37,0,41,41,0,33,38,24,41,26,0,32,3,13,0,16,27,29,0,17,35,111,52,37,48,54,49,24,18,21,0,37,24,21,23,33,25,50,5,31,39,63,29,26,38,36,18,34,20,8,29,0,9,22,10,47,72,114,26,33,63,33,16,4,23,29,32,30,7,19,4,20,15,9,5,44,19,56,21,36,60,73,34,0,12,65,26,20,23,17,63,29,9,12,69,2,23,46,25,22,11,44,28,1,22,16,53,20,28,26,7,31,44,38,37,0,0,31,0,8,51,0,15,68,12,16,20,19,52,32,78,75,76,18,26,20,21,1,38,29,25,4,0,17,25,71,4,0,14,12,10,36,29,25,168,23,63,25,24,19,77,18,14,14,20,43,14,11,26,14,49,19,0,0,15,32,34,33,48,43,25,30,10,36,23,37,21,39,31,20,22,49,0,34,15,0,25,15,34,21,13,32,29,0,3,53,48,0,29,18,23,23,36,23,2,46,16,30,8,47,27,14,33,30,24,9,21,65,14,36,21,37,9,19,22,26,0,21,8,20,60,0,3,0,0,32,0,21,19,6,14,9,42,17,177,42,22,30,19,10,8,32,38,15,45,30,15,18,7,39,16,18,38,23,17,15,12,7,13,14,29,16,17,13,28,21,23,2,51,7,28,22,39,22,22,29,35,2,35,14,15,31,30,7,19,39,38,33,24,32,31,45,27,0,22,25,45,9,100,38,7,67,22,26,20,18,7,29,9,32,0,56,59,99,7,31,58,1,19,23,16,5,0,36,27,22,29,24,62,31,26,35,6,9,28,27,0,15,2,31,7,30,67,0,9,15,15,18,12,20,16,0,16,6,24,10,20,33,38,43,26,6,39,22,0,5,16,23,29,11,9,15,36,32,43,14,9,19,1,25,22,45,10,13,48,17,36,0,32,12,28,52,30,20,15,32,3,18,5,18,41,31,33,24,21,2,21,26,17,18,32,0,41,44,6,15,47,9,37,11,30,13,35,3,43,16,24,25,34,4,29,18,12,15,24,40,14,20,0,24,16,27,7,25,32,1,37,16,24,23,48,23,51,0,14,24,32,17,24,11,13,21,50,39,0,13,18,18,46,10,55,7,30,16,18,17,3,24,15,45,48,7,9,29,9,9,3,25,25,2,14,4,3,20,18,27,2,17,84,10,31,12,15,17,30,26,18,10,24,6,35,26,0,27,27,5,11,22,50,24,9,4,18,8,17,38,20,17,16,24,26,25,40,6,11,25,23,3,20,22,26,24,0,0,30,10,0,4,0,1,2,106,11,20,16,18,21,9,1,26,32,15,0,15,111,18,58,42,10,4,38,39,12,51,13,12,41,25,19,8,23,8,22,9,51,23,2,46,8,65,52,16,12,24,19,21,15,27,36,50,0,21,29,10,12,13,7,10,12,28,25,13,0,5,11,2,12,6,7,24,0,23,22,17,0,18,6,9,698,9,0,30,12,6,25,9,19,51,29,13,40,11,0,12,19,34,16,1,30,6,1,3,0,13,8,0,16,22,0,17,10,23,0,18,23,18,7,6,21,15,12,23,2,15,4,16,1,14,10,23,13,13,31,32,26,6,11,12,12,23,22,14,2,0,7,19,19,37,21,20,3,14,30,19,33,7,11,19,12,5,5,18,10,11,13,27,26,3,9,10,15,1,20,20,4,22,16,10,3,18,3,20,5,39,9,35,31,7,19,17,25,61,26,17,8,0,19,24,10,0,33,4,15,26,22,12,27,17,13,13,62,47,65,0,4,14,18,2,35,18,19,20,12,15,11,53,13,49,9,36,24,10,10,9,20,10,10,15,34,11,0,32,16,8,0,3,20,26,8,3,46,7,17,24,33,25,3,3,6,26,8,5,19,18,1,55,0,23,24,35,21,2,7,18,8,18,1,0,17,13,21,28,22,29,19,38,10,19,0,371,15,0,12,27,0,0,2,6,6,31,12,24,22,7,0,17,25,41,10,16,2,17,13,9,26,37,7,7,0,10,6,25,2,0,21,0,21,4,38,18,0,26,2,3,38,18,23,37,2,13,13,8,31,1,21,0,0,12,5,13,22,2,1,1,21,12,15,18,9,5,1,32,16,23,13,20,16,18,30,26,6,14,9,15,30,28,0,0,20,17,9,28,10,19,17,0,4,7,2,19,21,12,8,10,5,21,14,24,37,5,21,8,11,11,13,7,4,0,27,0,9,17,43,8,9,18,38,13,7,7,22,28,1,10,9,16,11,21,11,4,9,2,17,3,14,9,14,43,13,10,28,0,7,16,2,3,24,15,25,15,24,34,19,8,10,6,11,1,23,28,19,16,19,18,8,9,19,14,61,14,25,0,11,23,29,26,21,3,3,9,7,30,16,11,10,25,6,10,27,15,5,20,0,69,23,29,15,38,7,2,10,17,10,13,22,18,13,19,22,20,25,7,9,17,22,0,12,15,15,8,36,14,16,22,40,6,7,24,3,13,14,13,7,5,28,24,18,2,15,2,6,6,19,1,10,0,21,22,12,19,0,7,22,8,6,0,2,11,13,4,11,5,5,18,10,9,3,3,4,25,6,30,8,0,2,47,28,28,18,8,11,10,2,6,16,5,21,2,0,19,10,10,16,5,13,0,4,9,8,1,9,8,42,7,44,7,18,20,7,5,0,17,21,17,15,0,48,18,18,3,16,4,5,36,0,16,29,5,6,11,12,6,13,8,8,8,1,20,10,6,0,20,14,16,9,21,5,5,12,11,5,23,19,28,1,14,12,0,5,12,15,1,11,12,14,10,27,16,17,12,2,10,4,17,6,10,1,0,8,4,8,10,0,2,0,10,7,13,12,7,6,8,11,13,10,9,6,3,16,15,3,4,8,6,30,16,7,9,12,3,17,0,2,15,44,19,20,7,2,13,4,2,0,12,4,10,6,10,0,8,7,1,40,11,3,17,9,5,6,3,8,0,0,9,4,0,14,4,6,17,5,17,13,7,11,4,17,7,0,5,17,9,9,13,10,13,5,6,5,16,17,37,13,21,10,17,5,21,25,25,40,1,21,31,20,13,15,1,14,3,1,1,14,4,4,7,7,15,14,14,10,16,0,28,6,10,27,9,7,2,6,58,11,10,5,22,15,29,15,0,1,28,23,4,16,1,8,26,19,6,11,35,19,9,13,21,13,6,19,10,21,1,7,5,3,9,34,10,13,1,5,15,7,6,0,17,0,10,18,4,5,0,5,6,12,0,17,28,12,9,13,8,12,71,9,8,0,3,15,27,3,14,17,14,10,4,3,4,19,14,11,6,36,15,5,4,18,8,2,79,12,0,36,7,7,1,12,11,6,8,2,21,49,5,4,1,11,30,8,11,0,0,1,15,9,3,11,0,11,14,15,13,7,12,815,10,10,38,4,13,12,5,0,107,6,0,18,19,6,7,15,19,17,13,4,6,14,8,11,1,4,10,15,2,13,0,5,21,3,22,3,5,2,7,0,1,28,26,15,19,17,48,9,9,20,15,6,1,34,6,9,3,18,9,18,1,2,4,9,9,21,5,1,11,23,2,20,9,2,0,1,10,20,6,1,22,7,3,19,3,3,2,2,5,10,17,3,15,4,45,4,21,7,10,0,1,0,11,5,14,32,25,6,30,14,4,8,0,16,4,3,31,3,5,5,11,3,16,18,2,12,8,0,0,11,12,12,34,41,18,11,7,7,0,1,12,0,0,5,4,9,1,1,4,8,34,10,27,22,18,0,6,17,13,0,13,5,15,16,3,33,19,0,17,0,14,7,21,15,20,0,24,8,12,13,4,15,2,3,67,5,15,8,3,3,3,1,18,3,37,10,2,10,0,15,11,0,10,9,2,0,9,19,8,14,68,13,6,0,6,0,1,12,7,8,5,14,5,2,11,11,0,1,13,13,17,15,5,0,3,6,0,0,8,7,1,8,0,2,10,37,5,11,3,1,14,2,13,2,5,8,1,8,5,19,15,12,7,6,22,0,14,0,7,22,11,6,3,9,3,3,16,6,13,8,19,12,9,4,18,10,11,10,1,2,140,8,9,21,8,5,3,0,4,11,10,15,12,7,8,10,0,3,8,0,6,6,17,34,52,9,6,1,3,28,23,4,2,2,0,6,0,15,22,21,3,1,5,5,15,16,16,9,38,16,8,3,1,13,6,4,10,0,5,0,3,8,12,6,8,3,13,2,16,3,0,99,13,4,19,0,4,7,4,18,6,4,114,0,2,11,10,11,14,10,3,14,8,8,7,6,7,8,4,0,4,1,20,36,4,0,9,6,2,9,3,18,14,10,7,4,19,0,4,4,13,1,4,17,17,4,0,38,24,14,28,7,0,8,22,12,5,10,21,13,4,2,5,6,6,24,0,12,4,12,35,3,18,3,68,4,22,23,3,9,4,6,1,27,0,19,23,5,0,8,25,4,5,25,12,2,0,4,4,11,13,4,12,5,0,15,1,21,40,70,18,0,5,10,9,0,7,0,0,0,8,25,11,4,8,11,16,23,10,9,0,3,11,2,5,3,4,16,6,21,18,24,15,38,5,15,9,2,6,5,4,4,5,8,3,3,0,11,20,11,6,12,5,2,3,8,12,5,9,2,10,3,10,0,30,0,14,2,11,9,9,24,9,15,1,13,15,8,9,6,20,1,4,10,10,18,10,22,0,2,12,18,0,5,3,22,4,11,9,2,11,2,0,12,23,2,26,6,13,3,2,7,6,4,5,7,0,10,16,3,9,6,10,9,4,11,3,9,9,13,7,0,8,17,1,3,2,5,6,6,6,9,2,19,1,12,1,2,10,12,9,6,8,13,37,1,7,15,8,9,5,2,5,0,4,3,4,24,2,7,7,20,5,7,11,3,0,3,5,5,1,2,11,3,0,27,10,0,1,3,54,17,7,17,3,3,8,12,8,0,0,12,6,2,1,0,13,9,3,7,5,11,0,8,3,48,0,8,3,14,14,5,7,15,11,1,7,3,29,4,13,2,1,0,18,3,5,3,8,21,2,16,2,14,14,3,1,18,4,6,157,16,4,0,5,13,1,0,24,7,4,6,0,6,3,11,5,5,8,8,6,2,4,7,8,1,20,6,5,1,7,9,6,10,5,19,2,1,4,5,7,7,6,5,5,0,5,27,9,11,0,19,0,22,6,9,0,25,5,30,12,14,11,22,13,17,5,25,7,2,11,13,2,6,1,2,9,11,4,7,4,26,4,4,12,53,10,17,3,0,3,6,1,3,0,24,10,9,8,13,5,7,9,30,6,1,4,0,1,2,13,0,4,7,16,22,2,2,3,11,8,1,6,2,4,11,9,27,0,0,4,8,3,10,4,0,7,7,18,5,13,12,15,9,12,3,9,7,2,0,39,12,1,8,7,10,4,5,1,3,2,7,14,4,12,9,19,8,6,8,2,0,0,15,8,17,7,14,3,10,2,7,8,0,5,26,8,6,6,11,5,8,5,21,11,12,8,0,11,0,5,7,1,4,4,20,8,6,6,9,32,4,7,1,0,8,0,8,3,9,5,9,8,0,7,13,9,6,3,2,0,8,1,24,3,5,1,12,5,4,6,2,7,3,5,18,3,17,0,5,15,0,5,1,10,2,24,8,3,5,3,13,4,2,0,21,13,25,9,11,18,11,0,0,7,1,51,1,0,9,5,1,0,10,12,1,45,2,0,11,8,0,1,1,0,11,8,2,5,5,0,1,4,6,1,3,24,17,0,11,6,4,1,0,7,13,14,4,7,5,2,5,0,2,9,4,0,11,1,2,5,2,8,3,11,5,16,6,8,2,3,13,9,12,4,13,4,12,0,16,13,7,4,8,7,4,2,5,14,6,9,9,3,28,12,4,3,26,18,0,9,0,0,7,1,8,2,2,17,1,4,1,17,0,6,0,5,23,8,29,12,4,10,3,21,20,8,8,2,6,0,0,5,12,8,4,0,5,9,21,9,9,6,0,1,2,12,0,14,11,2,1,5,6,3,4,4,5,10,0,2,1,12,1,0,2,8,2,16,9,4,3,1,3,0,13,0,1,14,6,5,7,5,2,12,50,3,2,11,20,11,17,7,11,0,6,4,1,3,7,1,9,1,6,8,2,10,1,0,1,3,10,4,11,0,5,2,5,7,8,13,0,10,8,13,6,2,2,1,27,2,26,22,6,11,13,4,7,0,19,11,5,4,4,5,6,0,6,0,5,3,15,17,1,0,17,3,10,1,0,14,26,0,6,0,7,20,7,12,1,2,3,0,13,5,9,4,4,12,2,3,14,16,3,0,6,15,17,7,5,14,2,1,0,6,7,3,3,2,1,0,2,7,2,13,1,9,0,4,12,12,25,5,6,10,3,22,5,12,2,8,17,16,8,0,1,1,8,11,10,5,14,5,6,1,18,3,13,13,4,4,7,4,4,2,5,3,8,5,7,9,3,1,9,20,7,9,10,10,6,0,15,22,0,0,5,8,0,11,1,6,2,0,3,2,15,12,2,10,10,1,8,1,8,1,3,20,0,0,1,3,0,2,6,12,0,6,7,6,13,7,9,2,0,1,4,13,1,4,5,0,5,0,1,0,5,6,2,2,14,0,7,25,4,0,4,9,8,6,20,0,7,8,0,5,12,2,2,4,4,0,0,1,5,7,9,20,15,0,2,18,11,3,4,10,0,6,5,5,10,2,8,0,1,1,8,12,0,13,8,5,14,3,0,4,2,5,0,4,1,1,2,1,5,17,1,4,4,15,8,2,0,6,16,1,4,4,22,6,21,0,10,18,9,4,0,0,2,0,9,0,4,24,2,11,11,7,4,5,6,1,1,6,4,10,6,14,10,2,21,0,2,0,1,6,4,2,3,23,0,5,1,3,0,1,15,5,6,0,8,10,4,6,7,4,3,11,7,0,17,4,7,4,8,7,19,7,1,1,0,9,5,11,2,11,6,5,3,4,2,3,9,6,19,0,6,5,9,1,3,10,2,0,7,8,8,1,4,5,5,0,2,11,13,0,1,0,1,2,10,8,3,4,6,3,2,3,1,5,30,11,5,6,9,10,2,0,0,12,4,4,1,14,3,4,0,17,9,10,3,12,5,8,8,7,1,4,11,0,7,6,0,0,0,0,5,1,14,9,8,6,27,1,1,3,6,0,0,6,12,3,6,0,14,18,0,4,4,7,2,6,6,5,0,1,4,4,15,20,9,17,7,5,1,34,14,11,1,3,0,17,6,5,1,4,5,0,2,2,2,2,12,5,18,7,4,0,7,9,0,8,12,4,0,8,14,11,11,5,2,3,6,6,2,0,0,10,3,1,18,4,0,15,16,0,6,0,1,0,0,0,28,8,0,18,7,0,50,2,11,5,8,1,4,11,5,6,8,2,6,6,2,0,1,1,6,0,36,3,5,0,5,6,3,1,5,1,16,4,18,3,1,2,8,1,5,1,3,10,0,6,1,12,9,9,2,18,7,0,2,6,5,6,10,5,4,7,17,9,3,2,3,10,0,2,0,1,9,1,2,5,0,9,2,1,12,0,2,7,3,20,1,3,4,9,4,3,4,5,1,5,0,13,9,15,2,3,0,9,7,6,6,6,0,7,0,10,11,3,2,3,7,4,4,6,0,0,11,3,7,1,15,3,7,4,5,2,1,6,9,1,8,2,3,10,3,1,13,1,1,20,4,5,7,3,1,3,6,3,7,30,3,0,1,0,0,1,4,7,1,2,0,8,9,1,0,4,0,6,4,0,14,3,9,5,3,2,2,4,14,1,13,5,9,8,2,6,3,6,0,7,2,0,3,1,4,3,4,0,11,4,2,1,6,2,11,2,0,1,2,7,3,14,1,1,8,0,2,3,7,10,0,4,3,7,11,0,3,8,5,0,3,6,0,10,2,4,1,13,0,3,1,2,0,1,0,4,4,11,1,1,1,0,14,5,1,2,16,9,8,7,4,3,3,7,2,13,3,6,15,2,3,5,10,0,10,1,1,9,10,10,0,0,2,1,5,1,4,1,8,11,3,2,0,1,4,1,1,0,0,3,0,2,11,6,1,2,66,1,0,3,9,3,1,8,3,11,0,4,11,0,3,0,2,20,9,3,3,0,8,6,11,3,2,0,0,1,4,2,3,9,2,5,9,7,6,8,15,1,5,0,2,0,10,2,0,1,10,1,6,8,1,1,0,0,7,2,13,1,2,5,21,0,10,20,0,22,6,2,0,9,0,0,1,0,3,12,11,0,6,0,0,0,4,1,0,1,9,4,2,0,2,12,0,1,4,5,0,2,12,3,2,13,0,0,0,0,0,0,0,0,1,0,10,0,0,0,23,0,198,0,20,0,0,3,414,0,0,2,0,0,0,0,0,0,0,0,0,0,80,0,0,1,12,3,0,0,0,1,0,0,0,0,0,0,0,0,0,0,0,0,0,0,0,0
K25 The Langoliers,king,4806,2312,2083,1983,1860,1009,1649,1258,1346,1354,858,1100,855,595,642,666,744,494,440,682,667,612,509,436,169,424,204,458,427,360,336,371,414,384,346,351,362,433,361,349,356,341,360,356,198,211,230,211,218,317,248,302,213,261,236,149,221,219,274,276,222,253,175,275,107,229,123,201,197,181,145,162,94,157,104,134,109,139,110,153,138,186,149,213,127,273,110,139,112,64,58,127,146,149,194,87,152,99,81,115,64,176,171,107,167,179,131,203,90,145,93,59,90,157,115,66,99,99,71,56,159,87,73,174,34,45,78,100,67,63,108,85,95,76,136,73,61,112,89,54,6,69,3,87,80,80,59,91,77,46,18,117,97,65,76,35,56,9,41,67,32,119,44,62,97,78,61,38,47,91,23,29,50,73,11,32,48,59,60,56,37,25,91,52,71,17,37,57,75,30,40,46,62,56,43,92,29,30,27,20,70,65,39,69,35,127,37,37,36,31,17,47,32,45,51,38,36,104,54,35,41,55,45,68,25,60,35,29,46,81,135,70,57,147,26,3,34,45,87,20,18,50,46,31,38,47,31,89,25,76,60,15,45,22,65,29,45,36,35,55,44,29,41,37,34,14,38,31,33,34,55,21,55,17,13,19,14,31,81,32,53,15,65,37,92,7,22,8,28,63,36,12,0,24,45,33,41,24,26,29,54,26,22,28,145,63,4,107,29,44,23,13,30,38,29,35,43,54,28,66,46,22,9,32,21,30,38,26,17,33,25,64,21,39,9,25,43,13,30,58,18,9,24,11,23,18,34,29,24,49,63,15,26,26,137,1,44,26,27,10,15,33,33,5,16,24,31,18,17,23,19,14,23,5,17,56,8,9,17,29,22,50,25,41,22,2,0,13,39,27,13,9,14,8,32,42,32,29,13,25,12,47,33,10,31,6,21,17,26,22,39,20,26,8,33,38,17,24,16,25,27,1,21,24,27,23,27,30,47,9,52,17,8,30,4,13,24,23,3,40,22,16,27,30,26,9,70,27,21,23,38,11,15,52,39,17,17,22,23,20,32,2,0,8,10,23,38,54,1,16,9,53,15,2,30,10,27,7,0,7,16,27,34,16,10,15,62,10,35,9,29,7,21,6,34,10,10,19,2,17,25,11,19,20,20,16,7,15,19,10,29,34,24,25,20,14,0,21,23,20,18,6,24,5,26,10,19,9,30,21,6,16,28,18,37,6,19,27,17,11,31,8,29,6,32,21,0,2,25,15,19,16,3,5,65,16,44,28,6,4,3,28,15,2,27,24,12,11,8,8,7,34,9,44,13,82,11,2,11,12,20,27,12,6,1,29,10,16,7,6,8,10,14,8,34,11,2,24,3,15,20,10,24,9,6,0,2,32,18,17,11,33,19,9,6,15,53,6,1,14,3,5,1,11,29,18,5,35,15,6,6,18,26,13,8,0,2,16,13,24,12,15,12,10,6,6,17,15,1,30,0,11,11,9,29,19,11,3,34,41,19,9,6,12,2,14,13,14,5,10,20,19,24,1,2,8,5,15,18,8,20,3,16,6,27,19,2,17,4,11,19,10,4,14,1,6,9,48,14,23,7,7,26,23,20,18,0,19,8,6,2,36,8,8,5,19,5,21,8,13,12,3,10,4,19,27,4,3,11,7,12,5,3,3,0,22,4,11,3,22,22,11,3,1,6,0,0,15,19,5,4,3,11,7,4,28,11,1,11,28,28,7,9,12,7,4,10,3,7,12,8,2,1,11,1,8,5,23,3,11,14,7,11,4,23,10,15,3,8,12,10,3,0,15,0,2,0,6,1,6,3,8,22,15,21,23,16,15,19,25,10,23,12,1,19,8,4,1,14,3,3,0,25,14,9,7,5,27,4,18,10,1,2,4,0,21,3,1,0,3,9,4,11,6,16,5,12,0,15,22,16,10,2,0,2,6,5,9,2,30,19,1,1,20,21,46,3,1,11,15,18,10,9,1,0,12,7,12,3,14,22,3,23,10,0,16,22,17,19,15,11,11,10,11,16,13,12,0,8,17,3,1,13,7,24,3,17,3,10,2,8,0,13,0,4,3,7,3,23,5,8,3,7,3,2,3,1,0,7,9,8,9,7,10,2,7,11,4,7,4,3,8,3,9,4,38,16,5,10,9,10,10,3,1,2,10,0,12,13,1,0,5,3,1,5,12,3,3,1,4,6,1,11,8,5,21,3,6,15,1,0,19,6,1,12,1,13,1,16,1,14,19,3,9,6,2,0,4,6,0,7,0,5,0,10,8,0,0,1,30,0,4,3,1,4,11,8,0,1,1,13,6,0,2,12,4,9,0,17,5,2,6,8,6,8,19,3,3,6,10,11,3,0,4,17,8,11,3,5,8,10,9,5,3,2,0,6,10,1,15,1,3,0,0,23,13,8,2,0,0,0,4,10,13,3,8,1,0,8,18,2,2,3,27,10,3,4,7,7,1,2,0,6,7,3,3,7,19,16,2,2,3,0,8,2,5,8,8,6,5,7,4,3,6,0,0,1,1,10,4,6,5,2,15,13,0,9,14,1,0,13,2,17,0,2,36,18,2,4,3,17,0,3,6,11,12,12,13,8,2,8,0,2,4,10,8,1,8,11,9,2,15,6,4,0,0,1,13,0,174,0,1,8,3,11,10,0,2,13,0,5,8,1,6,5,6,0,3,10,0,10,18,0,11,9,7,8,4,1,9,11,0,3,0,9,5,0,7,29,3,0,4,5,3,33,0,0,19,8,6,35,16,6,1,19,2,1,21,6,5,5,4,0,3,2,0,2,2,2,8,7,1,17,0,1,0,0,1,6,3,6,9,13,9,0,3,27,4,4,5,7,0,13,7,0,18,16,5,5,4,0,1,0,7,0,1,7,4,0,3,7,22,9,0,25,4,13,3,2,3,0,13,13,1,4,8,0,10,0,2,1,14,19,10,8,4,1,8,7,1,3,1,4,3,1,4,12,27,0,24,7,3,2,1,18,3,3,6,3,4,0,4,11,3,1,13,0,2,5,5,7,21,1,0,3,6,2,0,10,0,2,2,1,3,3,1,11,3,6,1,0,2,10,1,7,117,17,7,8,2,0,4,10,0,4,0,0,6,0,0,1,0,3,12,2,10,2,3,6,3,3,7,14,1,2,162,1,0,2,5,0,0,0,8,0,6,4,0,0,0,9,6,0,1,0,5,18,13,8,9,1,0,1,0,20,5,2,0,1,4,3,7,0,0,1,5,10,1,9,8,3,4,0,6,0,16,10,12,9,10,7,5,9,1,4,0,9,3,2,0,10,6,4,0,0,1,6,0,5,2,22,5,5,5,1,1,4,16,5,1,12,3,3,6,1,4,9,7,3,5,3,9,2,1,6,1,0,0,1,2,13,3,0,0,0,2,0,5,0,0,7,2,2,0,8,2,69,0,3,4,1,6,11,1,13,10,2,3,12,7,2,2,1,5,3,0,6,3,3,3,5,6,1,1,6,3,3,2,3,0,15,35,6,4,4,0,3,2,18,4,4,16,0,2,2,6,3,4,0,6,9,8,11,0,7,10,7,3,10,8,8,8,2,3,5,3,5,5,31,4,0,16,6,0,4,6,5,0,3,8,0,0,0,7,3,9,3,9,10,0,3,23,29,0,8,3,0,1,0,11,3,6,3,0,0,3,3,0,0,2,4,0,0,1,1,0,3,4,4,9,5,2,10,4,0,1,0,9,4,2,0,2,5,0,4,3,1,5,0,25,3,4,1,1,0,3,5,0,2,7,1,4,5,16,3,7,0,1,45,3,4,7,19,1,7,0,0,9,7,8,0,0,4,2,1,0,11,1,23,3,6,2,3,2,5,7,3,5,4,43,8,3,0,0,12,5,3,0,0,13,6,0,3,0,1,0,6,1,8,2,5,8,6,0,0,8,1,7,15,8,4,4,10,13,0,1,1,2,3,3,1,2,10,1,2,2,0,3,2,18,7,1,2,1,2,11,1,9,6,0,2,1,51,4,1,2,0,3,1,12,1,0,0,7,0,8,3,0,5,1,5,4,0,2,4,0,1,12,11,9,0,0,2,2,1,0,8,2,1,8,9,12,6,1,5,4,2,0,8,2,1,14,0,0,3,1,0,2,0,0,1,26,10,1,3,7,5,2,0,4,4,18,0,3,16,10,13,1,3,0,6,1,8,8,1,1,15,4,0,1,1,1,3,0,3,9,0,4,0,18,4,2,0,8,3,1,0,1,2,3,0,3,5,9,0,0,1,1,7,6,4,8,0,2,4,1,1,3,4,2,0,6,3,44,0,2,3,1,2,3,0,7,4,0,14,10,2,0,6,2,7,0,0,4,11,14,3,1,17,3,0,0,0,2,1,0,1,2,0,2,0,0,0,6,0,4,0,2,3,1,3,5,1,0,1,1,0,4,2,16,4,0,1,4,5,3,0,0,1,41,0,5,0,0,1,2,3,2,5,8,1,8,3,1,6,0,1,0,5,1,5,6,1,0,0,0,1,0,4,0,5,2,1,0,2,4,8,10,0,2,1,2,0,4,14,4,6,0,0,2,21,2,6,1,2,0,2,2,3,0,12,0,7,0,0,11,41,1,0,5,5,2,0,0,0,2,3,0,5,5,2,0,3,1,10,4,4,10,0,3,11,5,2,4,1,0,1,8,1,1,0,1,2,5,0,0,10,3,7,0,7,0,0,5,3,7,1,1,1,10,2,8,0,6,0,4,0,3,5,1,4,0,12,0,7,2,0,1,0,3,2,5,1,3,2,1,0,0,0,1,4,0,3,3,0,0,2,0,3,5,2,2,6,1,0,2,1,10,0,1,0,1,2,0,6,5,1,5,0,3,2,6,0,0,4,0,4,3,16,2,0,6,1,1,9,4,5,0,1,8,3,0,4,0,0,0,0,2,1,4,1,0,0,0,0,2,0,5,1,0,2,12,0,11,0,4,5,7,2,2,0,6,1,1,11,5,0,0,1,5,1,3,0,9,4,15,1,2,2,10,2,1,2,2,1,5,2,4,0,1,1,2,2,5,0,1,0,0,4,0,0,1,18,2,1,2,8,1,0,0,5,5,0,1,2,1,0,3,1,0,0,1,4,0,0,0,3,12,3,1,8,0,0,1,0,14,5,1,8,10,2,18,0,8,0,0,1,1,1,4,10,4,2,7,0,14,0,4,20,5,5,0,2,7,3,8,1,2,1,0,1,2,5,0,5,3,0,0,0,4,3,0,0,0,1,0,1,6,4,2,0,12,0,6,2,1,14,15,5,0,4,0,5,2,2,0,2,1,1,0,5,7,2,2,0,0,4,7,0,0,7,1,1,1,1,5,8,0,1,1,8,0,0,1,2,1,0,6,3,7,0,1,2,1,4,0,0,3,0,11,0,5,3,4,2,0,4,1,0,4,2,9,5,0,0,0,1,13,5,2,2,9,1,3,2,1,0,0,0,3,1,1,0,4,0,0,1,4,0,0,1,3,3,2,7,1,2,2,0,4,0,5,4,0,1,1,3,3,9,3,6,1,2,3,0,3,3,0,1,1,1,4,2,0,16,3,0,55,0,0,0,8,10,1,6,0,0,0,1,0,1,1,15,6,0,9,7,0,2,2,1,0,4,6,1,0,5,1,0,0,0,1,1,0,0,2,0,0,7,0,3,0,0,1,0,0,1,3,3,0,0,0,24,0,1,0,0,0,0,1,0,0,2,6,1,3,0,3,2,6,3,0,0,1,0,3,6,2,1,3,1,0,0,4,1,2,0,0,0,5,2,0,0,3,3,1,1,0,4,0,2,0,0,5,0,0,9,1,0,1,2,5,2,1,2,2,2,0,0,1,5,2,3,1,2,14,0,0,3,0,1,3,6,1,5,6,0,4,1,0,6,0,4,0,4,2,1,0,3,0,1,9,5,0,3,4,0,1,0,0,44,4,0,0,0,4,2,1,3,0,3,0,2,11,1,0,7,1,0,0,0,3,1,0,2,2,10,1,4,2,4,1,0,12,2,1,1,1,2,1,8,0,1,1,0,1,2,0,6,0,4,0,4,2,0,5,0,8,3,1,0,0,1,0,5,0,3,0,3,0,4,0,3,11,0,1,0,1,0,0,0,12,3,1,2,0,0,0,0,3,1,1,2,0,1,0,7,0,1,0,1,0,9,2,2,0,5,12,0,3,1,0,3,1,6,0,1,2,3,2,0,0,0,4,2,0,0,0,5,3,31,7,0,2,0,0,0,5,1,1,1,1,0,8,0,0,2,1,2,1,0,1,3,2,1,1,0,0,3,0,4,4,1,0,3,1,7,0,0,5,1,2,0,1,0,0,2,10,0,5,0,0,2,6,2,1,0,0,10,1,1,0,4,0,3,1,0,0,2,1,6,0,1,11,0,0,12,1,2,0,0,0,1,0,0,5,0,4,1,0,0,0,0,2,5,0,2,4,4,2,2,0,3,0,0,3,0,44,1,0,0,0,1,3,1,2,19,0,0,0,41,1,0,2,2,3,0,0,12,0,2,0,0,0,0,0,2,12,1,2,2,4,2,0,0,4,0,0,3,5,5,0,0,2,13,13,4,9,4,0,0,0,3,2,0,4,0,0,1,0,1,4,0,6,0,9,2,7,8,2,0,2,3,0,0,0,1,0,0,0,0,0,0,2,0,0,9,2,1,0,0,0,1,0,0,1,0,3,6,1,0,1,6,0,3,0,5,0,0,1,0,0,4,1,3,4,0,2,1,2,3,0,0,2,0,2,4,3,0,1,1,0,0,3,2,1,0,0,2,28,22,2,2,2,0,6,0,2,3,1,2,0,1,1,0,6,1,1,2,8,0,13,0,0,4,1,4,4,6,10,10,0,4,11,2,5,1,4,1,5,3,0,4,3,2,3,1,1,5,3,1,1,0,0,3,0,8,4,2,2,3,0,0,0,0,1,2,2,1,10,0,0,0,0,3,2,5,0,1,0,0,0,2,10,5,1,0,0,3,3,3,8,4,2,3,1,0,0,1,1,1,1,0,1,0,0,1,2,0,1,0,3,1,3,0,0,4,0,0,2,0,1,1,0,0,3,0,0,0,0,27,6,3,2,3,1,3,0,3,0,0,1,14,0,0,32,0,3,0,2,0,1,3,1,1,2,0,4,1,5,0,3,0,0,7,2,1,0,6,1,0,0,1,0,0,2,0,0,4,2,1,0,0,1,3,2,0,3,3,1,0,0,2,2,3,9,0,1,2,18,0,3,0,0,0,1,0,0,5,0,3,6,0,2,0,3,2,0,3,1,0,0,0,0,0,2,1,4,2,0,0,0,2,5,0,2,4,4,0,4,0,1,0,0,1,1,0,0,1,1,4,6,15,9,1,0,1,11,0,1,0,2,2,0,5,2,0,12,0,4,0,0,2,0,2,6,0,1,0,1,1,0,3,0,0,2,2,0,1,0,2,2,1,1,0,1,0,0,1,8,0,3,1,0,4,2,3,0,5,0,0,1,0,2,4,2,0,0,4,0,0,0,1,0,0,2,2,0,6,1,3,5,3,0,0,0,0,0,0,0,5,0,2,0,2,2,2,0,0,6,2,0,0,7,0,0,1,2,2,0,1,7,1,2,4,0,0,0,0,0,0,1,0,1,2,0,0,2,0,0,2,0,0,3,2,0,3,0,1,5,0,2,1,6,0,6,0,2,0,1,1,1,5,0,2,1,2,0,2,0,1,0,2,0,1,0,0,7,1,0,6,0,10,50,1,0,27,1,2,6,0,0,0,0,0,0,1,2,0,0,0,3,2,1,2,0,3,0,6,0,0,0,0,0,2,1,1,0,3,1,1,0,2,3,3,6,2,0,0,0,4,1,2,1,1,3,2,3,2,0,1,2,0,0,0,2,0,4,0,1,0,0,0,0,0,2,3,0,2,0,2,1,0,1,0,1,0,1,0,0,0,1,2,4,0,0,2,0,1,0,3,1,0,0,0,2,1,0,0,2,0,0,2,1,3,0,0,0,1,0,1,0,1,2,2,0,0,0,4,2,3,1,1,5,1,0,1,1,6,0,0,0,0,0,0,0,2,0,0,14,0,0,0,32,0,0,2,0,2,0,3,1,8,4,1,3,1,5,0,0,0,0,0,0,0,8,0,2,4,2,0,0,0,0,0,3,0,0,0,7,4,1,2,0,0,0,4,0,1,0,0,0,0,7,2,6,12,1,2,2,0,0,2,0,0,0,1,1,2,1,1,2,2,0,1,9,1,2,1,4,0,1,3,4,0,0,1,0,0,2,0,0,2,0,1,3,4,1,0,3,2,0,0,0,5,4,0,1,3,1,1,2,0,0,0,1,3,1,1,0,5,0,1,0,5,2,1,1,0,0,0,0,3,1,3,3,0,1,24,1,7,1,0,0,2,0,2,6,3,0,1,0,0,0,2,0,1,1,0,1,6,0,2,1,0,0,0,2,0,2,1,2,0,1,0,0,0,0,0,0,4,1,3,0,0,2,0,0,0,2,4,2,0,0,1,2,0,0,2,3,0,3,3,0,1,1,0,1,0,0,2,0,6,1,0,0,376,2,2,0,0,1,1,0,2,0,2,0,0,2,1,0,0,1,1,0,2,0,0,4,1,0,3,0,0,2,0,0,1,2,0,1,1,2,0,1,0,1,1,0,2,2,1,0,0,0,1,4,1,2,1,1,0,2,0,3,2,5,4,0,0,8,4,0,0,3,2,0,0,0,10,1,0,0,1,2,0,5,0,0,0,0,1,1,0,0,1,2,1,0,9,2,0,1,0,0,0,0,1,3,0,0,1,4,0,1,2,2,0,0,0,1,0,2,0,0,0,5,1,1,1,4,5,0,0,1,0,0,0,0,0,1,1,3,3,0,1,0,6,0,0,0,0,1,0,1,0,1,2,2,1,2,2,2,0,2,2,1,4,4,2,2,0,0,1,1,23,0,1,1,2,3,1,0,0,1,0,1,0,0,0,3,0,3,0,0,0,0,1,0,0,0,0,0,9,0,15,3,2,1,1,9,26,1,0,1,0,0,0,4,0,0,2,0,0,0,2,4,0,0,10,1,1,5,0,3,0,0,1,1,0,1,1,0,0,0,0,1,0,0,0,0,0,0,0,2,2,5,0,0,5,4,5,0,4,3,1,0,0,1,11,2,4,2,0,0,0,2,1,1,0,0,0,4,1,5,2,1,2,7,1,0,8,2,0,0,0,5,2,0,0,0,1,0,7,2,1,1,6,0,3,0,0,0,0,0,0,2,1,0,0,2,2,7,2,0,0,6,0,0,1,0,1,10,2,0,2,0,0,0,2,0,0,1,0,0,1,0,1,1,2,3,0,1,4,1,0,0,2,0,0,6,0,0,0,2,0,2,0,0,0,4,1,0,0,0,6,0,0,0,1,0,0,1,0,0,1,0,0,0,4,0,0,0,1,1,0,4,1,0,2,1,2,2,6,0,2,2,1,1,2,0,0,2,1,0,0,0,0,2,1,0,0,0,1,1,0,0,2,0,0,1,0,3,2,1,0,0,1,0,0,1,0,5,0,0,1,1,0,0,2,0,0,0,0,1,0,1,1,1,0,0,0,0,3,3,0,4,3,0,0,4,5,0,1,0,0,4,2,3,1,2,1,1,0,1,0,1,0,1,1,3,0,3,1,0,0,1,2,2,0,0,0,0,0,0,0,0,0,1,0,3,0,1,0,2,0,0,0,0,1,1,0,0,1,1,6,0,1,0,0,2,1,0,0,0,2,0,0,2,7,1,1,8,1,0,0,0,1,4,2,2,0,2,1,1,5,3,1,0,0,2,1,0,0,0,0,0,0,0,4,1,1,0,0,0,2,7,2,0,0,0,0,0,1,0,0,0,1,0,5,0,0,1,4,3,0,1,0,1,3,0,0,18,0,0,0,2,1,0,0,4,4,3,1,0,0,0,2,0,1,1,0,0,0,0,0,0,0,0,1,0,4,0,2,4,2,1,1,0,0,0,0,5,5,1,0,0,0,0,0,8,1,2,0,1,2,0,2,2,3,1,1,5,3,1,0,0,0,3,0,1,0,2,0,1,1,1,0,0,0,0,1,0,0,0,7,0,0,1,0,1,0,1,0,0,4,0,1,0,2,6,0,2,0,1,2,1,0,0,0,1,0,0,4,3,0,2,4,0,3,0,0,1,0,4,1,0,5,0,1,0,1,0,0,0,0,0,2,3,0,1,0,2,4,0,0,0,2,0,3,0,2,0,0,1,0,0,1,0,0,0,15,1,1,0,1,0,0,0,0,0,0,2,3,2,0,1,1,4,1,7,1,0,0,0,0,9,1,3,1,1,0,2,0,1,0,7,0,1,0,0,0,1,1,0,0,1,3,0,4,0,0,0,1,2,0,0,3,0,0,3,1,1,0,0,0,4,1,1,0,0,0,0,0,0,0,1,0,1,0,1,1,0,0,0,0,3,0,0,0,2,6,0,0,0,0,0,0,0,0,0,2,1,1,1,0,0,11,1,0,0,1,1,0,0,1,3,2,3,0,0,1,0,0,2,3,0,0,0,0,0,3,0,0,7,0,2,6,1,0,1,2,1,2,0,1,1,0,1,3,1,0,0,1,4,0,0,1,1,4,0,3,1,0,0,0,0,1,0,0,0,0,0,4,1,1,2,0,4,4,1,0,0,0,1,2,0,0,0,1,0,0,4,0,0,0,1,0,1,0,0,0,1,0,1,1,1,1,4,0,0,1,2,1,0,0,0,0,0,0,1,0,0,0,0,0,0,4,0,0,0,2,0,2,1,0,0,0,0,0,2,1,0,1,1,0,0,1,0,0,1,0,2,2,2,0,0,0,0,0,0,1,0,0,1,2,0,0,1,0,2,0,1,0,0,0,1,0,2,0,0,1,0,0,2,0,2,1,0,0,0,0,0,2,0,1,0,0,3,4,0,0,0,2,1,1,2,3,1,0,0,0,0,1,1,0,0,1,0,1,0,0,1,0,0,0,0,0,0,1,2,0,0,1,6,0,2,0,0,0,1,4,0,0,0,1,0,0,8,0,3,7,0,0,0,0,0,1,0,0,0,0,0,4,0,0,0,0,0,0,0,1,2,0,0,0,3,0,0,0,0,0,1,0,0,0,0,0,0,0,0,0,0,1,2,0,0,1,0,0,0,1,0,0,0,0,0,1,0,0,0,0,2,0,0,0,0,0,0,0,0,1,0,0,0,0,0,0,2,0,0,0,0,0,0,0,0,0,0,0,0,0,0,0,0,0,0,0,0
K26 Secret Window Secret Garden,king,3036,1569,1342,1347,1171,654,1923,838,1141,1092,734,828,774,289,242,402,878,351,351,411,405,465,285,343,106,293,159,182,267,147,197,252,226,246,245,291,182,257,49,217,277,211,226,184,206,189,201,165,259,205,167,138,195,108,120,114,277,138,150,163,163,100,106,126,127,142,57,106,42,146,85,82,105,67,101,91,85,145,93,81,70,65,183,126,122,111,85,60,99,62,39,67,104,63,102,88,86,54,86,77,65,151,65,62,196,126,73,115,66,84,76,76,20,58,74,73,46,93,54,31,85,42,68,52,58,53,70,60,41,48,72,81,76,37,65,47,15,42,45,45,137,61,52,47,64,54,62,92,34,67,37,52,51,36,34,38,40,23,46,88,16,90,100,72,40,38,55,36,44,40,24,53,39,53,52,14,36,49,62,60,27,45,65,48,31,21,45,32,29,23,20,22,55,48,10,35,2,34,22,17,23,46,49,42,22,68,26,27,34,32,3,36,16,31,26,21,34,31,26,18,22,43,52,28,63,19,16,35,21,79,46,24,29,89,30,2,19,22,19,15,29,23,29,11,23,31,28,44,23,30,31,9,22,36,19,17,22,13,24,14,26,17,32,34,24,20,33,41,26,17,35,32,41,27,12,25,25,16,43,39,28,18,28,26,79,9,46,14,22,7,24,10,26,6,25,35,33,20,5,23,19,28,34,15,28,13,7,1,9,14,18,12,19,27,25,22,14,12,11,4,24,45,29,13,13,42,9,35,38,18,34,31,27,19,16,19,11,2,19,34,25,10,13,24,23,7,26,32,14,12,43,4,40,11,25,12,11,50,6,19,9,11,14,2,13,8,16,22,2,13,12,9,19,16,18,21,6,26,12,22,22,14,14,14,9,19,0,32,11,17,10,22,115,8,15,31,9,9,25,22,5,13,27,26,18,10,16,12,7,10,15,29,17,24,13,12,20,11,13,24,13,0,1,22,10,20,15,13,14,4,21,21,7,22,0,37,14,14,0,15,10,8,4,25,24,15,46,21,9,10,9,8,5,31,14,16,2,20,12,12,16,0,0,2,9,9,6,8,7,17,3,37,17,10,6,17,4,0,0,10,14,11,8,9,2,13,5,1,27,6,17,5,4,9,7,5,5,26,0,19,14,33,19,5,15,1,4,9,16,21,8,9,7,13,7,20,0,7,14,5,11,5,15,2,19,15,15,6,12,19,88,5,27,12,23,0,12,24,7,10,21,11,24,8,15,7,0,1,11,16,1,18,6,2,13,4,9,14,11,3,10,17,15,27,7,13,7,4,5,2,8,3,8,8,15,4,12,0,3,3,8,12,10,4,5,11,4,25,2,17,10,3,10,8,9,10,2,7,2,14,17,13,12,1,3,0,1,12,0,6,9,2,18,18,0,6,6,18,6,2,3,15,5,8,8,7,10,15,19,0,12,16,4,2,4,0,21,5,20,4,9,0,12,7,2,14,24,4,1,14,0,6,18,14,7,15,9,4,3,3,7,10,9,5,0,5,12,14,8,16,10,7,2,3,2,4,10,4,13,9,1,9,17,5,40,7,3,12,4,10,11,4,1,13,14,12,6,0,4,10,4,5,17,11,8,3,0,5,9,9,2,9,1,4,10,5,1,4,8,3,0,2,4,1,8,10,12,0,5,3,6,5,6,3,0,42,5,1,10,5,10,10,9,13,2,0,14,9,15,4,1,5,5,4,1,7,9,2,4,1,3,3,10,4,2,8,5,3,18,7,16,8,1,1,0,6,6,7,0,7,5,3,2,7,9,5,5,5,3,6,11,5,0,11,2,12,0,2,0,11,2,4,0,12,4,4,23,8,1,1,1,17,17,0,5,7,14,0,6,12,6,10,9,4,5,4,6,2,3,7,12,0,0,8,1,6,11,13,0,9,4,3,1,2,7,3,2,0,6,4,10,6,0,2,4,4,0,9,22,15,9,3,14,3,1,4,25,0,8,4,8,11,7,2,0,4,4,8,5,4,6,6,7,4,3,7,7,5,5,11,5,3,10,5,6,15,5,0,3,10,3,0,9,7,13,8,9,3,4,3,6,0,7,0,4,1,3,4,10,6,8,0,7,4,1,9,1,0,16,0,8,3,4,0,3,3,4,7,10,10,9,5,3,2,6,2,5,29,3,4,4,6,11,3,0,5,15,9,6,1,0,14,8,0,1,6,0,1,6,3,6,0,13,11,4,18,4,6,8,3,1,31,3,2,11,3,7,0,2,9,5,3,7,8,6,3,0,4,6,0,3,0,0,3,2,4,0,0,1,5,5,2,3,1,21,4,6,0,3,7,0,4,1,3,4,1,9,2,3,10,7,8,2,1,4,4,6,2,11,9,5,2,2,3,14,32,8,0,3,13,6,2,0,9,7,0,2,5,1,1,4,4,0,1,5,1,2,3,1,0,184,10,2,2,1,1,8,0,5,3,2,2,5,1,4,0,0,13,4,0,6,0,15,3,1,2,4,5,5,0,4,3,7,4,6,2,4,8,7,14,5,8,1,9,0,0,2,0,4,2,1,8,3,3,3,2,9,8,1,0,2,0,2,0,7,7,4,3,0,56,2,3,2,6,1,0,5,6,3,2,7,0,5,1,3,1,7,1,0,19,17,3,1,7,0,0,0,6,0,0,2,1,8,5,2,5,2,0,5,0,8,0,0,4,2,10,0,1,2,0,5,10,0,11,2,1,6,0,0,2,7,0,8,3,8,2,2,1,11,3,0,0,7,3,13,0,0,2,7,5,6,13,1,4,4,2,3,5,0,2,4,4,0,5,7,0,0,3,1,2,0,0,3,0,2,4,0,6,2,10,2,6,0,5,0,13,3,2,0,6,6,0,2,3,0,2,6,0,3,4,0,0,0,0,0,1,8,8,0,0,5,12,1,9,5,9,5,3,4,2,0,7,4,1,4,2,0,4,0,43,2,3,6,3,0,5,0,0,5,1,24,0,5,1,3,1,11,14,7,2,6,2,1,0,15,0,4,1,0,3,0,8,7,0,6,5,4,0,1,2,0,9,6,0,4,4,3,4,4,7,13,0,1,1,7,1,2,5,1,0,0,1,8,0,7,1,6,1,5,0,2,4,4,2,17,0,0,4,0,0,0,0,6,9,0,3,1,1,8,2,5,2,5,50,0,1,2,0,1,0,0,3,0,2,0,1,1,0,7,16,1,0,1,7,0,1,7,3,0,1,1,12,0,1,1,2,4,1,7,2,9,3,0,0,0,4,5,1,2,5,3,4,0,2,0,3,1,3,5,2,5,4,0,3,2,0,1,3,1,5,1,10,5,0,0,2,9,0,3,0,1,3,7,1,0,0,1,2,1,4,3,3,0,2,3,2,11,3,0,3,6,7,6,7,1,2,0,1,0,9,3,0,1,0,0,1,0,3,1,4,4,0,0,0,3,10,1,1,2,1,0,5,9,5,2,1,1,7,1,3,2,2,1,5,1,3,2,6,25,1,12,1,4,2,1,3,2,0,6,0,3,4,2,2,16,0,1,0,2,2,7,2,6,0,3,4,0,3,4,1,3,7,13,0,1,8,9,5,3,3,5,0,3,3,3,4,7,4,0,4,0,3,4,1,1,4,3,0,3,2,0,0,0,14,4,2,6,4,2,1,4,4,2,4,4,0,0,1,0,5,1,1,9,0,0,7,3,4,3,3,6,3,0,0,2,1,2,1,2,9,1,3,8,2,0,2,0,4,4,0,1,0,2,1,1,5,3,5,0,0,2,4,1,1,0,1,3,0,2,1,8,9,9,12,2,3,11,1,0,0,3,1,1,1,1,0,0,3,1,0,1,0,1,0,0,3,5,0,6,2,1,1,5,0,1,2,0,1,0,0,3,4,18,0,4,1,0,0,0,3,0,1,2,2,0,0,1,0,1,0,2,3,6,0,5,1,5,3,4,0,4,0,2,2,0,2,0,0,1,1,11,2,0,0,0,1,0,3,0,5,4,0,1,1,1,0,7,1,6,0,2,0,6,2,2,0,0,2,1,0,0,0,2,2,3,2,1,6,1,2,2,8,0,1,4,0,1,0,14,2,0,1,13,2,0,0,2,4,0,0,5,4,3,2,0,7,1,0,3,3,7,3,0,0,2,2,0,5,0,0,0,9,0,2,0,2,1,4,0,6,0,2,0,1,0,2,10,2,1,1,2,0,5,4,1,3,5,2,0,1,2,0,0,1,0,0,0,0,2,7,0,1,0,2,1,1,0,0,3,2,0,0,3,2,0,1,4,1,2,3,0,7,0,0,1,0,1,2,0,5,0,15,3,4,1,10,0,0,83,3,0,0,2,0,7,3,1,1,3,0,8,0,0,1,5,7,0,0,0,0,0,0,0,0,0,0,0,3,0,5,0,0,0,2,0,1,2,0,2,1,0,1,1,9,1,0,0,3,0,0,3,1,1,2,7,1,1,1,1,0,0,3,1,0,3,6,0,0,8,6,2,8,5,9,0,6,0,7,2,1,1,0,3,0,1,16,2,0,2,0,1,0,1,2,0,2,2,3,3,0,3,3,0,2,0,0,7,1,4,2,5,5,0,4,3,0,1,0,0,0,1,1,1,2,13,4,1,0,2,1,9,1,0,0,5,3,0,0,1,3,2,3,7,2,1,9,2,2,1,1,4,3,0,1,2,2,3,0,1,1,0,4,0,3,0,0,4,0,2,0,9,0,3,6,3,4,0,0,1,1,2,2,0,1,2,5,0,1,4,3,0,0,8,0,3,2,0,3,4,1,3,2,2,1,2,0,0,1,0,0,2,0,3,0,0,0,0,0,1,5,1,1,1,0,0,4,4,4,0,1,1,1,2,0,4,5,2,0,0,4,1,3,0,0,4,0,1,2,4,0,0,3,0,0,0,4,1,1,2,2,7,0,2,0,0,0,0,1,0,1,4,0,0,0,0,3,7,1,3,3,1,1,4,1,1,3,1,1,2,4,0,0,0,1,2,0,0,0,2,3,0,7,1,2,2,0,6,3,0,2,1,2,0,0,0,1,0,3,2,8,1,0,1,3,0,2,2,0,2,0,1,6,0,1,0,4,8,13,2,0,0,2,2,0,0,2,0,0,1,0,0,0,0,0,2,0,1,5,0,2,4,0,1,2,0,0,11,0,0,55,1,2,0,1,4,0,1,1,0,5,1,1,4,1,1,2,2,2,2,4,2,0,1,6,0,1,0,1,0,2,4,2,0,0,4,7,0,0,4,0,1,2,0,13,0,0,5,3,4,0,1,1,0,0,10,0,0,2,4,0,6,0,4,2,0,0,0,0,1,0,7,2,0,1,0,19,13,5,0,2,5,1,0,2,1,3,1,0,0,0,1,1,1,0,8,0,5,2,0,5,0,0,0,2,0,0,0,3,0,11,3,0,0,3,1,0,1,0,2,2,1,6,1,0,1,1,2,0,0,0,3,1,1,1,3,0,0,1,0,1,1,0,3,2,0,0,0,3,23,0,0,3,4,1,1,1,1,1,2,3,0,2,0,10,1,0,1,0,3,0,0,1,1,5,0,4,0,0,1,2,2,4,4,4,15,4,1,0,4,0,0,2,0,2,8,1,1,0,1,0,2,1,0,0,0,0,2,0,0,0,1,0,1,0,3,2,1,0,8,0,1,1,0,2,0,1,0,0,1,0,2,1,0,0,0,4,2,1,0,0,1,0,0,2,9,1,0,5,0,1,2,0,0,4,1,2,1,3,3,5,0,0,0,2,0,8,0,5,0,1,0,0,0,3,1,0,0,2,0,3,0,0,0,1,1,0,0,0,1,0,15,0,0,0,0,0,4,2,0,1,0,1,1,2,1,1,2,0,0,0,0,1,1,0,0,0,2,1,1,1,4,1,1,0,3,0,0,2,2,0,1,0,0,0,3,1,1,0,6,0,0,3,2,1,0,0,0,1,0,2,1,4,0,0,0,1,0,2,2,0,1,0,1,1,0,0,5,2,0,0,0,3,4,2,0,4,0,1,1,2,0,1,0,0,0,3,3,0,2,0,4,0,0,0,0,0,2,2,0,0,1,6,1,0,0,6,1,1,1,0,0,0,0,0,3,0,4,1,1,1,0,2,3,2,10,0,0,1,0,2,1,0,0,1,1,0,0,0,2,1,4,0,1,0,0,1,1,1,0,2,2,0,3,1,4,0,0,3,0,0,0,2,0,1,1,0,0,0,3,2,0,0,0,2,0,1,2,0,0,1,0,1,0,2,0,4,2,13,1,2,0,0,0,4,3,0,3,4,2,1,0,2,4,3,2,1,0,0,1,0,0,0,4,0,1,0,1,2,0,2,1,0,1,1,0,0,4,2,0,2,0,0,0,0,1,3,1,0,0,0,3,4,1,0,1,3,0,0,3,0,1,0,0,0,0,0,2,3,0,0,1,4,5,0,0,0,2,1,2,0,0,0,1,1,4,1,2,2,0,4,0,1,0,0,0,0,0,1,0,1,1,1,0,3,2,1,1,0,1,0,0,4,0,0,2,0,0,0,2,0,0,0,0,0,0,0,0,2,3,1,3,0,0,0,1,0,0,0,6,0,2,0,0,2,1,1,1,3,0,1,0,3,2,2,0,1,0,3,0,8,0,1,1,3,0,1,1,2,1,3,0,1,2,1,1,0,0,0,0,0,0,0,0,0,0,0,0,0,0,0,2,0,0,0,1,0,0,0,1,0,0,0,0,0,0,5,2,0,0,1,0,0,1,7,2,0,0,1,0,4,0,0,0,3,0,1,1,0,0,0,0,0,0,0,0,0,1,0,2,0,0,0,1,0,0,0,0,1,0,1,2,0,18,1,0,5,1,1,1,3,0,4,0,0,1,3,3,15,2,3,0,0,0,0,1,1,8,0,3,0,3,0,3,0,2,10,0,2,2,0,0,0,0,1,1,1,0,2,0,0,1,0,0,3,0,0,0,1,6,9,0,1,0,0,1,2,0,0,0,0,5,0,2,2,2,2,0,0,1,1,0,0,0,5,0,0,0,0,1,0,0,0,0,0,0,1,0,0,0,3,0,1,0,1,0,0,3,0,2,1,0,1,0,2,1,0,3,0,0,0,0,1,3,0,0,0,0,0,4,0,0,0,0,0,0,0,0,0,0,2,0,0,2,1,0,4,1,2,2,5,0,0,0,0,1,0,1,5,3,5,0,0,0,3,5,0,0,0,1,0,1,1,2,1,0,0,0,1,2,1,2,0,1,0,0,2,1,4,1,3,0,3,7,0,0,1,2,0,1,0,4,2,4,0,0,2,0,0,1,0,0,0,0,0,3,1,2,1,3,0,0,0,0,1,3,0,4,0,2,0,0,3,0,0,0,0,3,0,0,0,3,2,2,2,3,0,1,0,1,1,0,1,2,2,2,1,0,0,4,0,1,0,0,0,0,3,0,1,0,0,0,0,0,0,0,0,0,0,0,0,0,1,0,1,0,1,0,0,0,4,0,0,0,0,0,0,3,1,2,0,0,2,0,0,0,0,0,1,0,1,1,1,1,0,1,1,2,0,1,1,5,12,0,0,1,2,0,0,2,1,0,1,0,0,3,0,0,2,1,0,6,4,1,0,2,0,1,0,1,0,4,1,0,2,3,1,2,0,1,0,0,0,2,1,0,1,0,1,1,1,0,1,0,5,2,0,0,1,0,2,0,3,3,0,0,0,0,0,0,1,0,0,3,0,3,0,0,0,0,0,1,0,2,0,1,0,1,0,0,0,2,1,1,0,1,2,1,4,0,2,0,1,0,2,0,0,1,1,1,3,0,99,1,0,0,1,0,0,1,0,3,0,0,0,4,1,8,2,1,2,2,0,0,0,2,0,6,0,0,3,0,1,0,0,2,0,3,0,1,0,0,1,1,2,2,0,0,0,0,0,1,0,0,0,0,0,2,0,1,0,1,0,1,2,1,1,0,0,3,5,1,2,0,0,0,1,0,1,2,0,1,0,0,0,1,0,0,0,0,3,0,3,0,21,2,0,6,0,1,4,0,0,4,0,0,0,1,3,1,0,2,0,6,3,0,0,1,2,1,0,0,1,0,0,2,0,0,0,5,0,0,2,0,0,1,0,0,0,1,0,1,1,1,5,1,0,0,0,2,0,0,0,1,0,2,2,0,1,0,0,1,0,0,0,1,0,0,0,2,0,4,2,2,0,0,0,0,0,1,1,0,0,0,1,0,0,3,0,0,3,0,0,3,0,0,0,0,0,2,0,0,0,1,0,2,0,0,0,0,0,1,1,0,2,0,1,1,0,0,0,1,0,0,0,0,2,2,0,0,0,0,1,4,0,1,1,0,0,0,0,3,0,0,0,0,1,0,1,0,0,0,0,2,0,0,1,2,1,0,0,0,0,0,0,0,0,0,1,0,2,1,0,0,0,0,0,2,1,3,0,3,0,1,0,1,2,0,0,0,1,0,1,0,0,0,0,0,0,0,1,5,1,0,2,0,0,0,2,0,0,0,0,1,0,27,2,1,0,0,1,2,0,0,0,0,0,0,0,1,0,1,0,0,0,1,0,0,1,0,0,2,0,3,0,1,1,0,0,2,0,0,1,0,0,0,0,2,1,0,4,0,2,0,0,1,0,1,4,2,0,0,2,1,0,1,1,0,2,2,0,0,0,0,2,0,1,1,2,0,0,1,2,0,0,2,3,0,1,2,1,0,0,0,3,0,1,2,3,0,0,0,0,3,0,0,0,0,0,0,0,0,0,0,0,0,0,1,0,0,0,0,0,0,1,1,3,0,0,0,0,0,1,0,1,0,4,0,0,4,2,0,0,0,6,0,0,0,0,0,0,0,2,0,0,0,0,1,2,0,1,0,0,2,0,0,0,0,0,0,0,0,1,0,3,1,0,0,0,1,0,1,0,0,4,0,0,0,0,3,5,0,0,2,1,0,2,4,2,0,1,0,0,0,0,1,0,0,1,1,0,2,2,0,0,0,0,1,1,1,0,5,1,0,4,0,0,0,0,1,0,0,0,0,0,3,0,4,5,0,0,3,0,0,1,0,2,1,0,0,0,0,0,0,0,20,0,2,1,4,0,0,0,12,0,0,1,0,0,0,1,0,0,3,0,0,0,1,1,1,2,0,1,0,1,0,0,0,5,0,0,0,2,2,6,3,0,1,0,0,0,0,2,1,0,0,0,0,2,1,2,1,0,0,2,0,1,2,0,1,0,0,0,4,1,1,0,1,0,1,0,0,0,0,2,0,0,1,0,0,0,3,0,1,0,0,0,0,1,0,1,1,0,4,9,0,0,0,0,1,1,5,3,0,0,1,0,0,2,0,0,0,0,0,0,0,0,1,0,0,3,3,1,0,0,0,0,3,7,2,1,0,1,2,0,0,0,0,0,1,2,0,0,4,0,0,1,0,0,0,0,0,0,1,0,0,0,0,0,4,0,4,0,1,0,2,5,0,5,0,0,1,1,0,0,2,0,1,0,1,0,3,0,1,0,0,0,0,0,0,0,0,5,0,0,1,2,1,1,0,0,0,1,0,0,0,0,0,0,1,1,0,0,0,0,1,0,0,1,0,0,1,1,0,1,0,2,0,0,0,0,1,0,0,0,2,0,0,0,3,0,0,1,2,4,3,0,0,1,1,13,0,0,2,0,0,2,0,0,0,2,1,0,0,0,0,0,0,3,1,3,4,1,0,1,0,0,1,0,0,1,0,3,0,1,0,1,0,1,2,0,4,0,1,0,1,3,0,0,0,1,0,0,1,0,1,0,1,0,1,0,3,0,1,0,0,0,0,0,0,3,1,1,0,0,0,1,5,1,0,0,1,0,0,0,1,0,3,7,0,1,2,0,0,3,0,1,0,0,1,1,2,0,0,1,1,0,0,0,0,0,2,0,0,0,0,0,0,0,3,0,1,0,1,1,0,0,0,0,2,1,0,0,3,1,0,0,1,0,0,0,0,2,0,0,1,1,0,0,0,0,2,0,1,1,0,1,1,0,0,0,0,0,0,3,0,2,0,0,0,0,0,0,1,1,0,2,1,0,0,1,0,0,0,1,0,1,0,5,0,2,1,2,0,1,0,3,0,2,0,0,1,0,3,0,0,0,2,0,0,0,0,1,1,0,0,0,1,0,0,1,3,1,0,1,0,0,1,1,0,0,0,0,0,1,1,1,0,0,0,1,0,0,0,0,0,0,4,0,0,0,1,0,0,0,0,0,2,0,1,2,0,1,0,0,1,0,0,0,2,0,0,0,2,1,0,3,1,1,0,0,1,0,3,0,0,0,0,1,3,0,0,0,3,0,0,2,0,3,0,0,9,0,2,0,0,0,0,0,0,2,0,0,2,10,0,1,2,0,0,0,0,1,0,0,0,1,0,0,0,0,0,0,0,0,0,0,0,0,0,0,1,3,0,1,0,0,0,0,1,1,0,0,0,0,0,0,0,0,0,0,0,1,2,1,0,0,1,5,2,1,0,1,1,0,1,0,0,0,0,0,0,0,1,2,0,0,1,0,0,0,0,0,1,0,1,1,4,0,1,1,0,0,0,0,0,3,0,0,0,0,0,0,0,2,0,1,0,3,3,0,0,0,1,0,0,0,1,0,1,2,3,0,0,0,4,2,2,0,4,0,2,1,1,1,0,1,1,0,0,3,0,1,0,0,0,1,0,0,0,0,4,0,0,0,0,1,0,0,0,0,0,0,1,0,0,0,0,1,0,1,0,0,2,4,1,0,0,0,2,3,2,3,3,1,0,1,0,1,1,1,0,0,0,0,0,0,0,0,0,1,0,1,2,0,0,0,0,0,1,0,0,4,0,0,0,1,0,0,0,0,0,1,0,2,1,0,1,0,1,0,2,0,0,1,1,0,0,0,0,0,0,2,0,0,2,0,0,0,0,1,0,0,1,0,0,0,0,1,0,0,0,0,0,0,2,0,0,0,0,0,0,0,0,0,0,0,1,0,0,0,0,0,0,0,1,2,0,0,2,0,0,1,3,1,0,0,0,0,0,0,0,1,1,0,0,2,0,0,0,0,0,0,10,0,0,0,0,0,1,0,0,0,1,1,0,0,0,0,0,0,0,0,1,0,0,0,0,0,0,0,0,0,0,0,0,0,1,0,0,0,1,0,0,0,0,0,0,0,0,0,0,0,0,0,0,0,0,0,0,0,0,0,0,0,0,0,0,0,0,0,2,0,8,0,0,0,0,0,0,0,0,0,0,0,0,0,0,0,0,0,0,0,0,0,0,0,0,0,0,0,0,0,0,0,0,0,0,0,0,0
K27 The Library Policeman,king,4095,2233,1859,1872,1716,1439,1609,1152,1505,1307,951,885,923,802,694,634,722,439,407,480,500,663,369,399,221,293,397,334,334,278,252,332,321,287,323,309,259,362,97,330,293,326,291,198,251,268,217,203,176,255,254,205,209,233,171,156,234,211,222,254,185,225,148,168,130,193,86,179,103,175,131,130,140,172,141,119,129,175,114,91,86,137,118,145,151,182,105,98,111,99,71,105,145,83,187,103,105,76,112,91,110,230,82,87,182,148,104,142,104,94,111,88,29,88,97,82,63,91,90,90,83,70,113,148,66,83,118,74,82,79,102,80,122,82,99,81,24,111,76,56,55,66,32,61,111,90,78,80,67,61,65,94,60,49,47,34,60,45,56,70,38,76,99,114,53,74,44,32,65,45,62,62,109,67,44,32,32,67,72,73,46,64,77,61,58,24,33,50,44,40,28,21,68,55,65,60,2,27,57,29,53,68,44,59,17,73,27,42,50,32,21,47,17,48,41,26,41,51,64,23,25,44,35,34,55,36,18,48,29,92,55,58,44,74,49,51,45,41,34,23,38,47,31,29,20,45,37,70,27,38,52,17,30,32,28,22,44,23,31,31,46,37,37,39,38,17,32,39,26,30,45,27,55,45,22,44,40,37,66,36,21,13,37,69,96,52,21,30,24,24,22,53,16,14,27,40,32,23,27,42,61,27,18,20,70,27,19,23,9,11,18,26,24,51,28,19,18,94,22,19,35,26,19,41,11,16,29,32,42,24,51,39,44,31,14,23,27,42,18,36,20,17,23,24,22,21,23,6,31,14,35,18,19,19,39,3,12,35,19,19,25,13,27,7,14,26,21,21,19,35,30,5,22,27,19,57,9,6,29,28,28,26,7,25,8,23,0,24,24,14,4,16,40,7,25,37,17,22,49,22,19,24,37,9,18,6,13,33,20,30,15,23,9,62,31,17,29,25,18,19,15,0,9,41,10,18,11,21,14,14,13,19,9,23,1,5,15,18,3,34,10,9,10,23,21,9,36,32,10,23,24,13,4,33,38,19,11,42,16,7,38,0,1,80,17,14,16,9,0,16,5,26,34,10,14,16,8,17,0,25,12,27,18,1,16,11,15,12,33,6,22,9,17,20,19,8,11,20,2,19,21,17,45,9,12,6,18,15,19,11,18,14,28,13,7,21,0,9,28,5,26,20,14,11,16,18,13,10,16,23,27,12,12,23,23,9,16,18,9,20,29,9,21,8,4,17,0,0,22,18,8,17,32,6,27,14,25,26,7,0,14,26,13,23,13,22,7,3,11,7,19,5,15,17,29,10,21,0,5,11,11,14,11,14,4,21,5,20,3,4,10,22,8,4,16,24,4,12,13,15,9,22,26,14,6,0,0,22,9,11,4,18,24,9,14,16,14,18,3,9,5,7,23,26,14,17,13,10,14,3,15,17,8,4,18,5,27,13,12,10,7,5,29,11,13,5,13,5,1,8,0,22,10,10,4,19,10,12,17,20,3,4,21,11,3,7,18,7,13,16,9,6,10,1,4,10,12,21,13,9,12,13,5,10,30,17,2,6,9,7,15,13,11,22,5,16,7,0,21,2,13,3,13,12,19,9,5,36,4,8,0,18,4,12,13,23,3,14,5,3,0,6,0,1,20,19,7,5,7,12,2,17,20,3,0,21,13,10,4,19,20,14,3,6,1,2,5,17,12,6,6,9,6,4,3,25,12,5,8,8,15,10,14,5,3,46,12,17,9,5,13,3,5,11,3,6,4,14,4,6,17,7,2,26,10,7,1,18,7,6,5,6,2,11,2,131,0,15,3,8,9,8,4,14,40,8,25,16,3,3,7,12,11,1,9,9,1,0,7,18,13,6,11,7,11,8,4,14,12,8,6,1,3,15,0,6,7,13,0,10,5,4,6,11,12,5,7,0,7,6,14,11,1,0,12,0,2,0,4,9,10,4,13,8,5,14,5,0,9,12,7,11,8,0,0,9,4,9,9,7,19,12,9,10,4,12,14,7,7,7,4,2,1,9,10,8,7,1,9,18,15,1,6,5,15,3,18,5,14,18,11,0,9,0,3,0,3,18,31,9,2,6,7,6,4,4,5,0,14,5,10,2,9,15,1,13,13,11,3,12,7,5,1,5,6,3,4,5,8,8,6,14,11,5,0,10,19,6,6,7,0,11,14,774,1,7,2,16,2,7,3,17,7,15,3,6,6,13,9,1,2,18,10,1,10,40,4,0,4,10,10,10,4,4,6,2,0,4,16,0,4,0,2,0,3,11,0,1,4,17,4,1,2,3,6,6,6,0,7,4,1,4,4,0,6,0,8,4,3,10,4,4,6,1,10,6,5,1,9,22,13,7,0,1,9,20,8,13,8,14,7,9,1,9,0,0,10,11,3,8,5,5,0,0,10,5,2,26,0,0,0,1,6,6,15,3,2,0,7,6,7,2,2,17,1,4,3,2,5,1,11,0,13,6,0,13,6,10,10,3,7,8,4,15,3,7,8,9,2,16,4,26,7,2,0,0,3,1,6,5,14,10,9,2,8,9,9,11,4,1,9,2,7,4,4,23,9,2,6,6,10,2,11,7,2,0,18,10,5,0,6,1,2,7,5,8,2,10,7,11,6,5,1,10,0,0,5,6,1,0,5,1,12,18,3,5,2,0,2,0,6,1,1,0,8,8,0,6,7,0,7,18,3,11,5,4,5,3,0,10,8,0,5,7,5,3,0,2,7,7,0,3,8,6,1,0,0,9,2,2,15,10,2,3,11,13,5,5,7,1,12,0,0,2,2,0,0,7,6,6,6,3,10,0,3,1,0,4,1,1,4,4,5,3,0,3,4,2,1,2,12,0,2,5,0,9,5,3,8,11,0,2,27,3,0,3,7,6,0,4,7,3,3,6,6,5,27,5,8,3,0,6,1,1,2,1,1,37,0,25,7,10,4,6,6,5,12,1,7,0,4,0,1,3,4,1,9,15,1,4,9,2,2,0,6,8,6,8,1,4,1,6,11,8,1,11,11,1,2,3,2,8,8,0,5,11,4,1,2,0,1,3,8,4,3,9,2,7,3,2,0,2,4,0,4,3,2,0,6,2,0,0,3,8,5,0,0,6,0,4,0,0,6,13,1,8,3,3,7,0,11,5,7,1,1,5,6,0,4,1,0,0,0,3,1,4,0,0,3,1,4,4,9,4,0,3,3,0,1,10,4,2,1,4,5,7,1,0,0,6,2,1,0,0,1,9,6,3,9,17,4,0,1,8,0,15,1,4,3,1,3,7,0,16,4,0,1,1,10,1,1,3,4,0,4,4,9,0,5,4,3,1,1,6,4,0,7,5,10,2,3,7,0,9,1,1,2,0,0,3,5,21,8,11,3,2,0,3,6,3,17,0,0,0,0,2,0,1,7,12,2,0,2,0,8,5,0,0,1,0,1,1,7,3,6,5,6,2,1,3,1,4,3,5,2,0,1,1,9,9,5,2,4,4,5,2,6,0,2,1,5,4,44,3,6,0,3,0,6,8,17,4,6,2,1,3,3,3,3,7,8,9,11,0,5,3,5,2,11,8,1,8,5,2,1,6,8,3,2,0,0,5,12,2,1,1,5,0,2,6,1,0,0,6,5,24,3,5,11,5,4,3,1,3,10,3,0,2,0,9,4,6,4,0,4,3,0,2,0,0,4,0,1,1,1,0,3,5,0,7,5,0,2,6,0,0,0,3,9,1,1,4,15,1,1,6,1,5,0,1,4,7,1,2,8,0,2,0,7,11,5,6,9,3,0,2,2,1,1,6,0,3,2,0,3,0,3,5,1,0,1,0,3,3,0,7,8,0,7,3,13,1,6,0,1,2,5,3,0,6,0,4,3,2,6,1,0,6,0,8,3,7,2,8,4,0,4,1,3,5,0,4,5,0,7,7,3,1,15,2,0,2,18,7,0,1,1,0,6,0,1,0,0,1,1,2,0,7,2,5,9,12,2,1,5,8,3,2,4,0,1,0,0,2,9,4,1,0,0,1,4,18,1,3,0,1,3,1,1,6,2,4,0,7,3,1,6,13,11,7,4,0,6,1,2,0,8,3,3,1,3,9,9,2,1,7,0,0,1,1,8,7,0,0,1,3,0,4,0,0,0,19,6,1,1,6,2,3,0,5,1,7,0,1,1,3,8,13,4,0,6,0,7,1,29,350,16,3,4,1,1,0,12,0,2,0,0,3,2,5,0,1,0,4,2,2,0,0,7,3,0,2,4,3,0,3,2,0,7,6,2,3,0,3,0,1,0,1,0,1,0,15,8,2,0,0,0,0,15,0,0,2,4,0,12,1,4,15,2,2,8,0,0,5,5,12,4,0,0,2,16,0,0,2,0,0,4,2,0,0,1,2,0,7,1,4,2,1,7,0,0,1,1,2,1,0,0,6,0,6,5,2,0,4,7,1,3,0,0,6,2,1,0,0,1,2,3,3,5,6,0,6,3,2,0,1,0,7,2,1,1,2,3,0,2,9,3,0,0,0,1,0,2,4,0,3,12,3,0,14,2,1,1,5,7,10,9,0,1,0,4,1,1,0,1,0,8,6,3,0,9,0,3,0,2,4,3,0,0,5,12,2,0,0,2,1,0,0,2,8,6,0,3,0,1,16,2,2,3,2,10,3,0,7,0,0,2,0,2,2,0,1,0,0,0,0,6,0,0,0,2,1,2,5,6,7,0,0,0,1,0,4,0,2,0,5,0,0,2,4,2,0,5,7,2,1,21,1,3,2,0,3,4,3,3,0,5,3,0,1,5,0,3,4,0,0,0,2,0,1,2,3,7,0,0,3,0,5,2,3,0,2,3,0,6,7,0,2,0,2,0,8,0,0,2,0,6,1,9,2,0,6,0,2,0,2,4,4,1,0,26,3,4,0,5,0,0,1,0,0,2,0,0,0,0,0,3,0,0,0,0,3,1,1,0,5,1,5,1,6,0,0,0,0,0,1,0,0,3,5,1,1,3,6,1,0,0,1,1,4,0,1,2,0,1,2,0,4,2,1,2,0,1,0,3,3,0,0,1,0,1,0,2,2,0,2,1,3,3,1,0,4,1,1,5,6,1,0,3,0,0,0,1,0,2,5,2,7,1,0,1,0,0,35,3,4,3,2,7,7,15,3,2,2,0,1,1,1,0,4,1,0,3,1,1,1,0,2,12,0,4,0,2,1,9,3,1,5,2,1,0,4,0,1,1,2,0,1,2,1,1,4,0,3,1,0,3,6,3,0,0,6,12,1,1,2,8,1,4,1,2,1,1,0,4,0,1,3,0,4,8,4,1,1,17,3,10,4,0,0,8,1,3,5,0,6,2,7,1,2,1,0,5,1,6,0,6,2,1,5,0,1,3,1,0,0,0,1,3,3,4,0,2,1,0,0,1,0,1,1,0,7,3,0,0,2,4,0,4,1,2,7,4,2,5,1,0,1,0,0,2,0,0,1,0,0,4,4,2,3,0,2,5,1,2,0,4,3,1,0,0,5,2,0,3,0,4,2,5,1,5,0,4,5,0,3,6,0,1,4,1,5,5,1,0,2,0,1,2,1,0,0,0,7,1,1,0,0,0,1,2,2,4,1,0,1,7,0,4,9,3,0,0,2,1,0,10,2,3,8,0,0,0,4,2,0,0,0,2,0,3,3,0,0,0,2,2,1,3,2,0,1,2,3,8,1,3,5,1,0,0,0,8,3,1,4,1,3,2,2,0,0,0,2,0,2,2,2,3,0,1,0,0,0,2,3,0,2,0,4,1,0,1,1,0,0,1,0,2,0,2,0,0,0,0,0,2,1,0,3,3,4,2,0,1,1,1,1,0,4,1,1,1,1,2,4,0,1,0,1,1,3,1,2,2,4,3,2,3,10,0,1,2,0,2,2,3,0,2,15,0,2,1,0,3,3,0,3,0,2,2,4,0,12,2,1,0,0,1,0,2,8,0,3,2,0,2,2,0,0,0,0,3,1,1,0,5,0,3,3,3,2,0,0,0,5,1,1,1,0,3,0,0,14,1,1,2,0,0,0,3,0,5,3,0,2,0,3,0,2,1,0,1,1,4,0,1,1,3,1,2,0,4,14,3,7,0,1,1,4,2,9,4,5,2,6,0,2,3,2,3,1,0,1,0,0,6,0,0,2,0,0,4,0,1,0,0,1,0,2,0,0,3,0,4,0,2,1,1,3,0,0,0,4,0,4,2,0,1,2,0,1,0,0,0,1,1,2,3,1,3,0,0,6,12,0,6,3,2,1,1,1,4,7,0,0,0,0,1,80,2,0,6,0,3,1,1,2,0,3,1,0,0,0,0,0,3,3,0,3,0,0,5,8,1,1,1,0,4,0,0,6,2,0,3,0,0,1,1,1,11,1,0,1,0,0,4,3,0,0,2,1,0,0,0,1,2,0,0,0,0,0,1,2,1,6,1,1,0,0,0,3,1,1,0,1,0,1,0,1,1,2,0,5,0,0,1,0,1,0,1,5,4,1,2,2,0,4,0,0,6,3,0,0,0,5,1,3,2,1,0,0,2,0,0,2,0,0,0,0,2,2,1,2,0,6,0,5,1,1,0,0,3,1,0,0,1,2,2,2,0,5,16,2,0,5,2,9,1,0,0,2,0,1,0,2,0,0,0,0,2,0,1,0,1,0,0,3,0,0,2,0,1,0,1,1,7,4,0,2,0,1,2,0,1,2,3,9,0,0,0,0,4,4,2,3,3,1,0,1,0,0,0,4,2,4,1,2,0,2,0,0,0,3,0,0,2,0,0,13,6,1,0,0,0,2,0,3,1,0,3,2,1,1,2,2,0,2,1,1,0,5,0,0,0,1,2,0,5,3,4,1,0,2,0,1,0,1,3,5,6,0,3,0,0,1,2,0,0,3,0,1,0,3,4,1,3,5,0,2,0,0,0,5,0,3,3,2,2,12,0,1,0,1,0,3,1,1,1,0,1,0,1,3,2,0,0,2,0,5,4,0,5,5,0,0,0,0,2,2,0,1,0,1,0,8,1,0,1,1,0,3,0,0,0,0,4,2,3,1,0,0,0,2,1,0,3,1,0,0,0,12,3,0,2,0,1,0,0,2,1,0,7,0,0,2,0,1,0,1,1,2,1,1,0,1,1,0,0,1,1,1,0,2,1,1,0,1,2,20,0,0,3,0,3,3,2,0,3,2,3,0,0,0,0,0,1,1,3,0,0,0,3,0,2,7,1,3,2,11,1,2,6,0,0,1,1,0,3,0,4,5,0,1,0,1,0,1,3,2,0,0,1,0,0,2,0,2,1,0,0,0,2,5,24,3,0,0,2,0,0,0,0,0,0,0,7,0,1,0,2,2,2,13,0,0,3,1,0,0,0,2,4,0,8,2,0,0,2,1,4,0,15,0,1,1,1,1,1,2,0,2,1,15,0,1,0,2,1,0,0,1,2,3,2,0,0,3,0,2,0,3,0,0,4,1,1,3,14,0,0,2,1,1,0,0,0,4,0,0,5,1,1,0,0,0,2,0,3,0,1,0,1,0,0,2,0,0,0,1,0,1,1,0,3,1,0,2,1,0,2,0,1,2,1,5,0,2,2,14,1,0,4,0,0,1,2,2,0,0,2,1,5,1,1,5,0,0,0,3,0,0,0,0,1,0,1,2,0,11,0,6,1,3,0,0,1,0,0,14,0,0,2,0,0,1,2,0,0,2,0,0,3,0,0,0,1,1,0,0,0,4,0,0,0,1,0,1,1,0,0,0,2,2,0,0,1,2,1,0,0,0,4,3,0,1,2,0,5,0,2,0,2,0,3,6,0,1,7,3,0,0,0,3,0,4,6,0,2,3,1,0,1,0,1,0,2,0,0,0,0,2,2,0,6,3,0,1,0,2,1,0,0,2,0,1,0,0,2,0,3,1,0,1,0,0,0,0,0,1,1,5,0,0,0,4,0,0,0,0,1,2,0,0,1,1,2,0,0,0,0,2,3,2,2,0,2,0,2,0,0,0,5,1,1,1,2,1,1,4,0,1,0,2,0,2,3,0,0,0,0,3,8,1,1,0,0,1,0,7,0,4,0,0,1,1,0,0,0,0,2,1,0,2,2,3,3,23,2,1,0,0,1,0,1,5,0,1,2,3,0,0,0,15,0,0,0,0,1,0,2,0,5,0,0,0,0,3,0,0,0,0,0,2,3,0,1,1,5,0,0,0,0,0,0,1,0,4,0,0,1,0,0,0,0,3,0,0,0,0,0,4,2,7,2,0,1,0,0,2,3,0,2,0,2,3,0,4,0,2,9,0,3,0,1,1,0,3,1,0,3,0,0,0,0,2,0,1,1,0,1,0,1,0,1,4,0,0,3,1,0,0,0,0,3,2,2,0,1,7,5,0,0,2,1,0,1,0,3,1,1,0,0,3,1,2,0,0,0,6,3,2,1,0,2,0,0,0,1,3,1,2,0,0,0,0,0,3,0,0,2,1,3,1,3,2,1,0,0,3,1,3,0,0,0,0,0,0,2,0,0,1,0,3,0,1,0,1,0,0,1,1,0,1,0,0,0,1,2,0,0,0,2,1,0,1,6,0,0,3,0,2,2,1,0,0,0,0,1,2,1,0,0,2,1,0,1,1,0,0,1,0,0,3,1,1,0,0,0,0,1,1,0,0,5,1,2,0,1,1,7,5,2,5,5,1,1,2,7,0,0,2,1,0,0,0,1,0,0,0,3,0,2,0,1,0,1,1,0,1,0,0,0,0,0,0,1,1,1,0,0,2,2,0,0,0,0,1,1,1,0,0,0,4,0,1,2,1,0,0,1,1,0,1,0,1,0,0,0,0,1,1,4,0,0,1,2,0,0,0,0,1,0,3,4,0,0,2,0,0,0,0,8,3,2,0,0,1,2,3,0,0,0,1,0,3,0,0,15,0,4,0,0,3,1,0,0,2,1,1,1,2,2,3,0,0,4,0,0,0,0,1,0,1,0,0,0,0,1,3,1,0,0,0,6,0,0,3,1,1,3,0,4,0,8,2,0,0,0,0,3,0,1,0,1,1,3,3,0,0,1,0,2,2,0,2,0,0,0,2,0,0,6,2,0,0,0,0,0,1,0,3,2,3,1,0,2,1,1,2,0,2,1,0,1,9,0,2,0,0,0,0,0,3,0,0,0,4,0,2,0,0,0,2,2,4,2,1,0,2,0,0,0,0,0,0,0,0,0,0,2,3,1,4,1,3,1,1,0,0,10,0,2,0,0,0,1,1,0,1,0,0,2,12,3,0,0,0,2,0,0,1,4,4,2,0,4,1,0,0,0,0,0,1,0,0,0,0,0,0,3,3,1,2,1,1,1,0,2,0,0,3,1,1,0,0,0,0,0,3,0,2,0,0,0,0,0,0,0,0,0,0,1,0,1,0,0,0,0,0,2,0,0,0,1,0,0,1,0,0,0,0,2,0,1,0,1,0,1,0,1,0,1,1,0,0,0,1,0,0,1,1,1,0,1,0,0,0,0,0,0,1,2,0,0,0,0,0,1,0,0,3,0,1,0,0,2,8,0,0,1,0,0,1,0,0,0,0,0,3,0,0,0,1,2,0,0,0,1,0,1,0,1,0,3,0,0,1,0,1,1,2,0,0,0,1,1,1,1,1,2,0,0,0,0,1,2,0,1,2,0,2,0,0,1,0,1,0,0,1,1,0,0,2,1,1,0,0,0,0,1,0,0,0,0,2,0,3,7,0,0,1,0,0,2,3,3,1,0,0,3,1,0,0,3,1,2,0,2,2,0,0,0,3,0,2,6,0,0,0,0,0,0,0,0,2,0,0,0,0,1,0,1,0,1,0,1,2,3,0,1,0,0,0,0,0,0,1,1,0,3,0,0,0,4,0,0,1,7,0,0,0,1,3,0,0,0,0,0,1,0,1,1,1,0,3,0,1,2,0,0,0,2,0,0,0,0,0,0,0,0,0,1,0,0,1,4,0,1,0,0,0,0,1,3,2,1,0,0,1,0,0,2,2,0,0,2,1,1,2,1,1,0,0,1,0,0,0,0,0,0,3,0,0,0,0,0,0,0,2,0,0,1,8,0,0,3,3,0,0,2,0,1,1,0,0,2,9,0,0,2,1,0,1,1,0,1,0,0,1,0,0,0,2,1,3,0,0,0,1,0,0,0,1,0,0,2,0,0,0,0,0,0,3,1,6,1,0,0,1,1,2,1,0,2,0,0,0,4,0,1,0,3,0,0,1,0,0,2,0,0,0,4,1,0,0,0,1,0,0,2,1,0,5,0,0,1,1,4,2,1,2,1,0,0,0,0,0,0,1,0,0,1,2,3,1,1,5,0,0,0,0,1,0,0,1,0,0,2,0,0,0,0,0,0,0,0,0,0,4,0,0,1,2,0,0,0,2,0,3,0,0,0,2,0,1,1,0,0,4,0,1,0,0,1,0,1,1,1,1,0,3,3,1,1,0,3,0,0,1,0,4,1,1,1,2,4,0,1,0,0,0,1,0,1,0,0,2,1,0,0,2,1,0,1,1,0,0,0,0,0,0,2,1,0,1,0,0,2,1,0,0,17,0,4,0,0,0,0,0,2,0,1,37,1,1,0,1,0,1,1,1,1,0,0,0,3,0,3,1,0,0,0,0,2,1,0,0,1,0,2,3,0,0,0,4,0,1,0,2,0,0,1,0,0,0,0,0,0,0,0,0,0,5,1,0,0,2,0,2,0,0,5,2,2,0,1,2,0,1,1,0,0,3,0,0,0,0,0,0,0,0,1,0,1,0,0,0,0,0,0,4,0,1,1,1,0,0,0,0,0,0,0,0,1,2,0,0,0,2,2,0,0,0,0,1,1,1,0,0,0,1,1,1,0,0,4,1,1,3,1,0,0,0,0,1,1,1,0,0,0,0,0,0,1,0,0,0,0,1,0,1,0,0,0,0,0,0,1,0,0,0,0,0,1,1,0,1,1,1,0,0,0,0,0,0,0,0,0,0,0,5,3,0,1,3,1,0,0,0,0,0,1,3,0,1,4,0,1,0,0,2,0,2,0,0,0,0,2,0,3,1,1,0,1,0,0,0,0,0,0,0,2,0,0,0,0,0,0,0,0,0,0,0,1,0,0,3,0,0,0,0,0,0,0,0,0,0,0,0,0,0,0,0,3,0,0,0,0,0,0,0,0,0,0,0,0,0,0,0,0,0,0,0,0,0,0,0,0,0,0,0,0,0,0,0,0,0,0,0,0,0,0,0,0,0,1,0,0,0
K28 The Sun Dog,king,3297,1780,1469,1550,1437,617,1276,938,1106,1216,580,822,868,196,194,404,754,402,314,363,404,518,443,275,93,333,85,282,278,170,192,237,352,224,223,278,187,285,73,310,271,291,225,175,118,201,276,213,283,189,168,185,222,133,135,119,194,112,153,214,113,106,138,136,99,145,84,157,51,132,98,43,76,123,102,130,99,139,105,53,98,115,111,127,108,124,58,56,156,65,126,81,122,65,96,67,70,72,68,65,96,144,61,79,158,216,80,114,72,107,72,121,19,64,85,47,38,77,74,52,57,27,82,66,33,53,59,93,79,51,54,45,64,68,35,61,8,54,52,59,30,60,24,36,103,56,41,108,94,61,43,40,51,44,39,34,22,23,56,84,24,56,85,120,46,172,54,29,53,33,34,43,90,26,25,38,15,35,53,41,57,57,50,27,45,25,36,29,39,29,35,28,70,58,35,50,101,32,28,8,38,85,22,47,19,154,36,37,45,17,29,35,17,30,20,33,41,33,45,11,24,36,45,19,20,38,24,12,17,63,44,24,24,38,38,6,13,21,18,30,5,13,33,17,23,33,33,47,27,26,23,6,23,14,18,19,99,19,38,47,33,22,24,25,25,4,32,19,33,26,25,33,39,18,29,21,16,9,54,39,23,29,23,19,66,16,30,11,22,17,12,5,3,14,27,20,21,41,6,28,18,21,12,17,40,14,29,4,7,15,39,12,3,33,27,27,15,27,24,6,24,29,19,59,12,16,30,20,13,19,21,11,23,14,11,23,12,3,14,20,10,13,6,3,18,9,16,11,13,17,46,10,17,16,48,13,14,37,9,19,26,12,29,2,14,14,10,16,11,19,17,2,32,1,14,25,7,10,21,17,7,15,32,8,8,6,0,21,16,15,121,18,3,14,24,30,12,12,12,27,13,9,18,12,41,15,13,13,10,13,21,9,10,27,24,22,19,17,10,19,17,1,7,28,5,11,17,39,15,12,17,13,7,18,1,15,13,17,0,30,17,18,5,32,7,8,16,13,10,17,14,11,2,33,10,17,3,6,17,16,10,2,1,8,7,11,10,6,7,13,3,19,12,27,12,14,3,1,0,10,8,15,15,3,9,19,2,6,35,7,22,10,8,5,18,4,12,12,1,15,12,6,15,6,18,9,3,23,11,5,9,27,21,8,4,11,0,5,11,15,38,12,9,4,6,11,12,3,13,32,38,9,8,9,8,4,18,25,11,10,15,1,28,6,7,6,0,1,28,9,12,11,22,3,22,6,9,21,16,7,3,10,16,22,10,12,7,3,6,10,55,15,13,19,11,5,5,14,11,10,8,9,12,10,0,8,7,39,6,6,4,28,11,7,17,12,4,2,6,8,9,15,21,4,0,0,1,9,0,10,2,3,25,5,3,6,9,5,3,10,2,4,0,14,11,11,11,14,76,0,6,12,9,0,10,0,5,18,9,14,7,0,8,4,6,15,10,10,0,10,0,8,15,7,3,7,16,8,2,2,4,6,7,4,1,9,15,11,4,5,5,2,6,5,9,9,3,18,12,1,3,4,6,7,17,13,1,8,4,12,15,2,2,16,6,10,4,0,0,5,6,2,24,9,8,7,0,8,1,12,1,16,1,7,12,20,6,14,15,8,0,2,2,4,10,12,6,4,12,18,8,11,3,4,0,12,3,6,1,10,17,98,1,3,0,0,3,12,7,8,8,5,7,4,0,7,7,2,10,0,12,6,18,13,1,3,4,3,14,6,12,3,11,8,0,7,7,4,6,10,2,2,4,4,4,4,24,6,2,3,2,1,2,5,5,6,0,4,0,2,12,4,6,13,6,6,39,7,3,1,3,20,8,0,13,5,0,0,4,12,7,4,9,3,11,13,5,4,19,7,6,1,1,7,0,4,3,5,0,8,12,3,3,3,4,1,1,0,9,9,8,2,0,2,6,3,2,3,0,8,18,4,5,11,3,9,1,0,10,16,18,6,7,3,0,3,1,11,2,13,10,5,5,19,2,6,10,6,5,13,18,2,2,0,4,17,8,0,6,19,11,0,3,4,11,7,33,4,5,7,17,0,3,0,2,5,2,7,13,4,3,0,4,2,3,4,5,1,21,8,10,1,3,23,3,12,4,3,12,5,7,8,5,7,7,2,1,2,6,26,4,8,4,3,0,9,3,7,8,3,0,7,5,0,4,6,2,1,1,5,3,5,6,7,6,12,4,6,16,1,0,8,7,1,0,15,4,0,23,24,9,3,0,5,4,6,0,8,3,0,3,0,2,0,4,5,0,0,1,11,7,2,1,0,0,3,9,1,0,4,0,3,2,0,5,3,15,3,1,4,4,11,1,1,11,4,12,1,3,2,6,4,1,2,14,1,2,3,30,2,5,2,8,4,1,0,2,10,3,11,6,5,0,1,4,6,9,2,0,0,0,0,3,6,1,9,0,0,8,6,16,1,2,6,7,3,0,6,1,0,1,0,9,1,0,7,2,5,11,1,19,1,1,4,10,1,9,3,8,3,6,13,1,7,0,2,2,0,6,1,2,9,5,7,3,4,7,6,3,0,6,13,3,1,5,14,11,1,5,1,4,0,1,3,5,8,5,1,0,5,2,0,4,12,3,2,1,3,0,1,2,5,2,7,2,2,2,10,1,0,6,1,6,1,3,5,0,1,6,0,3,3,1,3,5,5,0,11,8,0,8,2,0,15,2,2,4,10,1,3,6,0,3,3,17,0,5,3,3,13,0,4,6,3,1,0,0,8,4,2,6,13,9,1,11,12,1,10,7,6,3,9,2,2,1,0,0,4,1,3,17,1,1,0,0,1,0,7,2,2,0,9,1,8,1,0,2,6,0,14,6,0,1,9,0,4,1,3,5,0,0,0,0,2,0,4,2,1,0,35,6,5,6,4,5,8,26,10,3,44,0,1,4,5,4,9,2,0,1,4,5,16,6,7,4,7,0,8,3,0,0,1,6,3,0,3,8,14,1,9,32,0,222,1,6,0,4,4,1,1,0,13,9,4,2,5,1,0,0,3,9,6,0,0,6,6,2,3,1,1,2,0,7,1,1,1,3,2,2,0,3,7,4,0,2,0,2,0,8,12,4,3,4,1,5,0,0,8,0,1,0,0,1,6,6,4,2,0,9,3,10,1,1,2,6,3,3,0,3,2,0,0,0,12,0,4,0,0,0,3,1,9,2,0,0,4,2,3,5,3,6,7,0,3,0,5,0,0,5,3,0,1,0,0,4,14,9,2,2,10,4,1,0,5,0,1,8,5,3,5,1,5,0,9,1,0,6,1,7,2,3,11,5,0,0,3,5,0,5,2,5,1,7,5,0,3,1,19,1,3,4,1,0,5,1,4,3,7,1,6,3,3,1,5,2,3,0,0,0,3,7,0,1,0,0,0,0,3,2,0,5,0,4,0,3,2,0,0,0,1,2,5,2,2,2,7,8,3,1,1,1,1,1,2,3,0,3,4,8,2,4,1,1,3,7,3,4,0,1,1,7,3,8,0,4,0,2,1,2,2,0,16,2,2,3,1,0,1,1,7,7,3,2,0,9,3,5,1,14,7,2,3,6,4,2,2,3,3,21,3,0,6,4,2,5,2,8,0,3,14,0,0,0,1,5,2,5,6,3,4,2,4,1,1,10,1,0,1,0,2,0,6,11,0,0,5,1,0,2,0,2,1,4,0,0,34,2,2,0,2,10,1,4,7,0,0,0,2,1,1,0,4,10,0,0,4,42,5,0,2,2,11,0,1,11,3,2,0,9,1,3,8,6,9,2,16,0,0,0,8,1,1,9,1,19,0,0,5,3,1,4,0,4,6,0,1,6,0,2,0,6,4,0,3,1,5,14,2,2,0,0,1,7,1,0,1,6,2,0,7,0,5,6,2,4,1,6,7,2,3,3,0,11,0,3,0,3,0,3,1,1,0,24,6,0,0,2,1,3,1,0,1,0,0,0,7,0,1,1,1,5,2,2,0,1,2,0,5,1,0,1,0,0,4,0,1,2,4,0,0,1,1,3,2,0,3,5,0,3,1,2,4,0,1,0,0,0,1,9,9,1,52,5,1,0,0,3,7,0,1,4,10,28,1,1,3,0,0,1,7,6,3,0,0,4,2,0,3,0,0,0,15,3,3,0,2,3,5,0,2,1,8,0,13,0,8,11,5,12,0,3,0,6,3,6,0,4,2,1,1,3,2,1,0,1,1,5,2,1,2,0,6,0,1,1,4,0,19,6,0,0,2,3,9,0,3,4,1,8,13,1,3,0,0,0,9,1,1,0,2,0,11,1,3,0,1,2,0,0,0,0,1,0,0,3,2,1,1,0,0,4,0,0,3,10,8,1,1,1,9,1,5,0,1,2,0,1,2,0,0,0,0,0,2,0,2,0,1,12,2,1,3,5,1,0,0,1,6,1,1,7,1,1,2,1,0,0,1,0,6,1,2,0,0,0,5,1,2,2,3,0,0,4,4,3,0,2,4,1,1,1,0,1,0,0,1,6,0,1,3,5,0,6,1,0,4,0,1,0,0,5,3,1,6,1,3,2,0,1,3,6,0,1,1,2,0,2,1,18,0,5,3,0,1,3,0,2,0,3,2,3,1,1,0,2,5,0,0,4,4,6,3,36,2,3,3,10,2,0,1,6,2,1,5,1,2,2,2,3,1,0,0,3,4,0,0,9,0,17,2,4,0,0,3,1,10,0,0,1,5,0,0,0,2,0,6,0,0,1,3,2,0,8,2,1,0,0,0,1,1,1,3,0,4,6,0,2,1,0,0,2,0,0,4,0,0,1,2,0,4,1,5,1,6,0,1,3,7,1,0,1,1,4,0,15,5,1,2,0,1,1,2,0,0,5,0,1,0,3,2,0,4,2,0,0,4,8,1,22,3,3,0,2,0,0,0,0,3,0,1,5,0,0,0,1,2,0,2,2,1,1,8,7,0,4,2,0,3,1,5,0,1,0,0,3,0,0,0,1,6,0,4,0,3,4,0,0,2,0,1,2,0,0,0,1,6,6,1,1,0,2,2,0,2,1,0,0,3,1,0,4,5,2,1,1,4,4,0,0,0,0,6,0,1,5,3,1,2,1,0,0,2,0,0,0,0,5,19,2,0,0,0,0,0,1,0,0,2,3,1,2,0,1,0,0,1,3,3,2,1,2,5,1,0,0,1,0,1,6,1,0,0,0,4,1,4,1,1,0,0,1,1,0,0,0,1,2,0,2,1,0,2,0,1,0,1,5,1,0,2,0,3,7,4,0,0,0,3,4,0,6,2,2,0,0,0,1,0,2,7,10,0,0,4,1,0,0,0,0,1,2,2,1,1,1,6,0,4,2,0,1,1,2,7,1,0,6,4,0,4,0,0,0,0,0,0,0,0,0,1,4,2,0,3,1,0,0,1,2,8,0,8,5,0,0,0,3,0,2,0,2,0,0,0,2,0,0,0,0,1,3,0,2,5,0,0,1,11,0,0,1,2,4,0,3,1,0,4,1,0,0,1,0,0,1,0,1,0,4,1,3,0,2,0,0,2,2,0,0,2,2,0,2,0,0,1,0,2,1,0,0,438,1,1,1,0,0,0,0,2,2,1,1,1,0,1,8,0,0,1,4,0,1,4,2,1,1,1,0,6,0,0,0,1,0,2,0,0,1,0,0,0,0,0,0,3,1,1,0,2,0,0,0,3,0,0,0,1,2,2,2,1,2,4,5,4,0,1,6,1,1,0,0,1,0,6,2,0,0,2,1,1,0,1,0,2,0,1,0,0,2,21,0,2,2,4,1,0,0,21,1,0,0,4,0,0,0,0,0,0,0,8,0,0,3,2,0,1,0,1,1,1,2,3,3,0,0,0,1,0,1,0,2,2,3,2,1,2,0,0,3,0,2,2,4,3,2,0,4,6,0,0,1,1,0,0,1,0,1,2,0,5,0,1,2,0,1,1,1,0,0,3,0,0,0,0,4,0,0,0,0,2,1,0,1,8,0,0,2,0,0,2,0,1,7,3,1,0,2,1,3,0,1,0,1,0,2,4,0,0,4,0,4,4,1,6,0,0,1,2,0,0,0,1,2,0,1,3,3,1,0,0,3,0,0,0,0,1,1,1,2,2,6,1,0,0,0,2,1,0,3,0,0,0,0,0,0,2,0,1,1,0,1,5,1,0,0,2,0,3,1,3,0,0,2,0,1,2,0,4,0,0,0,1,0,0,1,0,1,0,0,2,0,0,0,0,0,19,0,0,1,0,0,11,3,0,8,1,1,1,0,2,1,0,0,0,0,1,1,0,2,0,0,0,0,0,2,2,2,6,3,6,1,2,0,0,7,0,0,1,1,0,3,1,0,3,0,0,1,0,2,0,0,3,14,2,0,4,0,1,4,0,1,0,1,0,5,0,1,0,0,2,3,0,0,2,4,1,1,3,0,0,1,0,2,1,3,2,1,1,2,3,0,0,0,3,0,2,3,0,0,2,4,2,6,1,1,0,0,1,6,11,0,0,1,2,2,1,2,0,1,2,0,0,0,0,0,2,1,3,1,0,1,0,0,3,0,0,0,1,3,0,0,1,0,3,1,5,1,3,0,0,1,0,0,2,0,2,0,1,0,5,2,0,0,2,0,0,0,1,0,2,3,3,0,5,1,4,0,0,1,1,0,4,0,0,1,1,3,0,0,1,6,0,3,0,0,2,0,1,0,0,0,0,2,1,1,0,0,10,0,0,0,1,0,0,0,1,0,2,0,0,0,0,2,5,2,0,0,0,0,0,0,1,4,0,1,0,0,3,2,3,3,0,0,0,0,4,0,0,5,0,3,3,0,1,0,0,1,0,0,0,0,0,0,3,11,5,1,0,0,0,1,3,1,3,0,1,0,2,1,0,1,0,4,5,0,4,3,1,0,5,0,2,1,0,1,0,1,0,2,0,0,1,0,2,0,2,0,9,0,1,0,1,5,1,0,1,1,0,1,0,2,3,2,1,0,0,0,3,4,0,1,3,2,0,0,0,0,3,0,1,0,1,0,0,0,0,1,10,0,2,1,5,0,0,5,0,1,2,0,4,0,0,2,0,1,0,0,0,0,0,2,0,0,0,2,5,1,6,1,1,10,0,0,0,0,1,0,2,0,0,2,10,0,2,2,1,1,3,0,0,0,0,2,4,0,0,2,0,1,0,5,2,0,1,0,0,3,1,0,0,2,1,5,0,1,1,1,5,0,0,1,1,0,0,0,2,1,5,0,5,4,0,2,2,1,0,0,0,3,1,0,0,0,8,0,0,1,3,0,0,0,0,4,1,2,4,1,0,1,0,4,9,0,0,0,2,3,0,0,5,0,0,0,0,3,4,0,0,1,2,5,1,0,0,1,0,0,0,2,0,3,0,2,1,0,0,0,0,0,0,0,1,0,1,0,2,0,2,0,0,1,0,2,1,2,0,0,3,2,1,1,1,0,2,0,0,0,4,0,0,0,1,0,0,1,1,3,0,4,0,0,3,1,0,0,2,4,0,0,0,2,0,0,4,0,0,2,0,1,0,8,0,0,0,1,0,1,2,0,2,0,1,0,0,0,1,0,0,1,0,1,3,1,4,0,1,0,0,1,1,0,1,3,3,1,1,0,0,5,2,0,0,3,1,0,4,1,0,0,0,0,0,2,0,2,1,0,2,1,0,0,4,1,1,10,0,0,0,1,0,5,0,1,3,0,0,0,0,0,0,3,0,1,0,0,0,0,0,1,0,0,0,0,3,3,3,0,0,0,0,1,0,1,0,0,0,0,0,0,0,3,0,1,4,3,0,0,0,0,0,2,0,4,0,0,2,2,2,0,4,2,1,0,2,8,1,0,4,0,3,0,0,1,1,2,1,1,0,1,3,2,0,2,1,0,0,0,1,1,0,0,0,0,0,0,0,1,0,2,1,3,0,1,0,0,0,0,0,1,0,1,1,0,0,0,2,0,1,0,1,0,0,2,2,0,0,0,2,0,1,0,2,1,0,3,0,1,0,1,0,0,0,1,0,2,1,0,0,2,0,4,3,0,1,1,2,0,0,0,1,1,0,2,0,1,0,0,0,4,0,2,0,0,1,0,0,0,0,3,0,1,0,2,0,12,0,1,2,1,0,1,0,0,0,0,1,1,0,0,0,0,0,0,0,0,1,0,0,4,0,2,0,0,0,6,1,1,0,0,1,0,0,1,1,3,1,0,0,0,0,2,0,0,9,0,0,0,1,1,4,0,0,2,0,0,9,0,1,0,3,1,5,1,0,0,0,1,5,2,0,1,1,1,1,2,1,0,0,2,2,2,1,2,3,0,0,1,1,0,1,0,0,0,0,0,0,1,2,1,2,1,0,1,3,0,2,0,0,1,0,1,1,6,0,2,0,0,0,3,1,0,0,0,0,1,0,0,0,0,0,0,0,3,2,0,0,0,1,3,2,1,0,3,2,0,5,0,3,0,0,0,0,0,2,0,0,0,0,1,1,2,0,0,3,0,0,0,1,1,0,1,0,0,1,0,0,2,0,1,2,0,0,2,0,0,4,0,0,6,0,6,0,2,0,1,1,8,0,0,1,0,0,3,1,7,1,0,1,1,0,0,0,0,2,1,0,0,0,1,0,2,0,3,2,0,0,0,0,0,1,1,0,0,1,0,0,0,0,0,0,0,0,1,1,6,2,2,0,1,0,2,0,1,0,1,1,1,1,4,0,4,0,0,1,0,0,0,0,7,0,0,0,0,0,0,4,0,0,0,0,0,2,5,0,1,1,1,4,1,0,0,0,0,1,1,0,2,0,1,0,1,3,0,1,1,3,0,0,0,1,0,0,3,0,0,1,1,1,1,0,3,2,0,0,0,1,0,0,0,3,0,1,7,0,0,0,0,0,1,0,0,1,0,0,1,1,1,4,0,0,0,1,1,1,0,0,1,0,1,1,0,0,1,2,0,0,0,1,1,0,1,0,1,2,1,0,0,0,1,2,0,0,2,0,0,0,1,1,2,0,0,0,6,2,7,0,0,2,9,2,0,1,0,0,1,0,0,2,2,0,1,0,0,0,0,0,2,0,0,0,5,0,0,2,0,0,0,0,0,0,1,3,0,1,0,0,1,0,1,2,2,2,1,0,0,1,2,0,0,0,2,1,1,1,0,4,0,0,1,0,0,1,1,0,2,0,0,4,0,0,0,2,0,3,3,1,0,1,3,0,5,0,0,0,0,1,1,0,0,0,0,1,3,3,1,0,0,0,6,0,3,0,0,0,0,1,0,0,0,0,0,2,0,0,0,0,0,0,1,0,2,0,2,0,0,1,0,0,0,0,0,1,0,1,0,0,0,0,7,6,0,1,0,0,2,0,0,2,1,1,0,0,0,0,0,1,0,0,0,1,1,0,0,0,0,0,0,1,2,1,5,0,0,0,0,0,1,0,0,0,21,1,0,0,0,7,0,0,1,6,2,1,1,0,0,0,0,1,1,0,0,2,1,0,0,0,1,1,1,2,3,0,0,1,0,1,1,1,0,2,0,0,0,1,0,0,1,1,0,0,0,6,0,0,1,1,0,2,6,0,1,1,2,1,0,0,0,3,0,0,26,0,0,1,0,2,1,2,0,1,1,0,3,0,0,1,0,3,1,0,1,0,1,6,0,1,0,3,6,0,0,0,0,1,0,1,1,0,2,2,0,0,0,0,4,0,0,0,2,0,0,1,1,0,0,0,0,0,0,3,3,0,0,1,2,6,3,1,0,0,0,0,1,3,1,0,0,3,3,0,0,0,0,0,1,0,0,0,0,2,0,1,0,0,2,1,3,0,1,0,0,0,0,1,0,0,3,0,4,0,1,0,0,0,0,1,1,0,1,0,0,0,2,0,0,0,0,0,0,0,0,0,2,3,0,3,2,0,0,0,0,1,0,0,0,1,1,0,0,1,2,2,0,1,1,0,0,0,1,0,0,0,0,3,0,94,0,0,0,0,0,2,1,0,3,0,4,1,1,0,0,2,1,1,2,3,0,0,0,1,0,0,0,0,2,3,1,0,0,0,0,1,1,2,9,2,0,0,0,5,1,0,0,1,0,0,0,0,0,0,2,1,0,0,1,2,0,0,0,0,1,0,0,0,0,1,0,1,1,1,0,4,2,0,1,0,0,1,0,0,0,0,0,3,1,0,0,2,1,0,1,1,0,1,0,2,0,0,1,0,0,0,1,0,0,0,0,0,0,0,1,0,1,1,0,0,2,0,0,0,1,0,0,6,1,0,0,0,0,1,4,1,0,0,1,1,3,0,1,1,1,0,0,0,0,1,0,1,1,1,2,0,0,0,0,0,0,1,0,1,2,0,0,1,1,5,0,0,0,0,0,0,0,1,0,0,0,1,1,0,0,0,1,0,0,0,0,1,0,1,0,0,0,1,0,0,2,1,0,0,0,0,1,1,0,1,0,0,0,0,1,0,0,0,0,0,3,0,0,3,2,1,2,0,1,0,1,1,1,0,1,0,0,1,1,0,0,0,0,0,0,0,0,0,2,4,0,0,0,1,0,2,0,0,0,0,0,0,0,0,0,1,1,2,4,1,1,1,0,1,0,2,0,0,0,0,1,1,4,1,1,0,1,0,0,1,0,4,0,0,0,0,5,1,0,0,0,0,0,0,2,0,0,0,0,1,1,0,1,0,0,0,0,3,0,0,0,1,0,0,0,0,0,1,0,0,0,1,1,0,0,4,1,0,0,1,0,1,0,0,1,1,0,1,0,0,0,1,0,1,0,0,0,1,0,0,6,0,0,0,1,0,1,0,2,5,0,6,0,1,0,0,1,0,1,0,2,0,1,0,1,0,0,0,0,0,0,1,0,0,0,0,0,0,0,1,0,0,2,1,2,0,0,0,0,1,0,0,0,0,0,0,0,0,1,2,0,2,0,0,0,0,3,2,0,0,0,2,3,0,1,0,0,0,3,1,1,0,0,0,0,1,0,2,0,2,1,1,0,0,0,0,0,0,0,0,1,0,0,0,0,0,0,1,0,1,0,0,0,0,0,3,1,0,4,0,1,0,2,1,0,0,0,0,0,0,1,0,0,2,1,0,1,0,0,0,0,1,0,0,0,0,0,0,0,0,0,0,1,0,0,1,1,0,0,1,0,0,0,0,0,0,0,0,1,0,0,0,0,0,0,0,0,0,2,0,0,0,0,0,0,0,0,0,0,0,0,0,0,0,0,0,0,0,0,0,0,0,0,0,0,0,0,0,0,0,0,0,0,0,0,0,0,0,0,0,0,0
K29 DT3 The Waste Lands,king,10147,5013,3572,4002,4223,1469,3451,2392,2760,2871,1608,2588,1792,686,731,1254,1861,1104,833,897,1293,1254,1066,900,332,720,386,801,597,570,663,613,645,622,802,595,664,634,353,678,622,740,614,474,331,441,461,425,469,527,469,596,443,485,360,353,574,302,429,380,345,279,317,540,355,364,285,368,311,315,178,198,246,302,149,280,227,249,275,205,185,305,273,328,258,453,241,175,214,155,139,249,317,236,234,160,271,210,181,205,155,281,187,200,386,522,274,374,160,248,243,330,149,265,164,157,189,188,159,123,240,159,131,342,58,115,259,218,164,134,253,193,148,102,288,140,76,248,200,93,39,110,52,97,176,109,104,219,119,108,128,174,166,143,116,60,102,63,132,133,105,172,114,148,126,350,148,70,105,182,32,87,139,124,13,182,80,168,150,132,81,76,164,110,118,46,47,133,159,78,70,74,103,137,96,142,105,42,101,39,79,176,99,191,66,54,45,85,63,98,56,85,50,80,82,108,86,144,114,54,72,86,151,132,41,99,49,66,50,117,171,107,115,330,110,8,80,93,119,75,49,43,72,69,55,70,60,133,54,115,85,57,119,73,129,59,70,73,116,224,109,60,59,78,73,33,53,105,44,118,84,36,107,47,53,55,71,45,143,62,55,15,96,106,182,92,53,29,52,59,73,11,1,43,60,68,66,63,4,55,56,57,50,59,238,70,10,12,55,59,72,15,34,77,60,83,45,74,85,51,139,70,41,170,29,28,51,52,54,52,52,54,59,63,74,28,88,24,43,68,52,26,39,5,28,29,71,28,34,55,93,37,45,97,126,3,14,58,25,32,30,119,47,17,52,34,51,52,39,48,49,44,36,18,31,91,38,6,72,35,62,73,63,66,17,2,0,41,41,92,20,32,42,30,57,81,53,23,39,38,69,55,62,25,33,22,32,43,19,78,67,29,34,35,75,69,62,61,17,50,36,1,16,18,38,52,16,48,39,17,78,18,68,51,9,86,45,60,2,75,48,21,50,44,23,14,104,62,24,52,90,25,13,78,54,22,17,53,58,37,50,24,0,144,6,21,35,55,1,54,23,79,35,32,36,38,43,46,0,32,19,59,57,60,27,31,86,87,46,13,38,21,67,25,29,31,46,37,21,18,52,23,28,44,57,18,6,40,81,19,38,60,26,73,33,53,0,20,37,24,52,36,35,14,43,25,42,20,38,43,29,34,37,26,53,1,36,57,21,11,84,15,43,58,51,78,0,6,24,23,49,35,19,9,51,39,28,42,18,14,15,26,22,24,39,24,36,53,9,7,16,44,20,45,20,16,43,3,13,27,28,41,19,32,21,58,29,41,12,11,23,22,19,12,34,16,12,28,29,33,26,58,42,19,11,0,1,45,27,29,15,54,59,6,11,48,28,5,12,38,11,3,3,30,40,30,48,68,38,9,10,82,27,30,28,0,26,62,32,45,17,17,29,33,9,40,30,27,1,30,0,34,65,25,72,24,48,3,74,4,23,11,24,17,1,35,52,16,15,32,51,29,48,6,22,31,10,43,15,9,21,32,18,13,62,18,3,37,16,41,35,3,30,22,3,20,19,1,23,36,24,8,45,21,14,52,5,34,7,34,10,49,74,23,8,62,20,69,35,29,16,5,14,11,50,64,7,14,18,18,23,7,31,49,0,35,14,17,18,38,62,26,59,17,1,6,34,14,30,14,10,44,23,11,5,93,11,3,24,16,36,34,28,17,28,27,24,33,37,16,22,18,16,5,0,16,4,34,11,19,34,8,47,28,41,18,22,10,10,17,11,21,3,33,25,28,0,24,20,28,11,14,32,35,24,24,82,18,7,8,29,30,34,2,21,21,2,10,46,29,15,7,12,25,18,31,8,49,20,33,6,6,25,11,2,25,20,20,0,9,53,8,19,18,33,29,20,0,18,16,29,35,13,9,12,11,21,6,2,29,13,5,6,38,22,78,8,1,26,42,18,11,20,3,0,7,5,29,15,40,61,19,35,24,9,19,21,14,19,36,17,19,3,3,19,19,39,1106,43,60,4,7,28,6,19,18,29,13,28,33,16,0,25,2,17,4,26,8,53,18,15,20,7,16,11,26,4,0,21,17,23,22,11,0,5,17,14,42,5,20,4,22,12,20,24,20,1,20,18,2,18,11,19,2,18,36,8,15,10,23,0,10,4,1,9,25,15,58,2,19,12,1,31,10,6,27,9,6,24,12,2,45,21,2,0,36,22,0,23,9,21,36,2,34,11,15,0,11,12,0,13,0,7,0,32,23,0,0,4,24,10,4,3,1,8,15,7,2,3,14,2,19,6,1,27,0,24,8,11,29,8,114,29,8,37,2,14,9,7,21,11,11,3,13,31,20,30,23,5,10,35,8,27,3,12,0,18,22,7,25,5,20,0,1,42,33,6,3,0,0,0,2,14,7,5,14,3,0,9,51,6,12,9,6,6,3,1,10,33,0,3,0,16,16,5,6,15,11,29,5,9,10,6,8,4,8,29,8,10,38,17,34,3,12,0,2,4,6,19,9,16,22,16,20,26,1,28,21,5,2,13,5,22,13,45,38,39,10,3,26,36,6,5,17,16,6,31,1,18,5,17,2,16,12,15,15,0,7,12,18,4,6,9,38,0,15,2,24,1,54,0,14,12,21,18,21,14,6,27,0,8,31,19,19,11,26,0,3,18,0,13,27,0,39,6,36,7,22,4,15,4,0,8,11,14,5,3,3,16,19,0,4,39,23,13,0,0,28,18,11,6,8,38,4,39,30,4,32,15,21,11,12,3,16,9,0,4,99,3,8,32,3,13,0,1,1,0,1,8,4,4,14,7,19,2,45,39,4,1,38,8,0,14,18,0,6,15,3,16,5,0,2,16,13,0,0,24,2,0,8,8,6,6,17,18,6,14,6,9,8,0,6,10,5,5,13,5,7,2,3,7,32,17,21,11,19,2,20,13,3,3,10,8,11,3,13,18,47,5,21,20,8,2,0,6,13,12,9,4,7,1,10,12,7,0,19,1,5,11,14,29,35,3,0,11,12,5,17,16,2,9,10,11,11,11,12,24,20,8,1,2,6,20,0,8,5,4,8,21,15,1,18,34,2,16,3,0,5,0,5,0,0,5,30,9,4,5,13,16,12,7,11,15,1,0,9,10,0,6,2,0,0,0,10,0,31,5,0,7,2,16,14,7,3,0,18,13,24,10,8,3,1,6,3,5,7,0,3,11,9,8,4,0,0,0,17,16,10,18,22,6,5,1,10,89,23,1,7,15,6,9,15,0,15,8,0,59,1,14,14,5,35,12,0,2,7,26,0,3,5,22,3,9,19,0,2,9,10,5,7,10,11,8,6,0,9,8,8,6,12,9,8,2,15,7,3,1,0,2,4,76,0,1,0,0,9,0,9,12,14,7,6,17,0,24,12,4,0,7,2,7,12,17,5,30,24,62,7,2,14,2,10,4,3,20,0,5,1,11,6,20,3,7,20,6,10,5,0,10,1,18,15,17,8,4,0,13,39,35,18,4,26,7,2,8,2,16,21,10,15,10,40,15,0,6,6,41,3,34,3,3,14,5,16,17,4,3,2,42,5,0,9,6,3,12,14,84,0,7,31,0,0,0,12,12,16,3,6,23,9,9,12,9,9,15,4,0,4,0,15,7,9,13,0,3,10,7,6,5,10,7,3,6,4,18,19,10,6,1,11,5,5,9,14,1,0,11,10,16,3,6,15,11,3,18,20,2,8,0,16,7,17,16,5,6,16,10,0,16,10,10,21,9,19,2,12,0,1,7,26,13,17,17,7,8,10,0,8,5,6,3,0,9,4,0,0,20,1,18,3,32,0,11,2,5,4,17,12,9,1,0,14,0,6,7,4,3,6,0,8,5,11,37,4,15,0,8,1,9,20,9,8,52,0,1,12,5,5,18,6,5,4,24,25,0,5,4,11,24,6,1,8,14,7,1,4,0,23,8,23,10,7,5,6,3,13,1,10,5,0,14,3,0,4,5,6,2,7,5,1,1,4,3,7,1,10,6,3,8,8,10,11,0,13,2,2,5,6,8,11,2,2,7,5,3,1,5,7,6,3,16,25,10,7,35,15,13,0,4,8,13,13,0,0,7,5,1,4,0,0,0,41,19,5,1,9,4,5,0,19,3,15,0,19,17,10,21,8,1,0,8,10,19,4,5,2,24,9,11,5,3,9,16,103,7,0,3,2,2,19,18,4,0,9,11,6,4,22,9,12,0,6,12,8,0,15,8,2,4,1,2,14,0,2,9,4,2,1,8,2,0,14,3,6,0,2,2,6,12,6,0,6,8,0,20,10,2,7,3,16,14,1,0,1,17,53,14,0,14,1,27,16,0,5,1,0,2,11,0,7,3,3,0,18,0,13,2,1,4,1,3,9,0,18,4,0,1,4,3,20,4,1,8,4,17,6,0,4,0,20,5,5,1,0,8,1,1,12,1,8,1,8,8,8,13,0,12,6,5,0,7,4,3,0,1,3,5,0,1,4,8,0,6,9,3,10,7,10,0,34,1,7,1,11,31,4,8,2,3,6,3,1,13,4,9,0,12,9,0,0,5,1,12,5,2,16,21,6,3,2,7,5,10,0,10,1,8,0,13,11,8,1,5,5,3,27,4,14,2,10,18,4,3,3,1,5,9,8,10,2,0,6,5,3,0,2,15,1,6,5,17,0,2,9,5,5,0,2,0,2,4,23,3,9,1,33,5,3,30,12,2,0,14,3,11,4,0,0,2,8,3,4,11,6,4,0,1,7,0,0,9,0,1,21,0,0,0,1,6,7,14,9,5,8,0,12,3,23,8,3,0,3,16,1,16,18,0,3,0,2,3,10,0,0,8,0,8,2,25,7,0,16,1,0,20,20,6,0,2,8,0,3,5,0,3,0,0,6,1,13,8,0,0,0,0,7,6,0,0,0,2,3,3,2,3,14,2,13,6,4,0,9,0,0,14,11,0,0,7,6,0,2,6,16,4,0,1,4,2,2,9,3,6,1,1,7,5,3,14,3,3,6,1,4,12,1,4,0,9,0,5,2,7,4,0,3,7,3,7,5,7,2,3,2,2,20,5,23,2,0,0,6,5,1,2,6,2,13,5,0,3,0,2,15,0,1,7,1,11,2,6,8,5,7,3,0,4,3,5,2,4,9,2,12,1,6,3,4,10,5,11,0,2,3,1,5,2,0,3,4,8,10,8,6,6,1,9,3,11,4,0,0,0,1,2,8,1,8,16,4,2,5,1,12,0,1,2,7,5,10,12,5,6,4,2,0,4,2,0,0,15,18,2,6,1,4,1,16,0,1,6,0,3,3,0,14,10,0,59,1,4,1,5,0,5,0,11,12,1,26,0,7,0,10,86,0,2,0,1,6,6,4,0,17,5,0,6,0,9,20,6,9,12,0,2,7,14,8,5,0,3,5,1,1,6,1,8,5,0,15,4,0,2,15,0,0,4,9,0,0,5,3,26,4,9,4,13,4,2,2,0,9,7,0,12,0,3,11,5,1,6,6,3,8,0,5,8,0,4,4,5,5,8,1,0,3,1,0,1,0,0,3,8,6,2,9,0,0,2,0,2,1,3,6,0,2,13,0,7,5,3,0,17,15,2,1,12,18,2,20,1,1,5,12,5,6,0,0,2,2,3,5,0,1,0,0,3,7,1,4,1,1,2,4,0,1,0,1,2,10,3,0,8,4,4,5,2,3,7,1,4,0,2,0,2,2,8,4,11,13,0,0,0,2,3,0,3,5,0,0,4,0,1,3,1,2,7,0,1,11,2,0,0,2,0,0,8,2,0,3,2,13,9,2,0,3,8,0,0,0,2,4,9,2,20,9,0,2,2,2,5,3,12,0,4,16,13,14,7,0,3,8,13,0,12,5,6,14,13,2,2,6,8,1,0,13,4,6,4,3,1,5,0,2,2,0,0,1,7,0,2,11,0,10,1,1,11,1,0,0,1,5,3,4,3,5,0,6,6,4,4,14,0,4,1,15,15,5,4,3,5,1,1,0,0,1,0,15,2,0,3,2,8,0,1,4,0,7,5,5,0,0,3,1,5,0,3,4,8,1,1,2,9,32,2,2,0,0,1,2,1,0,9,1,0,17,0,1,3,0,14,7,6,0,1,2,11,0,0,1,0,1,9,9,3,0,1,8,0,6,7,1,2,3,0,0,0,12,13,9,0,0,1,5,3,0,3,0,5,1,3,9,2,7,0,5,9,4,2,4,9,1,0,17,1,0,10,9,2,3,2,1,8,9,1,0,0,0,0,1,4,2,3,0,4,1,2,6,4,3,6,1,2,3,0,0,20,18,0,4,0,3,9,6,10,3,3,0,13,2,3,2,20,2,6,9,0,1,4,0,5,9,0,1,8,3,20,9,1,0,2,11,12,2,0,2,1,0,6,1,0,0,3,6,9,14,8,3,9,5,7,33,5,10,0,2,0,8,1,21,1,0,3,12,1,6,5,2,5,2,3,12,0,4,7,23,5,2,3,16,11,4,0,0,0,13,4,12,4,6,9,3,0,20,0,3,0,0,3,2,5,0,0,2,2,2,4,4,5,0,0,3,9,9,0,1,3,6,1,2,0,8,0,3,3,8,4,5,8,2,0,1,0,3,4,4,6,0,0,1,0,2,2,2,22,2,1,10,1,0,1,0,7,0,1,1,11,10,1,3,0,0,14,1,14,11,4,5,0,2,0,0,3,0,4,1,2,7,0,5,1,0,0,3,4,3,10,4,0,3,4,0,0,7,3,2,5,0,4,8,14,4,1,0,6,5,0,24,5,6,1,7,0,4,2,3,1,3,5,8,0,9,0,1,6,5,8,2,5,18,2,0,2,14,4,17,1,5,5,9,4,0,4,0,1,11,0,3,3,8,0,0,0,1,1,0,2,9,0,4,3,0,2,16,0,2,1,2,2,3,0,0,0,0,8,2,6,2,0,0,0,0,6,10,4,0,0,1,1,4,4,0,2,14,4,1,0,1,0,1,0,4,0,0,0,1,0,0,0,3,3,4,1,3,0,0,17,2,2,2,4,11,0,9,2,2,1,1,0,0,3,5,13,2,1,2,1,5,13,4,2,0,2,1,2,1,0,2,2,4,0,1,8,9,2,1,2,3,4,3,0,2,0,0,9,3,5,3,16,12,2,0,4,1,1,5,1,0,6,3,5,9,1,0,15,2,0,9,2,4,2,0,2,0,6,10,0,3,0,20,4,7,4,0,2,0,0,0,6,0,2,4,0,1,1,11,1,3,3,2,0,0,1,0,4,0,3,21,9,0,4,0,26,6,3,4,0,8,1,2,0,2,0,0,0,4,7,0,0,0,1,4,18,0,1,1,1,1,0,0,3,3,5,0,20,4,0,0,0,5,6,4,6,0,0,9,3,2,2,0,0,0,4,4,0,5,4,0,3,0,2,5,8,2,3,17,0,1,0,7,0,4,0,0,9,2,2,2,12,0,7,0,2,4,1,3,0,0,0,1,4,2,3,4,0,19,10,1,10,0,2,1,0,4,2,0,0,0,4,11,3,5,3,4,2,1,0,4,4,0,3,8,2,9,1,0,3,8,2,0,1,11,2,1,2,1,5,4,1,0,1,1,1,1,0,0,1,3,10,1,4,2,0,0,2,5,6,1,1,16,0,2,4,6,0,1,0,0,1,0,2,2,7,0,1,1,5,0,6,4,1,0,0,1,2,0,0,7,0,0,1,6,0,2,3,1,4,3,0,2,0,1,1,1,0,0,8,2,0,0,0,0,4,1,7,6,7,0,3,0,0,0,2,0,7,4,8,2,9,5,1,4,1,4,8,31,2,10,0,4,1,3,1,4,3,2,40,2,16,3,6,8,10,0,3,7,2,6,0,4,1,0,0,0,0,1,5,0,6,0,1,0,2,3,4,4,3,0,4,2,2,14,8,9,0,0,7,5,3,1,5,2,0,0,1,6,2,4,0,4,0,4,9,7,3,1,2,0,3,1,0,0,3,5,3,1,3,2,5,11,3,0,5,10,0,2,5,0,0,0,3,4,8,0,2,0,1,0,20,3,10,0,6,3,0,0,6,1,3,0,5,4,1,2,5,7,11,8,6,3,0,0,0,0,4,2,0,4,6,10,2,0,2,14,2,0,1,2,0,0,7,2,17,2,0,2,10,1,5,3,0,5,1,1,1,11,9,2,8,6,1,2,1,1,0,1,1,0,4,0,1,3,3,0,1,0,7,23,2,3,1,11,0,0,2,0,0,0,5,48,1,2,23,0,8,1,6,1,0,7,1,0,11,6,3,5,0,11,15,4,2,1,0,0,0,3,6,1,0,0,2,1,3,0,8,4,3,0,1,0,2,0,0,1,15,2,3,2,8,1,6,1,0,1,0,0,5,0,9,0,3,1,3,2,1,1,4,3,0,0,8,0,10,4,3,0,0,3,0,3,0,3,1,0,1,0,5,9,1,0,2,6,8,0,0,15,20,0,0,4,0,13,0,0,0,0,1,0,2,6,7,0,0,2,4,0,0,3,0,0,4,4,3,3,1,0,0,1,0,0,0,0,1,0,1,2,3,1,0,0,5,12,2,2,1,1,4,0,0,3,2,0,6,1,2,1,1,0,1,5,7,1,8,0,1,1,4,5,1,0,2,3,2,1,3,7,1,5,1,5,1,18,2,3,0,1,2,5,1,0,1,5,9,2,0,1,0,0,1,0,0,1,0,4,0,1,0,1,0,0,0,2,4,2,2,3,0,1,2,1,1,5,4,3,0,0,0,0,11,3,0,0,1,10,0,1,7,2,0,2,0,8,0,6,12,0,0,0,3,1,2,0,13,2,1,1,0,1,0,0,0,10,2,5,5,0,1,0,0,0,5,0,2,6,0,0,7,2,3,3,1,2,1,9,5,7,1,7,2,0,3,5,0,3,2,4,13,1,1,0,0,1,14,0,1,0,1,3,5,0,3,7,0,2,1,0,0,1,2,1,1,0,0,1,12,1,4,1,7,1,4,2,6,2,7,3,7,0,0,12,4,0,1,0,1,1,4,4,0,0,0,0,2,0,0,6,1,0,0,0,17,0,3,6,2,0,2,1,4,0,1,5,2,0,2,2,7,6,1,0,1,1,13,2,12,5,2,2,0,2,6,0,4,2,0,0,5,7,1,26,0,1,0,4,2,4,11,5,0,0,1,0,2,2,0,4,2,2,8,0,2,0,2,7,7,0,2,1,3,0,4,41,0,4,1,4,4,3,2,3,0,1,7,5,2,0,0,0,1,0,2,1,5,2,1,0,4,8,0,0,0,0,0,7,0,1,1,2,0,8,8,15,0,4,4,2,2,1,1,1,0,12,0,1,0,0,0,1,0,3,0,2,1,2,2,2,3,1,0,3,2,0,0,13,0,0,4,0,1,0,2,0,0,1,3,0,10,8,1,0,2,4,3,4,9,0,8,2,0,9,5,0,4,3,1,0,1,0,1,3,5,5,1,0,0,2,0,4,0,0,0,4,3,0,0,2,0,0,1,0,0,3,1,4,2,0,9,4,0,0,6,1,0,2,0,2,2,4,3,2,0,7,0,0,3,2,0,2,10,1,0,3,12,2,1,0,0,7,4,0,1,0,1,0,19,2,4,2,3,5,3,3,1,1,2,0,0,0,1,1,1,9,2,0,6,0,2,0,1,3,0,2,13,3,1,0,1,0,8,4,1,2,2,0,9,3,2,9,0,0,0,6,0,0,5,2,1,0,4,2,3,6,0,3,3,2,1,0,0,7,6,7,0,1,3,1,9,5,6,0,5,2,1,0,0,3,1,0,3,0,6,4,1,3,0,0,1,10,1,0,2,1,0,12,0,5,1,0,0,1,1,10,0,3,8,1,0,7,4,0,16,0,2,6,2,1,3,2,2,2,0,6,3,2,2,5,0,3,7,0,1,2,0,0,0,1,0,0,0,0,2,0,6,0,1,1,10,7,2,0,1,0,0,7,13,5,2,1,2,1,0,3,3,2,0,2,5,1,3,1,2,1,1,12,7,2,0,5,1,5,0,2,2,1,0,4,6,1,2,1,2,6,5,1,0,4,2,4,1,0,0,0,0,1,0,0,2,5,3,3,7,0,3,1,1,0,0,1,1,2,0,0,0,0,11,1,0,0,3,0,2,0,3,2,0,4,3,1,0,0,3,1,5,2,5,7,6,0,0,6,0,2,2,0,9,2,0,0,6,3,4,2,4,1,1,1,2,4,0,1,2,0,7,0,4,1,1,2,1,1,0,0,3,2,0,6,0,4,9,2,6,2,0,0,2,0,0,6,0,4,0,3,2,3,4,3,1,5,0,0,0,1,3,0,1,3,0,4,2,1,0,0,0,2,2,0,0,2,0,15,0,1,3,17,0,2,1,8,3,0,2,0,0,1,5,2,3,0,0,10,0,5,6,0,0,1,1,2,5,3,0,2,28,0,2,0,3,1,0,1,2,0,1,0,5,0,4,0,9,0,0,0,3,0,1,1,4,11,6,4,0,1,2,7,2,18,2,0,1,1,0,0,0,1,0,1,50,2,11,0,0,3,2,2,2,0,6,0,1,1,6,4,1,3,4,0,2,4,2,3,7,3,1,0,24,0,1,0,12,2,2,1,1,0,5,1,0,2,2,1,14,1,0,0,1,4,0,3,0,2,0,0,2,0,1,0,0,1,1,1,1,0,2,18,2,0,0,4,0,12,3,3,0,1,1,4,0,1,0,1,0,3,0,6,0,0,0,0,12,2,0,3,2,5,9,3,3,4,0,3,0,6,1,2,0,2,0,13,2,0,6,1,1,1,1,3,1,0,0,0,2,0,0,2,4,2,2,1,0,1,2,1,0,0,0,24,1,0,4,5,0,0,0,0,1,4,1,0,0,2,0,0,0,5,2,1,0,0,0,1,2,4,1,0,3,5,13,3,1,0,0,0,0,3,5,8,9,1,2,3,0,0,2,0,1,0,0,0,6,1,0,13,3,0,1,5,2,2,0,0,8,0,7,0,0,1,3,0,5,2,0,6,0,0,0,1,0,0,3,0,28,0,2,0,4,0,0,0,0,0,0,3,1,0,0,0,0,7,0,0,2,1,4,0,3,0,13,3,0,0,0,0,0,1,1,1,1,0,0,0,0,0,0,0,0,0,0,0,0,0,0,0,0,0,0,0,0,0,2,0,0,0,0,0,0,0,0,1,0,4,0,0,0,0,0,0,0,0,0,0,0,0,0,0,0,0,1,0,0,0
K30 Needful Things,king,13557,6781,5646,5882,5574,2107,5150,3851,4292,4172,2618,3224,2627,2823,2643,2025,3325,1649,1333,1286,1734,1707,1431,1158,396,1115,574,813,1134,664,855,1046,1004,900,1028,849,827,915,175,998,937,894,834,715,587,771,612,624,811,764,796,564,628,701,496,557,911,590,722,739,538,432,557,578,453,500,246,588,314,570,344,315,350,362,375,398,357,422,323,307,353,324,265,526,404,474,279,244,375,301,199,385,401,283,321,266,363,293,342,331,244,499,363,278,452,595,354,452,269,378,365,333,54,274,301,392,306,331,244,174,259,197,309,395,173,202,259,270,248,205,292,242,268,204,369,247,41,304,266,147,164,199,103,168,239,282,175,311,191,177,223,278,211,147,149,126,148,118,169,161,170,327,236,271,196,255,247,140,357,173,55,142,192,180,219,140,113,187,243,229,153,169,279,156,164,205,99,130,197,101,185,135,130,151,127,346,110,95,156,73,105,222,127,198,78,728,100,100,116,131,87,170,95,127,167,118,133,167,131,103,89,188,159,171,134,125,84,152,92,267,217,199,161,349,118,48,77,161,105,108,89,85,180,85,107,112,123,205,128,102,205,41,88,115,110,95,102,90,146,78,135,136,137,91,121,81,118,104,130,95,122,68,135,115,58,110,89,76,193,119,122,65,75,97,255,222,64,84,77,87,124,46,57,62,80,80,117,109,52,109,121,75,80,90,261,60,71,39,52,57,82,22,59,105,113,124,87,95,59,36,101,113,74,108,88,169,72,83,85,137,96,123,86,78,63,44,114,15,83,101,69,65,85,127,62,45,95,50,64,56,128,56,66,62,112,19,83,126,49,48,52,50,79,56,48,58,90,85,55,59,56,40,111,80,56,119,30,42,74,62,95,68,55,43,32,89,0,67,78,103,83,36,21,53,92,83,52,54,74,86,74,71,129,71,89,35,54,95,35,104,80,45,39,263,88,66,67,126,39,84,78,10,79,132,42,75,61,141,54,35,87,59,60,90,3,56,56,61,30,69,58,40,21,97,62,46,127,79,43,57,76,33,42,136,70,51,32,58,50,57,84,29,7,16,58,54,57,36,35,39,42,120,66,38,53,40,25,78,0,39,38,89,52,64,38,89,51,151,71,32,40,36,55,32,70,40,38,68,14,34,65,44,72,27,56,30,14,53,53,43,100,105,40,66,69,40,0,41,40,38,49,41,80,64,45,45,93,36,53,99,133,54,47,44,49,1,51,109,39,55,75,37,77,64,60,40,0,30,42,52,30,43,66,21,52,33,90,75,41,4,31,109,33,48,26,61,25,11,22,20,63,49,32,57,33,70,28,2,34,33,35,53,31,51,1,61,23,70,35,21,40,36,17,27,54,33,18,46,25,54,70,41,70,12,10,0,7,62,48,35,21,36,61,45,35,36,54,19,18,29,19,42,27,52,50,50,85,78,36,35,59,42,37,27,43,1,106,49,41,51,26,24,24,42,27,56,63,49,12,64,0,28,42,42,35,41,33,21,22,11,35,25,63,33,36,36,39,29,42,11,105,41,27,14,24,21,18,32,50,20,20,68,26,20,80,31,10,39,36,38,33,19,23,74,44,36,18,1,19,25,28,13,66,31,39,16,6,91,24,26,24,52,4,43,53,54,24,19,41,24,27,23,22,1,23,46,107,8,29,40,32,40,43,16,0,93,40,31,11,40,71,81,8,58,0,7,47,46,56,18,4,21,24,18,13,61,50,7,21,16,29,24,60,51,34,32,13,32,28,34,27,20,18,13,2,26,32,42,13,30,34,16,10,36,50,25,24,19,16,24,26,25,1,63,12,13,2,31,29,18,21,23,14,46,26,5,70,47,14,17,18,53,38,2,34,26,9,0,13,26,23,17,26,34,36,38,18,37,32,33,22,55,5,42,17,32,18,45,1,26,45,9,19,27,38,15,20,0,40,22,34,23,2,8,21,9,2,9,8,62,27,8,44,24,12,39,20,0,40,59,52,27,30,15,1,18,17,46,15,33,33,34,29,37,7,34,32,33,23,25,13,9,56,18,38,51,37,53,19,45,27,8,42,17,30,27,37,25,28,18,26,0,32,0,18,7,16,21,34,26,18,2,34,21,16,7,7,1,59,8,59,9,18,24,7,41,16,44,44,54,23,46,25,19,13,3,27,28,13,27,23,23,26,22,9,13,16,21,29,12,0,30,33,3,13,30,15,7,8,16,22,12,31,63,16,27,16,29,53,3,21,47,21,9,47,23,15,0,19,62,35,28,23,28,9,27,9,41,23,0,28,2,15,7,10,36,0,2,12,28,20,5,21,4,21,13,32,0,9,15,2,16,44,0,36,14,31,30,21,19,43,55,20,8,29,31,17,16,13,38,27,15,7,10,33,10,42,15,62,26,40,16,11,8,17,0,15,30,6,35,15,11,0,18,37,31,40,15,0,0,0,0,20,14,91,19,11,0,20,23,33,16,10,16,20,8,5,20,25,1,30,0,24,25,10,25,26,19,34,10,25,3,28,21,31,29,29,19,31,19,10,48,8,53,0,1,2,15,31,15,30,39,44,42,22,13,25,29,14,8,19,19,30,9,28,62,48,16,10,11,30,5,13,21,9,20,47,38,29,10,10,1,21,36,15,16,16,17,7,36,2,16,13,35,0,13,17,31,4,0,107,8,16,52,16,37,1,1,25,0,33,17,9,11,25,25,4,12,16,0,17,47,0,32,13,38,11,22,26,18,22,0,14,13,249,7,7,13,12,12,1,11,35,33,10,0,0,22,28,13,100,27,18,4,49,29,13,44,10,9,14,16,26,19,20,0,9,19,4,12,12,9,27,0,4,11,0,8,11,37,9,20,10,21,6,6,26,16,7,10,25,0,12,23,2,33,25,4,16,16,0,17,16,21,0,14,43,14,0,43,25,9,11,16,25,26,38,123,11,17,0,18,16,12,12,37,6,13,2,89,23,32,8,16,20,35,7,3,19,6,15,0,4,12,6,28,28,84,12,34,36,12,14,0,30,9,11,12,8,14,2,12,34,10,17,11,15,21,74,16,22,31,2,0,21,70,6,42,7,1,18,12,20,21,12,5,39,12,18,5,2,12,22,0,24,4,17,4,21,15,20,13,23,40,7,0,0,29,0,15,10,0,12,31,7,6,16,9,11,14,24,11,33,22,6,2,9,0,8,1,0,1,0,17,1,10,1,0,11,11,26,27,12,4,1,14,39,8,11,12,8,25,2,8,11,14,12,6,5,26,10,18,0,0,1,24,19,17,18,16,19,35,10,15,9,23,32,20,24,13,9,20,0,21,20,0,14,16,19,11,15,12,24,4,44,9,22,13,12,8,11,6,19,14,7,4,25,19,11,19,10,32,18,14,57,11,39,20,1,15,21,19,4,35,9,9,0,0,2,16,18,3,1,0,0,6,0,8,9,2,26,11,15,6,13,8,3,0,1,3,2,37,25,12,32,34,56,15,7,20,17,18,15,16,9,5,11,8,31,10,39,15,11,8,23,16,20,0,23,2,33,18,34,17,15,0,10,0,15,13,34,19,14,6,6,7,21,22,17,21,27,16,31,0,13,10,33,2,43,13,3,29,10,6,22,19,17,11,67,18,0,15,33,87,11,16,24,0,7,32,17,7,0,17,6,16,15,17,30,19,8,8,7,3,31,12,0,5,0,16,4,24,9,0,3,16,4,19,8,6,14,5,6,4,3,5,5,9,0,24,14,6,13,5,0,3,3,24,16,1,1,10,20,2,5,19,1,29,4,13,21,41,9,1,16,8,13,0,24,14,63,19,70,23,5,25,2,12,3,7,14,12,20,26,20,53,9,17,4,10,8,0,58,11,0,14,28,0,19,7,16,5,15,1,6,10,14,9,22,2,4,13,42,4,6,4,3,8,0,25,15,16,3,12,30,0,12,18,11,4,13,25,23,0,34,24,26,6,24,10,6,0,30,10,0,10,16,19,18,9,28,4,11,26,22,8,0,8,12,13,8,12,3,5,11,7,80,15,18,1,6,0,32,2,17,2,4,9,1,5,11,17,9,14,9,6,9,4,3,9,8,41,0,15,6,2,3,11,20,25,24,10,7,10,26,8,32,3,43,2,16,28,9,11,10,7,4,0,6,19,22,14,0,0,12,5,0,2,0,6,0,68,18,4,1,23,10,7,0,17,7,11,1,22,5,28,35,13,22,1,9,7,25,15,46,4,36,12,8,4,9,3,8,168,5,3,4,6,1,35,2,11,1,5,6,6,3,32,18,14,0,9,8,26,3,4,8,5,14,16,13,6,0,6,27,13,4,3,6,7,0,32,15,5,0,10,6,3,3,4,0,14,7,0,24,16,5,8,6,7,21,2,5,7,24,23,13,14,13,8,12,23,0,5,20,0,16,8,0,7,10,3,0,18,0,13,20,19,23,6,2,11,3,22,4,1,1,19,1,20,11,10,8,17,15,1,13,8,12,8,3,8,0,0,4,11,4,21,11,18,0,24,15,9,13,4,5,17,10,0,4,2,7,2,9,15,6,1,6,2,7,0,7,7,9,9,14,19,6,8,13,6,7,7,8,10,44,5,9,4,18,15,10,3,7,0,9,23,8,0,29,2,1,12,36,7,10,12,9,2,25,11,5,7,10,4,2,3,15,23,13,21,42,10,2,19,23,21,9,10,23,8,1,4,2,9,8,8,14,9,0,5,13,12,0,0,19,15,5,2,38,4,21,19,13,11,1,1,1,25,3,14,11,11,0,19,0,1,9,20,1,0,18,13,6,9,0,0,3,4,17,6,25,14,12,6,0,3,0,0,33,0,7,6,0,0,2,5,21,26,9,12,18,31,0,7,14,40,7,7,3,2,7,0,8,19,3,9,0,5,18,20,1,0,15,0,16,5,23,12,0,46,0,0,10,18,15,1,11,3,6,0,7,3,8,0,0,2,4,1,26,0,0,1,3,13,11,4,3,0,2,12,9,3,44,8,5,15,9,1,0,13,2,0,16,8,0,0,7,9,1,14,10,7,12,0,2,4,2,14,21,7,8,0,3,12,4,12,12,4,9,8,8,8,15,3,3,2,7,0,6,27,7,3,6,10,4,13,1,11,7,12,14,3,3,9,2,11,5,0,7,2,0,7,4,4,6,31,11,2,5,0,9,11,1,4,13,13,18,4,8,14,11,25,7,3,12,6,5,7,11,19,11,14,8,2,11,16,21,6,17,2,11,6,3,20,2,13,2,0,15,28,13,6,13,7,7,1,4,11,0,6,0,10,8,34,4,7,5,1,1,9,6,15,1,1,1,2,18,8,14,5,11,9,4,5,9,2,12,12,24,15,9,11,2,6,8,19,0,6,4,4,13,9,5,25,7,0,1,4,7,0,8,2,0,0,65,9,11,12,0,4,8,12,2,0,0,0,4,2,11,11,4,16,5,27,1,3,6,10,3,13,12,0,0,11,6,18,11,1,8,36,11,2,4,2,0,0,0,4,7,2,15,11,0,0,1,40,7,0,2,9,12,5,8,4,14,16,4,4,0,10,0,12,1,0,15,11,16,6,9,2,5,14,0,17,12,0,4,3,4,29,13,11,2,12,2,28,1,0,0,25,7,9,6,2,0,4,6,6,3,4,17,8,0,7,27,90,5,13,19,1,2,11,17,2,11,9,7,4,1,2,5,14,2,7,0,0,3,2,6,10,0,2,0,12,6,6,5,5,31,1,5,12,12,1,5,6,5,2,6,0,5,17,5,5,11,6,16,3,7,0,5,7,4,8,16,1,7,7,3,4,0,1,6,5,3,7,0,6,8,5,1,4,20,10,2,2,1,292,5,0,0,8,0,0,8,2,8,6,0,9,2,3,13,3,4,2,2,8,4,0,5,7,10,9,3,3,4,1,10,14,6,4,7,23,2,8,6,1,12,5,6,4,13,17,8,13,6,23,2,4,8,2,19,8,2,6,5,2,4,19,389,3,1,4,1,5,7,0,7,9,10,11,2,2,19,2,11,0,1,9,6,4,9,7,1,2,8,5,2,8,0,3,4,10,6,9,8,8,15,1,5,28,1,5,8,16,6,0,12,10,4,1,2,2,0,12,3,3,8,0,2,5,5,0,14,3,2,14,8,11,11,21,4,3,2,4,11,2,5,3,9,3,7,10,0,8,10,7,7,6,17,27,0,3,6,0,2,8,0,0,14,4,4,0,7,6,7,3,1,2,31,4,4,0,3,3,9,8,0,0,0,12,2,5,4,0,35,2,4,6,0,7,0,3,5,25,0,8,23,0,0,30,7,0,8,6,2,4,2,24,10,3,0,2,0,8,4,7,9,0,0,0,7,0,5,6,1,8,6,5,1,1,0,0,14,4,4,3,3,6,9,4,4,4,1,0,11,3,14,2,6,0,9,7,1,6,13,4,15,2,1,2,12,2,18,10,1,0,1,7,38,6,2,9,19,5,5,5,1,0,0,1,6,9,4,5,7,2,8,5,5,4,0,10,0,4,6,4,3,2,3,12,6,3,6,0,7,2,0,19,2,4,7,21,5,3,4,0,4,1,0,0,0,3,1,6,2,10,3,1,3,0,1,4,0,0,2,0,2,12,4,4,0,8,1,11,46,17,0,8,10,12,0,8,4,11,0,13,104,11,19,20,0,14,8,15,3,4,0,7,8,3,7,11,7,2,21,0,5,6,1,2,0,1,0,7,5,0,2,0,2,0,16,2,0,17,9,3,3,3,10,1,7,9,2,2,0,7,0,0,8,4,4,5,7,5,0,6,4,0,2,5,4,3,15,4,0,2,12,1,0,8,6,2,4,0,5,2,22,8,2,3,0,0,0,5,3,2,15,2,13,2,4,1,1,9,10,8,0,24,0,1,17,5,9,2,25,5,9,7,8,2,4,18,5,1,4,10,6,8,13,1,8,7,6,5,9,5,6,2,0,8,11,5,2,6,1,3,1,0,1,1,0,5,4,6,15,25,12,1,0,2,12,10,1,2,0,0,5,0,5,20,14,1,0,7,14,11,1,1,0,20,3,2,1,1,3,3,2,3,0,3,0,1,5,2,2,5,4,8,2,7,2,0,15,7,3,5,1,13,1,4,4,9,8,34,0,0,3,16,8,2,4,1,0,16,5,2,1,1,3,1,1,2,0,7,4,6,0,4,10,7,13,2,41,2,3,7,2,9,0,0,9,4,5,7,13,2,2,0,7,12,17,8,6,0,17,10,6,7,4,8,9,3,6,12,3,3,29,0,2,4,3,15,2,6,8,22,3,11,6,1,10,2,4,0,2,49,14,7,10,6,1,13,2,2,3,21,4,0,5,3,7,3,4,7,1,0,6,0,9,17,3,3,1,7,3,4,0,3,0,0,0,3,3,2,6,1,6,9,22,9,0,0,1,2,2,11,4,3,16,7,21,8,0,0,5,7,14,4,2,1,2,6,2,11,3,1,0,0,6,10,1,5,0,6,3,2,5,10,10,1,4,2,6,1,0,23,0,6,2,2,11,2,3,32,13,0,8,6,3,0,5,6,0,5,8,3,10,3,5,4,0,20,5,0,6,3,7,1,2,1,0,0,0,0,7,7,6,3,2,3,2,4,1,1,4,2,10,0,16,8,1,11,3,2,1,6,7,7,2,3,14,1,1,5,14,2,8,1,0,4,6,11,0,2,5,2,3,7,0,1,8,1,5,2,4,16,0,5,7,1,3,1,0,3,0,0,0,1,18,2,4,4,5,2,2,0,0,0,7,0,5,0,4,8,1,0,6,5,3,1,5,4,27,19,3,1,6,3,3,3,0,0,4,3,5,1,0,1,4,1,2,8,5,0,9,0,8,0,4,0,10,2,13,5,5,4,1,5,2,13,7,10,18,1,0,8,2,5,0,7,2,5,11,1,6,1,0,1,9,2,6,6,4,12,0,3,4,0,0,0,0,0,3,0,2,0,2,5,3,15,3,2,2,0,0,2,6,9,2,4,1,3,6,5,4,2,11,3,0,0,3,1,2,0,0,1,2,1,8,7,2,2,26,0,5,2,2,0,1,4,19,3,6,2,0,5,5,4,8,7,2,1,3,1,2,5,1,8,4,7,9,0,13,0,10,3,5,8,6,1,0,1,26,0,7,0,10,3,10,15,12,1,37,2,8,7,1,1,12,0,3,5,0,0,3,9,6,1,0,3,3,1,0,2,3,3,12,6,19,2,0,2,6,2,5,1,0,10,0,2,2,7,21,6,9,1,0,1,2,0,2,6,6,0,12,2,2,0,3,0,2,10,7,8,0,7,5,6,3,13,4,1,2,0,3,2,11,1,1,0,5,1,3,10,0,6,4,6,14,1,13,2,4,0,31,4,8,4,0,0,0,2,5,2,3,4,8,2,0,3,14,4,5,4,0,0,3,1,7,0,6,0,3,1,0,1,10,5,1,1,3,0,5,3,22,0,5,0,1,2,4,3,3,0,0,7,17,1,6,2,11,4,0,3,0,7,0,7,3,3,1,1,1,2,0,0,6,3,6,0,9,7,3,0,0,1,19,24,0,0,4,1,0,0,11,0,2,3,0,0,3,21,0,3,0,0,0,0,20,1,1,0,36,1,5,0,1,5,3,0,11,12,13,2,0,9,5,10,7,0,6,20,0,0,3,6,0,3,4,0,1,1,1,2,3,3,3,1,1,3,0,4,3,7,2,2,8,1,3,0,13,8,5,0,11,2,1,4,2,7,41,5,6,8,84,2,6,5,8,2,0,2,1,0,1,1,25,1,0,2,2,3,0,10,10,0,0,3,9,6,3,2,3,8,6,9,6,1,4,3,0,4,2,0,7,11,4,0,2,8,0,11,8,2,0,0,0,6,0,17,8,2,2,5,5,2,1,0,8,2,0,2,1,7,0,3,0,3,2,7,9,1,0,2,3,0,8,0,10,13,3,2,3,0,8,7,1,3,1,4,2,6,6,4,1,0,3,1,0,4,2,0,1,4,2,3,2,6,1,0,3,11,1,1,2,0,13,2,0,4,4,2,0,1,15,3,1,0,1,0,8,2,3,2,2,2,8,5,1,1,20,4,2,1,2,6,0,0,3,0,1,3,13,6,8,0,4,0,5,3,1,7,0,0,2,3,6,4,5,5,0,0,8,2,7,4,18,0,2,2,4,5,2,3,1,0,2,2,7,13,7,3,4,0,0,6,3,0,1,4,0,0,3,10,1,16,4,3,0,1,0,3,9,7,1,2,4,0,13,7,4,1,1,2,7,0,0,0,6,7,5,1,3,1,4,0,17,1,7,2,0,1,7,3,3,4,0,0,13,13,12,1,11,5,3,0,8,2,5,9,9,0,6,7,1,0,0,1,0,2,0,2,1,2,0,4,15,5,0,8,2,5,0,1,1,3,0,8,0,1,0,0,0,1,1,4,0,1,0,2,10,0,3,1,0,0,2,6,2,9,2,0,2,0,3,0,5,1,0,1,12,2,0,14,1,0,4,7,5,4,2,0,6,4,0,2,6,1,1,8,1,0,1,0,2,1,1,2,16,0,1,9,2,4,2,10,0,0,0,5,14,0,0,0,1,1,1,7,1,1,5,0,3,2,2,3,7,0,0,2,0,2,5,4,0,7,2,0,8,1,13,7,0,11,7,1,1,0,14,3,3,0,0,8,5,6,1,1,4,1,2,6,2,2,2,5,3,5,1,2,3,1,3,3,0,20,0,12,0,1,8,1,49,0,0,2,2,0,1,6,9,8,1,0,4,0,7,3,5,0,0,3,3,4,2,1,1,0,5,0,10,5,0,21,0,4,3,3,1,0,0,1,0,0,2,11,2,8,2,4,2,0,18,7,10,0,1,7,1,0,4,8,1,1,1,3,7,6,0,1,3,3,2,4,3,1,0,0,2,1,1,4,2,1,1,2,7,2,1,2,9,0,0,10,2,2,9,0,2,5,2,6,1,3,5,1,0,5,5,2,0,1,4,0,7,0,1,6,14,0,3,4,0,52,0,0,3,1,2,7,0,10,12,2,2,15,3,0,0,10,6,3,2,3,2,0,0,7,4,4,6,10,8,8,0,2,0,2,23,16,10,1,7,3,5,7,3,8,1,0,0,2,5,0,3,3,0,2,3,2,6,0,5,2,6,0,8,1,0,0,0,1,5,0,4,1,5,4,3,2,0,1,4,8,0,6,0,0,0,0,5,16,1,0,3,0,0,0,0,0,0,1,1,4,0,0,7,2,6,1,4,3,5,0,5,6,3,0,4,3,5,4,2,0,2,0,6,0,0,2,1,0,6,13,0,57,2,1,16,4,2,1,0,4,17,3,1,2,2,4,0,5,3,15,1,5,3,3,3,0,1,6,1,2,3,2,2,1,10,5,0,6,2,13,0,2,0,5,0,0,2,3,0,3,1,0,3,0,0,2,4,1,0,3,1,5,0,2,3,2,0,2,0,3,3,6,0,1,0,2,2,2,3,3,0,6,0,6,4,0,2,5,1,5,6,3,0,5,11,2,4,0,7,1,3,6,3,1,1,1,5,2,0,1,3,2,0,0,0,7,2,63,2,8,2,2,0,1,1,2,0,8,2,0,7,1,0,2,7,10,0,0,3,4,4,6,190,4,3,1,0,0,8,0,7,3,4,1,0,1,13,3,1,2,7,3,0,2,2,0,0,5,1,4,0,2,3,1,1,0,1,2,2,1,4,2,7,2,0,0,1,10,1,2,1,1,1,0,1,1,3,0,0,2,1,1,1,0,2,2,3,0,4,2,0,26,0,2,2,11,3,2,0,4,4,2,5,4,0,9,1,2,0,95,10,1,0,2,9,5,3,0,4,3,1,2,10,5,0,8,9,1,2,1,4,0,2,4,0,0,2,9,0,0,1,1,1,0,1,2,1,1,3,2,0,2,1,0,1,4,3,1,0,1,3,1,2,2,9,1,1,2,3,3,1,3,0,0,0,1,4,6,0,0,0,3,6,0,5,0,3,3,3,1,5,1,0,1,0,7,3,1,0,1,1,8,5,2,0,2,0,0,0,0,0,3,1,4,2,2,4,7,1,0,0,0,6,0,13,4,1,1,10,0,2,0,1,12,0,2,0,2,0,0,2,0,4,0,2,0,6,0,0,1,2,0,0,6,1,6,0,2,5,2,1,0,2,0,0,0,0,0,0,0,0,0,0,0,0,0,6,0,1,0,0,0,0,4,3,0,5,0,4,0,0,1,0,0,2,3,0,0,0,1,0,0,0,0,0,0,0,0,0,0,3,4,0,0,0,2,0,0,0,0,0,0,0,0,0,0,0,0,0,0,0,0
K31 Gerald's Game,king,7076,3453,3054,2764,3075,1076,697,1637,2239,2525,1090,538,1859,2899,2842,1021,1627,837,654,282,788,1007,860,272,245,553,309,309,571,400,444,489,447,498,582,465,371,569,86,495,548,495,428,386,289,364,426,357,455,353,382,257,386,282,295,265,509,195,300,413,258,253,228,396,220,310,118,206,139,241,220,148,167,156,106,272,156,246,228,147,174,180,84,331,219,147,96,150,203,171,103,133,268,130,179,164,130,109,154,167,167,285,204,196,295,285,240,298,128,152,141,136,22,161,176,93,141,140,145,65,63,121,93,200,94,91,158,110,98,92,130,116,122,62,226,140,27,148,188,109,98,90,40,105,195,76,94,190,66,129,130,127,96,103,132,34,91,67,71,25,63,146,201,184,55,355,89,71,106,73,44,112,122,50,31,86,69,58,156,104,57,73,127,77,124,33,66,80,98,49,33,56,125,76,74,100,74,40,95,41,58,114,30,141,81,18,44,44,86,72,58,61,20,43,107,41,90,54,92,19,51,109,68,87,42,55,40,21,49,175,109,62,28,271,51,66,43,62,87,30,32,34,85,31,67,89,44,83,56,84,83,99,60,7,68,32,44,51,86,40,66,75,60,64,83,51,66,45,35,81,89,46,82,33,26,50,42,52,151,56,80,20,55,64,174,5,73,160,28,37,37,20,22,26,47,49,65,69,23,65,65,31,49,31,123,32,2,60,33,30,50,20,26,104,50,44,34,41,46,14,35,111,41,14,130,29,59,61,23,31,52,72,41,48,22,50,38,3,20,87,20,18,20,9,27,57,81,24,27,18,109,14,54,36,96,16,58,99,29,42,19,12,31,20,57,16,32,59,22,39,32,20,44,17,25,78,34,17,51,47,28,52,15,10,24,35,0,29,38,30,160,26,17,5,35,70,70,35,36,41,20,84,49,22,32,17,36,60,34,55,17,44,33,21,67,43,27,51,20,70,35,5,4,25,49,23,22,179,29,21,60,28,24,63,3,17,40,42,3,42,17,16,7,62,17,7,79,38,11,41,34,10,6,148,53,31,18,10,27,26,26,20,1,6,18,27,39,15,44,11,14,50,25,6,42,30,8,1,0,9,9,40,24,1,15,41,34,17,35,18,30,15,16,21,31,15,20,18,5,47,32,13,9,9,25,21,12,37,43,11,19,72,38,40,16,39,1,19,23,15,21,19,26,10,28,19,19,23,30,39,8,51,27,30,37,0,29,70,22,39,21,5,85,45,12,36,0,8,17,15,35,33,16,1,34,22,54,33,34,2,9,9,36,13,20,35,4,4,13,1,4,16,15,32,25,19,18,12,8,21,43,66,11,27,2,22,4,39,3,8,18,11,13,9,30,17,7,6,9,18,47,48,61,14,9,0,3,37,15,18,12,12,40,19,5,37,23,17,7,20,12,22,15,35,19,28,40,22,60,5,12,53,11,5,7,0,39,21,38,32,25,3,7,20,12,32,28,13,2,44,0,37,40,21,18,82,22,5,24,1,22,11,16,20,6,22,38,34,10,11,64,17,10,11,6,12,11,27,19,4,8,15,29,3,51,16,3,22,13,8,31,9,7,13,55,16,14,0,22,14,12,7,41,24,12,33,20,4,9,14,6,30,3,16,24,10,10,27,20,14,10,4,7,7,32,23,23,8,11,11,24,12,2,6,0,32,6,12,10,19,35,10,3,19,0,1,3,7,28,1,12,7,18,16,4,31,4,5,5,6,5,18,31,16,6,6,17,13,11,9,11,5,2,2,0,18,7,12,25,13,17,17,16,11,24,41,9,6,22,6,3,6,4,20,8,7,0,18,0,10,6,8,12,16,12,23,62,29,2,5,3,28,21,4,25,8,6,0,29,47,1,0,22,10,17,32,21,7,4,10,21,9,26,13,1,17,7,14,0,7,12,8,16,31,46,3,16,0,6,5,22,20,4,12,8,6,2,15,9,39,15,11,16,25,12,34,4,0,25,25,15,12,18,9,0,7,14,20,12,18,27,16,25,13,12,24,34,17,18,14,3,11,7,2,11,24,10,0,2,47,8,2,34,4,28,11,35,5,21,3,11,1,24,0,4,4,23,5,25,8,13,0,5,16,6,16,9,2,41,5,12,4,7,0,1,21,23,11,9,9,14,19,3,21,5,12,2,14,6,11,16,3,18,0,5,21,2,13,11,3,0,23,10,0,7,12,27,3,6,4,7,1,18,7,9,23,12,18,12,2,1,48,14,15,4,7,17,0,14,5,21,24,5,18,9,9,0,13,15,0,15,0,9,0,7,9,0,0,2,25,3,4,1,11,26,1,12,4,5,11,3,8,2,0,12,2,17,2,16,7,7,28,10,7,16,5,19,18,6,33,8,5,2,5,11,3,4,7,3,5,31,7,16,5,4,0,6,15,0,23,7,9,0,3,17,3,8,1,0,0,0,0,10,10,25,24,2,0,10,5,10,5,6,7,2,3,4,36,5,10,1,0,12,8,3,6,12,4,33,14,2,4,21,6,9,5,26,9,16,15,8,25,2,13,0,1,4,0,25,13,29,29,5,27,6,2,15,7,1,1,4,8,15,1,4,22,23,4,8,2,19,2,5,9,3,5,15,4,5,4,6,5,7,8,9,1,4,6,5,11,1,6,4,4,0,8,1,31,2,1,6,1,13,1,5,18,8,1,1,0,4,3,3,2,12,21,0,4,10,0,10,15,0,21,4,26,15,17,0,19,18,0,18,10,10,0,7,4,14,29,0,1,15,16,5,0,0,23,37,8,3,5,11,1,16,7,6,6,4,8,5,12,1,10,2,0,2,7,1,7,6,5,10,0,7,3,0,2,9,3,3,26,12,16,2,8,3,8,0,3,16,0,0,17,0,3,9,0,11,8,0,4,8,2,0,2,9,16,0,11,7,14,11,5,12,11,13,6,2,2,0,2,18,16,2,4,30,6,2,15,7,22,7,14,7,11,1,8,3,0,2,0,4,4,5,9,30,28,9,15,18,8,0,0,11,5,3,16,3,4,0,6,13,14,6,11,11,0,5,5,16,16,15,0,2,6,6,10,1,1,10,1,2,9,6,7,13,18,1,11,1,3,8,0,4,1,26,11,3,10,2,9,31,17,5,9,0,8,0,18,0,0,5,33,3,8,5,2,5,1,7,6,18,79,3,2,1,0,12,0,0,0,0,6,0,8,5,0,8,0,9,17,10,2,0,8,8,3,16,6,8,25,10,3,5,6,4,1,1,20,0,7,0,0,1,9,11,1,5,13,6,11,2,9,0,14,0,14,9,8,2,12,0,5,11,0,38,5,17,9,9,13,11,0,2,8,11,0,6,6,21,6,9,4,0,2,2,15,1,4,7,16,0,3,2,20,25,5,3,3,7,19,2,7,2,2,0,1,2,4,27,0,0,0,0,3,0,4,2,0,8,0,0,0,11,4,3,1,3,1,0,16,10,4,17,13,5,4,1,14,4,3,3,7,11,3,7,5,15,6,13,3,4,4,10,7,11,0,6,3,19,2,12,6,9,0,4,6,17,3,0,17,8,4,6,3,3,2,12,8,9,13,17,0,24,5,11,1,25,5,0,15,10,22,5,8,0,7,1,2,0,13,11,4,5,5,16,0,14,6,0,3,0,10,3,17,15,9,12,4,4,9,1,0,27,1,0,7,0,13,2,2,7,0,4,12,1,1,18,32,8,1,1,1,2,1,6,4,0,18,9,17,7,13,0,2,2,8,13,3,5,2,17,1,15,33,4,19,2,3,2,22,9,3,4,3,7,0,9,4,0,12,15,21,1,4,0,3,2,15,1,7,8,3,3,0,1,12,6,6,8,0,6,1,0,1,27,0,12,2,43,2,5,5,2,18,9,2,6,0,1,4,17,4,5,5,2,4,0,5,1,10,5,6,25,0,1,5,5,25,10,8,21,0,2,4,6,6,17,0,7,1,27,16,0,3,1,6,6,0,11,0,1,5,0,5,0,17,9,13,7,3,9,1,3,5,7,13,8,0,3,1,1,3,2,1,5,15,2,0,6,7,2,7,1,4,2,0,11,6,14,11,0,2,5,0,1,9,1,14,2,4,4,11,10,2,8,9,2,1,6,6,8,2,1,7,2,1,4,13,12,24,0,0,1,3,1,0,0,0,0,26,5,4,0,16,13,3,0,11,0,14,0,1,4,20,10,4,0,2,8,21,5,4,9,2,31,6,1,2,4,1,6,0,59,3,7,4,1,14,0,5,0,4,3,7,1,0,21,4,0,2,4,0,0,0,3,0,4,3,3,1,0,4,1,0,2,1,4,9,0,27,7,22,0,6,2,1,37,9,0,17,5,3,9,7,1,2,8,4,7,0,0,3,15,19,5,3,4,2,1,0,0,6,1,0,4,3,0,0,1,0,0,13,0,6,3,0,0,8,0,6,1,5,3,5,0,7,8,1,15,2,7,0,0,18,1,1,4,3,4,7,0,0,3,7,5,26,4,4,3,20,9,4,1,3,2,11,2,1,1,0,1,2,1,4,17,0,7,5,3,0,3,8,1,11,7,1,10,3,0,4,0,15,3,5,5,2,8,5,2,4,8,5,8,0,4,4,0,0,8,1,0,4,1,5,5,0,19,1,8,4,0,0,0,2,1,1,8,5,5,7,4,6,5,10,5,5,2,2,9,1,2,7,3,0,3,3,7,2,0,0,2,10,0,0,23,24,19,3,2,2,4,10,11,9,0,0,1,5,2,6,3,12,0,9,0,2,3,13,0,0,2,11,4,2,0,0,1,1,8,2,1,14,1,0,1,1,0,0,8,0,6,11,0,0,0,1,2,24,6,6,48,2,0,7,3,13,2,6,1,1,11,0,0,13,1,5,0,3,4,3,0,0,8,0,5,6,17,6,0,3,0,0,5,10,4,2,3,4,13,0,3,0,4,0,0,0,10,3,3,0,0,0,5,5,3,3,3,1,3,8,10,0,5,0,6,7,2,1,0,4,1,1,2,2,0,0,1,15,3,7,7,5,4,0,0,6,4,12,17,4,3,0,3,1,2,15,5,11,4,3,0,8,1,2,0,0,6,0,2,12,6,1,1,4,7,3,1,5,6,4,3,10,5,5,2,10,3,0,1,2,1,2,2,2,7,1,2,6,6,0,0,0,1,1,12,4,10,7,4,28,17,3,4,2,3,2,0,1,5,3,8,8,2,1,1,2,22,8,8,3,1,2,1,10,3,5,4,4,4,3,6,2,10,12,1,5,9,5,1,5,0,2,7,1,4,5,4,8,2,5,1,3,0,0,2,3,5,4,8,1,5,1,0,6,2,4,3,22,21,6,1,4,0,2,7,7,2,0,3,6,0,7,4,2,5,0,1,1,2,0,0,1,4,0,6,7,7,15,0,0,0,1,0,0,0,3,1,2,7,0,1,6,0,4,2,1,4,3,1,7,8,0,0,5,5,5,5,0,3,4,3,2,17,1,2,0,0,0,2,0,3,6,2,0,3,2,3,0,7,2,14,4,6,1,9,5,2,1,0,8,1,2,9,0,8,6,6,22,4,6,2,2,0,10,1,0,2,0,1,4,7,1,0,6,7,4,0,0,0,4,3,2,3,5,2,1,2,18,1,7,3,3,0,6,7,0,16,9,11,0,19,5,4,2,10,1,5,22,1,0,1,4,1,9,0,0,4,1,6,5,0,0,0,6,0,2,2,4,1,2,1,2,0,1,1,0,1,3,1,3,3,5,10,4,1,6,2,2,6,0,0,1,4,6,6,0,0,1,5,2,0,2,0,5,4,2,0,5,12,0,1,2,4,2,2,2,1,4,6,0,0,4,0,0,11,2,0,6,4,4,4,3,2,3,5,1,0,3,3,4,2,2,6,4,1,4,6,2,4,4,2,4,3,4,1,2,1,0,0,3,7,2,9,11,5,0,3,3,0,1,0,1,2,5,2,0,0,3,0,9,0,0,2,1,1,1,2,0,4,1,0,0,1,0,10,2,0,0,0,6,2,7,5,0,0,8,2,2,3,6,0,3,3,1,4,0,9,3,5,0,2,5,3,0,2,3,5,1,6,2,1,1,0,3,0,5,6,1,8,0,2,1,2,0,6,20,5,2,10,1,6,26,2,5,1,0,2,0,0,3,2,0,3,8,0,5,3,4,14,1,0,3,0,4,5,0,0,8,2,0,5,1,2,0,0,18,0,4,1,0,0,6,5,0,3,2,6,1,0,0,0,4,2,4,3,0,2,3,0,10,1,1,0,2,0,4,5,6,2,0,0,34,1,0,1,5,4,0,0,2,5,4,1,1,0,7,2,0,1,3,2,0,5,1,1,4,0,4,0,2,7,5,0,0,9,1,1,3,1,5,6,10,5,1,0,0,9,2,6,0,4,1,3,4,0,4,0,4,9,1,0,1,5,3,3,3,0,0,1,5,3,1,0,7,1,1,2,4,0,0,1,0,6,9,0,0,3,0,1,1,7,1,0,7,0,23,3,2,2,1,0,3,17,6,0,0,0,0,0,4,0,1,2,12,3,0,8,0,11,2,0,0,0,1,4,1,2,8,5,2,2,0,0,0,0,0,0,2,0,0,1,2,0,7,0,1,0,1,0,3,2,5,0,0,4,2,0,1,28,3,0,13,1,7,0,9,1,2,0,1,3,3,6,1,0,3,0,0,1,5,1,6,9,0,0,8,0,0,2,1,6,0,9,4,0,3,2,0,0,1,1,0,2,6,2,0,0,1,0,0,0,1,3,1,4,1,0,5,1,0,0,1,4,25,4,0,0,1,1,0,0,2,2,2,10,0,1,4,8,3,3,0,0,5,0,4,0,3,3,1,3,8,1,2,2,3,7,7,0,3,0,0,7,0,22,2,3,4,3,1,7,9,6,5,1,1,0,8,2,2,3,0,2,2,0,3,5,2,0,2,0,1,2,3,0,6,0,7,1,0,1,4,0,1,2,4,0,21,0,1,1,1,0,1,0,0,2,0,1,1,3,0,5,0,1,1,2,1,2,0,8,11,0,1,0,3,3,0,1,11,0,0,0,1,3,2,1,5,6,4,0,1,1,0,14,6,2,0,0,2,0,0,0,1,0,0,0,1,9,1,10,4,1,1,2,1,5,0,2,0,0,0,2,0,0,0,0,7,0,0,0,1,3,4,3,5,0,1,1,5,0,0,9,4,3,2,5,1,1,0,13,5,1,1,1,0,8,4,4,0,0,0,8,1,1,5,1,1,1,0,3,2,1,9,1,0,3,11,1,7,6,0,2,4,2,0,1,0,4,2,1,1,2,2,0,2,4,4,0,0,0,1,5,1,8,11,3,0,3,0,1,13,0,0,2,4,4,22,0,6,0,0,0,0,3,1,2,1,2,4,7,95,1,3,0,1,2,5,1,0,11,11,11,10,0,0,11,5,8,1,1,0,4,8,3,2,2,2,7,0,2,2,1,1,1,0,2,1,4,4,5,0,2,0,4,1,0,13,0,21,0,1,5,3,2,1,15,0,1,7,1,1,0,0,0,0,5,1,0,0,2,0,0,1,3,1,3,0,2,4,1,28,1,3,0,0,3,1,1,9,1,4,3,0,3,1,2,0,5,0,0,3,3,3,1,1,2,1,1,0,2,1,2,0,0,3,0,0,4,0,1,0,3,2,0,2,0,1,7,3,0,0,2,2,1,0,11,17,3,7,3,1,0,0,1,2,0,0,1,1,2,2,8,1,1,1,0,1,3,0,4,0,1,0,0,4,4,0,4,2,0,0,1,0,2,2,0,4,1,0,3,2,3,0,5,2,0,2,0,0,8,0,2,4,0,0,9,0,0,0,1,0,4,0,0,2,7,4,1,5,0,2,2,7,10,1,0,13,0,4,0,7,0,0,5,2,1,3,1,0,6,0,4,6,1,1,0,7,0,0,0,0,0,0,0,0,0,0,2,1,2,0,1,0,0,0,1,4,1,1,1,3,0,2,4,1,1,1,12,0,1,0,0,6,0,0,2,2,0,7,0,3,4,0,1,0,10,2,1,0,0,0,0,0,1,3,3,2,3,1,4,1,1,2,5,1,1,0,0,7,3,0,6,0,6,2,0,0,4,6,1,1,0,1,7,0,1,0,4,15,0,1,3,0,0,1,2,7,1,0,1,0,1,10,0,3,11,1,2,0,3,0,12,0,2,0,0,0,2,1,10,1,0,1,2,1,4,0,0,2,1,1,4,2,2,1,3,1,0,0,4,1,0,1,2,0,1,4,0,0,2,0,1,3,0,1,1,6,2,9,2,4,6,0,1,0,12,0,2,0,2,1,4,1,1,3,0,1,1,2,4,0,5,0,0,0,2,2,1,1,0,0,0,11,1,6,5,0,1,3,1,0,3,3,2,0,0,0,2,0,3,0,1,1,2,0,2,4,12,1,1,0,0,0,7,0,5,1,1,0,0,1,0,1,1,1,1,3,9,0,2,0,7,1,1,2,0,1,1,1,2,2,1,2,0,1,1,0,3,3,2,0,0,6,0,0,0,8,1,0,0,0,1,1,0,0,2,1,0,1,0,0,1,0,0,0,0,0,1,1,2,2,2,0,0,2,2,0,0,0,2,0,2,0,4,0,0,4,0,2,1,1,0,0,0,0,1,3,3,0,6,0,0,1,2,0,1,3,1,1,3,1,2,2,1,8,0,0,3,4,1,0,11,4,0,0,5,0,2,0,1,0,2,0,4,7,0,1,2,3,2,2,0,0,0,0,0,0,1,2,0,3,1,0,0,1,0,0,0,0,4,0,2,0,3,4,4,0,1,0,3,9,3,0,0,0,2,3,3,0,7,8,0,4,8,0,0,0,0,1,3,3,6,1,1,2,0,0,2,1,9,0,1,0,1,2,0,0,12,3,3,4,3,0,1,1,1,0,3,0,3,4,1,1,2,0,3,2,0,1,2,0,0,3,1,1,0,0,7,1,0,3,0,0,0,2,4,0,0,8,0,0,0,7,0,0,0,0,4,1,0,5,0,0,0,2,2,8,1,220,0,0,10,2,2,2,1,7,7,0,0,0,4,4,1,5,1,1,1,0,2,0,0,1,2,2,1,0,1,0,5,3,0,4,1,0,1,0,1,1,2,2,1,0,2,0,13,2,1,0,3,0,2,0,0,11,1,1,0,3,8,2,11,1,0,1,0,0,3,0,0,4,1,0,3,0,1,12,2,3,0,0,1,3,6,5,5,3,0,0,1,2,4,2,0,4,2,0,1,0,1,8,3,3,1,0,2,0,3,0,7,0,1,0,0,2,2,2,0,0,2,21,5,0,0,1,0,1,5,4,2,3,3,0,3,0,0,0,1,0,0,6,0,3,0,0,0,2,5,3,0,2,2,2,5,0,6,1,1,13,0,0,0,0,0,1,4,2,0,5,4,1,1,0,0,1,0,0,1,2,1,6,1,0,1,0,1,0,0,4,2,0,3,0,0,7,5,1,1,0,1,1,1,0,11,4,0,0,3,1,0,1,2,0,0,6,0,3,10,2,2,0,1,10,0,0,2,2,0,1,0,0,1,0,15,4,0,0,0,5,0,8,0,0,1,0,0,3,0,0,0,1,0,1,0,1,1,5,0,0,23,0,4,1,0,2,6,0,0,0,3,3,3,0,0,1,4,2,6,1,2,3,0,1,1,4,0,3,2,6,1,0,2,0,1,1,0,2,2,5,0,164,2,0,2,0,0,1,1,3,0,2,1,0,0,0,1,0,2,1,0,0,0,3,4,2,0,37,0,7,2,0,5,3,4,1,2,1,12,3,0,0,0,8,2,2,1,2,1,3,1,3,2,0,11,5,1,0,2,3,1,0,2,3,0,0,14,1,4,2,1,0,2,0,3,2,3,1,0,0,0,0,3,3,0,0,1,1,4,1,3,1,7,0,1,4,2,0,6,0,0,4,0,4,1,0,3,1,0,5,8,2,1,6,1,0,2,0,0,2,0,0,0,0,0,0,0,0,3,0,1,0,1,4,7,4,1,0,4,2,0,4,2,0,2,4,1,6,0,1,0,0,3,6,2,0,1,0,5,0,3,10,0,6,1,3,0,1,0,2,1,3,0,1,0,1,2,0,1,1,3,0,1,0,8,3,0,4,1,1,6,0,0,1,3,4,0,0,4,0,1,1,0,0,1,0,1,1,0,0,0,22,10,5,0,0,1,0,1,0,0,0,0,3,0,1,0,0,8,1,2,10,2,1,3,0,1,1,0,2,3,1,1,6,4,0,3,0,2,0,2,0,2,0,3,4,1,0,1,0,4,5,1,1,3,4,2,0,4,0,1,3,0,3,1,0,5,3,0,1,5,0,0,11,0,4,0,3,0,1,1,1,1,7,2,4,0,1,0,0,1,1,0,1,1,1,12,0,1,0,0,2,1,0,0,3,0,0,1,2,1,1,0,0,0,4,0,0,1,0,0,3,3,0,1,0,0,1,0,0,0,2,0,1,3,1,2,1,0,2,6,0,5,0,1,3,10,2,1,0,1,0,2,0,0,0,1,0,0,0,0,0,0,0,1,3,4,0,0,0,1,2,0,3,2,0,2,2,0,1,2,3,0,1,0,0,3,4,0,1,0,1,1,0,0,3,0,2,6,0,1,0,0,1,0,5,4,0,3,4,1,1,0,1,1,3,0,1,1,1,4,0,0,2,0,2,1,1,3,0,0,0,1,2,2,0,0,3,1,0,1,0,0,1,0,1,0,3,1,0,1,8,1,0,0,1,0,23,0,1,6,11,0,2,0,1,1,0,0,1,2,4,1,0,0,0,9,2,0,3,2,2,5,2,1,3,0,0,1,2,1,1,0,1,2,2,4,0,1,0,0,0,1,1,2,0,0,0,0,0,0,0,0,0,3,1,0,1,0,0,0,0,0,1,0,0,2,2,0,0,0,0,0,0,0,1,0,1,0,0,0,0,0,1,0,0,0,1,4,0,0,0,2,1,6,1,1,2,0,0,1,1,1,2,1,3,1,1,0,0,2,0,0,0,0,0,0,0,0,10,3,3,0,7,0,7,0,0,3,0,1,0,0,0,5,0,1,0,0,5,0,0,0,0,0,0,3,3,0,0,4,0,2,0,0,0,4,0,0,0,2,0,0,1,0,0,0,0,1,1,0,0,3,2,0,22,0,0,0,0,0,0,0,0,0,0,0,0,0,0,0,0,0,0,4,0,0,0,1,0,0,0,0,0,0,0,0,0,0,0,0,0,0,0,0,0,0,0,0,0,0,1,0,0,0,0,0,0,0,1,0,0,0,0,0,0,0,0
K32 Dolores Claiborne,king,4137,2372,2290,1868,1730,3714,991,1265,1934,1784,1162,654,1572,1084,1065,914,529,586,562,262,557,775,517,474,795,262,1015,326,509,191,269,558,487,365,141,369,236,575,114,386,512,613,454,220,384,525,363,351,136,401,401,52,295,202,124,189,277,270,339,494,305,213,112,107,194,301,97,278,94,233,224,147,237,214,258,172,132,373,126,80,176,141,82,251,260,146,86,121,199,181,164,178,134,67,215,175,154,103,144,166,187,337,53,88,221,46,148,195,94,24,172,149,43,129,126,52,116,183,132,85,42,62,212,145,60,143,98,137,139,142,119,80,135,84,100,114,40,117,74,101,87,79,147,61,175,126,98,102,81,106,156,32,57,48,52,25,40,75,97,18,39,74,195,163,48,16,69,69,114,2,315,83,156,77,16,25,65,56,97,85,107,92,58,51,80,73,52,53,53,82,34,63,88,83,31,78,26,33,59,83,59,39,54,101,3,20,59,19,128,85,18,63,19,30,25,47,84,28,118,44,33,114,35,34,46,39,21,34,26,111,5,8,42,58,86,192,35,35,42,24,47,64,65,24,42,73,49,74,29,47,49,30,35,23,30,66,63,54,43,32,66,70,57,54,12,28,66,45,54,33,59,43,14,8,42,49,73,65,102,106,22,19,72,96,73,0,6,83,40,15,29,344,14,3,4,57,42,7,36,98,75,25,5,36,14,45,75,58,7,19,13,74,20,61,27,18,21,30,24,10,15,25,19,18,26,27,39,35,15,25,118,48,49,36,12,2,32,11,33,56,14,68,25,9,6,9,43,1,18,26,59,11,3,26,53,6,6,65,17,49,24,5,23,15,8,7,26,63,27,44,18,5,27,38,34,53,22,11,87,7,13,21,29,12,20,5,0,29,26,12,4,4,16,3,30,63,23,16,30,46,39,29,16,3,19,3,2,79,1,44,24,17,19,21,22,2,15,38,19,14,7,0,5,32,14,22,22,32,32,20,0,22,30,4,0,13,24,14,13,38,29,2,7,41,25,7,1,30,28,31,15,30,6,4,12,23,19,8,15,1,19,2,0,6,16,25,23,3,39,22,3,1,24,125,34,20,9,2,0,15,18,16,15,2,7,26,10,2,92,3,20,22,6,13,11,1,3,23,5,37,24,21,13,2,27,21,26,36,22,10,3,23,23,12,2,18,0,10,13,54,41,31,1,33,8,16,36,22,39,12,9,23,8,27,18,1,27,29,0,2,46,2,25,19,9,9,0,4,33,37,0,19,37,2,21,15,23,14,13,2,10,25,16,54,14,31,11,2,11,0,10,5,20,16,18,9,18,6,23,25,9,25,8,23,7,11,8,34,4,9,14,7,9,18,17,31,1,9,12,29,14,23,50,3,6,0,1,24,4,10,19,3,14,15,5,10,20,10,18,8,10,6,16,17,10,6,17,21,27,5,4,22,9,22,7,0,30,15,10,9,15,2,0,0,0,0,28,7,7,22,0,10,23,3,21,30,11,23,11,11,10,11,20,14,6,6,8,19,27,3,13,17,0,6,12,11,6,10,15,1,3,14,5,14,11,13,11,3,7,14,28,10,6,8,16,13,2,0,17,4,18,11,16,21,17,14,18,7,11,1,5,12,0,8,18,9,2,5,22,0,1,7,3,5,6,10,10,4,7,23,5,22,14,15,0,20,0,13,0,12,30,2,8,16,0,0,2,13,5,5,7,3,9,8,4,1,10,20,0,5,4,4,17,7,6,82,18,32,3,2,13,5,148,39,5,6,18,7,15,2,2,5,4,14,5,10,4,0,8,4,37,9,0,13,3,7,0,20,0,6,12,23,2,9,9,0,40,7,4,11,1,1,33,12,0,12,6,0,8,51,7,1,1,18,7,4,10,1,17,15,18,0,3,11,1,13,9,18,0,24,6,20,17,9,18,5,12,0,14,3,7,19,2,2,0,0,12,0,0,0,10,8,2,14,9,4,5,0,26,18,18,14,21,11,1,7,1,25,16,15,5,10,6,4,6,17,27,12,7,17,19,0,2,2,9,15,0,0,6,23,12,1,0,6,6,12,16,1,12,0,15,0,24,0,6,0,5,11,15,7,2,0,0,3,4,5,2,0,32,1,4,2,5,0,0,6,6,7,7,5,1,2,4,3,3,27,0,1,8,3,10,21,14,0,3,1,29,12,9,2,0,16,26,1,4,19,8,3,3,1,3,271,15,9,0,19,7,18,2,0,0,32,17,1,0,220,0,0,21,5,2,1,4,10,6,3,1,2,35,0,11,0,11,0,2,1,0,0,0,46,2,4,6,2,3,3,22,0,0,0,1,4,0,0,0,0,14,6,5,6,1,1,7,6,11,5,2,0,18,15,39,1,2,2,1,6,23,8,22,8,1,4,6,7,3,0,3,2,0,17,12,6,0,0,6,5,6,1,0,0,0,0,0,0,2,29,0,0,5,2,5,1,6,1,29,3,0,3,6,2,0,0,14,7,3,13,6,0,14,11,2,1,1,5,8,13,1,3,0,1,9,10,2,1,0,1,4,0,19,6,7,35,4,8,7,3,14,11,1,1,9,5,3,0,6,7,9,4,6,2,5,12,6,6,3,3,10,0,7,4,0,0,5,4,0,0,2,9,0,0,1,1,0,14,0,6,2,17,3,0,0,0,2,2,0,1,1,4,0,0,2,0,2,2,9,2,2,3,8,0,11,6,0,0,0,7,0,10,1,10,1,0,5,11,29,0,1,1,11,8,0,1,14,43,0,0,0,2,2,4,4,3,2,0,11,6,13,18,5,2,7,16,0,2,13,0,0,9,3,3,4,0,3,0,1,2,0,3,1,5,5,1,0,0,1,5,3,13,3,1,10,0,0,14,0,0,13,74,6,3,0,3,1,0,0,6,8,3,0,25,2,0,0,20,0,1,11,4,5,0,0,1,1,3,13,8,0,21,3,10,9,3,2,1,0,2,1,3,2,1,13,0,2,6,3,5,6,21,14,15,21,5,1,0,10,7,5,2,1,8,0,1,1,1,11,0,5,0,2,6,4,22,16,0,1,18,15,5,2,0,5,1,0,1,2,0,3,15,7,0,1,5,5,1,2,0,4,0,1,9,1,0,0,6,3,0,0,9,0,1,1,0,1,24,19,6,5,1,25,2,5,6,8,1,13,2,5,0,1,1,0,0,0,18,0,1,1,0,1,3,0,1,8,2,0,2,0,0,4,5,6,0,0,2,7,0,0,4,1,14,5,2,0,0,14,6,1,5,4,3,6,2,2,4,1,9,4,3,1,1,2,11,0,9,11,0,2,1,4,2,5,3,0,2,4,19,16,0,11,5,0,0,0,3,0,0,0,3,1,1,7,5,3,11,4,0,1,7,0,2,8,22,2,3,5,4,0,9,0,4,4,0,9,0,0,3,0,10,0,51,6,1,1,0,12,3,6,0,3,1,0,3,0,11,0,3,1,0,0,23,3,0,7,3,0,0,0,9,6,1,11,3,3,1,6,2,14,0,0,0,11,2,12,2,3,0,0,2,3,3,4,0,9,22,7,0,0,9,2,3,0,19,3,0,0,19,2,0,8,8,1,5,0,2,8,4,5,12,2,2,0,7,12,50,1,0,1,0,1,3,0,0,0,6,2,2,0,0,3,0,6,8,5,0,4,0,0,1,0,2,1,5,15,0,2,6,0,3,2,3,5,1,1,0,2,1,6,2,0,6,1,0,0,7,1,0,0,0,4,1,1,0,0,1,0,3,0,7,1,5,2,4,0,9,2,1,2,0,4,0,2,2,49,1,0,5,0,5,2,0,10,2,0,3,1,0,2,8,10,2,0,0,6,2,0,0,8,0,7,1,7,0,2,0,0,1,0,3,0,0,0,6,7,5,4,3,1,6,1,1,2,5,0,2,2,0,8,12,5,2,0,12,1,0,2,5,7,0,1,1,1,8,4,12,0,1,0,0,2,0,8,0,0,1,1,1,0,0,0,4,2,7,3,0,0,1,2,3,5,52,0,0,1,6,7,1,0,0,0,0,2,2,1,1,5,1,5,0,1,2,1,2,0,3,0,0,0,5,11,0,9,0,2,1,1,0,16,1,0,7,5,2,4,1,0,8,0,0,3,13,4,1,0,0,2,2,0,0,0,0,0,18,9,4,0,10,4,3,0,8,0,27,2,4,0,3,0,6,3,0,3,1,0,6,10,0,22,2,0,0,0,0,2,1,2,4,0,0,4,4,0,1,0,0,1,1,1,1,14,0,0,2,4,1,0,4,2,1,2,9,2,3,0,4,1,0,0,0,1,4,0,40,5,0,0,0,0,1,0,0,0,1,4,3,6,0,0,2,4,1,19,0,0,0,0,2,1,0,1,1,0,0,0,1,0,0,1,2,0,1,1,0,0,0,0,3,6,3,7,7,0,6,0,1,0,3,0,9,0,0,0,0,1,1,1,0,4,2,1,4,4,0,0,0,4,2,2,3,2,2,0,2,0,5,0,0,0,0,0,0,0,0,0,1,0,1,17,0,0,0,1,0,2,5,0,9,0,0,1,0,1,0,0,1,1,2,12,0,1,4,2,2,0,3,3,0,2,5,2,0,2,1,0,1,3,0,8,0,0,0,2,3,0,0,0,4,0,0,4,3,6,6,4,1,1,1,0,4,0,0,0,2,2,3,0,3,1,2,4,7,0,1,1,1,0,0,1,0,5,0,2,0,6,0,5,4,0,1,0,2,3,0,3,3,2,3,0,0,1,2,0,0,3,2,1,5,0,0,2,0,9,2,0,0,0,1,16,3,0,0,5,0,0,6,0,0,2,2,6,26,0,0,4,3,0,5,0,0,0,2,0,0,1,0,5,4,0,2,0,2,0,9,0,0,1,0,2,0,4,0,0,5,0,0,4,0,5,2,0,2,0,0,2,0,0,0,0,2,0,1,2,0,0,1,1,0,1,0,0,9,0,1,0,0,33,0,3,2,6,6,0,0,2,0,0,0,0,0,1,0,0,2,1,1,3,0,0,2,3,4,1,4,0,0,0,1,0,4,0,4,3,0,0,0,4,0,3,0,1,0,9,7,9,2,2,0,6,1,2,9,0,0,0,5,6,0,1,4,2,0,2,0,2,4,3,1,3,0,5,0,4,0,0,1,0,6,3,0,0,2,6,9,9,0,0,0,2,2,0,1,0,0,6,0,1,0,1,1,10,0,3,1,0,5,2,5,1,4,1,0,4,3,9,1,3,0,0,4,3,0,0,4,0,6,0,5,2,8,0,0,0,5,1,2,0,1,0,3,2,0,1,0,1,0,1,1,0,0,4,1,1,0,0,2,0,2,4,3,1,0,0,0,0,2,0,2,7,1,0,0,1,2,0,0,0,0,7,8,1,7,0,1,0,1,0,0,0,0,0,1,3,4,0,2,1,1,0,2,0,5,0,1,0,0,0,10,3,8,6,6,3,1,10,0,4,0,0,0,0,1,1,0,1,7,2,0,1,5,3,0,0,2,2,1,0,0,1,2,0,0,0,5,0,0,0,0,4,1,5,0,0,0,6,7,0,3,0,0,5,0,0,1,2,4,0,1,4,5,0,0,0,2,1,2,1,3,1,2,2,4,0,4,2,2,0,3,2,0,1,14,0,0,0,0,2,1,5,1,3,2,0,0,0,0,2,1,0,0,0,0,0,0,0,0,0,4,9,9,0,4,0,0,0,0,0,1,0,5,2,1,0,3,2,2,0,11,2,1,7,1,3,0,0,0,4,6,1,0,0,0,1,1,0,0,1,0,0,0,0,0,0,2,0,4,1,0,2,1,0,1,1,0,0,2,0,0,5,4,0,0,0,1,0,5,4,0,3,0,1,4,3,1,2,1,1,0,0,0,3,6,0,8,0,0,0,3,3,0,1,5,4,6,6,2,0,0,4,0,1,6,0,1,1,0,0,1,0,1,0,0,0,1,3,1,0,1,1,3,5,0,0,4,17,1,0,0,0,4,0,0,0,3,10,1,6,0,1,3,2,0,0,2,0,0,0,2,2,0,3,2,7,0,1,0,2,1,1,1,1,0,0,1,2,1,0,2,1,4,0,0,2,0,0,3,2,0,0,1,0,10,1,2,4,2,0,1,0,0,1,1,2,0,4,0,1,2,0,3,1,2,2,0,1,4,0,0,0,0,1,21,0,0,3,0,0,0,0,1,0,1,0,1,1,1,0,1,3,1,2,1,0,0,0,6,2,0,1,0,1,3,2,0,0,0,0,0,0,5,1,4,2,0,0,11,0,0,0,2,4,9,0,0,0,0,0,0,0,1,2,0,1,1,4,0,5,14,1,0,1,2,0,1,0,0,0,0,4,1,0,0,0,0,3,1,3,3,1,0,1,2,0,1,0,0,3,1,0,1,0,0,3,1,1,0,1,0,0,4,0,0,0,1,0,1,0,2,1,0,0,0,0,0,0,0,0,10,3,0,0,7,0,0,0,0,0,0,0,4,0,5,0,0,1,2,2,0,0,0,7,4,0,1,1,0,0,8,0,3,6,0,0,1,0,0,0,2,0,2,0,1,0,1,0,0,0,0,0,0,1,0,1,1,1,0,0,1,3,1,0,1,0,1,1,0,0,1,0,2,0,1,0,0,3,2,0,7,1,2,0,0,0,2,2,0,0,2,0,1,1,0,0,0,0,4,0,0,0,1,1,0,2,0,4,0,2,0,0,7,1,0,0,3,0,0,0,3,3,0,0,6,147,0,0,0,1,0,1,0,0,0,1,0,1,0,0,0,1,0,0,0,0,0,0,1,0,3,3,0,0,0,0,0,0,1,0,0,0,0,1,0,0,5,1,3,1,0,0,4,5,2,0,0,0,0,2,0,3,0,0,0,0,1,1,3,0,10,1,0,0,5,3,1,7,1,0,1,0,0,2,0,1,0,0,0,0,3,1,0,1,0,4,0,0,0,0,2,1,0,0,2,0,1,0,0,1,0,0,0,0,0,1,0,0,0,1,0,0,2,0,1,4,0,0,2,1,1,0,0,0,1,0,1,0,2,0,0,0,1,0,3,0,0,0,0,0,0,0,2,5,4,0,5,0,0,0,0,0,0,0,1,4,1,0,0,0,0,1,1,0,3,0,0,0,2,3,0,0,0,2,2,0,0,0,2,3,2,0,2,0,1,0,0,0,0,3,5,0,1,0,10,0,0,0,5,0,1,1,0,6,2,2,0,0,2,0,0,1,0,0,0,1,0,5,2,1,0,4,0,0,4,1,0,1,0,0,0,6,0,0,28,0,8,0,1,0,3,0,0,0,2,0,0,0,0,0,38,2,0,0,0,0,0,2,6,0,0,0,0,0,0,0,1,0,0,1,0,2,2,3,1,2,0,0,3,1,0,1,0,0,0,0,0,0,6,0,0,0,0,3,0,2,0,0,1,0,0,4,0,3,3,0,0,1,0,0,0,1,0,0,0,2,0,0,1,1,0,0,0,0,11,0,1,0,1,0,1,0,0,3,0,1,0,0,0,0,0,0,0,0,0,0,1,0,0,0,3,4,0,0,0,0,0,0,3,0,5,0,0,1,5,0,4,0,0,0,0,2,1,1,2,1,0,1,0,0,1,1,0,1,0,1,0,0,3,0,0,0,2,1,1,1,0,0,1,3,1,0,2,0,0,1,0,0,0,4,3,0,0,2,1,0,0,1,0,7,2,0,1,0,0,2,0,2,1,0,1,0,0,0,2,2,0,0,0,1,0,0,3,2,0,0,0,1,0,0,1,2,0,0,0,0,0,0,3,0,0,0,0,0,0,0,2,0,1,0,1,0,0,0,0,2,0,2,0,0,3,3,0,2,2,4,1,1,0,1,0,2,0,0,0,0,0,0,0,2,1,1,0,0,2,0,0,2,0,10,0,0,2,0,0,0,0,0,0,0,1,1,0,1,0,0,3,1,0,0,0,0,0,4,1,2,7,2,0,0,0,0,3,0,6,0,0,0,0,0,2,0,0,0,0,0,5,0,0,2,0,4,0,0,0,2,0,0,0,0,1,0,8,0,6,0,0,0,7,0,1,0,1,1,0,0,1,1,1,0,0,0,0,3,0,1,0,1,0,0,7,1,0,1,0,1,1,0,1,0,0,0,0,1,0,0,1,2,0,0,12,0,0,0,3,6,0,0,1,0,0,0,0,0,0,0,0,4,1,0,0,0,2,0,0,0,0,0,2,2,3,0,3,0,1,1,0,1,0,0,19,0,1,0,9,0,0,0,1,0,1,0,4,0,1,1,1,0,1,2,0,0,0,0,13,0,0,0,2,3,0,0,0,0,2,1,1,1,0,0,0,3,3,2,5,3,2,0,0,1,1,2,0,0,0,2,3,1,1,0,645,0,1,2,2,3,0,3,0,0,0,0,2,0,0,5,1,0,0,3,0,0,0,5,0,3,0,0,2,0,1,2,0,2,1,0,2,4,0,1,0,0,0,0,5,0,0,1,3,0,1,0,0,0,0,4,1,1,0,1,0,5,0,0,0,3,1,0,0,0,0,9,0,2,1,0,1,0,0,4,1,0,0,0,0,0,2,0,0,0,0,0,0,0,0,0,0,1,0,0,0,2,3,0,0,0,2,0,0,1,0,2,0,3,4,0,1,0,1,0,0,2,0,0,2,2,0,1,1,0,0,0,2,0,0,0,1,3,1,4,0,0,0,1,0,0,0,0,1,0,1,0,0,16,0,1,0,1,2,0,1,0,0,0,1,0,0,42,0,0,0,5,3,0,0,0,0,3,0,0,1,5,1,0,2,2,0,0,0,0,1,0,0,5,0,1,0,0,0,0,3,0,0,0,0,0,0,0,0,2,1,0,1,0,0,0,0,0,0,0,0,0,0,0,0,3,2,2,1,2,0,0,0,0,0,1,0,12,5,0,0,1,0,1,2,0,1,0,0,0,0,0,0,0,0,0,0,0,1,4,0,2,0,1,0,0,1,0,0,3,2,0,1,1,0,1,0,0,18,0,0,0,0,0,2,0,0,0,0,0,0,5,6,0,0,4,2,0,0,0,4,3,0,2,2,0,0,3,0,1,0,0,1,0,0,0,0,4,4,0,3,1,0,0,1,1,1,0,1,0,0,0,3,0,1,1,0,0,1,0,0,0,1,7,0,0,0,7,0,0,0,0,0,0,2,0,0,0,2,1,0,0,4,0,6,0,1,0,0,2,0,0,0,0,3,0,0,1,0,0,0,2,0,0,0,0,0,0,8,2,0,2,0,0,0,0,10,0,0,0,0,0,0,0,1,0,0,0,35,5,0,0,0,2,0,0,1,0,0,2,0,0,1,0,0,0,0,0,0,0,0,0,1,0,2,8,2,0,0,0,0,0,0,1,2,0,1,0,0,0,0,0,0,2,3,0,0,1,3,4,1,0,1,0,13,5,0,0,10,0,0,0,0,0,0,1,0,1,0,0,2,0,1,0,29,0,0,0,0,1,0,0,0,0,0,0,0,0,1,0,0,0,3,0,0,0,0,3,0,1,6,0,1,0,1,0,0,0,2,1,12,9,0,0,1,1,0,0,4,0,0,1,0,0,0,0,0,0,3,0,0,1,0,0,0,2,0,1,1,1,0,0,0,1,2,0,0,1,2,0,8,0,0,0,0,0,0,0,0,0,0,0,0,0,0,0,0,1,0,0,1,0,0,1,5,0,0,0,0,0,0,3,0,0,2,0,0,0,0,4,0,0,0,0,1,3,0,0,0,0,1,1,3,5,0,0,0,0,0,1,0,0,0,0,2,0,0,0,0,0,0,2,0,0,0,2,0,3,2,2,0,1,0,0,0,1,0,0,0,0,0,2,1,0,0,0,1,0,1,2,1,0,1,0,1,1,0,0,1,0,0,0,0,0,0,0,1,3,0,0,6,0,1,2,0,0,0,0,0,2,0,0,0,0,0,0,0,1,0,0,0,0,0,0,0,0,0,0,0,0,1,0,0,0,0,1,0,0,0,0,2,10,0,1,98,1,1,0,0,0,1,0,1,0,3,0,1,0,0,1,0,0,1,0,0,1,1,0,3,0,0,3,0,0,0,2,0,0,1,0,0,0,0,0,0,1,0,1,0,0,0,0,2,1,1,7,0,0,0,0,0,1,2,0,0,3,0,0,0,0,0,0,1,0,0,0,0,0,0,0,0,2,2,1,0,0,0,0,0,0,4,0,1,0,1,1,0,4,0,3,2,0,0,0,0,0,0,4,0,0,0,2,0,0,0,0,1,2,0,1,0,0,0,0,0,0,0,0,0,0,0,0,5,0,2,2,2,0,3,0,0,1,0,4,0,0,1,0,0,0,0,0,0,0,0,0,0,1,1,0,0,0,2,0,0,0,0,0,0,1,0,0,0,1,0,1,0,0,0,2,0,0,0,0,2,0,0,1,3,0,0,0,0,1,1,0,0,0,1,0,0,2,0,0,1,0,0,1,1,0,2,0,0,1,0,0,0,0,17,0,0,2,1,0,0,0,1,0,0,2,0,0,0,0,0,0,0,0,0,0,0,1,3,0,1,3,0,2,0,1,3,0,0,0,0,0,0,0,2,0,0,0,0,0,2,1,2,4,0,2,0,1,2,0,2,0,1,0,2,2,0,0,1,3,0,0,1,0,0,0,1,0,0,0,1,0,0,0,0,1,0,0,0,0,1,0,0,0,0,0,1,0,0,0,1,0,1,0,0,0,1,0,0,0,1,4,0,1,10,0,0,0,0,0,8,0,1,1,0,0,0,0,0,0,0,0,1,0,1,0,0,0,0,1,0,1,0,0,1,0,1,1,3,0,0,1,2,0,0,1,0,0,0,2,0,0,0,0,0,0,1,0,0,2,0,1,0,0,0,3,1,0,0,0,0,0,2,0,1,0,0,0,1,0,1,0,0,0,0,0,0,2,0,0,0,0,0,0,0,0,1,0,0,1,0,0,0,0,1,0,0,1,1,0,0,0,0,0,0,0,0,0,0,0,0,0,0,0,0,0,0,0,1,0,0,0,1,1,0,0,1,0,0,0,1,1,0,1,0,0,0,5,0,1,0,0,0,0,0,0,0,0,0,0,0,0,0,0,0,0,0,0,0,1,0,0,0,1,0,0,0,0,0,0,0,0,0,0,0,0,0,0,1,0,0,0,0,0,0,0,0,0,0,0,0,0,0,1,0,0,0,1,0,0,0,0,0,0,0,0,0,0,0,0,0,0,0,0,0,1,0,0,0,1,0,0,0,0,19,0,0,0,0,0,0,0,0,0,0,0,0,0,0,0,0
K33 Insomnia,king,12376,6613,5502,5628,5735,2424,4825,3271,3845,3483,2585,3160,2940,1411,1845,1839,2616,1551,1247,1147,1892,1806,1440,1290,438,1015,594,1043,1011,690,940,1053,1090,874,998,794,818,896,470,964,894,1077,744,693,660,600,713,608,546,803,770,758,650,607,605,529,779,495,681,816,586,544,466,638,428,589,384,469,438,500,367,335,438,499,278,438,423,497,307,267,299,386,365,531,382,613,302,324,369,262,185,325,341,337,457,244,391,269,276,289,212,538,383,328,562,536,359,487,207,369,301,456,164,357,263,159,261,218,272,230,237,145,199,437,139,196,248,361,210,181,397,231,293,190,412,278,101,246,224,205,128,185,150,201,272,202,180,275,205,252,294,264,263,173,149,129,134,105,158,209,94,298,268,242,149,209,175,105,190,261,85,137,228,146,91,154,227,160,222,268,124,111,330,119,135,90,95,119,236,86,137,78,150,190,129,230,10,77,157,61,171,231,134,174,165,114,106,115,135,135,78,126,109,99,133,112,132,173,134,91,120,179,171,165,113,144,79,73,86,272,223,175,107,227,177,31,106,110,122,76,69,74,143,74,75,105,89,161,89,79,143,44,108,78,107,120,97,105,147,137,108,181,134,120,128,56,75,106,79,106,135,75,131,123,117,76,77,93,210,98,80,59,121,114,288,151,110,46,79,73,62,30,42,65,95,90,87,107,84,88,89,85,136,58,218,83,20,32,41,105,96,33,46,99,80,81,62,229,89,93,94,164,65,88,29,73,86,89,90,84,116,100,75,94,46,98,113,26,70,116,54,35,51,18,86,55,131,64,63,70,170,56,102,61,110,18,66,112,57,54,58,123,69,88,59,63,70,49,94,51,63,50,51,62,65,139,75,64,92,69,53,137,38,75,40,86,0,60,87,154,50,68,35,46,81,150,93,38,57,90,22,93,60,65,78,61,56,91,35,84,52,43,46,54,93,94,54,106,47,71,84,1,8,46,30,69,44,44,75,40,115,65,94,96,1,49,77,63,46,85,62,51,40,76,63,33,137,59,39,66,106,40,15,177,96,55,45,56,56,64,94,13,2,36,40,53,71,33,15,43,28,91,53,24,41,52,28,53,0,79,51,116,67,20,34,62,81,50,115,19,125,20,116,38,60,23,79,41,14,48,34,29,24,40,51,35,22,49,59,35,54,123,45,39,91,51,0,30,54,39,74,53,74,36,69,27,63,32,38,73,57,44,143,45,44,5,75,92,26,64,53,20,109,50,49,63,0,8,37,43,49,64,34,12,60,87,64,73,41,40,36,48,37,80,41,49,23,21,92,16,49,49,41,55,31,35,38,12,31,23,57,82,22,35,9,45,24,72,27,13,36,33,19,32,37,29,17,42,25,48,75,68,73,27,18,1,4,50,51,24,20,77,76,41,7,40,45,25,32,108,20,28,12,50,34,84,28,54,45,10,19,78,32,21,34,0,51,43,77,53,22,45,53,32,63,78,55,46,45,33,0,43,27,52,57,47,37,7,32,9,46,37,34,28,68,35,53,30,34,19,52,47,33,25,16,30,12,38,37,12,26,54,36,18,97,24,7,44,15,40,63,12,22,58,14,22,30,1,13,19,32,9,37,36,39,37,18,39,70,27,8,87,10,22,30,44,35,45,32,23,37,28,11,3,39,64,26,3,26,28,87,35,25,9,0,62,34,30,15,57,116,56,7,27,10,33,13,32,33,14,18,37,29,36,14,81,30,8,24,26,48,20,43,34,46,30,27,15,34,25,37,12,20,28,6,22,15,35,9,20,21,19,31,35,30,35,40,25,16,22,18,19,9,38,23,24,3,28,3,19,20,13,15,47,33,26,99,35,23,13,43,51,50,2,45,28,5,1,50,68,23,9,17,22,35,32,20,98,17,35,17,13,14,25,14,37,20,39,17,17,43,12,16,26,31,30,35,0,41,48,32,30,13,8,15,18,5,10,4,43,30,11,19,39,38,56,4,0,23,27,35,24,23,17,261,13,21,35,27,32,43,23,32,48,13,28,30,36,18,32,20,18,15,9,62,23,26,0,24,56,18,69,38,12,59,19,41,17,28,10,43,0,48,1,42,8,39,7,64,17,36,0,13,13,16,33,11,0,57,18,31,15,25,32,7,36,27,18,6,43,19,22,32,15,17,16,14,23,16,25,26,17,28,31,4,22,56,20,22,8,0,23,21,3,5,37,7,8,15,24,31,58,36,19,15,23,15,33,25,9,2,57,13,7,13,18,14,0,25,28,34,20,26,45,13,20,0,31,29,0,14,1,29,1,15,52,0,2,26,36,11,5,19,8,19,33,29,0,14,28,15,7,54,19,34,2,22,6,19,20,27,10,11,18,33,22,21,22,14,40,36,9,2,9,40,10,27,12,10,30,56,17,0,11,13,0,24,17,3,22,23,19,0,8,46,51,20,18,1,0,0,2,25,16,33,24,6,0,19,19,11,25,10,26,11,6,9,42,19,5,25,0,35,20,10,28,24,20,34,15,12,3,15,37,13,16,31,7,28,31,12,25,9,20,0,1,2,8,34,27,35,41,177,37,32,25,16,31,17,6,13,13,22,4,6,35,50,14,11,63,52,8,8,25,5,10,26,12,34,10,15,4,8,14,20,6,3,15,12,16,15,17,10,25,0,12,6,44,3,29,0,24,21,13,29,21,0,4,17,0,14,11,2,4,25,37,3,6,26,0,8,24,0,45,7,38,19,16,8,27,4,0,18,10,22,4,5,9,25,7,0,8,34,14,4,0,0,29,33,24,26,17,18,7,32,6,11,27,5,25,22,26,2,22,12,0,13,7,4,11,6,5,22,1,7,7,1,11,11,9,9,28,16,17,2,16,23,22,74,5,26,0,8,19,0,18,17,3,11,15,6,10,21,15,0,11,23,7,1,5,11,39,14,42,43,22,46,14,14,12,0,7,10,10,8,16,3,14,6,31,11,44,43,17,21,68,4,4,16,2,9,4,8,13,3,19,23,51,11,8,27,12,10,0,9,12,21,8,8,12,0,17,13,18,4,19,14,6,5,16,24,23,6,0,1,54,4,72,56,21,11,5,13,28,5,11,19,29,12,5,6,7,22,0,16,6,26,9,14,23,7,17,32,10,12,0,0,12,1,30,5,0,5,37,18,28,6,13,15,8,25,30,22,4,17,24,10,0,6,0,0,5,0,19,4,24,2,0,13,9,15,22,16,11,0,22,15,7,25,26,10,2,6,9,12,21,2,3,12,16,16,8,0,2,5,24,27,8,10,19,4,8,15,22,51,22,5,13,25,12,9,25,0,12,44,0,12,8,19,4,17,17,20,0,12,10,16,0,12,7,49,5,8,10,0,14,16,24,6,6,17,5,6,25,8,19,25,19,17,22,13,20,6,21,10,2,0,0,2,6,38,1,1,1,0,3,0,8,7,1,8,3,4,9,37,21,1,1,6,8,13,14,16,20,20,13,12,21,10,28,4,6,15,9,10,450,15,8,4,15,17,12,20,20,10,13,25,0,17,2,25,8,34,38,6,4,9,4,18,16,20,14,5,8,16,3,10,13,16,9,24,28,22,0,26,11,22,10,55,15,5,9,5,6,12,5,8,15,6,8,0,12,25,5,7,16,15,0,7,23,18,1,0,9,51,17,22,15,8,7,17,18,1,1,39,8,0,6,0,44,14,9,8,0,1,11,6,13,3,6,15,2,2,10,6,21,9,8,3,33,19,7,26,25,0,4,3,17,10,3,2,8,15,22,9,27,3,19,2,18,6,32,5,5,24,1,4,0,20,42,20,17,38,28,3,10,0,4,1,13,13,14,28,2,12,0,3,12,11,9,6,0,17,8,0,6,43,1,21,11,12,1,20,6,0,4,33,9,9,34,10,12,6,6,9,8,6,14,0,25,6,16,12,6,5,0,19,3,12,9,17,21,28,0,3,33,10,5,37,2,5,11,16,19,9,9,5,13,19,2,17,4,4,20,2,20,0,8,24,21,15,9,7,1,8,13,11,20,21,1,6,1,23,9,13,14,5,16,1,12,5,7,7,26,9,10,3,11,8,11,16,32,0,17,5,12,5,9,21,17,2,8,9,8,15,3,17,5,51,5,23,38,21,6,1,19,8,1,4,12,12,25,0,0,25,3,0,3,0,0,1,46,11,5,1,12,2,10,0,17,0,35,0,19,3,26,16,11,4,0,4,24,30,20,9,24,35,15,3,9,9,6,5,1,2,6,1,10,5,41,2,13,6,15,7,19,8,45,15,8,0,9,12,16,2,14,7,6,18,19,7,11,0,8,3,5,12,2,5,7,0,43,14,4,0,13,4,2,4,11,0,12,10,1,33,12,3,6,5,10,19,1,0,6,15,29,14,0,12,4,10,7,0,12,9,0,7,8,0,7,0,1,0,23,2,12,7,7,8,12,2,4,12,14,1,2,1,13,3,16,21,2,7,14,18,4,13,4,5,13,1,11,0,0,4,4,3,16,12,12,3,16,14,6,5,5,9,7,6,3,13,5,7,1,5,6,15,0,9,3,13,0,6,9,3,17,10,7,3,117,3,4,1,21,9,6,13,3,14,4,2,8,14,2,13,0,12,27,3,0,4,2,2,4,8,18,12,5,5,2,17,9,10,0,0,8,8,6,9,3,8,8,0,7,2,18,7,31,1,5,20,11,2,22,8,1,2,4,9,16,0,0,10,11,0,3,21,2,3,5,40,2,5,34,10,5,1,0,2,5,7,19,13,19,4,38,1,6,22,4,1,0,14,11,13,6,0,2,1,7,0,8,15,8,3,9,0,4,0,3079,10,0,12,6,0,0,3,4,4,34,5,17,27,2,0,14,12,23,7,8,21,5,10,0,10,22,5,4,0,1,5,7,0,0,15,0,15,5,39,5,0,30,1,13,19,11,5,17,11,5,2,8,2,1,4,1,0,2,1,2,8,0,0,7,8,3,3,7,2,0,2,13,7,7,6,9,3,28,3,5,0,19,3,0,8,17,0,0,9,19,13,12,7,6,8,2,5,8,6,8,11,0,3,2,5,5,15,7,3,3,5,9,7,8,13,3,8,0,7,0,5,15,3,8,3,9,12,6,11,4,8,9,4,5,7,7,4,10,10,2,0,4,3,5,2,31,8,13,8,4,15,0,1,29,4,1,13,10,14,3,2,12,8,7,10,3,7,8,6,14,12,10,7,42,9,2,7,12,27,11,23,3,6,10,21,15,5,4,1,4,3,18,4,7,12,6,4,4,7,2,0,33,0,11,18,4,6,15,13,2,3,10,8,5,0,1,6,14,7,10,16,3,10,2,5,5,4,4,4,3,22,19,10,21,1,11,12,20,3,2,9,2,5,10,4,9,18,0,5,3,43,6,8,7,4,0,17,25,4,15,1,3,0,4,9,0,0,3,4,3,6,3,4,15,7,1,5,2,3,10,7,19,19,0,5,13,11,15,11,9,10,9,4,3,6,1,6,1,0,8,10,7,8,4,14,0,6,5,5,0,5,5,18,7,11,1,19,9,5,5,0,19,2,5,9,0,10,5,10,3,8,8,6,18,0,14,38,0,6,8,3,16,15,2,2,5,47,14,4,0,0,13,4,5,6,7,2,0,4,15,0,3,9,5,0,10,10,0,4,7,13,0,8,6,4,8,9,4,8,38,4,5,0,22,3,5,3,0,5,3,8,20,0,1,0,17,6,4,56,5,8,2,3,3,1,1,2,2,3,17,0,0,6,15,16,6,1,3,4,1,8,0,1,6,11,3,26,4,4,5,4,0,0,0,4,8,22,10,0,5,13,13,1,4,4,11,6,4,1,1,5,0,0,2,1,0,23,5,0,9,1,15,5,15,5,13,5,3,0,8,10,7,7,6,6,30,0,18,11,11,11,14,7,3,7,9,5,10,4,0,5,2,15,4,25,7,4,1,7,11,13,10,10,6,1,5,4,3,8,6,2,18,0,15,2,2,1,10,8,0,3,3,2,0,2,1,19,9,0,0,1,8,6,4,6,4,5,5,8,4,3,6,0,7,5,6,17,3,10,6,8,1,1,0,4,4,3,3,12,2,5,3,3,4,1,7,0,7,8,2,4,0,6,0,8,0,7,24,2,9,4,4,8,27,5,2,0,5,13,4,4,3,11,8,1,9,0,6,4,7,19,0,11,10,0,5,7,3,1,18,1,0,13,23,3,0,4,17,1,5,10,2,29,8,9,0,2,5,9,4,0,0,0,6,2,1,3,0,9,6,6,19,1,4,26,3,3,4,6,6,7,0,1,44,8,0,18,5,7,4,4,1,11,11,1,1,0,3,8,7,7,2,11,0,7,1,12,6,1,5,7,8,6,2,0,0,11,10,0,7,2,3,5,6,9,3,11,0,13,4,3,5,7,5,51,6,0,2,6,4,19,3,6,1,5,7,14,10,0,0,2,11,15,1,0,3,4,2,6,6,1,2,5,1,4,18,4,8,3,9,12,6,6,2,0,3,0,18,1,3,6,3,2,6,3,3,0,0,8,1,3,27,11,2,0,16,11,3,5,0,12,5,0,0,0,7,4,4,1,6,12,7,6,0,0,13,0,0,4,0,3,4,20,3,2,8,2,5,5,5,0,0,25,6,0,8,4,8,1,2,0,7,7,8,1,6,5,13,4,15,0,14,7,4,8,4,7,2,6,0,4,5,1,3,0,0,0,7,4,0,7,0,10,1,8,6,1,6,2,1,0,2,10,12,6,8,6,6,0,7,0,0,8,0,0,3,3,3,0,7,5,0,0,3,3,8,12,2,0,2,0,0,0,8,2,3,4,0,3,11,9,6,0,1,6,3,0,11,6,4,5,2,8,9,3,8,2,7,6,14,0,12,0,0,4,10,7,2,18,14,3,3,7,11,4,7,1,2,5,9,6,0,9,5,4,4,2,7,10,31,3,1,0,0,6,12,2,7,2,8,7,0,8,5,0,8,3,5,16,16,0,0,3,1,55,2,0,1,1,1,1,1,8,7,12,0,0,1,3,2,8,1,0,3,23,8,2,0,5,2,3,4,0,5,0,0,4,1,4,12,2,3,4,8,5,3,17,5,7,2,0,2,1,2,0,3,4,1,0,8,4,13,16,1,9,1,2,6,8,3,4,3,8,0,2,7,1,5,8,3,0,6,7,5,2,4,2,6,3,3,2,6,0,0,7,12,2,4,7,4,18,0,7,6,15,74,1,0,12,7,8,5,2,2,10,1,7,6,6,5,4,0,2,0,4,14,2,2,4,13,8,7,10,7,2,7,6,0,3,16,14,14,2,4,2,11,9,3,3,8,0,0,2,5,7,4,8,19,7,0,2,0,6,21,5,5,2,6,6,2,0,7,0,0,0,1,2,3,3,3,2,12,17,8,2,2,0,1,2,1,4,4,15,2,30,6,0,0,13,7,9,5,1,3,7,8,3,4,13,6,2,2,12,10,2,9,2,2,6,8,4,6,11,2,5,1,0,1,0,29,0,10,0,3,3,8,4,6,12,0,7,10,4,9,3,6,3,6,1,2,1,0,6,2,0,6,7,0,6,2,10,3,3,0,1,10,0,1,8,9,8,10,1,5,4,2,8,4,6,0,8,0,0,9,3,5,2,3,3,1,6,10,14,5,6,2,0,3,6,0,5,1,6,2,7,4,1,7,10,2,13,3,2,1,5,2,8,17,3,16,2,4,7,8,5,2,1,4,0,0,3,0,12,1,3,2,9,4,2,5,4,0,6,1,0,1,0,0,4,0,5,7,2,1,1,13,3,2,1,2,1,1,3,1,0,0,11,3,3,2,0,2,5,0,13,7,1,0,8,0,9,0,6,0,13,17,5,5,7,2,1,2,2,7,2,18,5,1,0,5,0,2,1,6,3,7,10,0,4,2,5,2,6,4,9,4,0,5,0,2,1,0,0,1,0,4,5,0,5,0,4,4,7,7,2,6,2,0,4,3,1,8,0,0,0,1,5,6,19,3,9,0,1,3,2,10,1,0,7,21,0,0,9,4,4,2,19,0,6,6,2,0,3,2,9,0,2,11,6,7,3,5,6,12,1,3,12,1,1,0,0,3,4,9,18,0,5,0,0,5,1,6,2,1,0,0,0,0,0,0,9,2,2,2,9,7,6,10,3,5,0,19,10,1,2,2,0,2,7,1,12,0,2,2,10,3,0,6,1,1,6,1,11,1,8,1,10,0,5,5,1,5,1,16,0,27,15,1,11,1,0,0,3,0,0,5,2,4,5,3,11,1,2,0,3,12,2,5,0,3,1,9,4,4,5,1,0,0,7,15,13,0,5,1,8,1,17,7,0,1,9,1,9,0,10,8,2,0,15,8,4,1,0,12,4,6,3,3,7,0,6,2,4,3,5,15,2,3,0,2,2,1,0,0,11,4,5,3,6,3,18,0,0,2,1,0,7,0,16,0,14,2,1,1,4,6,2,1,0,4,14,4,6,0,5,2,2,2,8,6,0,4,5,2,3,2,2,6,1,0,8,5,8,1,1,9,6,0,0,3,31,2,0,0,1,4,2,0,3,2,1,2,0,2,6,2,0,10,0,0,9,1,6,3,0,2,1,1,3,3,1,1,2,0,2,6,5,1,0,2,5,11,1,4,3,1,5,1,4,5,9,2,13,0,6,3,2,4,7,11,2,0,4,1,0,3,0,3,0,0,1,10,2,4,4,5,3,0,1,3,1,6,7,17,0,2,7,9,5,7,5,2,8,0,0,2,1,0,1,1,6,0,4,0,0,2,0,5,15,4,0,2,8,4,3,2,5,3,0,0,3,2,5,2,1,1,2,1,10,4,3,0,4,9,0,4,7,1,0,0,0,1,0,0,9,1,6,4,42,8,3,1,13,1,3,0,3,3,0,0,0,3,3,10,3,3,2,0,1,0,5,0,9,3,3,0,2,4,4,8,1,0,4,3,3,5,4,2,1,1,1,7,0,2,5,0,2,2,6,4,5,4,2,0,5,5,2,2,3,0,5,4,0,12,0,1,0,4,3,2,3,0,0,0,9,1,120,5,1,4,3,3,7,2,8,3,2,0,7,5,1,0,1,0,1,1,4,2,2,0,5,3,7,8,0,7,2,0,4,0,17,0,3,3,1,0,6,4,4,3,6,3,11,3,2,2,3,6,3,1,1,4,14,0,18,15,1,3,0,0,13,1,9,1,0,0,1,13,2,11,3,4,1,6,2,4,6,6,4,1,2,0,1,7,2,4,4,3,4,0,0,2,5,8,6,9,10,7,0,0,1,5,9,2,4,0,2,3,4,3,9,1,13,39,9,0,3,1,4,5,2,3,11,5,2,0,9,23,0,0,1,2,0,5,0,2,0,14,0,2,19,12,1,4,2,4,11,1,2,5,5,3,0,1,0,1,0,0,2,24,0,4,6,2,5,0,4,1,0,2,1,2,1,9,14,0,1,0,7,0,2,0,2,1,5,0,0,5,1,0,2,6,3,0,6,0,13,4,0,1,8,0,1,3,4,0,10,1,4,4,2,13,2,0,0,0,1,0,1,5,0,5,9,1,1,0,4,11,3,0,4,3,1,2,9,0,3,7,1,1,3,1,0,7,0,3,5,0,4,3,0,0,4,1,4,4,0,8,10,1,4,8,4,4,2,0,0,7,19,9,0,2,0,0,3,19,1,2,2,22,5,4,3,3,4,0,0,6,1,7,10,19,0,0,7,1,1,0,0,6,1,10,0,2,2,4,2,3,0,2,4,3,2,0,0,2,5,8,3,2,1,8,4,0,7,6,2,8,1,2,20,3,0,2,2,2,2,0,0,4,1,5,0,8,2,1,16,4,5,2,4,3,4,0,8,2,4,0,1,2,4,0,1,4,0,0,1,5,8,0,2,1,2,0,2,3,2,0,0,5,5,2,2,2,13,25,0,7,0,0,7,0,12,5,9,1,3,3,2,1,0,7,4,4,2,7,2,0,5,2,4,1,0,0,0,0,0,0,0,0,2,0,7,3,4,2,12,1,2,26,4,0,0,2,3,2,4,9,0,1,0,7,2,4,0,10,2,10,0,1,1,1,2,9,2,2,3,8,0,3,2,1,1,5,0,4,2,1,3,3,1,2,5,2,2,1,7,3,0,14,1,1,2,0,0,1,2,26,2,6,10,4,5,2,1,1,3,21,1,0,0,0,2,5,24,7,0,0,4,12,2,0,1,0,0,1,4,2,1,0,4,0,0,0,3,0,2,2,3,12,2,4,7,2,12,1,0,0,1,0,5,3,6,0,3,0,2,7,0,0,1,0,5,4,6,2,6,10,5,1,3,3,1,7,0,2,5,1,9,2,1,4,6,0,5,0,3,4,0,5,0,2,3,4,2,5,3,17,0,0,0,0,2,3,2,5,0,2,8,1,0,0,3,1,5,0,0,4,1,7,4,4,3,4,0,5,0,2,4,1,1,0,1,2,3,1,1,1,0,4,0,2,4,2,2,1,2,4,6,2,2,2,17,3,1,2,3,0,1,7,1,0,0,1,5,1,2,0,1,0,1,1,2,2,1,1,6,4,8,2,0,0,1,0,0,4,2,0,5,5,0,0,3,1,0,0,0,3,14,0,0,3,6,4,1,0,1,1,1,8,10,0,0,3,3,1,5,0,5,2,2,3,1,0,0,0,0,1,0,9,3,3,3,0,1,4,3,7,0,0,7,0,0,2,0,10,3,2,0,2,1,0,1,0,2,0,0,2,1,2,0,0,3,2,3,1,7,2,1,22,0,0,3,9,3,3,1,3,0,3,1,2,6,3,0,1,0,0,7,1,32,2,0,6,7,4,2,0,0,3,2,10,0,1,1,1,3,1,1,0,7,1,3,2,4,3,1,0,1,0,6,5,2,0,3,12,5,6,0,1,1,0,1,4,5,5,5,4,0,3,3,2,2,0,1,0,0,4,0,2,0,1,0,3,8,0,0,2,0,3,4,2,8,3,1,2,13,3,2,0,0,0,0,5,4,2,1,5,4,6,1,0,2,0,1,0,1,0,1,2,1,13,1,2,2,11,1,0,0,0,5,0,7,9,1,0,7,0,2,3,0,4,1,2,0,3,0,0,7,0,1,2,1,1,5,39,0,0,0,2,0,0,0,8,0,1,2,7,1,0,1,3,0,1,3,0,0,0,0,0,0,0,0,0,0,0,3,0,2,0,0,0,1,0,3,0,1,0,1,2,0,0,0,0,0,0,0,0,0,0,1,0,0,0,0,0,0,1,2,1,0,0,0,0,0,0,0,0,0,0,0,0,0,0,0,0,0,0,0,0
K34 Rose Madder,king,9488,4828,3888,4286,3873,1097,2597,2508,3136,2917,1727,1596,2093,3951,3535,1407,1929,1236,1008,733,1269,1273,1067,773,226,698,367,525,770,423,589,715,716,696,699,554,563,661,119,773,720,835,627,556,425,512,513,439,574,644,601,420,516,514,367,378,559,302,441,457,477,347,349,471,271,365,217,391,195,310,262,241,341,249,213,288,235,375,242,285,250,232,267,375,331,410,310,215,316,217,138,251,284,218,244,194,285,194,213,193,196,397,243,206,404,315,279,346,224,252,271,176,36,292,205,170,211,176,210,133,185,106,174,322,196,139,181,227,179,112,236,195,187,158,302,187,24,212,245,124,46,133,149,146,222,167,115,239,127,143,110,157,227,114,108,57,101,70,136,92,99,223,218,136,169,207,140,82,130,215,36,105,118,104,64,102,125,154,114,161,89,117,193,101,109,78,83,83,162,49,121,63,120,113,113,161,29,64,294,66,69,114,101,109,97,39,54,104,123,125,30,108,51,79,123,50,89,154,110,66,78,121,89,120,57,80,56,113,44,183,153,89,87,247,93,160,115,73,102,70,74,57,93,70,57,89,81,130,97,72,101,79,78,97,116,65,42,69,73,94,76,72,81,102,81,25,84,58,62,106,120,57,105,61,54,55,52,66,188,84,84,34,73,98,171,82,85,81,76,42,67,50,34,50,87,51,74,69,38,83,90,41,51,43,111,35,22,44,26,33,71,14,34,71,53,86,41,95,106,19,48,125,60,51,157,85,64,73,54,77,93,69,72,80,8,60,76,8,38,72,72,45,39,15,54,33,71,54,51,20,122,31,88,47,109,20,44,95,30,36,45,56,32,103,37,48,30,43,31,45,51,19,34,38,34,103,24,32,67,43,63,69,51,45,40,60,0,41,47,61,30,41,25,39,58,95,87,52,50,38,26,99,65,30,67,34,49,54,27,64,50,33,42,7,63,85,19,80,34,53,61,2,11,28,31,37,25,42,29,30,82,38,33,61,10,10,26,64,0,48,33,22,10,70,34,24,84,44,33,42,66,25,13,105,36,26,48,39,50,57,49,8,0,83,37,50,67,7,47,41,29,61,35,21,46,27,19,46,0,47,32,73,65,21,22,60,51,258,36,27,55,13,53,28,37,13,44,51,1,38,34,25,28,20,33,20,12,28,41,25,32,80,27,44,35,34,0,26,42,40,48,13,61,54,54,44,36,25,35,66,6,41,46,31,41,3,59,61,35,24,29,24,77,64,50,46,0,4,29,17,52,45,24,5,39,33,52,48,25,5,23,44,31,4,16,33,25,26,96,11,4,26,37,46,24,26,16,2,19,22,51,50,24,37,7,45,26,64,33,14,24,31,21,12,27,24,7,40,13,32,76,27,58,16,13,0,0,63,40,36,16,24,69,27,6,29,45,12,10,23,14,12,8,46,24,26,10,50,17,11,13,36,20,6,15,0,23,23,41,34,32,20,41,12,22,73,32,13,3,31,0,49,20,35,32,75,22,9,34,8,41,16,28,25,11,25,36,19,36,21,50,17,24,12,29,32,14,21,17,10,19,26,15,11,52,30,6,22,22,17,30,15,8,43,6,16,18,3,17,24,29,5,44,22,27,12,5,38,15,6,6,54,11,20,9,28,18,30,32,27,30,8,8,0,23,32,9,9,12,22,42,14,24,72,0,46,18,16,6,47,51,186,4,24,7,2,30,31,24,8,7,100,23,18,5,56,17,15,16,40,20,21,61,14,15,14,12,9,17,33,25,11,19,41,6,15,6,36,15,19,25,16,14,56,56,24,24,32,20,23,34,17,4,32,11,17,0,33,3,11,3,23,6,28,8,17,60,33,4,10,21,38,16,24,31,24,3,3,44,23,18,0,24,17,20,13,10,36,28,16,29,1,5,11,12,17,14,41,8,15,16,13,27,37,59,18,5,0,32,38,26,30,5,6,12,1,4,10,2,49,23,4,16,38,15,30,4,0,27,26,29,16,19,9,1,11,8,16,18,46,40,38,30,34,4,11,32,19,18,24,20,14,19,8,32,16,20,0,15,68,6,44,39,14,23,28,47,13,17,24,17,0,20,1,13,12,22,5,30,19,16,7,3,19,10,13,5,1,51,6,18,10,22,1,4,32,28,9,25,13,18,41,9,18,16,9,20,7,6,13,11,15,18,42,3,16,10,20,13,7,0,13,19,2,6,22,10,3,5,15,7,0,13,4,10,21,4,21,14,6,1,43,19,1,11,4,31,0,19,18,17,43,8,20,20,17,0,13,13,0,11,0,16,11,48,33,0,0,3,26,2,6,4,5,32,12,22,2,7,27,14,11,16,14,23,4,17,8,14,10,8,25,6,6,27,20,28,2,15,27,24,8,0,19,21,9,13,4,30,23,26,16,5,6,9,0,17,14,1,12,5,17,0,12,26,15,15,2,0,0,0,4,13,19,75,3,5,0,5,13,12,13,14,14,49,12,3,30,10,4,7,0,26,8,3,16,9,11,30,21,16,9,25,12,16,18,26,3,18,25,10,25,7,14,0,1,9,2,23,9,36,31,265,27,14,2,44,30,11,30,12,3,20,0,10,19,45,14,12,16,21,17,3,20,7,7,20,9,14,5,13,0,7,15,14,4,1,17,7,15,2,21,4,17,0,5,3,36,1,1,0,8,23,9,8,36,5,0,9,0,11,8,8,3,19,16,0,3,12,0,23,11,0,20,2,18,11,24,14,9,24,0,12,6,39,5,1,11,11,11,0,15,20,8,8,0,0,25,18,7,11,31,11,5,28,28,9,11,8,21,11,11,0,14,4,0,2,5,3,12,8,7,8,0,1,6,0,11,13,10,6,9,18,15,4,50,16,10,0,8,20,0,12,17,0,7,14,0,14,10,3,13,82,10,0,13,10,37,0,6,13,18,17,4,28,12,29,20,9,16,0,17,15,23,6,17,7,12,5,16,12,21,14,9,14,68,3,9,18,4,18,0,4,13,4,6,22,25,1,11,19,12,6,0,15,3,6,16,10,13,0,20,10,10,2,12,2,3,5,9,10,10,5,0,5,32,1,48,15,75,7,4,7,17,8,4,21,12,7,1,6,2,11,0,8,4,9,4,19,11,6,5,32,3,11,0,0,15,0,56,0,0,6,37,7,5,1,7,10,13,11,20,23,28,3,0,11,0,15,0,0,0,2,8,0,7,6,0,8,4,14,21,1,3,0,13,18,5,8,15,24,5,1,8,3,11,17,2,5,15,14,3,1,0,1,27,9,8,17,13,8,6,0,19,5,13,14,9,13,10,6,10,0,19,15,0,11,5,11,5,5,31,13,0,9,14,8,0,15,16,25,1,8,9,0,0,6,13,9,4,8,9,5,5,2,10,11,8,10,7,17,18,14,16,11,2,0,2,3,3,19,1,5,0,0,11,0,4,10,10,17,7,4,0,36,3,0,0,0,4,4,8,14,18,11,12,4,8,8,23,1,9,40,25,10,0,17,17,8,8,11,1,7,14,6,11,12,0,5,4,26,3,21,9,2,0,4,3,22,11,11,16,12,6,20,3,4,4,8,8,17,39,15,0,18,7,22,4,18,10,1,16,10,8,4,14,7,5,2,7,0,5,10,3,10,20,12,0,12,16,1,1,0,7,5,14,10,11,16,9,11,4,9,0,24,4,1,12,0,15,10,13,12,0,7,11,2,24,1,2,7,2,1,11,11,6,4,5,0,16,13,2,15,8,5,0,13,8,5,1,0,8,25,6,8,23,1,19,3,5,8,26,12,1,4,5,10,0,12,3,9,9,58,17,5,12,0,4,0,7,25,7,10,5,4,0,10,11,11,7,3,0,6,5,0,2,37,0,14,4,13,1,9,2,0,8,11,4,6,1,5,14,9,5,6,10,11,8,0,6,4,3,2,6,0,0,10,0,14,5,16,8,16,0,11,21,31,7,26,10,8,2,35,7,0,3,1,7,8,4,8,4,7,7,2,5,0,6,7,13,18,13,6,4,6,17,2,16,5,2,6,4,0,3,8,10,2,7,7,4,0,32,5,7,2,8,4,3,7,8,13,15,0,11,2,2,1,10,19,16,3,4,7,6,8,0,39,5,4,5,16,24,19,12,1,11,4,1,14,9,6,17,0,0,10,5,0,13,0,2,1,39,11,10,1,12,8,7,1,9,2,12,0,9,2,18,20,8,7,1,7,12,10,11,3,5,35,7,14,2,9,9,6,0,4,0,7,6,6,21,2,10,2,21,10,8,3,15,7,9,0,9,12,47,2,9,8,3,3,13,2,7,0,4,7,6,5,1,3,3,0,25,4,4,0,2,7,3,1,2,0,8,0,0,12,0,4,14,7,4,12,0,0,6,13,18,9,1,6,0,23,3,1,8,11,0,2,3,0,2,4,0,0,13,2,13,5,2,6,2,2,8,9,17,6,1,7,11,2,17,7,7,8,6,9,1,4,2,4,11,2,9,0,0,2,2,11,9,4,9,4,11,8,13,2,5,1,13,5,0,4,5,3,5,0,4,9,0,5,4,7,0,6,6,0,8,3,11,0,26,1,12,2,22,4,4,21,3,5,1,9,1,7,2,13,0,5,26,17,0,22,1,1,8,0,10,7,0,3,7,9,9,6,0,2,5,2,16,14,6,4,10,8,5,3,9,16,13,7,5,21,3,1,8,0,9,2,2,10,22,0,0,4,6,0,0,14,23,4,4,12,2,10,23,4,5,0,1,1,12,8,8,10,14,1,20,1,1,27,6,2,0,18,14,9,1,0,2,5,12,2,3,6,12,2,4,7,2,0,1,15,0,4,5,0,0,2,1,5,17,7,10,21,2,0,4,9,19,10,2,1,10,8,0,11,5,1,0,0,2,4,8,0,67,9,0,4,6,20,3,0,23,5,1,13,15,6,0,3,3,5,3,1,0,3,0,0,19,4,3,12,0,5,0,1,3,15,1,0,0,1,14,7,0,10,2,2,7,10,3,0,2,0,3,5,6,0,0,3,12,1,5,6,2,5,0,1,2,1,8,3,4,8,0,1,5,7,5,1,1,4,1,5,10,8,9,1,0,3,0,13,2,4,2,4,12,3,10,10,2,1,4,2,13,1,10,7,16,2,1,0,1,1,5,6,5,4,5,9,2,0,0,2,2,1,2,4,1,13,3,7,18,7,5,1,2,3,5,0,3,8,9,5,9,2,3,2,8,24,9,16,2,3,7,4,11,2,2,1,2,3,6,7,3,5,4,2,5,6,3,0,16,0,3,9,1,5,13,15,2,2,10,4,9,10,3,5,12,7,11,12,4,11,5,3,0,7,2,0,4,12,7,3,11,1,2,1,2,4,0,5,5,3,11,1,18,9,9,23,1,4,1,16,1,13,0,4,5,2,6,0,2,0,6,2,0,4,2,1,4,6,4,2,7,3,3,6,1,3,7,5,10,3,0,0,7,4,5,6,0,3,9,5,2,7,0,1,9,0,1,4,2,3,3,0,0,1,10,3,4,1,10,11,2,6,2,11,3,3,4,0,5,10,6,5,0,6,5,6,0,6,6,4,6,0,8,6,0,8,0,1,25,3,3,2,3,0,0,3,0,0,15,6,8,2,6,4,0,3,9,1,4,7,5,0,17,17,0,2,7,4,0,6,3,6,1,8,5,3,9,0,1,0,8,0,8,0,0,1,2,19,8,0,0,0,3,2,10,0,14,1,33,4,3,2,0,8,1,3,4,1,2,6,16,6,9,7,1,5,10,7,0,4,1,9,11,12,2,1,6,0,0,0,1,4,8,6,11,0,8,16,56,4,4,4,8,0,2,2,1,9,0,0,8,2,0,9,3,0,7,1,4,3,4,26,4,1,3,5,2,0,3,0,18,0,1,0,3,4,4,16,7,6,3,74,23,11,4,4,1,10,0,11,1,9,5,4,0,4,9,1,3,2,1,1,7,2,4,4,2,0,11,0,37,0,1,0,1,4,3,2,5,1,1,3,0,10,2,5,0,1,5,3,9,18,6,3,1,2,3,2,9,7,3,7,11,12,3,2,7,6,0,3,0,5,0,7,1,4,1,8,0,0,5,0,7,0,6,1,3,0,0,2,1,4,0,2,5,4,5,9,0,8,17,36,3,3,3,8,1,1,3,4,2,4,7,0,3,4,5,9,6,3,0,3,6,5,22,0,4,0,0,9,3,2,0,1,5,0,4,9,4,4,3,6,0,1,4,2,3,0,0,0,3,3,1,0,1,24,3,1,8,0,8,0,1,3,1,5,8,5,0,0,19,6,0,11,2,5,4,1,1,7,3,1,2,0,3,2,2,4,1,18,0,3,1,5,6,2,6,7,1,4,3,0,0,10,2,0,6,1,2,3,4,4,3,4,0,16,4,5,3,1,1,5,5,0,1,1,6,12,1,1,0,3,0,5,9,2,0,1,5,12,3,3,5,11,1,10,2,0,0,0,2,6,7,4,3,7,0,5,3,3,1,0,2,0,11,1,12,10,0,1,3,0,1,0,0,5,0,0,7,3,3,7,10,4,0,8,0,16,1,0,0,1,3,2,7,0,8,6,2,2,0,0,11,0,0,1,2,6,1,3,1,3,9,2,7,2,3,0,4,6,6,0,4,2,0,0,4,0,3,5,10,2,7,17,4,6,7,0,5,6,1,1,6,3,0,0,0,1,3,2,5,2,0,0,13,1,0,2,0,7,0,11,2,0,7,3,0,0,4,4,1,7,5,3,2,0,3,0,1,15,0,5,2,1,2,2,8,0,0,0,4,0,12,4,0,0,0,2,0,0,3,0,2,2,0,7,16,4,10,4,0,0,7,0,1,3,1,1,1,7,2,2,10,0,3,6,11,0,7,0,1,11,4,10,0,16,4,7,4,1,6,2,8,1,4,8,19,3,1,4,0,0,10,2,5,12,7,2,3,0,2,0,9,5,6,4,3,5,0,5,2,0,3,5,1,7,12,0,6,3,1,2,1,1,0,2,0,0,0,10,6,7,1,1,5,1,1,4,0,8,1,16,2,3,5,5,5,0,4,0,4,0,1,2,0,6,6,3,3,0,4,2,0,11,2,3,2,1,10,0,2,1,2,4,10,0,5,3,8,12,1,1,1,1,2,0,2,1,3,8,1,7,28,0,4,4,0,0,5,9,1,8,2,3,0,2,1,2,2,0,0,6,8,5,1,1,5,0,0,3,3,2,1,0,0,19,1,10,3,2,1,16,0,1,4,3,0,6,0,5,4,3,26,1,17,2,15,3,4,5,1,6,3,4,0,0,0,4,10,4,2,1,3,4,0,3,3,0,0,1,2,8,4,8,3,2,0,3,1,1,11,8,3,1,3,6,4,0,5,0,0,0,2,2,3,0,0,1,2,9,7,3,1,0,0,1,0,1,3,10,16,6,6,0,0,4,2,12,7,0,1,1,5,2,2,13,1,0,0,2,1,1,70,0,0,1,2,3,9,4,2,4,2,3,1,1,9,0,5,1,2,2,4,0,11,5,0,3,5,8,2,1,2,0,0,2,2,3,4,7,5,0,6,5,0,4,2,2,4,4,0,7,0,1,0,9,5,0,3,1,5,3,1,7,3,4,2,3,1,7,5,3,4,2,1,2,1,1,3,4,2,1,0,0,3,1,0,2,0,6,0,1,3,1,3,2,0,5,5,1,2,7,1,2,3,1,12,1,5,3,1,2,1,0,2,0,0,1,0,6,0,2,0,3,3,0,3,4,0,6,0,5,155,1,5,1,0,2,3,0,0,5,1,3,3,6,2,1,2,0,1,0,0,2,0,2,0,0,0,2,2,1,2,5,0,3,0,1,0,2,0,8,1,5,4,3,3,0,2,7,4,2,28,2,0,0,11,2,1,0,14,1,0,4,0,7,5,2,5,7,1,4,1,1,2,0,0,3,0,0,2,0,2,3,0,0,0,1,4,1,2,2,3,5,0,1,1,1,1,3,2,1,3,1,1,1,2,5,2,1,1,0,5,1,1,0,0,1,2,5,5,1,1,4,0,9,1,1,0,7,1,1,0,1,3,4,12,10,2,8,2,1,7,2,1,3,1,2,5,1,3,16,1,10,1,4,3,4,1,2,1,0,3,12,0,10,0,6,2,1,2,5,3,2,6,4,4,0,4,0,0,0,9,0,0,3,5,1,0,0,0,10,8,0,0,0,0,4,2,6,0,959,0,5,0,2,4,0,4,0,3,2,3,13,1,2,4,0,13,1,3,0,3,4,2,0,1,3,0,0,0,0,1,0,6,4,2,9,4,3,5,5,0,3,0,2,2,7,15,0,0,2,2,4,1,2,5,1,3,12,1,1,0,69,4,19,7,1,2,0,0,0,2,6,0,3,1,7,2,1,1,6,13,3,3,0,0,1,1,0,0,5,6,2,1,1,4,13,2,1,1,2,0,4,1,11,2,1,0,6,6,3,2,4,0,1,1,6,0,3,1,8,2,1,3,3,2,0,6,0,1,0,3,1,3,0,0,5,3,6,1,3,8,5,0,0,5,2,4,0,0,0,2,0,0,2,0,1,2,0,5,3,1,0,1,0,0,9,0,3,0,3,0,0,2,3,1,1,3,3,0,5,4,7,0,0,1,4,4,0,1,1,2,0,0,0,1,0,1,1,1,0,0,2,2,2,3,3,0,4,3,0,1,0,5,2,1,4,8,1,1,9,12,2,0,2,1,2,1,2,7,0,1,7,8,0,0,0,2,8,2,0,1,1,0,0,0,6,4,0,1,0,2,2,3,0,0,0,1,3,1,0,1,6,3,2,2,4,0,2,2,11,5,0,2,0,4,3,0,5,15,0,8,5,0,0,0,0,4,2,1,12,0,0,2,0,1,1,6,3,1,4,1,0,3,0,0,1,1,0,5,0,1,0,0,0,0,0,0,5,8,3,0,4,0,3,5,3,0,4,4,6,5,1,0,3,0,3,1,1,1,1,1,0,1,0,0,1,0,0,0,0,4,4,5,0,0,4,3,0,7,0,1,0,5,2,6,1,0,1,0,6,5,13,5,3,3,4,7,2,0,3,1,2,0,0,2,7,0,2,0,4,5,6,5,1,0,1,3,6,3,0,5,1,0,0,0,3,1,5,2,0,0,3,2,2,3,3,0,1,2,1,1,1,5,3,0,1,6,11,1,10,3,0,2,0,5,8,0,6,2,0,0,1,4,1,8,2,3,1,5,0,1,3,4,3,5,1,0,1,1,2,1,2,1,1,0,0,1,1,4,2,5,15,0,1,0,2,32,10,5,1,0,3,1,0,2,0,1,5,32,15,1,3,2,2,12,1,1,3,7,4,0,4,0,0,0,1,1,0,14,0,1,0,1,3,3,12,8,0,0,3,7,2,0,5,1,2,9,1,0,1,0,0,0,2,1,0,5,4,0,1,1,9,0,1,2,2,1,1,3,1,0,0,0,2,0,0,1,3,0,3,0,1,1,1,1,2,1,3,9,3,0,1,5,1,0,5,2,0,1,0,0,3,1,4,3,1,4,4,0,1,0,0,0,3,3,0,3,3,2,1,1,27,0,1,0,1,0,0,4,7,6,5,5,0,3,2,0,0,3,1,1,0,3,1,6,0,1,1,1,1,2,0,4,5,0,0,2,5,1,3,0,20,3,4,16,1,3,0,0,0,5,2,4,2,9,3,2,0,1,2,0,0,4,0,1,6,5,0,0,0,2,9,0,0,0,4,3,0,2,4,2,0,0,4,0,2,1,0,0,0,2,4,5,6,3,2,3,4,0,2,3,5,4,2,0,11,0,7,0,0,0,1,0,1,5,0,10,1,4,2,3,8,4,2,0,3,3,1,0,5,5,4,0,2,2,2,0,1,0,2,1,3,7,3,0,0,0,0,0,1,1,8,1,2,0,7,1,6,0,3,5,1,13,10,4,1,0,1,0,2,3,5,1,2,0,0,6,6,3,0,1,0,0,2,0,0,1,0,0,4,0,0,0,0,0,4,0,4,1,0,6,9,0,1,0,4,1,0,8,3,3,2,1,1,6,1,3,2,0,3,12,4,2,1,4,2,1,7,2,0,8,10,1,0,4,2,40,0,5,0,3,2,0,3,0,2,1,4,1,2,0,2,2,8,9,0,4,2,12,0,0,4,6,1,1,8,1,1,2,1,0,2,10,2,6,0,2,1,1,9,4,0,0,4,0,1,0,0,2,0,1,2,3,1,0,4,0,2,3,1,0,1,0,2,7,2,1,3,0,1,2,0,0,1,0,2,0,5,0,1,0,0,2,2,0,0,0,7,2,1,1,3,4,1,3,1,2,1,0,0,1,0,0,4,5,5,1,0,0,0,2,0,3,0,4,2,1,3,7,0,2,0,13,0,0,0,1,2,0,2,1,0,0,4,4,1,0,0,1,4,1,0,2,1,1,1,2,2,2,0,1,0,7,3,4,1,0,1,0,1,2,1,0,0,0,0,3,10,0,1,5,1,0,1,2,0,2,18,4,1,0,1,0,0,3,2,1,1,2,9,4,1,1,0,0,0,0,4,2,0,0,1,5,2,1,0,2,4,0,0,1,0,0,1,1,0,0,0,4,2,0,1,3,9,0,0,4,0,0,3,0,6,0,0,1,5,1,3,1,4,0,5,0,1,0,3,2,2,0,0,2,1,0,0,1,1,2,0,0,3,0,5,2,0,0,7,0,0,0,4,1,1,0,0,3,1,0,0,1,0,1,0,2,0,1,2,0,0,2,2,0,3,1,0,15,3,1,0,8,0,1,0,2,1,0,1,3,3,9,2,0,0,0,5,0,1,1,0,0,5,3,0,3,0,1,0,8,0,0,1,3,0,1,3,0,1,1,1,3,1,3,0,0,3,2,1,1,0,0,0,1,1,0,0,0,0,0,1,1,1,3,0,0,0,2,0,0,1,0,0,3,0,1,1,0,0,2,0,0,4,0,0,0,0,2,6,0,0,0,0,1,9,1,0,0,0,0,1,2,1,7,2,4,2,4,2,0,5,2,1,0,0,0,0,0,1,24,1,9,0,4,4,2,0,0,1,0,6,0,3,0,13,0,0,1,2,8,1,1,0,1,0,0,1,1,0,1,2,0,1,0,0,0,1,0,0,0,1,1,0,1,0,0,0,0,4,0,0,0,5,0,0,2,0,0,0,0,0,2,1,2,0,0,0,0,0,1,1,0,3,0,0,0,0,0,0,0,0,1,0,0,0,0,0,0,0,0,0,0,0,0,0,0,1,1,0,0,0,0,1,0,0,0,0,0,0,0,0,0,0,0,0,0,0,0
K35 The Green Mile,king,6150,3660,3226,2900,2746,3441,2222,1964,2300,2174,1296,1799,1750,363,383,1130,1132,900,820,1011,933,1070,991,881,921,507,794,379,675,347,402,604,604,513,380,539,413,606,592,510,553,572,532,369,395,435,350,405,403,546,497,354,388,288,247,262,384,292,347,443,440,263,286,233,193,350,179,306,151,268,258,148,248,235,265,168,153,345,151,163,232,177,255,343,284,316,159,174,230,188,144,237,189,160,284,180,206,149,187,184,210,361,213,150,199,148,221,208,147,142,156,263,247,178,162,139,132,137,134,88,181,87,218,271,133,132,121,128,123,124,154,202,149,130,180,186,155,163,101,112,48,114,126,79,128,157,112,144,105,119,128,80,134,90,94,123,60,125,82,84,38,102,166,149,80,126,95,66,91,136,150,71,143,79,12,48,83,65,139,117,61,92,95,73,96,56,75,74,120,61,75,48,110,97,68,162,18,46,31,58,67,90,68,98,77,191,66,71,79,131,23,83,72,31,70,40,93,66,93,78,53,121,59,57,34,44,54,59,44,76,78,38,76,152,73,17,62,61,41,42,48,64,39,21,75,69,28,106,53,63,85,38,52,55,57,57,45,72,73,45,93,69,56,74,45,29,45,33,48,66,54,65,104,59,95,43,69,82,67,90,56,20,62,70,119,2,56,33,45,26,44,10,7,30,39,50,51,68,12,72,74,36,31,47,90,53,1,25,28,27,45,65,22,60,50,49,31,36,27,33,29,82,54,65,6,21,65,37,34,38,75,63,51,42,22,46,26,15,22,78,37,30,27,63,42,32,39,15,19,40,90,16,74,29,68,11,27,71,28,21,29,83,33,8,17,20,33,26,20,57,26,23,22,37,37,95,42,70,71,54,46,53,19,42,20,1,0,40,42,30,39,40,38,23,45,81,74,32,37,50,14,43,30,14,38,24,27,59,27,40,52,19,81,8,29,31,3,39,27,22,62,4,8,31,20,22,29,24,16,25,73,36,64,30,5,35,11,25,5,53,41,28,31,53,25,5,21,42,22,57,58,28,10,56,30,32,24,16,34,34,46,9,0,4,16,56,31,19,8,31,4,19,35,45,56,30,11,10,0,50,24,39,58,29,21,39,58,4,64,22,31,17,107,23,34,11,38,22,3,43,31,34,65,15,26,18,13,29,17,16,7,35,26,40,31,22,2,24,30,35,22,21,35,14,20,13,39,18,32,39,367,28,13,20,19,4,56,42,3,30,36,20,49,28,26,12,0,2,16,22,27,17,23,23,27,12,16,22,18,3,16,18,21,15,22,33,9,6,14,3,20,18,21,30,12,15,27,6,25,23,27,42,22,29,18,47,15,59,14,16,27,15,12,9,24,27,15,50,7,18,43,15,43,7,6,0,288,30,10,11,40,16,42,22,16,19,25,5,8,14,8,2,15,21,31,21,44,36,17,3,13,22,13,32,10,0,22,28,9,10,17,14,33,3,15,20,23,13,18,42,0,21,20,43,17,48,11,6,9,5,31,10,19,35,17,17,26,15,36,9,40,13,12,10,7,22,18,9,19,3,16,9,12,12,25,15,1,10,12,8,30,14,9,18,8,14,11,0,17,15,20,7,18,26,28,20,6,8,9,8,1,34,14,11,13,34,24,24,28,13,19,29,19,0,26,32,47,2,13,22,22,16,29,8,0,21,18,11,8,24,23,6,1,17,1,2,1,24,13,4,3,6,10,18,2,14,14,6,19,1,16,9,20,22,6,24,14,6,34,9,29,5,29,21,0,15,20,25,60,8,29,3,4,25,28,19,22,13,15,9,9,5,105,21,11,5,0,9,25,11,17,5,3,17,19,3,35,19,8,5,18,14,32,1,14,20,1,3,28,17,13,19,18,14,15,12,5,19,13,10,16,23,24,7,5,14,34,7,0,12,11,12,33,14,23,19,12,0,18,2,19,42,2,7,2,1,49,5,26,30,10,8,21,15,15,9,19,0,10,25,9,14,28,9,0,6,2,26,20,12,33,13,16,24,5,17,14,19,9,21,13,3,5,12,12,16,4,3,9,15,21,2,15,5,43,18,28,10,19,5,21,0,19,0,17,15,1,16,19,19,8,8,7,7,5,10,5,2,34,6,9,8,14,0,2,16,20,17,7,11,19,7,4,8,4,7,2,4,13,0,9,17,9,4,16,15,23,11,14,2,0,20,17,4,3,32,10,6,9,18,4,0,19,5,3,21,6,25,12,0,1,51,14,3,6,11,18,0,14,2,10,5,10,17,5,21,0,6,28,0,7,0,6,1,4,24,0,0,11,22,8,6,12,1,0,11,28,0,1,14,0,6,7,1,7,3,4,29,15,5,4,15,7,10,18,14,9,1,9,41,10,5,150,7,8,4,39,4,2,3,6,7,4,1,7,0,7,14,1,4,6,7,0,1,17,2,3,3,0,0,0,1,8,9,2,5,1,0,8,21,14,24,21,13,6,2,0,13,9,9,0,0,24,18,18,12,17,7,6,9,98,9,3,7,7,11,19,5,7,16,6,9,5,10,0,1,1,0,10,15,10,33,67,17,11,10,5,15,1,0,8,0,5,14,6,12,9,11,9,5,21,8,11,3,8,8,20,4,16,3,2,0,42,8,15,2,33,37,3,18,0,8,2,32,0,12,5,16,2,0,18,2,10,5,5,32,0,0,5,0,9,7,2,5,2,0,0,8,15,0,18,23,0,13,6,9,1,2,6,11,7,0,13,11,0,3,0,2,3,15,0,3,14,2,3,0,0,11,5,10,3,1,11,1,21,2,9,22,5,7,10,25,1,15,5,0,2,7,3,16,7,5,3,1,3,5,0,0,14,0,29,10,20,13,56,11,7,10,5,1,7,0,2,11,0,4,19,1,8,5,0,3,2,1,1,11,14,9,0,4,9,9,15,12,8,10,16,14,8,7,0,7,1,10,15,7,3,7,0,5,5,17,7,8,10,8,4,11,10,4,5,1,3,10,1,6,19,18,7,6,5,7,3,2,6,5,5,8,1,5,1,8,5,9,2,5,2,5,1,6,7,18,5,0,6,19,4,6,3,8,14,2,10,11,11,0,9,11,6,6,3,2,8,0,12,2,12,2,8,13,10,6,8,28,9,0,0,6,0,1,1,0,4,20,4,14,9,5,33,5,14,18,6,2,8,0,1,0,11,0,0,0,0,8,0,22,1,0,8,0,6,11,8,8,0,9,2,5,7,18,12,9,5,6,8,2,0,68,9,8,2,6,0,0,1,10,8,0,14,5,9,2,1,18,0,9,1,25,10,6,6,21,0,6,17,0,3,1,9,1,10,13,1,0,7,12,24,0,3,9,9,4,3,4,0,4,8,6,7,9,10,2,8,16,0,6,3,27,2,7,4,14,7,5,4,8,0,0,3,3,5,1,0,0,0,1,0,1,2,4,12,2,0,0,4,115,1,0,5,3,2,5,10,2,4,6,1,5,2,16,0,5,5,4,7,0,8,8,1,3,4,5,7,4,2,6,9,0,11,5,13,6,8,1,4,4,2,1,7,3,6,1,8,1,12,1,7,12,5,10,9,8,11,0,1,9,16,11,11,18,3,8,6,7,6,4,4,4,7,5,0,5,11,5,9,7,11,0,7,3,1,0,0,14,8,10,4,5,4,1,13,8,1,0,10,2,0,12,0,2,0,12,5,0,1,8,1,4,3,2,10,3,0,0,2,0,4,6,0,11,16,1,13,4,0,0,0,2,12,0,3,4,13,2,6,7,1,12,4,5,8,11,5,3,2,4,4,0,17,6,0,6,7,15,3,10,0,3,0,8,2,1,5,1,3,0,1,5,7,5,7,0,20,1,0,6,5,0,10,3,17,7,9,1,43,9,8,1,8,0,2,4,1,2,5,5,1,4,0,2,34,3,0,4,17,0,10,14,12,6,1,36,13,0,1,6,2,1,22,2,3,9,13,11,0,3,2,5,5,1,6,2,6,2,0,15,0,7,1,15,3,8,5,7,1,3,0,8,6,0,0,1,0,3,5,0,0,0,9,2,2,3,3,1,5,6,1,2,5,12,2,2,0,2,3,0,2,10,11,15,3,2,17,2,2,1,4,1,4,0,13,11,14,6,0,18,4,0,7,16,11,12,0,0,5,4,0,1,0,1,0,23,4,12,0,9,5,4,0,9,3,20,3,7,0,9,13,3,1,1,3,6,7,16,4,8,24,4,2,1,8,1,2,0,6,2,0,4,0,6,2,5,0,13,3,8,8,0,12,0,0,3,7,1,24,10,1,0,9,4,5,4,0,5,0,0,1,0,2,1,0,40,0,0,0,0,5,3,7,2,0,5,5,0,17,3,1,4,5,6,11,0,0,3,5,4,7,0,18,2,0,1,0,3,12,0,1,6,0,14,2,1,0,8,1,4,0,5,3,4,0,9,0,4,0,3,1,5,0,9,3,2,4,2,12,0,3,79,5,6,3,2,0,0,1,6,12,16,6,4,2,8,6,4,2,2,6,2,1,0,0,1,1,5,0,2,1,1,3,1,3,0,4,3,2,2,2,4,2,0,6,1,1,14,1,8,10,3,0,4,4,13,8,1,5,0,3,6,2,0,2,0,1,4,6,5,3,1,0,0,15,8,29,1,2,7,2,0,3,3,4,5,5,1,1,12,13,5,2,3,6,2,1,1,4,0,3,5,5,2,0,1,0,3,0,4,1,2,3,1,10,0,1,8,3,4,1,0,0,0,1,6,12,17,0,7,0,2,8,4,0,1,10,3,7,8,0,0,2,4,5,3,2,2,2,3,1,6,0,0,3,0,4,3,0,0,0,4,1,3,3,5,29,2,0,9,4,11,0,6,2,3,1,1,11,9,2,2,0,3,5,9,0,0,0,0,8,0,6,2,0,3,0,1,2,10,6,8,2,3,2,0,1,4,1,0,0,4,0,3,4,0,0,0,3,1,0,1,4,0,1,9,6,0,1,10,0,1,3,4,1,0,3,2,2,33,0,0,7,15,0,1,3,4,3,0,0,5,2,5,3,3,3,0,3,6,2,0,49,1,9,1,9,11,6,4,1,0,2,0,13,12,8,2,13,5,10,1,3,3,3,2,32,2,3,5,3,2,2,0,0,4,6,9,4,5,8,24,5,0,3,1,0,9,0,0,3,7,5,4,2,5,1,3,2,1,2,2,2,1,3,8,0,3,1,1,4,6,17,4,13,2,3,4,3,7,0,1,2,0,5,4,4,2,9,1,0,2,4,0,1,1,0,4,4,2,5,4,4,2,0,4,0,5,0,1,0,2,8,5,2,4,6,2,0,1,0,3,2,0,12,7,4,9,1,3,1,11,2,17,1,1,3,0,5,2,11,1,2,4,2,3,0,1,1,0,11,4,1,10,0,1,0,0,0,0,0,0,1,3,1,1,3,2,1,1,1,0,3,1,0,7,2,0,2,7,1,5,3,3,6,1,1,0,0,3,0,0,0,0,1,5,2,3,1,0,2,2,0,0,2,2,7,5,4,3,9,6,5,2,0,10,11,1,1,0,6,4,5,0,1,4,11,4,1,3,1,10,1,3,4,8,4,3,1,2,1,0,0,0,0,10,1,7,2,5,0,3,0,5,2,3,3,5,0,3,6,0,3,0,4,0,3,2,6,5,9,1,4,0,0,0,2,4,1,5,0,0,2,0,2,3,0,0,0,2,1,3,8,1,3,1,2,0,1,0,1,0,1,5,1,1,4,10,4,1,1,3,5,0,3,0,0,0,1,8,3,1,2,0,1,2,0,0,3,0,5,4,1,4,0,2,0,4,2,3,5,1,4,1,0,0,0,1,0,0,0,2,2,5,2,3,2,4,2,0,3,0,0,5,0,0,0,6,2,8,0,2,1,2,6,6,4,2,18,4,0,0,2,1,1,2,12,0,7,4,0,0,4,1,1,2,0,3,0,7,1,3,0,2,1,6,0,0,0,3,0,0,4,0,1,1,2,5,2,10,3,4,0,0,0,9,1,5,1,0,1,3,3,1,1,2,0,2,3,6,6,3,6,2,1,0,0,14,3,0,5,8,3,0,3,0,2,0,1,2,0,6,1,0,2,0,1,0,5,0,0,5,1,1,0,3,2,4,0,1,0,0,0,1,0,0,2,2,3,1,0,2,1,10,7,2,21,7,0,1,5,0,0,6,1,0,10,3,2,0,0,11,1,1,2,3,1,1,3,0,12,2,3,0,0,0,1,1,10,0,3,0,2,6,0,2,0,4,0,10,3,4,4,4,6,1,0,19,2,0,5,3,5,2,0,0,3,2,5,0,1,9,0,0,0,1,15,0,4,0,1,10,1,1,2,1,1,2,0,0,1,0,0,2,0,2,3,2,9,3,0,0,2,1,5,4,3,1,4,0,0,1,0,3,3,0,2,0,5,1,3,3,0,0,1,3,7,4,1,17,2,2,1,0,1,15,2,0,2,9,1,10,2,2,0,3,1,2,0,0,0,3,0,1,1,2,0,2,1,2,1,0,0,3,0,9,8,1,0,2,1,1,12,0,2,0,1,0,0,2,2,4,6,9,4,0,1,1,0,6,0,0,3,0,3,1,3,0,0,2,3,14,1,2,0,0,5,1,0,0,0,3,5,1,0,0,2,7,0,7,4,10,2,5,0,1,3,1,0,1,0,0,0,0,1,2,0,0,0,0,0,7,2,0,9,0,1,0,5,3,1,4,2,1,0,3,6,0,4,14,6,2,0,0,0,0,3,0,1,1,3,2,0,6,1,0,2,2,3,8,7,0,0,2,0,0,0,1,2,0,3,0,1,2,0,2,1,1,0,2,1,2,0,1,3,4,0,7,0,0,6,5,3,3,0,1,0,1,4,6,3,1,3,1,0,3,7,3,5,7,9,0,2,3,2,13,10,2,1,1,5,1,7,2,1,0,0,0,2,1,1,3,1,5,0,0,0,2,0,0,6,0,3,8,0,0,0,0,1,0,0,1,1,0,1,0,4,7,2,4,0,2,4,2,3,0,0,2,0,4,0,1,4,4,2,2,0,1,0,1,0,3,4,7,1,1,2,7,0,0,10,0,0,2,0,2,0,1,2,20,2,1,0,0,2,3,6,20,0,0,3,2,4,1,0,2,7,1,1,0,0,3,1,1,0,7,0,2,1,1,11,2,1,0,1,7,0,0,3,8,0,0,1,4,2,2,2,4,0,6,7,0,3,1,3,6,3,0,3,0,1,6,1,3,0,0,1,3,0,11,0,13,0,3,6,2,1,8,5,2,7,0,3,0,0,6,1,0,1,4,1,0,1,0,1,0,0,6,8,0,8,0,2,0,3,0,8,13,1,1,0,2,5,8,0,3,0,0,0,1,0,1,1,3,3,4,6,5,14,0,1,0,1,3,1,2,4,2,4,5,0,0,3,1,1,2,19,1,1,5,1,0,0,2,0,0,4,3,1,3,0,0,0,2,2,3,5,5,3,2,2,10,5,7,0,1,0,1,1,0,1,0,7,0,0,10,0,1,3,2,0,4,5,2,3,0,2,0,1,1,2,0,1,1,3,0,2,2,0,0,68,0,2,2,5,3,0,7,3,0,1,2,1,0,0,0,0,4,0,2,5,1,30,0,1,1,9,2,10,0,0,0,0,2,1,0,0,0,1,1,2,1,1,1,1,0,0,0,1,1,3,2,2,11,0,3,2,2,1,0,2,2,0,0,0,0,1,1,0,2,2,2,0,1,0,0,0,0,3,0,1,2,0,0,2,3,0,0,2,2,3,4,0,0,1,0,5,2,0,0,0,2,2,2,0,0,0,1,1,1,2,0,5,0,9,0,0,0,1,2,1,2,0,8,0,2,2,5,3,7,5,0,2,4,1,0,1,0,2,2,3,0,0,2,4,0,11,1,2,1,2,1,0,2,0,0,0,0,0,1,1,0,3,2,12,4,1,5,0,0,4,1,1,1,2,5,1,8,1,1,0,5,0,3,5,0,1,0,1,1,1,0,0,0,0,1,2,0,2,0,9,0,5,3,2,0,2,2,2,1,1,3,2,9,3,0,2,9,0,9,1,0,0,6,1,4,13,6,14,1,3,0,0,0,5,2,2,0,2,0,0,0,1,0,4,1,1,3,4,0,0,3,2,0,0,0,0,0,1,0,0,2,3,2,2,0,1,0,5,3,0,4,1,1,4,1,9,0,0,0,1,0,3,1,0,1,0,2,3,2,3,7,10,4,1,1,0,4,1,5,1,0,1,0,1,2,2,0,0,2,2,2,0,1,10,4,1,0,1,1,0,0,2,5,1,0,5,0,3,1,7,0,0,2,9,3,3,0,2,1,7,1,18,6,2,14,0,0,0,1,6,0,0,2,1,2,4,1,0,4,1,2,0,1,1,0,0,0,4,0,1,4,3,3,8,1,26,1,0,0,2,0,8,0,1,0,3,2,3,0,5,0,0,1,3,2,0,1,0,1,0,2,1,3,0,1,2,0,1,1,0,2,0,0,1,3,1,25,1,1,5,0,0,3,0,4,0,0,1,2,2,0,0,16,5,2,0,2,0,0,0,1,0,0,3,0,1,1,3,0,0,0,2,1,0,1,2,0,1,3,4,6,0,0,3,5,2,0,3,3,6,0,1,0,1,0,4,1,0,0,0,0,12,1,0,16,0,1,0,0,1,1,1,0,0,3,0,0,11,6,5,7,1,0,3,1,0,5,1,2,3,2,1,0,1,4,3,4,0,5,4,0,1,1,2,0,1,2,0,2,0,0,0,1,0,0,2,3,3,2,1,4,0,0,0,2,1,2,0,0,9,1,2,6,7,0,4,1,0,3,1,1,0,0,1,2,0,1,1,0,0,1,19,0,0,1,3,1,0,1,0,9,0,0,1,1,2,1,1,1,0,0,0,0,2,0,1,5,0,0,9,2,3,7,1,0,0,6,0,7,0,0,0,0,0,4,0,0,3,0,0,7,1,0,1,0,0,0,2,4,6,0,2,0,0,4,0,4,0,0,0,7,0,1,0,0,0,3,1,2,16,5,1,1,4,1,1,0,4,0,2,1,0,3,1,0,2,0,0,0,1,1,0,0,3,0,1,1,1,7,0,0,1,0,0,1,6,1,1,0,4,0,5,2,0,2,0,2,1,3,0,0,1,1,0,2,6,1,0,1,0,0,0,1,1,0,1,3,0,0,1,1,1,11,2,0,0,4,3,0,3,2,2,1,1,1,0,2,1,0,5,1,2,0,0,0,2,7,2,2,0,0,2,1,2,2,2,0,1,0,1,0,2,0,0,0,2,26,5,0,0,0,1,0,2,1,7,1,0,0,6,5,0,0,1,0,0,5,0,0,0,3,0,0,2,4,0,5,1,2,3,0,2,1,2,4,0,0,0,0,0,0,0,2,0,0,2,16,2,2,2,4,0,0,2,0,0,0,1,0,3,0,2,0,0,4,0,0,2,0,0,5,0,0,3,0,0,0,0,0,1,9,0,0,1,0,0,4,0,0,0,0,1,2,1,1,1,0,3,2,0,2,2,3,0,1,0,0,5,1,0,0,0,0,22,1,1,5,0,1,0,1,0,0,1,0,0,1,0,0,1,0,1,8,0,0,3,0,2,2,0,5,6,1,0,0,4,2,0,1,0,6,2,1,0,0,0,0,11,1,0,0,0,3,0,2,0,0,5,1,0,1,1,1,1,4,0,0,1,0,0,0,0,1,0,1,0,1,2,2,0,0,1,1,11,1,0,0,0,4,2,2,2,4,1,4,2,3,1,1,0,1,1,2,0,1,0,0,0,3,0,0,1,3,0,1,2,0,2,1,12,1,1,0,6,0,0,0,10,1,1,0,11,1,2,0,0,2,0,0,0,9,1,0,0,0,0,0,0,2,1,0,2,1,3,22,3,1,2,9,0,1,3,1,4,0,2,4,5,1,1,0,1,1,0,8,4,5,2,3,0,0,2,2,0,2,0,0,0,2,0,0,0,0,1,1,2,2,4,7,9,1,1,1,5,0,1,5,6,3,0,2,1,8,0,3,2,0,0,3,2,2,1,0,2,3,0,2,0,1,0,1,0,1,2,1,0,2,0,1,0,2,0,0,1,1,5,3,3,0,3,0,7,0,0,3,3,0,0,0,0,2,1,0,8,3,1,0,0,0,0,2,0,0,0,0,1,2,3,4,0,0,1,0,2,0,0,1,0,1,0,2,0,0,6,0,2,6,1,0,1,0,1,3,6,4,1,0,1,1,0,0,1,0,0,0,2,0,0,2,0,4,1,0,1,0,1,1,2,0,3,0,0,0,0,1,1,1,0,0,0,1,1,4,0,2,0,0,0,0,0,0,0,0,0,1,1,2,2,2,13,5,0,0,0,0,1,0,3,0,0,3,0,0,2,0,1,0,0,1,0,0,0,3,3,0,1,2,1,1,0,6,4,1,1,1,0,2,0,4,3,1,0,0,0,0,0,0,0,3,0,1,0,2,0,4,2,0,1,0,0,0,0,4,0,0,1,2,2,0,0,2,0,1,0,1,0,1,0,0,0,4,3,1,0,0,2,0,0,1,2,0,1,1,0,0,0,2,0,2,1,3,2,2,0,1,2,4,0,0,4,3,1,2,2,0,0,0,0,1,3,0,1,2,3,1,0,0,0,0,0,0,0,4,2,1,0,0,1,2,2,1,0,0,2,1,0,0,0,1,0,1,0,3,0,0,0,0,0,0,0,2,2,2,2,0,0,4,2,0,0,6,1,5,1,0,5,3,0,1,0,0,0,0,0,1,10,4,0,0,0,0,0,0,0,2,1,2,4,0,2,1,0,0,0,3,0,1,0,1,0,0,2,0,0,0,0,1,0,4,0,0,1,1,1,1,0,1,6,0,2,1,0,1,0,1,0,1,1,0,1,0,2,0,3,2,0,0,0,0,0,0,0,0,0,0,0,0,0,0,0,0,0,1,3,1,0,0,3,2,1,0,0,1,0,0,0,2,1,0,1,2,2,2,0,0,4,0,0,0,1,0,0,1,0,8,2,0,2,2,3,0,0,0,4,0,2,3,2,0,2,0,2,0,0,1,0,0,0,0,0,0,2,1,0,0,2,0,1,0,0,6,0,0,0,0,0,1,0,1,0,0,2,0,0,0,0,0,1,0,4,0,0,0,0,0,0,0,0,0,1,0,0,0,0,0,4,0,0,0,0,0,0,0,0,0,1,0,0,0,0,0,0,1,0,0,0,0,0,0,0,0,0,0,0,0,0,0,0,0,0,0,0,0,0,0,0,0,0,0,0,0,2,0
K36 Desperation,king,11652,4854,4008,4435,4088,1507,4063,2952,3331,3341,1871,2625,2069,1535,1593,1629,1970,1231,1034,1159,1527,1413,1096,1178,326,803,462,769,1091,552,734,893,924,694,705,597,727,684,302,819,793,948,812,591,427,502,540,468,445,766,794,659,563,575,444,380,615,395,500,525,563,445,342,529,326,348,264,456,268,350,372,212,304,336,265,283,242,439,254,347,300,274,253,397,365,543,237,291,335,258,133,302,260,224,301,167,330,213,173,206,169,387,249,210,385,268,337,369,187,350,270,273,134,406,238,253,228,217,177,136,271,84,224,411,118,135,168,260,137,125,328,198,251,165,311,200,49,278,201,145,40,172,136,147,176,188,115,208,173,232,76,133,270,142,126,140,65,62,125,162,74,178,263,200,147,357,118,80,112,255,58,55,114,87,127,94,102,107,140,181,71,105,168,80,154,58,122,160,222,54,137,62,132,112,80,216,100,51,112,59,109,143,109,167,76,105,92,90,138,184,68,132,51,67,176,65,86,167,122,48,83,101,103,157,53,118,73,81,46,131,176,76,96,319,105,49,98,161,104,42,49,49,100,57,59,90,73,151,75,164,95,31,95,76,128,67,62,72,111,51,75,99,102,83,89,33,91,82,64,110,111,101,74,28,80,60,48,103,131,62,97,33,116,73,163,112,110,17,78,54,121,42,83,25,103,72,92,91,33,79,109,74,97,56,129,92,12,50,37,38,60,19,14,92,38,100,28,79,60,70,45,130,51,175,55,102,304,51,53,95,108,63,65,84,132,64,56,6,34,102,63,31,49,64,60,80,80,97,52,81,150,18,89,58,169,18,33,109,88,45,48,77,39,24,32,38,38,34,42,43,42,62,36,12,41,145,42,32,61,51,99,118,55,66,20,39,0,45,48,50,22,61,37,73,57,91,78,60,42,59,38,148,92,22,62,32,52,85,32,61,85,30,37,136,57,43,34,72,21,44,77,4,14,28,28,40,39,44,53,27,87,42,43,54,3,30,32,50,9,63,19,37,40,68,41,26,63,56,35,64,70,25,16,108,40,29,50,49,45,54,45,13,0,11,33,21,49,72,18,53,14,45,34,18,62,26,34,55,0,35,31,55,87,79,19,55,84,25,53,16,11,20,32,20,32,31,36,54,11,38,39,66,76,33,31,17,34,26,39,8,33,91,42,41,47,30,0,27,34,61,45,23,104,45,50,26,40,31,50,69,37,61,36,29,49,425,55,54,17,16,75,24,83,39,77,63,0,17,27,72,38,42,10,17,54,17,76,40,13,1,27,24,19,17,29,57,19,1,22,10,59,39,18,64,25,61,23,32,8,10,42,53,17,45,9,46,23,75,18,22,28,16,14,14,43,28,15,39,5,44,70,132,68,25,6,0,0,38,31,17,19,52,52,20,12,37,66,20,13,54,21,33,12,25,56,87,26,71,27,35,25,33,16,18,17,0,27,52,28,37,32,11,19,11,39,34,27,14,18,56,0,46,20,39,26,68,44,12,43,35,29,23,56,22,13,47,42,21,27,22,47,39,33,13,10,21,28,34,22,8,32,13,19,12,71,31,2,13,24,15,25,7,17,59,4,19,14,1,18,26,27,7,25,36,23,37,11,79,9,8,8,67,2,20,10,90,14,30,41,20,38,162,27,5,25,58,28,21,19,21,36,10,4,37,0,57,9,16,34,46,40,24,21,25,4,3,12,35,21,26,7,15,12,13,1,61,6,12,38,21,45,19,28,37,28,35,25,12,27,12,26,19,15,46,0,15,10,41,6,14,16,12,4,43,58,28,15,22,13,13,40,14,7,33,9,10,1,27,21,13,15,25,15,26,16,11,71,14,11,20,23,29,31,5,33,19,7,0,42,11,8,8,17,51,18,9,14,27,26,25,29,10,11,33,32,20,19,19,0,58,39,16,25,19,50,15,14,0,35,47,39,64,3,5,8,13,8,25,9,55,33,6,5,31,60,45,16,1,41,53,12,10,24,16,0,12,3,40,16,22,27,16,29,37,8,31,50,20,12,18,5,15,9,7,6,14,15,0,32,14,12,19,19,7,14,18,44,29,21,15,21,0,24,2,6,7,25,8,37,14,18,14,5,17,6,14,8,1,59,1,43,33,19,25,3,27,32,22,2,8,19,43,16,7,19,31,11,3,7,23,16,23,42,29,1,24,6,21,8,6,0,18,11,10,5,19,12,9,2,27,13,8,29,2,5,22,11,15,16,4,2,79,24,2,20,29,22,1,18,18,22,25,21,34,13,19,1,10,39,0,18,0,19,0,5,30,0,0,6,50,3,3,10,3,13,15,21,0,5,17,1,16,26,0,21,6,8,0,39,21,35,31,5,7,22,5,17,8,12,30,15,12,58,14,24,10,58,14,9,22,12,30,13,10,7,0,10,12,35,10,4,22,0,6,34,4,3,3,0,0,0,12,10,10,9,17,3,0,6,29,9,4,5,5,4,6,8,16,8,2,11,0,25,17,8,5,23,5,43,7,5,7,28,22,11,17,49,7,18,20,14,15,7,7,0,1,3,2,19,8,23,63,14,14,19,4,23,28,7,151,18,24,8,15,8,24,29,19,2,35,18,4,12,28,8,16,18,15,7,9,14,0,16,11,31,0,10,16,5,17,2,7,6,32,1,5,2,33,0,2,2,7,16,9,10,33,2,0,24,0,10,29,15,8,11,35,0,2,9,0,21,13,0,33,23,10,10,8,0,11,4,0,8,12,42,3,0,5,5,11,0,13,34,50,4,0,0,13,31,11,24,10,40,2,53,8,3,62,2,16,26,23,4,16,12,0,6,33,2,8,14,5,8,37,2,3,0,4,7,3,8,18,15,35,5,18,17,22,3,8,15,0,3,18,0,28,8,5,9,21,1,2,403,7,3,4,21,3,0,51,37,6,18,26,18,18,14,6,12,10,0,5,15,12,7,15,15,32,1,21,10,22,12,5,4,17,13,28,23,20,1,1,4,11,1,19,27,49,4,15,17,26,7,0,15,13,19,13,3,6,0,5,9,6,2,23,11,10,9,10,16,23,6,0,4,16,4,3,11,6,5,27,8,15,2,2,22,8,6,0,2,4,6,0,9,6,8,1,24,9,1,14,29,10,6,0,0,11,0,30,4,0,9,36,5,10,5,22,29,12,15,17,13,10,8,8,4,0,8,1,0,0,1,9,0,21,3,0,5,1,8,28,3,3,0,14,13,15,6,8,9,35,3,6,10,9,4,1,10,11,13,5,0,0,2,28,23,6,13,9,13,2,0,19,0,17,7,11,12,11,7,9,0,19,22,0,15,4,30,10,4,16,20,15,12,15,11,0,10,5,23,4,8,13,0,19,23,53,9,6,6,12,11,12,20,11,13,24,5,9,7,20,4,15,3,1,0,6,0,4,34,0,1,0,0,17,0,9,1,2,9,14,4,5,9,21,15,0,5,7,4,13,7,11,9,13,2,5,6,15,7,1,10,1,8,1,13,2,3,13,11,6,4,8,12,13,9,1,6,0,23,32,21,4,16,12,8,2,28,12,12,16,17,5,15,14,22,23,7,13,18,41,7,0,12,7,13,5,19,9,8,14,7,12,12,6,5,11,3,11,0,11,5,2,9,12,8,0,3,17,0,1,0,5,7,15,11,2,20,3,7,15,2,0,25,4,0,9,0,9,13,13,5,0,4,10,3,1,6,2,4,2,7,1,13,13,9,4,1,11,16,1,20,7,1,2,871,4,8,2,2,23,17,77,18,9,2,17,1,14,14,10,3,3,2,2,21,0,11,7,10,14,32,25,5,22,6,3,7,9,37,6,31,1,23,0,3,6,13,3,0,0,17,2,1,0,16,1,6,1,25,11,10,8,6,7,15,5,7,1,10,7,6,3,10,5,5,6,0,21,0,1,16,8,6,0,19,3,17,14,11,16,14,0,0,11,14,1,43,3,5,1,21,16,0,10,8,6,10,1,6,6,14,8,2,14,0,6,4,17,8,1,15,4,3,23,2,19,10,0,7,3,1,11,2,5,3,3,44,4,14,9,11,5,11,11,5,3,8,5,14,21,0,5,3,2,3,14,14,20,3,2,3,2,3,1,15,5,7,1,15,18,1,10,9,17,3,2,9,21,19,15,0,0,7,7,0,8,0,0,7,73,9,5,2,15,7,5,0,9,9,30,0,5,79,19,15,7,3,1,10,27,10,28,1,2,29,6,2,6,3,1,4,1,13,3,3,5,4,13,9,6,4,13,9,3,1,17,18,3,0,3,22,0,2,7,2,4,9,8,2,12,0,3,12,7,4,1,1,1,0,33,9,12,0,4,3,0,41,12,0,10,1,0,30,3,5,12,13,4,6,1,0,19,6,34,16,0,18,0,3,11,0,3,11,0,1,9,0,4,2,2,0,20,0,8,19,0,2,1,1,17,5,14,2,0,6,9,3,9,6,9,7,18,12,2,4,74,1,10,7,7,1,0,2,4,4,13,4,8,2,17,9,9,9,4,1,1,2,1,3,9,10,8,2,3,8,1,3,9,4,0,5,7,8,7,3,6,1,2,3,6,1,24,5,5,5,2,1,1,1,0,16,12,16,0,10,20,8,0,7,1,4,5,5,10,0,3,3,2,7,8,5,0,0,4,6,1,11,10,12,12,1,4,1,13,3,25,1,1,25,5,1,3,7,2,1,7,14,10,0,0,7,2,0,3,29,11,0,1,31,2,31,10,14,8,0,0,16,14,5,13,11,23,0,12,0,3,11,13,0,0,5,3,7,4,0,10,5,12,2,3,2,6,2,12,7,6,0,276,11,0,4,7,0,0,1,1,2,4,10,6,15,4,0,6,9,26,8,4,2,5,16,2,12,14,15,0,0,5,4,12,2,0,11,0,12,5,24,6,0,14,1,1,22,5,12,7,3,18,7,19,10,0,4,0,0,6,1,1,11,0,0,0,6,5,13,6,0,0,2,8,2,2,1,6,3,23,3,4,0,0,0,7,4,4,0,0,2,6,1,9,3,12,6,0,1,4,1,8,6,4,3,1,4,12,2,4,61,0,12,3,7,5,14,4,1,102,11,0,3,0,5,6,2,5,4,4,6,2,16,4,1,2,4,14,4,9,6,1,1,1,1,1,4,5,5,8,7,0,0,0,0,3,2,8,3,6,10,18,1,13,9,14,1,1,8,3,5,15,2,3,8,14,2,4,15,5,30,5,25,1,3,8,1,4,1,0,0,2,3,2,4,3,9,3,3,1,9,1,0,1,0,1,37,13,5,6,6,4,0,9,2,19,2,1,5,7,23,7,6,3,11,7,10,2,4,2,0,0,17,7,9,4,51,6,1,5,2,1,7,1,1,8,5,13,24,2,5,1,4,0,2,0,11,0,6,7,1,20,0,1,0,6,1,0,0,9,4,2,1,5,1,8,7,1,33,7,3,17,4,13,2,0,14,1,6,9,5,12,13,16,3,4,7,0,2,10,0,1,11,2,6,1,12,0,4,7,1,0,4,3,18,5,4,9,12,3,5,3,0,15,19,0,6,0,9,2,15,4,2,5,0,3,0,8,12,0,4,1,1,17,12,2,36,4,2,2,1,2,0,8,22,1,1,4,0,0,3,7,3,6,19,15,0,23,22,0,3,1,9,1,5,3,6,0,5,8,3,11,0,4,0,12,4,4,0,1,2,2,2,10,0,0,0,5,1,7,4,3,1,2,19,8,1,6,1,1,1,7,0,0,7,12,6,12,2,7,8,3,3,0,0,5,2,2,8,3,2,7,2,0,0,3,6,5,6,15,1,3,13,4,4,4,6,4,0,0,0,1,2,9,0,2,0,0,1,3,0,5,0,5,2,0,4,6,0,0,0,2,7,0,1,9,4,12,1,2,8,4,15,40,5,3,2,5,3,2,3,16,2,2,18,0,5,2,10,43,4,3,6,6,6,0,0,6,2,6,4,3,4,11,0,13,1,1,5,4,8,0,3,4,58,14,2,3,5,2,0,0,0,5,4,6,6,1,8,9,11,9,0,5,0,3,10,5,11,3,1,11,5,0,2,2,7,0,10,5,2,1,6,1,6,2,0,3,0,6,8,0,1,0,2,0,3,0,4,4,4,4,1,3,3,15,1,3,1,0,2,0,0,0,32,1,20,7,0,0,0,4,7,2,4,7,4,0,6,1,0,2,2,0,5,7,6,0,3,9,0,18,0,6,0,4,2,0,1,4,10,6,0,0,1,4,19,2,2,0,3,3,3,2,0,11,1,1,4,6,1,1,5,0,0,29,9,0,12,4,2,62,3,0,26,4,0,1,0,15,3,4,1,4,20,2,10,0,2,3,0,6,2,5,4,2,0,0,22,5,0,17,2,2,8,5,7,4,5,0,10,1,3,0,2,0,2,1,1,0,1,1,13,0,0,1,3,0,5,2,2,0,1,2,3,0,1,6,0,3,2,0,2,0,2,0,8,9,7,3,9,11,10,7,2,0,0,2,0,8,0,7,0,1,0,11,8,4,2,0,9,0,0,12,4,1,0,3,10,0,0,0,14,4,0,0,0,3,1,7,1,6,5,4,2,0,0,13,0,0,5,0,2,4,1,6,0,4,2,11,2,56,0,1,9,4,0,0,3,6,1,4,7,7,0,3,0,6,3,17,2,3,0,10,1,2,2,6,3,1,0,0,0,6,0,17,1,0,0,12,0,50,1,0,6,1,3,5,0,3,2,2,0,1,15,0,7,2,2,1,0,2,0,0,12,0,0,3,2,5,0,9,2,0,1,3,0,10,6,1,0,0,9,0,0,1,1,1,3,0,1,5,7,5,3,1,0,0,0,4,2,2,3,3,7,8,0,8,0,2,4,15,0,4,0,0,15,3,6,1,14,10,0,16,11,8,1,16,1,4,3,16,2,9,5,2,3,4,0,5,10,2,4,0,0,1,11,1,3,11,3,7,1,0,0,3,0,0,2,1,4,15,2,3,4,2,10,1,0,0,0,1,3,0,5,10,4,2,2,1,0,1,4,0,4,12,4,0,0,6,2,4,1,1,0,0,0,1,2,0,3,14,12,2,0,1,0,2,23,4,1,1,1,2,0,1,4,4,2,28,0,4,12,7,12,0,0,3,0,29,8,2,3,0,10,1,1,1,0,8,1,5,0,1,4,1,2,8,3,3,1,0,0,3,1,1,3,3,4,2,7,4,2,0,7,18,15,2,3,0,2,2,5,3,1,4,12,1,2,8,8,4,5,0,7,0,0,10,5,1,0,8,2,4,6,0,18,10,7,0,2,7,3,3,0,5,1,2,2,0,6,7,0,0,2,0,9,2,3,11,2,0,2,0,26,19,2,0,0,5,4,5,0,3,1,0,0,3,7,3,2,1,4,5,12,7,2,0,6,1,2,10,5,5,20,3,7,6,0,0,4,2,16,2,12,1,7,4,4,1,0,3,1,2,13,12,0,6,1,1,1,0,0,8,5,6,1,5,2,0,0,17,0,5,0,2,5,3,2,24,8,0,3,13,2,2,1,14,0,2,2,3,0,0,9,1,0,14,7,2,4,3,5,2,0,0,1,1,0,0,2,3,4,6,3,4,4,0,0,2,7,0,5,0,2,7,1,1,2,23,6,1,11,1,2,2,4,0,0,2,1,0,0,2,1,1,3,5,7,1,2,1,9,0,0,1,2,0,5,5,1,30,0,5,4,0,2,2,0,1,0,0,0,0,10,0,3,3,12,2,3,6,0,0,1,1,4,1,7,10,1,0,1,1,1,0,0,4,0,2,5,8,0,0,3,1,1,0,3,2,0,0,0,2,3,4,5,4,3,0,4,1,3,0,0,0,7,1,1,5,3,8,0,2,7,7,3,15,2,1,0,5,2,1,0,7,1,3,0,0,1,0,0,1,7,1,3,7,16,10,0,4,2,0,0,2,0,5,3,0,0,0,1,4,4,8,2,6,2,4,1,1,1,9,6,4,1,0,4,6,2,0,8,0,0,0,0,0,4,2,36,3,0,3,3,4,7,0,2,0,13,2,1,0,1,1,27,1,8,5,14,14,5,3,4,2,1,8,12,3,2,1,1,3,1,0,14,0,2,2,1,1,2,20,1,0,0,0,7,0,3,0,8,1,2,0,7,5,6,7,3,8,0,0,1,0,1,13,0,2,10,2,7,0,1,1,5,3,0,3,0,5,34,0,15,2,0,1,5,0,1,9,1,5,7,0,6,10,12,1,16,6,0,25,4,1,0,0,8,1,7,0,2,1,3,0,0,3,0,7,1,3,3,15,1,9,3,0,0,0,5,15,10,0,4,0,23,1,1,2,0,2,5,0,14,0,3,2,0,2,4,3,4,3,0,0,0,2,6,2,2,0,2,3,1,2,3,12,5,2,4,0,0,0,2,0,8,3,5,2,1,2,0,1,0,0,2,0,2,0,3,0,2,0,2,1,1,1,2,1,0,7,4,2,4,0,7,2,3,2,0,14,2,4,1,0,0,0,2,1,0,0,7,2,5,0,2,14,0,0,1,5,3,11,0,0,0,1,3,0,1,12,0,6,1,3,6,1,0,1,0,0,14,0,0,2,3,1,5,2,2,0,0,18,4,0,2,2,4,4,0,1,4,9,1,1,8,1,3,4,0,3,1,1,2,2,2,0,3,24,3,4,0,1,1,1,0,0,2,1,1,0,3,5,0,0,6,8,3,4,0,1,1,0,1,1,0,4,1,4,8,2,2,1,6,0,1,2,1,0,0,1,3,2,0,0,1,4,3,4,0,3,0,0,0,0,4,0,6,3,4,2,4,4,2,2,2,1,0,0,5,12,2,0,19,8,0,1,11,0,0,0,0,4,0,4,2,0,0,0,3,2,0,2,7,2,1,5,1,0,0,0,0,6,0,1,5,2,1,5,0,0,23,0,1,4,2,1,0,1,1,6,14,1,4,5,1,2,5,6,2,0,5,4,0,2,0,0,1,2,3,0,1,4,1,0,0,1,0,8,6,0,8,6,1,6,7,3,0,0,1,2,0,0,0,0,9,1,7,4,0,5,6,1,0,0,7,9,3,1,0,4,3,0,4,0,7,0,9,1,0,0,1,1,5,1,0,3,0,0,6,3,0,0,5,2,1,0,1,0,10,4,3,0,5,0,1,0,3,3,1,0,2,2,13,3,8,2,2,0,0,0,3,0,6,4,0,0,0,107,1,29,0,3,0,0,2,6,10,2,2,7,0,0,6,4,1,1,4,0,1,0,0,0,0,11,12,4,5,1,0,0,8,2,2,4,1,5,0,6,1,2,0,0,5,20,5,0,1,0,7,2,4,4,2,7,1,0,2,702,0,0,0,0,0,7,0,2,0,0,1,8,17,8,0,1,1,1,1,2,2,3,0,13,2,1,0,0,0,1,0,2,0,1,2,1,1,1,3,1,0,0,1,1,0,1,0,0,2,0,1,0,1,0,7,0,3,0,1,4,6,0,2,4,7,1,0,0,5,4,1,1,6,1,2,2,0,0,0,1,1,8,1,1,0,0,1,5,2,1,4,5,0,0,0,1,7,1,1,1,0,0,0,4,1,1,0,1,1,3,0,0,2,1,0,0,0,1,1,3,1,1,0,0,1,1,0,0,0,2,2,3,1,0,9,3,2,0,0,3,2,6,0,1,0,0,2,1,1,8,3,6,1,0,1,0,10,1,1,1,0,0,2,11,1,1,1,0,0,0,1,11,3,1,0,1,0,2,1,1,2,1,3,0,2,0,1,5,1,4,1,1,2,7,2,0,1,2,4,3,0,4,6,0,0,0,2,2,0,0,1,10,0,7,1,0,2,1,5,6,9,0,2,0,2,0,7,3,0,0,2,1,1,0,3,0,1,2,1,14,1,0,0,0,0,2,0,7,1,0,3,0,8,0,6,0,4,0,0,4,5,0,5,0,2,7,0,1,3,1,1,1,0,17,7,5,1,8,2,1,3,0,2,1,0,0,1,3,0,0,0,0,3,0,1,1,1,3,8,1,3,2,2,0,0,4,3,3,0,3,1,3,0,2,4,0,2,2,9,5,2,2,2,0,0,6,1,10,1,0,0,4,2,2,0,0,0,0,2,1,1,0,0,1,3,0,0,0,9,2,0,2,2,1,5,5,0,1,23,5,1,0,6,2,1,3,1,2,3,3,0,4,0,0,5,0,10,5,0,0,2,1,3,0,0,0,0,1,0,1,3,1,8,0,2,3,4,0,0,1,2,15,1,0,4,0,1,2,0,0,4,1,1,0,6,0,1,0,0,2,2,4,0,0,1,5,12,0,4,4,5,1,1,0,2,3,0,6,1,5,7,1,9,3,2,0,0,0,0,0,1,1,2,1,2,1,4,3,0,18,0,0,1,0,1,0,0,2,0,2,1,0,3,0,0,1,0,2,0,2,0,1,0,3,2,1,0,0,0,2,2,3,1,2,1,1,1,3,0,2,0,7,0,6,5,0,2,2,1,1,3,2,5,0,17,0,2,2,1,10,5,12,0,1,2,0,1,1,3,0,2,5,0,0,4,0,0,2,2,4,1,2,1,1,0,0,1,4,1,0,1,2,0,0,0,3,0,1,5,1,7,2,0,1,0,1,2,0,2,0,4,2,3,0,0,0,5,1,4,3,2,3,1,1,0,1,0,0,1,0,1,0,3,1,4,0,0,0,6,3,2,4,10,2,0,0,0,4,2,1,0,3,5,0,4,2,0,0,0,1,3,2,4,0,2,11,1,0,0,5,1,15,0,2,2,6,1,3,0,0,0,1,0,0,0,3,1,2,0,10,14,1,1,0,2,2,3,1,0,0,0,2,0,7,0,3,0,4,0,5,2,2,1,2,0,1,1,4,1,0,1,1,1,2,0,1,0,2,0,0,0,1,1,0,0,0,3,6,0,0,0,2,1,0,0,0,0,0,1,1,0,1,0,3,0,0,2,0,0,0,0,2,3,8,1,4,0,1,5,2,1,0,0,0,1,0,3,4,1,5,0,5,3,0,0,1,5,0,0,0,1,1,0,5,4,0,0,2,2,1,0,0,4,0,9,1,1,1,10,0,1,3,0,1,1,2,0,1,0,0,2,2,2,0,1,1,3,0,0,0,1,0,0,2,3,1,0,0,0,4,1,0,0,0,0,0,7,0,0,0,0,0,0,0,0,0,0,0,1,0,0,0,0,1,1,4,3,0,0,0,0,0,0,0,0,1,0,0,4,0,0,0,1,0,0,0,0,0,0,2,0,0,0,0,0,0,0,0,0,0,0,0,0,0,0,0,0,0,0,0,40,0
K37 The Regulators,king,6822,2996,2430,2645,2544,1231,1842,1771,1580,2002,831,1438,1249,909,1053,1010,899,780,654,462,772,910,694,655,260,460,309,435,582,724,547,528,480,423,407,403,330,489,239,495,423,662,462,398,246,325,347,308,256,443,416,359,300,272,227,236,328,234,252,400,373,257,182,300,128,241,169,271,241,213,218,114,171,211,165,204,148,249,140,133,191,259,101,212,203,231,152,199,209,139,105,197,190,147,211,92,187,145,139,153,166,302,160,114,186,201,247,164,102,165,147,188,76,162,143,145,113,101,106,77,129,83,100,214,101,61,88,145,67,91,164,105,126,67,166,136,40,200,111,96,174,92,38,61,120,82,80,105,55,138,59,99,102,74,70,116,190,35,64,77,45,86,98,156,117,202,69,55,73,132,39,48,65,51,42,40,75,96,76,115,70,69,83,55,62,52,49,67,113,32,123,31,91,70,58,94,25,37,70,54,85,72,70,78,54,73,66,101,86,77,42,80,16,39,62,41,49,106,87,16,41,78,64,96,46,65,51,37,23,106,93,31,20,159,60,19,74,74,54,23,35,35,90,37,42,54,25,117,61,95,40,24,41,28,57,44,45,48,67,39,64,37,61,42,62,29,35,63,27,66,51,77,59,27,32,41,30,71,93,39,49,42,79,21,123,239,61,14,46,51,30,121,63,27,68,39,44,57,50,49,55,34,43,28,62,71,4,72,18,41,40,24,21,37,29,35,12,116,35,36,21,74,35,143,39,41,61,39,18,26,71,30,52,49,16,54,37,17,32,59,49,21,15,10,45,64,70,64,17,50,88,11,50,39,105,29,22,44,21,25,18,35,58,10,18,6,34,23,28,42,25,44,18,85,22,72,16,47,57,87,44,68,10,16,10,22,0,23,27,43,25,33,16,22,30,67,67,17,29,50,17,53,17,58,23,20,36,55,17,31,30,19,26,17,35,43,23,58,4,30,41,0,16,8,25,21,29,46,30,35,83,20,15,23,6,45,16,38,1,50,28,17,15,31,20,16,45,36,19,43,34,11,14,59,50,30,16,16,15,52,18,49,0,10,7,17,51,31,27,23,9,26,32,8,43,25,26,19,0,31,15,30,39,48,27,34,29,16,22,13,5,10,34,17,21,15,25,25,5,20,29,32,7,27,24,9,11,24,20,5,21,35,25,13,38,14,0,10,17,20,40,25,41,22,25,12,20,39,34,43,24,24,24,9,21,37,46,44,6,15,20,6,55,43,35,33,0,8,6,42,37,22,10,5,36,12,22,27,5,0,12,13,16,42,20,28,11,10,13,4,30,15,20,23,15,6,21,14,8,12,24,35,20,15,13,32,7,52,12,6,17,12,4,7,15,10,6,22,8,27,36,12,58,18,9,0,0,16,5,88,11,12,32,11,9,9,26,19,15,14,6,16,13,25,14,24,10,35,18,4,8,17,26,27,3,0,36,20,8,11,18,11,12,12,16,36,12,15,5,25,0,23,17,19,18,38,17,2,24,15,25,9,15,17,3,15,20,12,14,9,26,9,13,8,10,11,20,28,30,8,14,15,9,7,30,13,1,15,9,9,22,3,9,15,4,10,9,3,11,8,38,4,24,22,13,16,17,26,4,9,1,23,0,7,15,63,12,28,9,16,15,25,19,0,20,19,8,3,9,12,22,6,54,5,4,29,3,7,11,24,35,20,10,24,6,2,5,11,20,5,13,5,8,11,2,9,9,5,17,9,19,7,19,20,4,63,32,5,18,12,14,12,13,8,0,9,11,6,11,5,11,8,4,18,14,17,21,10,20,19,11,8,1,25,2,17,1,12,1,17,12,7,5,8,59,4,58,16,9,2,7,12,14,5,28,35,6,0,17,40,12,7,23,10,17,19,28,19,3,7,16,94,28,9,2,5,8,7,0,37,31,1,19,8,21,10,10,0,10,3,13,32,2,0,0,2,15,39,13,39,12,8,2,20,19,16,9,0,18,28,13,12,17,5,0,5,7,21,13,11,22,5,31,17,3,15,12,7,7,17,6,7,12,2,7,9,6,4,26,44,8,2,6,1,20,12,27,6,9,4,21,0,6,0,6,1,8,3,23,8,27,1,2,13,9,8,4,0,25,5,19,4,22,15,6,17,9,11,0,7,9,23,10,10,11,15,10,5,15,29,12,10,26,3,3,7,6,23,30,6,0,20,12,0,9,1,8,4,8,5,9,15,11,3,5,25,9,20,7,3,1,34,20,1,14,13,9,39,6,39,7,9,10,15,13,11,1,11,21,0,5,1,11,0,12,12,0,1,5,25,8,4,3,0,15,24,22,5,6,13,1,16,1,4,8,1,7,18,9,8,17,5,4,5,17,4,13,9,3,23,10,7,0,8,10,3,25,2,4,8,19,13,4,5,2,0,7,7,6,10,8,17,0,12,20,4,7,3,1,0,0,3,3,15,4,9,3,0,12,22,3,5,7,14,5,24,2,20,5,0,3,5,7,8,5,5,13,5,22,5,36,3,7,11,7,6,14,5,13,10,7,8,6,6,0,0,1,1,9,10,19,41,53,15,7,5,9,11,4,122,6,23,15,4,5,8,12,5,18,15,18,7,6,5,7,4,5,1,0,1,4,0,15,9,15,3,5,6,4,7,1,2,4,14,0,1,3,21,0,0,13,8,13,28,12,19,2,2,13,16,4,13,3,2,9,18,0,2,6,0,10,5,15,8,8,24,5,7,7,11,6,0,9,12,25,2,0,3,6,1,0,1,12,12,2,0,0,4,9,6,22,17,29,1,21,7,19,23,4,7,9,11,5,12,8,0,1,27,1,10,9,1,8,3,24,2,0,1,7,7,14,12,17,16,16,61,12,6,41,3,14,0,4,8,0,15,4,0,6,6,0,11,34,3,26,1,15,9,2,20,8,20,10,27,7,5,9,0,4,13,0,5,4,65,3,8,4,8,1,18,8,17,9,8,11,11,7,11,6,2,2,0,2,6,1,19,21,18,5,13,10,12,7,0,4,4,8,6,1,6,0,8,8,8,1,9,0,18,2,3,11,17,7,0,4,54,7,30,12,2,6,3,5,6,4,3,24,7,1,1,3,2,3,0,8,0,10,4,6,3,2,4,10,4,3,0,0,18,0,22,0,0,7,28,6,8,1,6,12,6,7,27,5,0,8,1,3,0,8,1,0,0,0,5,0,9,2,0,5,10,7,11,2,3,0,5,6,29,5,7,13,1,1,6,8,4,2,2,5,6,4,6,0,0,1,7,8,8,3,7,7,2,0,7,4,12,1,10,10,4,8,17,0,6,4,0,11,4,7,5,7,7,9,1,5,10,5,0,5,31,21,5,2,14,0,15,14,35,4,2,8,7,9,2,14,9,2,16,1,2,6,11,0,11,4,2,0,0,2,4,15,1,3,0,0,1,0,2,3,2,8,3,3,0,8,5,2,0,1,3,1,7,5,19,8,5,4,8,3,8,2,1,4,9,5,1,3,1,0,11,5,4,9,5,7,6,3,0,26,0,13,12,13,2,18,8,2,1,5,7,6,7,3,4,6,3,12,13,5,2,7,15,7,0,9,7,6,1,7,8,0,5,6,10,4,2,4,4,26,4,0,6,4,1,5,12,4,0,2,4,1,0,0,11,2,4,7,5,4,1,1,9,0,0,19,1,0,9,0,13,4,9,2,0,5,5,0,4,1,5,12,0,2,9,8,37,2,0,3,12,7,6,16,1,1,0,50,4,8,1,0,6,7,4,5,7,6,5,0,2,3,12,3,2,41,5,3,0,8,2,4,9,16,21,1,5,1,5,2,6,6,3,10,1,12,0,5,6,3,5,2,0,9,1,0,0,6,0,4,3,12,3,8,1,21,14,13,4,7,1,2,4,18,7,4,1,4,2,0,8,1,0,1,3,2,0,0,2,6,8,4,7,17,0,3,11,1,2,42,14,5,3,8,6,0,4,4,2,5,1,2,2,0,8,4,7,0,8,3,12,5,6,4,3,2,8,2,9,9,0,1,0,0,3,2,2,4,5,4,5,3,11,5,5,4,4,2,3,2,4,4,5,0,1,7,7,3,28,11,13,6,3,1,0,2,2,4,2,2,1,4,10,5,4,1,8,2,1,4,3,10,12,0,0,3,4,0,1,0,1,0,27,12,1,0,7,3,7,0,4,6,17,1,11,13,12,6,7,0,0,3,10,5,16,1,4,12,2,7,1,5,2,5,36,13,3,5,5,2,8,4,3,2,6,0,12,2,18,14,4,1,4,11,1,0,11,4,6,7,11,15,2,0,4,5,3,4,1,1,6,0,19,8,4,0,0,1,2,24,3,0,6,3,1,14,4,2,7,5,2,8,0,0,6,4,18,9,0,5,14,0,0,0,1,19,0,4,4,0,1,2,2,0,6,3,3,3,2,2,3,1,4,6,3,3,0,6,2,1,8,4,2,4,3,4,0,0,4,1,1,6,3,0,0,2,3,1,17,6,1,0,7,8,11,17,0,2,2,1,1,5,0,5,2,2,6,11,0,1,2,0,1,0,2,3,1,2,3,1,7,1,9,6,10,3,1,3,1,3,1,4,1,10,4,3,0,8,11,1,0,3,1,2,2,57,10,9,0,0,0,5,1,1,0,1,3,15,3,3,1,0,4,7,2,1,9,10,6,2,1,10,0,0,2,4,1,2,7,3,2,0,1,2,2,0,0,23,6,0,0,6,0,5,12,8,9,2,3,0,2,2,8,6,2,2,6,0,2,5,6,0,0,10,61,3,2,0,9,4,1,5,5,1,2,2,1,20,5,0,10,11,0,1,5,0,0,1,2,7,3,4,5,8,4,0,4,7,15,4,8,14,4,6,0,11,9,11,2,0,2,1,5,1,0,10,0,1,2,9,5,0,9,0,3,2,3,11,2,5,6,4,12,3,0,10,0,0,2,1,2,2,0,0,0,2,1,4,2,1,0,3,5,1,2,4,3,6,3,3,5,0,2,1,0,6,22,0,1,4,4,1,9,0,4,3,1,3,1,0,2,1,1,3,0,1,3,1,2,2,0,2,2,1,9,4,5,0,21,0,0,11,5,6,3,3,5,1,1,1,0,6,0,7,3,2,6,10,3,8,0,0,3,3,0,1,3,2,6,10,2,1,0,1,1,10,2,7,3,7,7,1,6,0,4,2,0,9,1,1,1,2,1,6,3,1,4,1,0,19,5,6,0,1,3,1,1,1,0,5,3,7,7,7,0,5,3,0,0,3,7,0,2,0,18,3,3,1,5,7,2,1,4,6,6,0,0,1,8,2,5,8,3,1,1,2,0,0,1,0,0,16,4,2,3,1,4,2,3,11,2,2,1,2,6,3,0,6,9,2,2,3,1,5,6,7,0,6,4,4,8,2,1,1,0,8,0,2,1,0,1,2,2,1,3,8,0,4,0,0,5,1,6,4,0,2,1,4,19,5,0,3,9,7,0,3,15,0,0,0,3,3,0,3,3,0,1,2,0,0,0,2,1,4,0,1,0,2,4,4,0,0,1,3,0,3,0,1,3,8,3,3,4,3,1,0,2,4,0,2,1,7,9,11,4,6,1,7,2,0,0,0,6,14,3,1,3,1,2,2,3,2,4,3,11,0,7,6,0,1,4,9,0,3,4,4,2,6,2,0,14,0,0,0,10,2,2,0,0,3,2,2,8,0,0,0,7,8,2,1,12,3,1,1,3,1,2,1,1,1,6,1,0,18,7,6,2,3,4,3,13,0,0,1,0,0,3,5,1,7,2,1,0,0,0,1,3,3,9,0,4,8,4,3,3,0,5,0,17,0,1,2,0,0,1,0,0,6,1,0,3,2,4,1,3,2,1,3,3,0,0,2,0,3,1,12,2,0,2,1,3,4,18,1,1,7,5,1,2,1,64,0,2,15,0,4,5,4,3,2,1,4,2,3,1,1,1,4,1,8,1,0,5,0,0,1,2,70,1,0,0,2,1,1,6,4,0,5,2,1,0,0,1,7,4,14,2,0,3,3,2,1,3,0,3,6,7,11,1,2,2,0,0,1,3,0,0,9,4,2,0,4,2,2,0,0,1,1,2,6,1,2,0,0,0,3,0,0,23,3,1,5,10,4,8,2,1,0,0,3,0,1,2,6,0,5,1,0,9,0,0,16,2,10,6,3,3,4,1,2,24,0,0,2,7,1,0,3,19,1,4,7,5,1,2,4,0,3,1,1,3,0,0,1,7,7,2,6,0,1,5,1,13,2,1,0,0,16,3,0,3,4,0,0,32,1,0,12,3,2,22,1,2,7,1,1,0,0,2,0,1,3,3,9,1,13,0,5,6,1,4,4,5,2,0,0,1,2,4,2,3,1,2,2,6,9,1,2,0,7,0,4,1,2,2,3,7,0,4,1,5,11,3,2,1,7,0,1,0,1,0,1,0,16,0,1,1,2,1,2,3,3,0,2,0,8,6,3,1,0,3,1,6,2,0,0,3,0,12,1,1,3,1,4,4,0,1,1,0,7,1,0,2,0,7,1,2,3,1,7,0,1,1,0,0,0,2,3,2,0,4,2,0,0,0,0,2,0,0,1,0,1,0,1,0,2,4,0,8,0,24,0,1,4,4,0,19,2,9,0,2,2,4,3,0,1,6,3,4,0,8,0,3,2,0,5,6,2,1,0,0,0,13,0,3,2,0,2,8,2,7,3,0,2,0,1,4,1,3,0,2,0,1,6,0,13,5,3,0,0,1,0,0,6,0,1,2,0,0,0,8,1,0,0,3,1,2,0,1,0,1,6,0,0,0,1,2,5,0,3,1,8,4,3,1,0,0,0,11,2,2,0,0,6,5,1,8,3,0,1,6,0,4,0,3,9,4,3,0,5,1,0,1,9,11,3,10,4,1,2,9,0,6,0,1,3,4,3,4,1,0,0,1,0,1,1,4,0,2,0,3,1,0,0,1,0,1,2,1,1,20,2,3,0,1,11,6,3,0,0,0,1,22,6,1,1,0,0,0,0,2,4,2,30,12,3,3,0,2,1,1,1,2,0,0,0,0,1,0,1,4,3,0,1,0,0,0,19,4,1,4,0,3,0,2,1,0,4,11,0,0,19,5,8,0,1,0,2,3,1,0,1,2,7,0,0,1,0,4,1,4,1,2,2,0,2,1,1,2,1,0,0,1,7,0,0,7,2,0,3,3,2,0,8,4,9,4,2,0,5,3,4,2,2,1,10,14,1,3,1,0,1,0,2,3,2,11,0,0,1,2,5,5,0,0,2,1,6,0,3,4,0,7,0,1,0,2,3,1,5,1,1,0,0,0,3,3,5,4,4,0,1,0,24,11,1,1,0,1,7,3,0,1,0,0,0,4,1,4,0,3,3,5,5,7,3,0,1,1,0,0,0,1,8,4,8,4,0,1,2,7,4,0,1,1,3,3,3,14,0,1,3,0,2,1,1,3,1,2,0,6,1,4,3,1,2,0,0,1,0,1,0,4,0,0,2,2,0,1,11,0,0,5,2,2,2,0,0,1,3,0,3,3,6,0,0,20,2,0,0,1,6,1,0,2,0,0,0,0,2,3,3,4,1,5,0,1,1,1,1,17,1,0,0,5,2,1,2,5,0,1,5,1,1,1,1,1,0,1,2,1,0,0,5,0,0,1,4,3,4,1,3,4,0,0,0,1,3,4,0,4,2,4,0,1,0,1,13,1,0,0,0,0,1,2,1,0,2,1,0,2,1,0,2,0,6,0,1,0,1,1,0,5,1,0,0,1,0,1,0,2,0,0,4,2,0,0,6,1,4,0,0,0,1,1,1,2,0,0,3,0,0,0,3,0,2,2,1,3,4,0,0,0,4,2,0,6,5,0,0,3,0,2,1,3,3,2,4,0,0,0,0,1,4,0,4,4,9,3,0,0,2,0,0,0,0,1,2,0,0,0,4,0,4,7,4,2,1,2,2,0,1,5,0,0,0,1,0,5,1,0,2,1,0,1,4,3,0,1,0,6,0,3,2,1,4,1,3,0,3,1,0,1,3,2,3,1,0,3,3,4,2,2,0,2,0,1,1,0,0,0,2,0,2,0,7,0,14,1,1,2,4,2,17,0,0,0,0,0,0,0,4,0,1,10,4,0,0,1,0,1,0,1,0,0,1,7,0,2,0,6,3,0,2,0,1,1,0,4,0,1,1,0,4,3,0,5,11,2,1,0,0,6,0,0,1,1,9,3,9,2,2,2,1,0,0,3,4,0,7,1,1,2,4,0,1,0,1,5,0,3,2,8,2,4,1,1,0,0,2,1,10,1,1,0,5,1,4,0,0,1,12,0,3,0,4,2,1,1,44,2,10,2,0,0,0,2,1,0,6,0,1,1,2,2,2,3,4,1,1,0,2,0,0,0,4,0,3,0,5,1,10,5,1,0,0,0,1,0,3,1,4,0,1,6,3,3,0,0,0,0,0,0,4,1,2,0,1,0,2,6,0,2,1,1,0,0,0,5,0,0,4,4,2,1,1,4,3,0,0,1,0,0,0,0,4,2,4,0,2,1,0,1,0,2,2,1,0,0,1,0,2,0,2,1,1,2,2,1,1,1,0,4,3,0,1,0,3,0,0,1,0,6,2,0,0,1,0,0,2,1,1,1,2,0,0,0,1,56,9,1,6,0,3,0,1,0,0,1,1,0,0,4,2,0,7,6,0,2,1,0,9,0,1,1,1,0,1,6,1,0,1,1,0,1,0,0,0,0,0,1,1,0,3,1,1,0,0,1,0,0,0,1,7,3,1,1,2,3,0,13,2,0,4,2,0,1,0,2,11,6,0,0,1,4,0,0,0,1,0,0,1,4,0,2,0,0,2,1,1,0,0,1,1,0,0,0,0,1,0,1,3,2,0,3,4,0,0,1,0,0,9,0,1,5,2,0,1,0,1,3,6,0,1,4,2,1,7,2,3,0,5,2,0,8,0,0,7,2,1,0,0,1,0,0,1,5,3,7,1,0,2,0,0,5,1,3,0,0,2,2,0,0,0,0,2,0,5,8,1,3,2,1,1,0,4,2,2,8,1,3,0,0,2,0,1,1,0,2,0,0,1,1,16,0,1,3,0,0,1,0,1,0,2,2,1,0,8,0,4,3,2,6,5,2,1,0,8,2,1,0,0,3,5,2,1,5,0,2,0,6,1,0,11,3,0,0,2,28,1,5,0,0,2,3,4,1,9,4,0,4,1,0,0,0,0,2,0,1,2,0,0,0,0,5,4,1,3,0,1,0,7,0,5,3,0,0,0,1,0,0,6,0,4,11,3,0,0,3,1,1,2,2,1,1,1,0,1,403,0,0,2,0,0,5,0,4,0,1,0,3,3,2,1,4,0,2,0,0,5,1,0,5,0,1,0,0,0,0,0,1,0,0,2,3,3,4,6,4,0,0,0,0,0,0,10,0,1,0,0,0,1,0,0,0,0,0,2,6,1,0,3,2,1,0,3,0,5,2,0,0,4,0,1,0,0,0,0,0,0,1,3,4,4,0,3,1,0,1,0,3,0,2,3,1,4,0,9,0,0,0,0,0,1,2,1,2,0,1,0,0,3,1,0,1,1,1,0,5,1,1,0,1,0,0,1,1,0,2,3,2,0,0,1,4,3,0,0,5,5,4,0,1,2,0,27,4,0,9,1,4,1,5,0,1,1,0,0,1,1,0,28,4,0,0,0,0,0,0,0,3,2,2,2,0,1,0,0,1,1,0,5,0,0,0,0,3,2,7,2,0,1,3,2,0,2,2,6,0,1,2,4,2,0,0,9,1,0,0,0,4,4,2,1,0,0,0,4,2,5,0,4,1,0,0,5,0,2,0,0,0,14,6,0,0,4,0,0,3,2,0,1,1,3,0,0,0,0,0,2,3,2,1,0,0,3,2,0,1,6,0,2,0,3,2,0,2,0,0,1,0,0,3,3,2,3,7,2,0,2,1,0,1,0,0,1,1,0,0,0,0,0,1,0,0,2,3,1,2,1,0,0,0,0,7,16,2,1,0,0,0,0,2,0,0,0,4,8,1,1,0,4,0,1,4,0,7,0,4,1,2,3,0,0,4,0,0,0,4,0,1,0,1,2,2,1,1,4,0,2,0,0,0,2,1,0,1,2,1,0,1,2,3,1,1,0,2,1,1,1,9,0,0,0,1,7,7,0,0,0,1,2,0,0,0,0,9,0,2,4,1,1,0,1,0,2,0,0,0,1,7,1,1,2,0,2,0,0,0,0,0,4,3,2,0,0,1,1,3,1,0,0,0,3,3,0,0,2,0,2,3,1,1,2,2,0,1,1,1,3,2,1,1,1,0,1,1,0,0,0,3,1,2,1,0,1,5,0,6,0,0,1,3,2,0,0,0,0,4,1,0,0,1,0,1,0,1,0,0,1,3,0,3,1,2,0,0,0,2,1,3,0,0,0,1,0,3,0,0,0,3,0,0,2,0,1,5,1,4,1,3,0,4,6,0,0,0,1,1,1,4,1,2,0,0,2,0,1,0,10,3,0,1,6,1,1,2,0,10,2,1,0,0,0,1,0,0,1,0,3,1,0,0,0,1,0,4,7,0,12,0,6,0,1,0,0,0,8,0,2,0,4,0,0,4,0,0,4,0,3,2,1,1,3,0,0,3,3,0,0,1,1,1,1,0,1,2,3,0,0,2,2,0,0,0,0,3,0,0,0,0,1,0,0,1,0,0,0,2,0,0,2,0,4,6,0,0,1,1,0,8,0,0,6,3,2,1,0,1,0,1,3,0,1,10,0,0,0,0,2,2,0,0,1,0,1,4,0,3,1,3,0,3,0,2,0,0,0,0,3,0,3,0,0,0,0,1,0,0,1,0,0,1,0,1,0,0,0,0,0,2,0,2,3,0,7,1,1,1,4,5,1,1,0,0,0,1,1,0,1,0,2,0,0,0,2,0,0,1,0,2,7,0,0,0,0,1,3,4,2,0,0,2,0,0,4,3,0,1,0,2,2,0,2,0,0,0,0,338,0,0,0,1,2,6,1,2,1,1,0,0,6,0,4,2,0,1,22,0,5,0,0,0,0,0,0,0,0,0,5,0,0,6,2,0,3,0,0,0,0,0,0,0,1,1,0,0,0,2,0,0,1,0,0,0,0,1,0,0,0,0,0,0,0,0,0,0,1,0,1,0,0,0,3,0,0,0,1,0,0,0,0,0,0,4,0,0,1,0,0,0,0,0,0,0,0,0,0,0,0,1,0,0,0,0,0,0,0,0,0,0,0,1,0,0,0,0,0,0,16,0
K38 DT4 Wizard and Glass,king,13845,7267,5408,5426,6151,1943,3815,3721,3573,3803,1885,3241,2610,2676,3059,1819,2684,1824,1497,1545,1947,1861,1965,1170,509,1212,576,1346,1067,710,1065,868,1000,1130,955,858,966,1056,589,1175,1043,901,919,906,426,736,651,856,860,868,917,944,647,644,489,584,887,486,652,466,526,402,536,722,517,537,634,455,381,466,278,185,368,461,200,521,353,361,295,391,303,360,320,375,439,641,363,266,409,300,236,355,440,233,352,295,332,278,372,405,293,447,189,350,522,464,402,430,189,240,405,505,229,344,322,152,324,383,298,75,293,414,253,523,103,157,295,315,235,203,380,284,196,235,410,305,198,424,219,223,105,193,115,98,175,271,151,296,183,95,218,227,259,193,200,110,196,164,263,183,122,252,172,202,229,349,241,92,167,260,85,87,208,161,9,216,153,199,240,150,138,135,220,113,149,66,82,125,227,109,114,77,225,193,115,321,139,73,159,72,106,178,135,236,106,52,120,120,113,151,87,138,222,98,152,141,154,246,135,126,126,161,152,137,56,148,105,76,84,114,197,123,163,354,159,68,161,128,147,132,63,115,124,76,77,154,74,214,64,137,148,63,134,89,108,114,88,106,130,233,216,56,117,128,108,150,90,167,80,165,120,92,86,87,81,79,119,99,235,174,64,54,139,85,242,67,63,98,83,90,107,38,1,190,92,66,71,72,60,100,139,112,10,95,189,98,15,155,65,133,185,26,64,121,201,165,57,144,121,100,133,65,53,176,112,45,32,67,42,79,50,86,68,82,92,31,105,33,80,72,72,52,59,26,45,47,99,22,106,65,129,61,85,80,180,15,53,86,51,54,38,147,89,46,67,82,75,52,65,59,61,49,45,26,47,163,46,25,84,76,58,74,62,84,31,1,0,89,71,96,24,40,43,20,76,111,102,74,110,37,6,71,58,15,66,30,68,70,64,147,79,44,71,133,73,211,46,66,47,55,70,3,32,65,52,81,35,166,41,14,75,52,50,66,2,105,49,70,2,94,42,37,114,93,41,22,59,74,54,118,82,51,32,90,37,48,52,34,86,49,68,27,0,21,21,30,69,62,14,53,28,58,67,32,39,53,49,29,0,41,38,168,75,105,61,56,102,87,21,32,53,20,123,24,40,29,60,46,9,100,69,58,23,53,72,23,39,45,70,5,50,107,45,103,83,87,9,52,79,22,80,28,70,25,30,42,49,52,66,52,38,75,42,41,70,1,66,92,20,25,87,50,71,68,59,122,0,143,30,28,28,53,28,24,82,123,44,40,37,5,59,50,37,6,52,36,26,24,18,25,43,46,36,44,37,25,57,20,20,39,69,71,31,53,2,82,58,47,12,14,58,19,24,22,46,40,19,69,30,31,58,130,83,21,18,0,0,32,24,36,34,29,85,42,5,36,54,27,14,45,25,11,24,32,36,20,73,88,63,96,8,44,17,171,33,0,36,44,31,46,43,41,24,37,23,65,36,38,3,35,0,58,41,24,81,61,60,2,70,2,17,73,49,42,4,33,98,23,56,54,34,38,38,27,21,22,30,40,29,36,25,33,27,32,66,32,6,36,22,25,30,26,23,25,15,17,31,5,47,38,40,3,55,69,36,41,31,44,12,20,22,106,17,26,19,23,40,67,32,33,9,3,23,29,47,77,10,12,41,32,34,22,19,47,1,17,30,24,25,49,83,9,39,38,3,4,17,69,24,8,16,49,25,28,5,137,8,6,20,10,58,18,65,7,33,8,30,25,48,45,36,21,4,13,0,22,29,53,18,20,46,17,29,23,77,35,59,13,6,33,12,40,2,33,33,6,0,27,6,41,19,67,39,33,11,28,119,30,44,23,48,41,43,5,31,25,2,1,50,44,12,9,9,27,34,37,14,51,22,32,44,0,8,13,0,32,20,37,1,28,33,10,32,21,57,29,21,0,39,14,73,61,7,6,25,12,13,0,3,33,35,14,50,63,99,76,8,0,24,49,34,19,34,12,0,48,2,25,18,35,48,17,38,40,19,27,32,15,20,34,15,8,13,7,35,29,65,490,49,33,22,28,24,19,48,17,70,23,54,19,35,0,22,0,31,10,45,25,63,25,28,24,11,33,15,26,7,0,36,33,21,28,36,30,6,36,34,23,8,44,19,21,19,8,28,55,10,23,33,1,22,35,37,4,1,45,26,22,9,75,0,33,25,0,3,61,48,19,7,42,14,3,40,39,26,57,20,24,13,7,1,67,8,0,3,100,28,0,10,6,18,12,23,62,18,13,0,20,20,0,19,0,18,0,74,59,2,0,1,15,12,18,18,3,4,20,39,1,8,16,4,21,6,0,35,3,52,25,2,43,4,12,32,10,36,8,30,12,10,57,13,22,6,15,35,12,19,17,0,13,41,26,53,0,11,0,38,17,8,30,17,48,0,2,44,38,2,8,0,0,1,1,22,15,13,21,3,0,4,25,1,17,6,7,10,3,2,27,18,6,25,0,50,12,8,10,19,15,52,13,7,8,18,13,11,37,68,14,17,36,3,17,12,25,0,4,6,13,41,25,44,40,2,34,37,15,116,39,2,3,10,1,46,20,25,43,47,64,13,45,31,13,9,21,12,22,72,22,30,15,21,0,22,36,13,12,15,22,15,18,7,13,3,24,0,6,5,13,1,4,77,20,36,44,35,45,3,5,25,0,13,25,71,6,23,9,0,7,36,0,29,65,0,30,8,128,8,12,0,26,12,0,19,34,57,6,22,13,15,8,0,14,31,51,9,0,0,33,20,11,20,2,34,4,53,139,18,34,17,36,41,99,145,25,7,0,1,45,5,16,20,9,35,0,1,2,0,7,21,15,10,13,6,24,1,57,20,8,0,16,22,0,5,34,1,16,12,0,17,17,1,3,0,7,0,24,40,22,0,12,4,21,19,23,23,23,9,5,13,9,0,15,17,26,16,20,10,21,3,1,11,43,18,30,14,14,4,12,26,2,15,2,2,14,2,19,18,72,22,26,34,11,1,0,6,10,14,18,14,13,2,31,17,5,1,22,7,8,4,16,30,35,1,0,8,3,2,41,13,1,41,9,8,24,20,19,23,19,20,0,0,12,15,0,25,1,14,4,18,25,4,19,27,0,8,0,0,12,0,0,6,0,10,56,27,22,18,21,44,20,8,15,11,5,1,3,12,0,20,0,0,0,0,10,0,20,2,0,7,1,23,35,13,8,0,13,18,25,6,50,141,4,8,11,18,10,2,0,23,8,23,18,0,6,2,36,26,11,21,17,14,2,3,21,11,38,3,8,27,11,16,28,0,8,44,0,15,1,26,5,5,29,8,0,2,24,17,0,5,8,20,3,7,21,0,3,26,8,4,7,11,17,9,25,0,15,23,11,3,7,6,20,6,22,32,13,0,1,10,14,34,0,0,0,0,15,0,15,8,3,14,4,7,0,24,14,1,0,2,5,12,29,22,4,36,41,11,14,4,42,2,8,6,3,25,0,10,3,6,13,88,10,13,11,10,18,9,0,34,3,27,25,23,14,36,7,8,9,19,17,13,17,21,6,14,1,77,3,5,13,13,27,20,0,13,28,31,7,44,17,2,20,11,7,24,13,0,6,173,9,0,38,3,12,17,9,38,0,9,5,0,0,0,26,15,11,14,11,33,9,18,9,2,1,19,4,0,7,0,43,8,7,8,0,4,14,9,18,7,4,18,2,7,2,23,10,12,15,0,7,15,6,28,9,0,0,4,6,19,5,0,18,18,6,12,13,0,10,5,5,9,16,9,2,2,4,11,0,18,22,1,36,34,32,4,11,0,12,2,9,18,9,23,6,50,0,0,19,48,10,1,0,23,9,0,2,21,0,16,5,37,5,18,6,4,14,31,24,32,0,2,12,0,3,15,12,10,2,0,27,8,12,26,8,8,0,18,8,17,19,11,2,38,0,4,17,8,15,29,9,2,11,35,6,0,8,7,21,31,6,10,13,32,28,2,26,0,23,13,27,21,6,14,87,10,24,11,18,1,1,14,5,0,10,20,2,4,11,11,2,5,0,7,13,10,25,1,5,4,10,20,14,0,18,9,25,3,6,11,3,7,0,5,1,20,8,26,7,7,12,19,26,26,5,8,26,14,0,5,22,29,22,0,0,12,2,1,2,0,0,0,40,26,21,5,20,9,5,0,17,3,14,0,16,20,7,14,5,0,2,21,19,11,6,8,0,61,7,1,8,7,20,16,36,1,2,0,13,2,37,13,10,0,29,9,6,9,2,18,38,0,6,31,13,3,11,8,1,17,8,5,12,0,3,39,0,7,4,1,7,0,37,10,5,0,6,17,3,3,5,1,5,11,0,20,15,14,70,8,11,16,0,0,1,15,16,17,0,19,6,0,13,0,8,0,0,17,12,0,8,0,5,0,29,0,24,1,3,0,4,6,11,0,21,1,5,1,15,5,12,4,1,3,6,17,13,1,7,5,24,3,23,0,0,0,10,9,17,12,9,1,12,11,18,22,4,12,6,7,4,8,1,5,5,3,2,0,0,3,4,12,0,5,14,0,12,4,27,0,4,5,9,3,10,6,5,12,4,12,11,12,25,18,2,2,0,15,41,4,0,2,3,10,6,10,7,23,7,8,7,14,54,2,1,8,8,8,11,16,15,2,7,8,13,5,66,9,23,10,16,24,4,3,7,5,31,20,8,11,8,0,4,8,8,0,0,12,25,3,2,6,4,1,40,11,6,0,1,0,7,5,21,2,21,6,28,0,0,14,10,1,0,6,21,10,6,0,1,2,9,15,9,4,10,8,0,2,9,0,0,32,0,8,8,0,0,1,3,12,16,19,8,16,4,0,11,11,22,5,8,2,4,12,3,11,17,0,20,0,3,7,13,0,0,21,0,12,1,32,19,0,31,1,0,17,12,12,9,0,5,1,0,4,0,12,0,0,11,2,10,13,0,0,0,11,5,4,7,3,10,0,14,9,0,9,4,1,16,3,2,0,5,0,1,9,20,0,0,20,19,4,13,9,12,7,0,2,4,4,3,15,7,13,0,2,9,10,8,9,4,7,1,4,10,8,6,4,0,2,0,11,1,18,8,2,9,20,8,5,11,10,8,4,11,4,20,10,7,6,0,2,1,12,3,1,4,4,29,8,1,2,0,1,14,2,5,20,16,25,0,10,10,15,11,2,3,7,3,1,5,7,3,13,12,2,2,1,22,20,8,16,0,6,7,5,24,3,1,3,1,14,12,12,6,12,10,6,2,6,9,0,9,0,3,11,8,20,14,13,20,2,19,1,19,0,0,4,16,5,27,2,1,12,8,2,0,4,7,0,0,27,14,5,15,6,0,0,9,2,4,8,6,8,12,3,9,6,0,33,10,10,5,3,0,0,0,10,10,2,24,0,4,0,7,69,0,3,1,1,5,2,4,5,24,7,7,6,1,4,17,8,24,3,0,0,5,9,9,10,16,22,3,1,5,2,0,28,1,0,13,7,2,4,8,1,0,12,11,2,0,6,9,34,5,11,12,15,14,6,1,0,12,0,0,5,0,17,8,13,5,9,13,3,13,0,7,21,0,4,3,3,14,12,2,0,3,1,2,1,0,0,3,14,6,5,10,1,1,1,16,1,5,0,7,0,7,17,0,10,21,7,6,10,5,13,6,11,8,5,18,1,4,7,27,4,14,0,0,0,0,6,10,0,0,0,2,0,16,1,4,5,3,2,8,0,2,1,1,1,11,1,10,7,1,11,3,2,3,13,0,2,0,2,1,2,9,26,2,5,9,1,0,0,0,1,1,12,16,0,1,1,1,3,2,2,0,1,4,0,10,3,0,0,9,0,0,19,1,0,10,5,19,8,6,15,19,5,1,0,4,20,4,4,8,5,13,2,0,8,6,17,5,12,1,3,23,9,3,7,0,11,14,44,0,11,2,8,0,3,1,0,2,9,1,39,11,5,12,12,7,3,9,0,2,1,7,1,6,5,0,2,17,1,1,0,4,10,3,18,0,0,8,9,0,6,0,4,10,0,1,5,15,0,2,2,22,17,7,11,2,4,0,5,27,15,0,8,8,7,3,2,2,16,6,2,2,1,7,16,2,1,0,4,5,9,0,3,0,11,13,17,2,12,12,4,12,0,1,1,1,3,1,12,2,2,7,0,1,1,5,19,4,9,7,0,1,8,0,2,0,5,0,9,7,4,0,6,11,0,10,6,0,1,4,6,0,9,3,6,2,0,0,0,2,10,1,9,0,3,3,5,10,3,9,0,2,3,17,6,11,7,4,0,38,9,0,0,8,4,0,0,0,14,6,0,1,0,1,5,0,4,3,4,0,4,2,1,4,1,8,2,6,0,3,0,0,24,21,2,4,1,6,16,10,15,8,3,0,12,1,10,1,4,0,13,9,1,10,7,8,5,3,3,3,9,5,7,11,2,0,3,10,8,5,0,15,1,3,9,3,0,1,2,2,6,26,6,5,14,2,8,9,2,2,0,3,0,4,6,8,1,0,4,10,4,7,3,1,7,33,0,7,3,5,9,23,3,2,1,3,12,2,0,0,0,13,3,5,3,15,3,7,0,111,4,4,0,0,7,6,3,0,1,7,0,5,4,5,2,1,0,11,17,9,0,2,8,1,2,1,1,7,0,6,1,10,11,18,5,8,0,3,6,5,21,0,12,2,0,0,0,0,4,4,3,20,0,5,3,0,6,0,5,0,4,0,5,8,3,0,1,6,28,5,14,10,15,0,0,0,0,0,6,0,7,7,4,6,0,10,3,0,0,12,3,8,15,2,0,3,14,2,0,3,2,2,7,0,8,11,10,14,2,1,1,10,0,11,4,3,1,1,1,16,5,2,0,9,4,7,0,4,0,0,14,11,10,1,10,10,0,1,10,9,10,15,0,3,0,17,3,0,5,1,0,0,4,10,0,2,2,2,0,3,8,0,8,6,0,4,4,0,2,9,0,4,1,6,2,12,2,1,0,0,18,6,5,2,2,0,1,0,17,13,11,1,3,1,5,4,4,4,4,9,5,1,0,0,3,3,2,3,0,1,0,9,2,3,1,9,2,2,4,3,0,0,24,8,3,6,0,7,1,6,2,1,0,1,0,3,25,26,12,3,0,2,1,3,22,6,8,2,48,0,4,1,0,4,1,3,0,8,6,0,3,24,7,5,4,1,0,5,0,0,5,9,9,3,9,7,4,0,3,2,0,9,2,0,6,8,13,1,1,0,5,6,0,14,10,3,1,0,3,1,6,8,4,1,0,19,7,7,11,1,8,5,2,0,2,0,7,8,1,7,3,14,3,0,6,17,0,0,0,3,8,0,6,4,7,0,2,0,25,24,5,6,0,0,6,5,0,8,0,0,0,14,1,4,3,2,6,12,14,6,7,0,1,1,1,3,1,8,7,3,21,2,0,0,1,13,5,10,7,3,2,9,5,1,0,0,10,0,3,2,0,7,1,0,5,1,6,5,9,4,22,7,1,0,0,14,0,4,31,4,9,7,4,1,9,0,2,3,3,3,5,0,0,0,3,1,4,6,4,0,0,27,18,0,4,1,4,1,0,5,1,6,0,0,7,5,10,5,3,6,1,0,3,10,6,1,3,0,4,12,1,0,2,6,10,0,5,1,6,3,4,5,1,3,0,0,0,3,6,0,1,1,0,3,8,3,17,3,2,0,9,8,6,2,1,18,1,4,9,4,7,0,1,1,0,0,4,0,2,6,1,4,11,1,1,7,1,0,5,1,4,0,1,2,2,0,5,4,0,2,0,0,6,1,2,0,0,5,1,0,3,0,5,3,4,0,0,0,2,0,9,5,2,0,5,0,1,0,4,0,21,4,7,6,3,11,0,8,0,20,1,29,1,1,0,13,6,3,0,8,6,2,40,2,1,7,2,0,7,0,7,13,1,5,0,2,3,0,0,5,0,4,11,0,2,0,5,8,1,9,3,3,2,1,0,2,6,15,15,9,0,5,10,0,10,2,8,1,0,0,2,12,0,3,0,6,0,3,3,2,14,0,4,0,12,0,0,0,19,5,1,3,0,6,22,14,4,4,7,24,2,8,3,1,0,5,1,14,10,5,13,1,2,0,6,3,11,0,4,0,0,0,0,0,4,0,7,3,10,16,7,6,1,5,7,14,4,0,0,1,0,12,0,7,10,10,0,0,0,1,5,3,0,7,3,2,10,0,18,3,0,0,7,1,12,5,0,16,2,1,4,2,22,1,2,3,2,0,3,1,0,10,1,0,6,1,2,1,4,1,1,2,1,13,0,1,0,12,3,7,4,0,1,0,2,34,11,1,3,0,12,5,8,3,0,1,1,5,13,0,4,6,2,1,11,6,3,3,0,0,0,1,5,1,2,2,2,6,1,7,7,20,5,13,0,6,3,0,5,1,12,0,5,3,5,2,8,1,1,1,8,0,4,0,15,2,10,0,9,16,0,1,0,1,42,5,11,1,12,1,13,4,0,2,2,12,1,8,1,2,0,13,6,6,0,0,9,0,12,0,0,8,7,0,3,4,1,1,0,0,3,0,3,0,5,5,8,2,1,4,3,0,0,0,6,0,5,6,0,5,1,0,0,3,11,0,0,2,3,0,5,1,4,1,1,2,3,5,3,2,2,1,10,1,2,6,3,0,6,0,1,0,2,0,1,12,3,6,4,2,0,0,8,4,11,0,9,10,0,6,8,9,0,22,3,0,3,6,5,9,17,5,7,7,11,0,4,2,10,12,0,1,0,0,2,1,5,0,0,1,2,5,0,6,0,6,1,1,4,1,1,2,1,0,1,4,2,4,7,3,3,0,0,3,1,5,3,0,7,14,0,2,8,3,0,0,2,7,0,4,2,1,0,1,4,2,0,3,7,2,1,2,0,3,1,0,2,7,4,6,9,1,0,0,2,0,1,0,0,6,3,5,2,0,5,7,0,8,2,5,10,3,3,10,0,0,2,3,0,3,5,2,6,0,1,1,1,6,5,0,2,5,0,3,10,0,5,9,0,2,2,0,0,9,5,1,1,0,1,1,13,8,11,3,2,3,1,7,0,0,8,3,8,2,0,4,2,5,0,0,1,2,5,12,2,0,9,0,5,2,0,5,3,0,3,2,2,2,11,5,2,2,10,1,1,14,1,5,13,0,3,0,2,8,1,0,1,3,20,2,6,0,0,1,0,4,13,0,3,0,0,0,1,3,2,25,3,3,0,3,4,1,10,12,2,5,3,0,1,8,0,2,3,4,4,0,0,1,3,7,4,4,9,0,4,5,22,19,11,1,0,0,5,2,1,3,1,0,13,24,7,0,0,3,2,0,6,5,14,3,3,0,10,1,0,0,0,2,0,3,0,2,1,1,0,1,1,19,0,7,8,34,4,0,0,3,1,11,0,1,0,1,0,0,1,5,0,2,1,1,3,22,8,5,0,0,2,0,0,1,2,0,8,0,0,0,4,0,0,0,16,1,1,6,1,0,4,3,5,0,1,0,11,2,0,6,3,32,4,4,4,0,0,0,2,3,8,0,8,0,3,3,0,3,5,1,0,2,1,7,4,3,29,1,2,0,7,18,10,2,3,0,10,1,0,0,1,1,0,7,0,0,1,3,2,4,2,0,7,0,10,1,0,7,7,1,1,3,6,2,0,0,2,5,10,3,0,3,6,1,2,0,4,10,0,2,4,7,0,4,9,1,1,3,4,13,4,13,0,0,5,0,0,0,0,11,2,4,4,4,0,7,3,1,9,0,12,2,2,0,1,3,3,8,0,0,3,3,4,1,7,6,2,0,2,4,5,5,0,0,2,1,0,0,0,9,9,15,0,3,4,2,17,8,5,0,9,6,2,0,6,6,1,0,1,8,11,5,0,1,2,0,6,6,6,1,0,0,0,3,2,2,0,0,0,0,8,2,2,3,12,6,4,7,3,2,6,0,7,7,4,5,6,0,7,4,0,6,14,3,0,3,3,1,2,0,1,0,6,0,0,0,0,0,0,0,2,1,4,2,2,2,8,3,2,0,3,0,0,6,11,10,1,1,2,2,1,1,4,0,0,16,1,6,3,2,2,2,3,13,0,4,1,6,0,4,1,4,1,3,0,3,9,4,0,6,11,21,4,2,2,2,9,5,1,2,0,3,11,2,0,5,3,4,1,5,6,0,2,0,2,0,2,82,0,4,0,0,0,1,13,3,0,281,2,12,5,0,0,0,0,9,36,4,0,0,6,0,1,1,5,3,2,80,5,8,0,4,5,0,4,4,0,0,5,1,1,0,5,5,3,2,5,9,0,0,24,1,5,6,3,2,2,1,4,4,0,3,2,8,0,5,10,0,4,1,3,2,0,0,38,1,0,0,2,2,0,1,9,2,4,2,0,16,0,2,0,0,0,0,0,5,0,11,5,0,2,0,0,2,1,4,0,3,1,18,0,0,0,0,0,32,0,6,0,3,83,2,1,3,1,7,1,0,0,3,0,8,5,0,0,0,4,6,14,5,0,4,16,1,64,0,15,0,0,4,2,1,3,1,10,2,4,0,0,1,0,0,3,1,3,2,5,12,3,4,0,1,1,2,3,7,2,0,7,3,0,1,0,8,0,0,3,10,5,0,1,2,4,0,5,0,4,0,9,3,7,1,2,0,4,2,4,4,3,7,1,0,9,2,1,1,0,1,0,8,0,1,0,0,2,1,5,4,2,1,9,2,0,0,2,7,0,7,0,10,2,0,0,0,1,0,0,1,2,1,3,0,3,9,2,5,0,7,0,10,3,1,3,9,0,4,0,2,0,0,1,1,0,18,5,2,0,0,12,0,0,3,4,14,3,9,5,8,0,1,0,13,2,2,1,1,2,0,4,1,10,2,1,1,1,6,2,0,0,0,9,1,1,3,0,0,0,3,0,0,3,0,0,1,0,101,0,0,3,3,0,0,1,0,1,1,2,0,0,1,2,1,0,8,2,0,0,0,0,3,5,0,0,0,1,2,5,3,3,0,0,5,4,7,3,4,8,2,5,4,2,0,61,0,0,0,0,0,0,0,0,10,7,3,1,7,0,3,0,1,0,4,1,3,0,2,9,0,4,2,0,3,0,4,0,1,0,0,4,0,1,0,1,0,4,0,0,1,5,0,0,0,0,2,0,0,2,5,1,1,4,0,1,0,3,2,8,0,0,0,0,0,0,0,0,0,1,0,0,0,0,0,2,0,0,0,0,0,0,0,0,0,0,0,0,0,0,0,0,1,0,0,0,0,0,0,0,4,2,1,0,0,0,0,0,0,0,0,0,0,0,0,0,0,0,0,1,0,0,0
K39 Bag of Bones,king,10806,5380,4517,4742,4320,6941,1384,3165,3545,3053,1874,826,2301,1723,2039,1879,1915,1270,1094,1060,1307,1438,1208,444,2129,680,1454,573,909,646,715,799,754,714,654,787,616,798,419,889,865,829,874,646,575,629,604,471,528,723,692,463,587,429,424,462,707,438,482,531,623,424,387,402,349,424,235,434,332,371,319,280,327,346,323,297,297,427,302,299,315,317,216,400,390,377,341,279,322,254,206,321,298,215,369,188,311,212,263,247,253,506,267,221,380,315,343,276,244,284,251,386,138,194,228,131,207,218,192,162,192,159,284,226,97,179,196,172,172,184,208,219,222,144,250,254,137,190,180,182,186,149,60,142,204,224,134,231,172,200,149,153,189,161,166,85,138,138,162,36,111,182,241,184,140,169,167,125,133,170,342,125,154,132,89,84,104,130,180,155,138,173,174,97,137,91,92,88,181,93,111,66,159,151,189,147,55,92,107,89,122,143,145,172,79,123,78,112,115,120,66,146,73,70,121,62,152,105,143,73,86,165,129,113,111,94,74,102,75,157,123,46,113,181,81,83,99,70,132,68,89,85,89,74,78,90,98,141,100,105,96,164,96,84,87,101,65,99,115,94,127,116,71,88,118,54,94,69,88,102,99,105,83,84,74,69,62,88,117,90,39,59,126,98,197,94,81,96,63,100,66,52,96,90,82,76,94,100,81,83,83,72,100,67,108,87,19,93,36,58,69,147,51,112,69,74,35,156,49,35,71,130,42,80,51,36,75,87,77,56,100,63,66,83,65,70,57,18,54,62,72,50,47,42,51,41,63,107,47,49,125,27,93,63,110,33,59,124,38,72,49,34,44,37,81,31,26,60,41,61,44,17,53,60,53,120,39,77,82,57,31,65,56,32,27,6,0,56,58,85,51,67,68,53,70,110,98,46,74,36,24,62,48,54,59,43,64,99,28,64,49,36,72,54,60,101,26,106,28,45,55,3,17,46,33,76,42,54,37,57,84,53,42,65,5,38,43,62,2,65,37,37,23,60,41,49,33,50,25,60,57,37,20,119,65,46,50,129,45,52,50,31,0,8,26,47,40,41,12,15,23,26,50,39,55,48,36,9,0,55,28,39,41,11,90,84,38,28,66,39,33,14,50,28,30,14,60,68,17,43,55,14,34,26,51,19,26,47,63,28,17,61,29,51,46,48,0,20,56,52,34,77,61,25,66,26,49,25,56,60,208,42,29,34,29,23,62,90,4,39,52,36,71,35,65,45,0,2,39,47,23,56,45,6,65,41,53,60,31,1,59,50,19,59,23,36,20,48,52,11,45,27,28,29,22,21,41,19,21,47,59,47,27,31,5,35,17,59,24,23,40,34,22,21,37,30,13,26,25,49,45,43,79,19,6,0,23,44,26,18,26,20,63,37,10,34,35,23,33,49,38,21,31,26,32,57,53,59,45,23,20,61,15,43,25,0,34,30,39,29,21,19,50,18,28,88,51,40,7,44,1,46,28,41,60,50,27,13,17,14,14,10,54,28,4,28,34,20,31,32,26,17,16,20,22,33,32,33,48,17,24,19,21,22,31,21,10,20,23,12,28,15,17,26,42,31,15,2,32,28,41,3,40,32,30,10,35,37,34,15,10,47,13,23,26,71,10,38,36,15,25,26,27,6,18,20,27,12,26,23,39,19,46,9,0,25,43,19,75,37,58,33,28,30,3,14,8,30,24,17,28,35,30,38,4,46,33,23,8,17,17,6,35,20,6,36,28,17,15,23,53,9,10,28,38,21,17,35,17,15,26,10,8,54,18,26,24,37,26,30,17,6,7,35,32,48,1,26,2,13,12,51,30,24,17,16,82,14,11,35,17,21,54,4,33,29,8,0,17,105,28,20,16,24,34,34,12,22,37,52,29,2,68,22,0,16,12,32,0,45,29,29,45,9,22,12,22,0,22,27,28,30,28,4,15,23,32,11,60,55,12,8,27,23,25,53,49,0,30,38,17,34,43,34,10,8,45,33,25,15,24,14,23,26,10,20,29,17,10,17,19,14,12,18,16,19,24,1,21,99,17,12,19,8,54,16,44,22,23,24,19,0,21,1,14,14,25,14,44,24,24,5,8,10,22,20,10,1,51,1,35,7,12,30,19,60,15,23,38,13,32,19,11,13,20,24,10,19,20,55,25,31,31,8,11,18,11,30,27,9,0,15,30,1,37,21,36,6,27,9,35,7,31,19,2,23,23,30,16,25,6,65,18,1,24,30,25,0,23,29,14,10,27,14,21,9,0,20,29,0,14,0,18,0,24,21,0,2,7,48,17,6,6,9,22,18,32,0,16,27,2,11,20,10,13,3,20,23,17,11,21,33,15,9,33,3,18,17,13,36,21,6,1,9,24,20,28,14,29,37,19,25,1,7,9,0,11,11,5,15,13,15,0,6,30,10,27,9,0,0,0,15,14,10,16,21,13,2,14,24,43,12,24,5,13,3,1,29,7,14,33,0,31,15,2,17,11,4,42,17,26,17,11,13,11,5,21,9,17,10,16,15,17,22,0,2,3,16,19,25,27,48,156,24,20,10,18,37,6,4,14,20,24,8,12,27,40,6,10,26,21,15,12,14,12,15,22,21,17,8,15,1,11,20,17,4,6,15,9,42,11,14,7,30,0,28,1,23,5,2,8,18,12,17,9,64,7,21,16,0,62,4,6,10,17,15,0,22,10,0,14,16,0,16,11,18,11,11,7,9,14,0,12,11,64,4,4,6,22,15,1,6,23,27,4,0,0,13,15,6,13,22,6,4,25,21,18,17,10,20,5,53,0,16,9,0,4,10,3,6,13,3,20,0,5,8,0,14,11,8,4,13,11,15,6,42,11,18,3,7,11,0,5,13,0,13,11,5,10,18,5,18,3,9,0,7,18,25,0,14,9,21,20,19,12,20,25,8,9,9,0,14,6,10,4,14,22,15,3,46,14,15,5,8,15,24,16,10,15,1,5,0,12,6,15,14,25,58,25,29,26,6,2,1,9,17,18,7,2,13,13,23,10,7,9,23,18,4,13,20,13,29,9,0,12,31,23,34,14,2,14,3,12,22,8,9,7,11,9,49,2,25,9,0,5,5,9,12,8,9,1,8,21,48,33,2,0,17,1,4,0,0,12,27,9,16,12,12,77,5,11,47,9,206,25,11,7,0,14,3,0,1,0,5,0,11,0,0,24,12,12,21,23,7,0,6,3,7,7,22,21,5,8,11,19,9,12,3,4,15,8,10,0,0,3,17,5,7,19,16,10,11,2,15,0,14,6,19,18,7,19,13,0,14,31,1,17,5,16,2,3,18,10,1,13,21,18,0,10,11,19,5,2,11,1,0,41,16,8,6,6,11,8,9,18,28,16,20,5,7,17,23,17,12,14,18,6,0,1,18,30,0,0,0,0,9,0,8,8,0,10,7,3,4,51,20,3,0,1,6,2,10,4,11,31,10,8,13,5,27,17,1,13,9,4,4,9,17,11,24,42,13,11,14,14,14,25,0,20,1,13,15,18,11,13,0,14,4,31,10,26,18,5,6,12,7,2,6,9,8,8,16,9,0,12,23,15,7,22,5,8,10,16,5,16,13,12,4,9,8,8,14,19,87,18,5,12,0,12,13,1,2,0,12,16,2,5,13,12,14,14,14,9,0,21,8,0,9,0,17,1,11,15,0,11,17,8,12,8,42,15,0,10,2,7,3,6,7,3,24,26,4,17,13,0,0,1,9,12,1,2,11,18,2,16,9,8,3,9,6,15,21,14,3,8,3,9,0,16,8,17,17,22,17,7,11,3,11,0,7,12,14,10,1,13,0,15,13,14,8,11,0,13,8,11,3,16,1,4,11,18,5,17,1,3,1,20,3,23,9,10,4,56,11,3,5,2,5,0,16,3,16,6,4,9,0,14,7,9,27,11,28,24,0,7,25,5,6,27,11,11,8,23,13,1,12,2,16,20,3,4,12,7,4,0,10,0,12,5,17,28,13,3,1,15,18,5,8,9,2,3,0,1,10,10,0,8,5,17,6,5,16,7,13,4,12,8,3,4,13,5,14,0,12,12,4,3,11,19,17,7,10,26,2,13,3,13,3,5,3,7,7,20,6,0,4,11,1,8,10,13,14,0,0,5,2,0,5,0,2,0,31,5,12,2,7,14,1,0,11,24,28,3,14,4,17,13,27,11,2,6,10,5,14,11,16,35,14,0,3,6,3,10,1,25,5,1,5,2,12,12,14,1,14,5,10,2,2,13,24,0,9,15,8,0,7,2,26,5,7,9,10,1,11,1,10,4,1,1,9,0,29,0,3,0,7,4,0,5,10,0,4,7,0,24,14,3,5,8,7,17,2,0,14,10,12,13,0,12,1,12,5,0,10,3,0,4,6,0,3,4,1,0,10,0,16,4,27,7,3,5,13,26,3,2,8,1,12,0,16,8,8,14,4,11,15,1,4,7,7,2,13,0,0,14,4,14,10,6,13,0,11,14,24,2,11,25,6,4,1,2,0,11,6,4,9,13,0,4,3,4,0,2,4,3,1,6,13,8,8,2,8,2,19,4,9,24,0,7,3,8,9,13,2,4,0,5,8,2,0,8,5,8,5,0,12,16,1,6,3,14,10,2,1,3,3,6,0,4,6,0,10,9,6,9,20,13,14,1,3,12,4,5,7,2,6,5,8,15,9,0,2,10,13,0,0,20,13,4,0,31,2,11,15,10,9,0,6,0,14,1,5,4,8,4,27,0,1,12,16,4,0,8,7,6,5,0,0,6,5,3,3,30,2,8,3,12,5,0,7,8,0,8,5,0,0,1,1,5,11,3,8,10,7,0,4,20,21,7,6,4,2,25,2,23,15,5,2,0,10,6,9,5,0,12,0,7,3,27,3,0,20,2,4,5,4,12,9,6,7,5,1,4,7,7,0,0,9,21,0,11,0,0,1,3,4,8,12,6,4,3,10,4,1,12,2,0,17,4,6,1,5,1,1,12,15,0,0,6,9,4,4,7,7,6,0,2,11,1,7,6,3,2,0,1,7,9,6,1,5,5,2,2,8,2,5,5,1,10,0,7,10,7,4,6,5,7,4,5,3,8,6,8,18,4,11,10,16,1,3,5,1,4,2,3,5,6,16,10,2,5,8,1,3,4,6,8,6,9,3,6,18,44,4,1,2,8,9,0,6,4,20,8,9,3,3,7,8,35,9,12,4,4,6,9,7,2,13,5,0,9,13,9,6,9,3,6,0,5,1,0,7,1,8,15,19,5,14,10,4,0,7,5,10,2,2,5,3,10,16,12,7,9,3,3,2,1,4,6,2,10,3,9,4,5,5,3,5,1,1,3,3,4,3,7,37,10,2,7,2,6,0,1,6,22,0,7,13,7,8,0,0,0,1,1,0,1,0,2,10,9,5,1,7,6,1,4,21,6,6,4,8,7,0,4,8,5,19,7,4,9,18,8,5,10,2,0,3,0,5,4,0,3,4,10,0,10,46,11,0,2,2,15,2,3,7,8,3,6,1,0,6,4,19,5,0,2,1,10,6,2,10,4,6,2,3,14,5,7,2,4,7,16,4,29,3,3,13,6,0,0,6,10,3,3,14,2,7,2,13,0,9,10,3,0,5,10,0,15,4,6,0,7,9,7,2,15,0,5,8,0,2,1,9,2,5,0,0,1,0,2,4,0,2,0,9,3,4,1,9,4,10,2,4,2,1,3,10,4,11,3,3,11,5,9,8,20,5,10,1,7,0,1,16,13,5,8,13,1,5,3,0,0,5,10,5,13,5,0,4,17,3,1,4,9,3,0,2,2,66,6,0,0,6,1,0,1,2,3,5,4,9,5,9,9,3,1,1,0,7,7,3,3,10,2,24,1,4,5,6,16,6,4,5,29,1,15,3,6,1,5,6,18,6,18,4,7,1,6,33,1,5,7,3,6,4,2,7,1,4,0,12,0,10,0,1,0,2,9,0,2,2,10,2,3,4,6,4,1,0,0,7,5,8,12,2,4,2,19,8,2,4,0,10,7,2,10,1,5,4,5,0,0,11,2,3,8,6,4,2,3,5,4,1,1,7,0,1,15,4,3,0,2,3,7,0,0,32,13,2,12,4,7,16,8,0,2,1,1,2,2,6,3,4,1,6,3,5,7,10,38,6,2,13,1,1,6,5,0,43,1,0,4,16,1,0,1,10,0,9,5,0,188,7,3,0,9,6,2,5,0,0,0,13,5,11,7,0,3,9,10,10,0,3,65,2,4,1,1,3,1,0,0,18,9,0,9,12,3,1,6,2,6,3,3,0,1,3,6,0,6,4,7,0,7,20,0,8,0,1,3,3,3,1,0,0,11,5,0,3,0,2,7,5,14,4,2,0,2,5,9,2,2,3,13,2,0,0,3,2,4,0,3,0,5,3,4,2,1,0,3,7,26,1,3,2,11,1,7,2,3,0,2,1,5,9,6,5,6,2,3,6,0,23,0,3,0,9,3,5,8,2,2,11,2,1,5,0,16,4,5,10,2,1,7,13,5,3,8,0,8,5,1,0,0,22,5,11,2,11,3,2,4,2,3,11,0,0,5,1,4,0,1,5,2,11,6,10,2,2,0,4,18,2,0,3,4,8,1,6,1,5,3,2,1,6,4,7,4,3,0,10,11,8,0,7,6,3,0,1,3,12,9,1,1,0,3,9,1,0,0,1,11,0,18,4,10,3,4,3,0,1,7,5,8,11,7,20,0,4,0,0,6,3,1,9,3,1,2,9,1,0,0,3,4,5,9,0,0,0,2,0,0,2,2,2,6,0,3,1,6,2,1,5,0,0,1,4,1,4,2,4,18,4,4,12,4,7,4,5,0,8,0,1,9,4,11,3,15,7,6,4,6,8,2,6,8,1,1,9,7,5,9,0,2,14,12,2,11,11,3,3,0,7,3,3,0,15,3,11,2,0,1,21,0,5,3,3,13,9,2,2,0,0,0,2,0,6,3,0,0,1,4,4,5,4,1,1,4,8,5,0,11,35,12,2,1,3,1,3,2,3,0,5,0,4,4,2,4,2,4,2,3,4,0,0,13,5,2,5,0,10,1,1,0,2,1,1,0,4,6,2,6,2,0,4,1,8,9,3,5,1,1,1,2,5,0,12,5,4,0,4,2,0,2,2,12,3,2,3,0,5,0,7,3,5,5,3,1,15,3,0,6,4,6,3,5,0,3,7,14,2,4,4,17,0,1,6,4,1,2,0,1,2,2,10,5,5,5,4,4,5,6,2,3,29,5,0,3,3,3,16,20,2,3,5,2,0,7,2,0,0,4,4,8,6,5,2,5,1,1,0,8,23,7,4,15,11,4,7,0,16,4,0,1,3,3,0,3,8,5,5,9,10,7,5,5,0,4,3,4,8,8,2,7,1,0,1,21,1,6,2,1,2,0,3,6,1,1,2,2,0,9,7,2,1,3,2,2,1,3,1,6,2,1,3,0,0,0,19,0,2,0,5,16,4,0,3,13,0,2,9,3,2,2,1,0,11,6,0,0,2,4,2,0,8,3,0,2,4,6,2,0,0,5,4,0,19,12,4,4,3,0,17,5,1,0,4,2,0,3,1,3,4,1,3,1,0,7,0,6,1,3,0,1,1,1,3,0,2,3,2,1,0,6,1,2,0,6,0,7,8,0,10,5,2,5,2,3,8,0,4,2,2,4,2,1,0,0,0,4,0,2,6,2,5,11,2,2,1,3,0,4,0,3,0,3,9,16,0,2,3,0,1,2,6,3,6,0,9,1,1,8,2,8,0,7,3,4,0,0,2,3,1,2,4,0,0,3,3,3,0,3,0,16,5,7,2,3,0,27,6,6,1,1,8,7,1,0,7,3,1,0,2,3,5,14,2,5,1,1,2,4,2,7,36,52,6,0,3,9,0,0,2,0,2,7,0,2,0,5,5,6,8,5,1,3,2,12,1,4,4,0,1,1,3,1,4,2,1,3,2,2,0,2,2,0,0,1,3,0,5,4,2,9,1,11,0,3,0,2,0,10,3,7,2,8,6,15,6,7,1,2,2,1,2,2,1,1,5,4,4,1,2,23,0,7,69,12,5,6,5,3,0,0,3,1,0,2,0,4,5,0,10,10,2,0,3,5,14,0,4,31,2,4,9,0,3,5,2,0,0,1,0,9,4,0,5,1,3,10,1,3,0,2,0,5,0,5,0,0,8,2,5,0,4,1,11,7,2,2,1,3,1,4,4,2,0,13,5,4,3,0,1,2,8,25,4,0,2,15,5,0,5,1,2,0,0,7,4,5,0,1,0,3,5,6,1,0,4,8,16,9,0,2,7,4,1,39,5,2,0,0,0,0,3,5,4,2,2,1,0,5,4,5,12,1,5,3,1,3,0,2,1,4,4,2,2,12,2,14,6,3,0,6,0,2,3,4,5,2,0,2,1,4,4,2,0,0,0,8,1,4,1,1,1,1,5,5,7,13,5,8,0,0,1,0,2,1,0,7,4,5,0,2,8,10,0,0,5,3,4,0,0,10,1,2,0,1,2,0,13,0,8,2,0,0,1,0,0,4,4,5,1,0,4,0,3,3,1,3,4,0,0,4,3,4,1,0,3,7,4,2,0,1,1,3,6,6,1,1,1,8,0,0,1,1,4,17,1,4,0,2,1,2,2,8,5,3,4,4,1,0,2,9,9,5,2,2,0,3,0,1,3,4,3,9,2,78,0,1,3,0,2,0,1,1,0,1,0,4,0,1,3,1,3,3,7,1,2,0,1,3,4,2,2,6,0,1,7,1,2,4,2,12,0,1,2,8,9,0,0,2,16,0,9,5,0,0,0,1,0,3,4,0,4,2,1,8,2,2,3,2,1,3,0,2,0,0,1,13,3,31,5,3,2,3,1,2,0,5,0,3,11,0,0,0,0,3,0,0,2,3,4,1,2,6,6,3,0,2,0,0,5,3,0,0,3,3,1,2,6,3,0,1,4,3,2,5,0,1,0,0,2,2,1,0,4,1,6,3,0,1,0,1,1,3,11,5,7,3,7,3,0,4,3,1,89,9,3,0,0,1,0,9,8,6,2,2,0,1,1,6,2,0,14,3,0,1,0,0,2,2,3,2,0,1,0,8,4,2,0,6,7,2,0,3,5,4,0,0,4,11,2,15,7,0,2,0,4,6,0,2,1,2,0,2,14,2,15,6,3,0,10,1,4,13,4,2,21,2,0,3,2,3,1,1,11,2,0,0,1,1,5,2,6,8,2,1,0,6,15,5,1,0,1,0,4,5,3,1,1,5,29,5,0,1,2,6,49,2,6,2,10,1,1,2,2,0,0,1,1,0,1,0,6,0,3,1,1,7,9,0,4,1,7,2,0,1,0,3,4,0,1,0,1,3,0,4,10,0,1,1,4,13,3,8,1,0,1,2,0,1,0,2,0,2,0,2,0,2,0,1,0,1,0,1,8,1,0,1,1,1,1,3,1,5,4,1,0,5,1,0,2,3,0,0,2,2,2,28,19,6,1,6,11,0,5,2,3,0,0,4,0,3,2,6,1,3,2,3,2,0,4,7,7,2,2,0,0,1,0,1,1,0,0,1,3,2,1,0,0,2,2,4,3,0,5,1,2,16,0,5,2,4,0,0,13,2,7,1,4,1,1,3,2,0,3,0,6,3,1,1,0,3,1,0,9,1,8,6,6,0,0,8,0,0,0,0,0,2,4,1,0,5,1,3,1,2,9,6,1,10,0,1,2,4,5,3,0,3,6,6,0,9,0,2,4,1,0,9,11,0,1,2,0,1,1,1,6,3,6,4,1,0,0,8,2,3,0,3,1,0,0,3,9,2,2,2,5,11,1,5,1,0,1,3,8,3,0,7,0,0,1,5,2,3,0,3,1,5,2,3,2,6,5,2,6,3,5,2,0,1,4,1,0,1,0,2,1,0,4,6,5,0,8,3,1,1,1,3,1,0,0,0,1,0,23,0,0,1,0,7,1,1,1,2,1,8,14,0,0,0,0,2,4,1,0,2,4,2,5,1,3,0,6,2,4,2,1,4,1,9,9,5,7,0,4,0,2,8,1,0,0,0,1,2,1,1,0,0,1,32,0,0,0,4,1,13,0,5,0,2,3,0,2,3,3,0,3,5,1,1,2,1,0,1,2,3,6,0,1,0,3,11,6,1,2,5,1,0,0,0,1,1,4,0,2,3,0,6,2,7,0,1,0,0,0,1,11,3,2,2,3,1,0,1,0,4,1,5,0,2,2,0,2,2,1,0,0,6,0,5,2,1,1,2,6,6,3,8,2,4,4,0,4,7,10,4,2,5,2,1,0,0,2,1,1,3,2,0,3,4,8,0,5,2,7,0,0,0,1,3,1,2,3,1,2,1,4,7,0,2,0,6,0,0,1,3,6,1,1,10,1,0,0,0,0,0,1,0,2,1,1,2,6,4,1,0,1,0,4,0,1,5,2,2,3,3,8,3,2,6,0,13,0,7,9,1,3,2,1,0,1,11,2,2,0,1,1,0,0,5,1,2,1,3,25,1,1,0,0,1,0,0,15,1,0,4,7,0,0,0,2,0,1,1,2,7,2,0,1,1,0,3,0,6,2,2,1,4,2,0,1,18,1,3,1,10,1,0,1,3,0,0,1,0,0,6,1,1,3,2,0,0,2,5,1,3,0,5,0,0,0,1,6,0,1,0,6,3,0,4,1,0,0,0,3,0,1,6,0,4,22,3,0,1,3,0,3,0,0,1,2,7,3,0,0,1,1,0,2,0,9,2,1,0,0,0,0,0,2,8,8,0,4,0,1,1,5,2,5,0,4,12,1,2,1,3,1,0,2,1,0,2,4,0,0,0,0,2,2,3,0,1,1,2,3,0,0,2,3,0,1,1,0,4,0,11,5,0,1,0,0,0,6,3,1,3,0,0,1,0,0,1,3,0,0,0,3,1,2,3,0,0,2,3,5,2,1,0,1,0,1,0,0,0,2,3,2,2,0,0,1,0,0,0,0,1,0,2,9,2,0,1,2,2,1,0,0,1,1,9,2,4,1,4,0,6,0,0,2,0,5,0,2,0,0,0,0,1,8,3,0,11,10,0,1,1,0,0,0,4,0,0,0,2,1,1,0,9,0,0,0,3,2,0,2,1,0,123,0,0,0,2,0,1,0,0,0,0,0,0,0,1,0,6,0,0,1,0,0,0,1,0,0,1,0,0,0,0,0,0,0,0,0,0,1,3,4,0,0,0,2,0,0,0,0,0,0,0,0,0,0,0,0,0,0,0,0
K40 The Girl Who Loved Tom Gordon,king,3421,2010,1370,1434,1445,180,259,928,1206,1083,316,164,610,2112,1895,553,721,430,298,192,392,494,362,85,43,276,68,179,294,64,244,298,166,208,238,153,274,274,24,257,211,267,287,228,103,227,202,168,238,212,250,195,209,175,103,143,178,65,94,168,171,63,71,198,60,117,86,154,26,112,84,43,71,82,114,136,83,128,84,70,111,60,25,120,117,142,111,23,114,99,32,76,94,117,54,55,127,62,53,66,53,203,68,68,140,92,136,169,38,102,81,67,6,99,88,7,94,48,73,33,30,10,63,106,13,30,60,44,57,31,88,86,27,51,72,58,7,71,60,44,15,45,10,12,72,61,32,70,28,55,37,55,65,63,61,17,18,43,67,3,33,80,90,90,50,126,38,39,37,74,3,9,50,27,9,39,21,47,66,53,28,52,13,35,40,23,31,31,78,18,20,33,44,20,40,48,31,12,8,25,21,74,40,47,39,3,24,52,69,51,54,46,9,29,43,25,35,48,39,36,35,41,28,38,27,38,19,14,11,40,33,37,47,82,26,55,21,26,41,18,16,4,39,17,34,35,21,76,18,45,35,107,25,45,65,16,10,20,49,30,17,20,34,34,43,4,16,19,21,37,44,21,41,28,19,17,14,28,30,16,12,5,41,15,68,6,28,18,20,27,26,4,4,6,21,18,39,17,3,25,27,21,14,22,70,13,6,40,24,5,20,3,11,23,16,32,25,67,28,5,20,45,20,3,87,9,69,28,9,32,46,34,24,33,51,26,26,2,4,11,8,7,11,1,7,39,26,8,33,7,48,18,18,38,59,5,9,34,8,13,12,6,2,3,21,5,15,21,9,12,76,5,18,7,12,45,9,0,28,8,4,22,7,4,20,7,0,12,11,31,3,19,2,16,15,25,39,16,19,4,9,18,18,7,9,9,18,18,17,11,22,12,49,10,28,39,16,51,10,13,24,0,1,1,10,22,9,4,18,7,36,12,5,21,1,6,9,10,0,18,4,7,2,15,2,12,21,7,6,21,23,8,1,27,2,14,20,3,16,20,6,17,0,2,8,3,18,3,0,10,11,35,14,0,24,4,36,0,0,22,11,6,16,5,4,20,30,11,6,3,22,14,31,6,15,3,32,18,0,24,18,5,0,11,20,9,9,10,12,1,11,32,14,21,10,12,0,13,12,13,19,4,18,3,13,16,11,1,13,12,1,28,13,5,4,0,25,18,5,6,25,2,33,7,18,14,0,3,11,7,38,4,4,3,29,5,22,17,4,0,6,6,6,8,11,6,19,78,18,6,2,4,9,12,10,11,15,1,4,9,26,20,1,24,0,21,2,22,12,4,6,12,7,1,12,5,5,23,4,18,31,12,35,12,11,0,0,20,6,6,5,1,30,9,2,10,6,2,1,20,6,6,5,8,15,15,2,19,30,1,3,17,2,2,4,0,13,19,21,14,7,4,35,6,14,12,21,4,0,15,0,18,7,7,28,12,27,0,21,1,3,9,13,16,2,8,8,4,3,5,11,7,1,3,2,16,2,5,6,1,6,13,4,4,10,12,1,8,11,8,11,7,3,9,4,8,2,0,15,16,11,2,14,5,10,18,3,20,5,7,5,15,1,11,3,11,4,14,6,4,15,10,5,1,13,10,9,8,5,2,15,6,16,7,0,12,0,9,16,6,35,4,2,1,0,1,5,5,6,7,10,81,7,8,0,16,4,0,3,3,13,12,11,1,2,11,3,8,1,4,5,3,0,1,0,3,5,4,10,7,10,5,8,12,17,15,5,2,9,6,21,4,1,14,3,1,0,6,0,9,5,0,1,5,9,5,30,8,3,8,4,11,15,1,17,7,4,0,15,5,1,0,4,6,8,26,5,6,6,8,11,11,136,8,0,6,12,1,0,6,7,11,20,8,31,0,0,0,10,9,11,25,5,5,1,6,1,3,0,15,6,3,4,21,22,14,1,2,8,25,7,17,15,1,0,1,2,9,8,4,7,6,13,10,2,4,21,3,2,6,7,7,4,0,3,4,6,2,9,15,12,9,11,3,0,2,15,3,13,0,5,0,15,0,1,6,5,1,18,2,6,1,1,7,1,8,2,0,26,8,5,1,1,0,1,1,1,7,1,17,4,2,4,6,4,6,3,6,1,11,1,6,6,3,1,11,0,11,1,0,0,1,8,0,0,6,2,0,1,0,2,25,10,1,0,11,4,2,6,2,2,12,8,1,1,7,17,0,9,1,5,2,6,17,5,3,1,6,13,0,9,0,3,0,25,5,0,9,1,9,0,5,0,0,1,5,23,1,6,7,0,3,7,0,2,0,7,5,18,3,4,0,16,2,5,2,10,9,3,25,11,2,1,5,11,2,12,9,0,3,13,5,5,2,1,0,1,5,0,5,2,9,0,0,31,0,2,1,0,0,0,0,6,7,0,4,0,0,0,4,4,0,8,1,7,5,1,6,5,0,1,0,2,11,1,3,6,1,23,2,1,20,0,4,0,1,9,3,2,6,6,4,4,6,0,2,4,3,11,4,5,14,2,5,8,2,16,12,1,3,3,53,4,2,6,11,14,3,2,8,8,0,0,10,2,18,9,1,1,6,2,0,2,4,7,3,0,2,1,1,0,2,2,7,0,0,1,9,2,1,0,1,5,3,4,9,4,2,4,0,0,1,2,1,5,1,0,2,7,0,5,4,0,8,3,1,3,3,1,11,0,0,4,4,30,3,0,1,15,0,0,0,17,9,2,0,0,4,5,2,13,2,2,3,16,7,4,5,0,2,0,8,2,3,4,0,0,29,9,8,2,3,5,0,1,4,0,0,5,1,1,2,6,6,1,38,2,1,0,77,30,0,3,7,0,3,5,6,4,6,0,0,0,1,0,2,3,2,0,34,2,5,7,5,5,10,3,0,4,4,0,0,6,3,3,9,1,3,2,5,10,1,4,6,8,2,2,3,1,1,0,0,3,6,0,5,8,23,6,1,1,4,0,0,1,11,9,2,4,2,1,29,1,0,0,13,2,0,3,6,15,12,0,1,0,6,2,8,5,0,1,5,1,9,11,0,0,2,4,0,1,2,6,0,3,2,6,2,1,6,0,8,13,2,0,3,0,2,0,0,0,0,1,26,3,19,3,6,2,12,4,16,9,1,1,2,0,0,1,1,0,0,0,10,0,3,2,0,0,0,6,5,1,3,3,2,5,1,1,4,8,0,1,1,1,2,0,0,2,4,7,3,0,0,0,10,1,1,3,19,9,0,0,6,0,6,0,5,7,0,2,1,0,7,1,0,24,0,7,1,3,6,1,0,3,8,11,0,1,1,0,2,2,9,0,4,5,8,1,4,0,3,0,2,0,6,1,3,0,1,5,20,2,6,2,0,0,0,1,21,9,1,0,0,0,9,0,2,0,0,4,1,0,6,3,4,0,0,0,1,40,1,2,1,9,3,2,10,3,6,0,2,0,3,3,0,2,0,1,10,3,2,4,2,5,6,8,0,1,0,11,3,10,0,0,3,3,24,13,0,4,4,7,0,2,0,0,4,1,2,3,35,10,0,6,2,5,2,9,3,2,8,0,1,0,1,1,4,0,4,0,2,12,0,3,7,1,0,3,9,0,0,0,4,3,1,4,3,4,1,8,9,0,0,12,1,0,3,0,6,0,2,13,0,0,4,1,1,0,1,1,2,0,1,1,1,1,0,0,12,4,0,3,2,76,0,0,1,1,1,4,0,3,0,2,2,0,0,0,2,10,6,6,1,7,3,4,0,4,1,1,5,3,3,0,3,0,2,2,5,25,4,6,1,5,9,0,3,4,1,1,0,7,0,0,0,6,0,4,0,9,1,8,0,1,1,6,0,4,1,0,0,0,1,2,3,0,0,0,6,0,0,8,3,3,10,5,0,10,2,3,24,9,0,0,5,0,0,12,1,0,2,7,1,0,1,7,3,1,1,2,3,0,0,0,7,0,8,5,5,11,0,1,0,1,5,1,3,2,0,2,0,0,3,0,0,0,0,0,1,0,12,0,4,0,2,7,1,1,1,5,4,0,3,0,0,0,0,14,6,22,0,0,3,0,0,5,2,0,0,4,3,2,2,0,5,3,2,3,3,1,3,0,0,2,0,0,0,0,0,0,12,4,3,0,7,11,0,0,3,0,3,0,5,0,5,7,10,1,1,4,3,6,5,1,0,8,4,1,0,2,4,2,0,0,3,0,9,0,14,2,4,0,4,1,2,0,1,12,7,0,2,3,0,0,3,2,1,2,0,1,3,0,1,2,0,1,0,0,0,0,7,1,1,0,0,0,1,109,1,0,4,2,0,0,1,1,1,6,4,2,0,7,0,1,5,0,1,1,3,0,1,0,3,9,0,0,2,0,1,2,0,0,10,0,0,2,0,0,1,1,3,1,0,1,1,0,0,2,10,3,0,0,0,4,1,3,0,0,4,6,1,0,0,2,1,1,1,3,5,0,5,5,3,0,2,16,2,2,0,2,0,2,0,2,0,10,0,1,4,2,0,2,3,0,1,3,2,0,2,2,2,1,10,0,1,1,0,1,1,0,1,4,0,0,0,1,1,2,0,1,0,0,1,1,6,6,0,2,0,1,1,0,0,5,1,1,2,16,5,3,5,0,3,0,4,0,0,0,0,8,2,0,1,0,3,0,1,15,0,0,0,3,1,0,0,2,0,1,4,2,0,2,2,6,3,0,0,0,1,1,2,0,1,0,9,0,0,5,1,1,0,2,2,1,1,0,0,1,2,1,2,0,0,0,1,0,3,0,0,0,0,0,10,0,0,0,1,1,1,5,4,2,2,0,3,5,11,2,2,7,2,8,0,3,5,0,1,0,0,1,0,0,0,4,0,3,1,17,7,0,2,0,0,7,1,3,3,0,0,3,1,1,0,1,0,0,0,0,0,1,0,0,0,5,0,17,2,0,0,1,0,1,0,0,6,1,5,0,0,0,2,0,0,6,0,0,0,2,6,0,3,1,3,1,0,1,0,1,3,4,1,2,0,0,6,1,4,3,1,0,1,0,8,0,2,0,0,12,0,0,1,9,3,0,1,3,0,8,2,2,4,0,9,0,3,5,2,2,0,0,0,0,1,0,1,3,1,0,0,1,0,0,0,0,0,1,1,3,0,0,7,0,0,0,0,3,0,1,3,6,0,0,4,0,0,1,1,6,1,0,1,2,5,1,1,6,2,0,0,1,1,0,7,1,3,0,0,2,3,0,1,0,5,0,8,0,9,3,1,0,0,0,17,2,0,1,2,0,1,9,1,2,0,0,1,5,1,3,0,4,1,1,5,0,0,0,20,0,1,2,1,0,4,0,6,3,0,36,0,2,1,0,1,0,0,3,2,1,4,0,0,0,0,0,0,1,1,1,1,0,1,0,1,0,0,0,0,2,6,1,6,1,0,0,1,2,5,0,0,1,14,1,1,0,0,0,0,0,1,0,0,1,2,0,0,0,2,6,0,1,1,11,3,3,0,7,0,0,0,0,1,9,0,2,0,2,1,1,2,5,3,0,5,0,0,1,0,0,0,4,2,6,2,0,2,0,11,0,0,0,0,5,1,2,0,2,0,0,0,2,0,0,2,0,5,10,0,3,1,2,0,2,2,5,1,5,1,1,5,0,1,0,0,0,1,0,0,4,0,0,2,0,0,0,0,0,2,0,1,1,1,2,1,2,2,0,0,1,3,0,0,5,11,1,2,1,5,2,1,1,0,1,1,0,3,4,2,0,4,1,0,0,0,0,4,4,1,0,3,3,1,0,1,1,3,12,1,0,9,0,0,0,1,0,0,0,0,1,2,0,5,1,1,1,4,0,1,2,0,1,2,0,3,3,2,0,0,3,7,2,1,6,1,0,103,42,3,1,4,0,0,2,0,4,2,4,0,0,2,0,0,1,0,0,5,0,1,0,2,0,0,0,0,0,0,0,1,2,0,1,0,0,4,0,2,1,2,2,0,13,4,1,1,0,0,0,11,1,1,0,0,1,3,5,4,9,0,3,1,1,0,0,0,0,0,3,6,3,1,0,0,0,2,0,0,2,1,5,0,0,0,1,0,2,0,0,2,1,0,0,1,5,9,2,2,0,1,0,0,0,1,6,0,0,2,0,0,2,2,2,1,3,0,0,0,3,0,0,4,0,0,2,13,0,0,0,1,1,0,1,0,4,0,0,0,1,4,0,7,0,0,1,0,3,0,4,0,2,2,0,5,0,2,0,0,0,1,3,1,0,0,0,1,1,0,2,1,1,0,0,0,3,3,1,0,1,1,1,0,1,0,0,0,0,0,3,2,1,8,1,2,2,1,0,0,5,2,0,0,0,1,1,0,6,3,0,0,0,11,1,0,4,0,1,0,1,0,0,0,5,3,0,0,2,0,5,0,1,0,0,3,8,0,0,0,0,0,0,0,0,0,1,0,1,7,1,1,1,1,0,2,0,0,0,2,0,9,0,2,1,1,0,16,0,1,0,0,1,0,0,3,2,0,0,0,0,0,8,0,3,0,0,0,0,12,0,1,2,2,1,0,0,0,0,8,0,0,0,0,0,0,1,1,2,0,2,1,1,0,0,0,2,0,0,2,1,0,2,1,0,4,2,2,0,5,0,0,0,0,0,0,1,0,4,0,2,0,1,0,0,1,0,1,0,0,0,11,2,0,0,0,2,0,3,0,0,1,1,0,0,1,2,0,12,4,0,0,0,0,0,0,5,0,1,2,1,1,0,0,0,0,0,4,8,2,8,0,0,0,1,0,0,2,0,1,1,0,1,0,0,8,2,0,0,5,0,7,0,0,0,0,0,3,0,0,0,2,0,4,0,0,1,0,0,3,6,0,1,2,0,0,0,7,0,9,1,0,0,3,0,7,13,0,0,1,0,1,2,1,5,0,0,1,0,0,0,2,0,4,0,0,1,30,0,0,0,4,0,7,0,2,0,1,0,0,1,0,0,1,0,0,8,3,4,0,0,1,0,0,1,0,2,3,1,3,0,1,0,2,0,2,0,0,0,1,1,1,1,1,2,1,0,2,1,0,1,0,0,0,0,0,0,0,0,0,0,0,0,1,3,0,1,0,0,0,1,3,1,0,0,0,0,1,0,0,0,4,1,1,0,4,5,0,1,0,0,2,1,1,0,1,0,0,4,1,2,0,8,50,2,0,2,3,4,1,1,0,7,2,0,0,2,0,2,2,0,2,4,1,0,0,0,0,7,4,0,1,0,5,2,2,3,0,6,7,0,0,0,54,0,4,0,1,0,2,0,0,3,2,0,0,1,0,4,1,1,4,1,0,1,0,0,0,1,0,0,0,1,0,0,8,0,0,0,0,2,1,0,0,1,2,5,0,2,0,1,0,0,0,1,1,4,0,1,2,0,0,0,3,0,1,0,0,1,3,3,3,0,0,2,0,9,30,1,1,0,0,1,1,1,3,0,1,0,0,0,0,0,13,0,0,0,15,3,0,1,0,3,0,0,1,0,0,1,0,0,0,0,1,0,2,4,0,0,8,2,2,1,0,0,5,0,0,0,1,0,0,7,3,2,2,0,6,2,0,1,2,1,0,0,0,1,0,1,0,1,5,0,0,1,5,0,0,0,0,0,5,0,0,0,0,2,0,1,0,2,1,0,0,2,0,0,0,3,7,2,1,1,8,0,0,0,0,0,0,0,1,0,0,0,0,3,0,0,1,2,1,0,0,1,0,0,0,0,0,0,4,0,0,0,0,0,0,0,0,1,1,0,1,0,0,0,1,0,0,1,0,0,0,0,0,3,1,0,0,2,0,0,0,0,0,0,0,2,3,0,0,1,0,0,0,0,1,0,3,0,0,0,2,0,1,1,1,6,1,2,0,8,3,1,1,2,0,2,1,0,0,0,0,0,0,0,0,0,1,1,0,0,0,1,0,1,2,1,0,1,0,1,1,1,2,0,1,0,0,0,1,0,1,2,0,0,0,1,0,0,0,0,0,0,1,1,0,2,0,2,0,2,0,0,0,0,1,1,0,0,1,31,5,2,0,0,1,0,0,1,2,2,0,0,1,0,0,4,0,0,0,0,0,6,0,1,0,0,1,0,0,0,0,2,4,0,2,0,1,0,2,1,4,1,0,2,0,0,0,0,1,7,0,0,0,0,0,2,0,0,0,0,0,0,1,8,1,0,0,1,0,1,0,0,1,0,0,1,3,0,0,1,1,0,0,4,0,0,2,0,0,3,0,0,1,0,0,0,1,0,1,5,0,0,4,0,0,3,0,1,0,1,0,3,0,0,0,0,1,1,0,0,1,0,0,3,2,1,0,1,0,13,2,0,1,0,0,0,2,0,4,1,0,0,1,2,0,0,1,0,0,0,0,1,0,1,0,2,1,0,2,0,1,3,2,1,0,0,0,0,0,2,0,4,0,1,1,1,1,0,0,0,2,4,0,1,0,3,2,0,0,0,0,0,0,0,0,0,0,1,0,0,0,3,2,6,0,0,6,3,0,2,2,0,0,0,0,8,1,1,0,0,0,0,1,0,2,0,0,0,1,0,0,2,1,0,0,0,1,0,0,0,0,1,1,0,0,1,0,1,0,0,1,1,7,1,0,0,0,0,0,1,5,1,1,4,1,1,0,1,0,1,2,1,0,4,1,0,5,1,2,2,0,2,2,0,0,4,4,0,0,0,0,0,3,0,2,0,0,0,3,2,0,0,1,0,1,4,0,1,0,0,1,2,2,1,2,0,1,0,0,0,3,0,0,0,0,25,0,0,1,0,2,0,4,0,0,0,2,1,0,0,1,0,0,4,1,0,0,2,1,0,0,0,0,0,2,1,0,1,0,6,2,0,0,7,1,0,0,1,0,0,0,1,1,7,1,1,0,1,0,0,0,3,0,2,1,1,0,0,0,3,1,0,0,0,1,1,0,0,5,0,0,2,1,0,0,0,0,0,0,3,0,0,1,0,0,0,3,1,0,0,0,0,0,0,0,2,0,0,0,0,1,0,0,1,0,1,3,2,3,1,1,0,1,0,0,14,6,1,0,1,0,0,0,0,0,0,0,2,1,0,0,0,0,3,1,0,0,3,0,1,0,0,0,1,11,1,0,2,0,3,6,1,1,6,1,0,0,7,1,0,0,0,0,2,0,3,11,0,0,0,0,0,0,0,3,0,0,0,0,1,6,1,1,0,0,0,0,15,0,0,1,0,0,0,2,0,0,0,0,0,0,0,0,0,3,0,0,2,0,0,3,3,0,5,0,0,0,1,1,1,2,0,0,3,15,0,0,0,0,1,0,4,0,0,0,0,0,1,1,0,0,0,4,0,9,0,2,0,0,0,3,0,3,0,0,0,0,2,0,1,1,0,2,0,0,0,0,0,0,0,3,0,0,0,0,0,1,3,0,0,0,0,0,0,1,1,0,0,0,2,0,0,0,1,0,3,0,0,3,1,0,1,0,0,0,1,0,0,0,0,0,0,0,0,3,0,0,0,2,0,3,0,2,1,0,2,1,0,0,0,0,0,3,0,0,0,0,11,0,0,0,1,1,0,0,4,1,2,0,0,0,1,0,0,0,1,0,2,0,0,1,0,1,0,0,1,2,0,1,2,0,0,0,0,0,1,0,0,4,1,0,0,0,0,1,0,0,1,2,0,2,1,5,0,1,0,1,0,0,0,0,5,1,1,0,0,0,2,0,1,0,0,2,0,0,0,0,1,0,0,0,3,0,0,0,0,0,0,5,10,1,0,2,0,0,5,1,2,0,1,1,5,0,0,0,0,0,0,0,0,1,0,0,0,0,0,0,3,0,1,0,0,0,3,0,0,1,1,0,1,0,3,11,0,0,1,0,0,0,2,0,0,0,0,0,0,1,0,0,1,0,0,0,9,0,0,41,0,3,0,1,1,0,0,3,0,2,2,1,1,0,0,2,3,1,0,1,0,0,1,0,0,0,0,0,0,0,0,0,0,0,0,0,5,0,0,0,3,0,0,2,0,0,0,3,1,0,0,0,0,0,1,0,0,0,1,3,3,1,0,1,0,0,0,2,2,5,0,0,0,0,1,0,0,0,0,1,2,0,1,0,1,1,0,0,0,0,0,2,0,0,1,1,1,0,0,0,0,0,0,3,5,1,2,0,0,0,0,6,0,0,0,0,0,0,6,1,0,0,0,0,2,0,0,0,0,0,0,5,0,0,1,0,0,0,0,1,1,0,0,4,0,1,0,1,0,2,0,0,0,0,1,0,0,0,0,0,1,1,1,0,1,0,2,1,0,1,0,1,2,0,1,1,0,0,0,2,0,1,0,3,0,0,0,0,0,0,0,2,0,0,0,0,0,0,1,2,0,3,0,1,0,0,1,0,0,0,0,0,1,0,3,0,2,0,3,0,0,0,0,1,0,0,0,1,0,4,0,1,1,1,0,0,0,1,3,1,0,0,0,3,0,1,0,0,0,1,0,1,3,1,0,0,0,0,0,1,1,1,1,1,0,0,0,1,1,0,0,0,0,1,0,0,0,2,0,0,0,3,0,0,0,1,0,7,1,6,1,0,1,0,0,0,0,1,0,0,0,1,5,3,0,1,1,0,0,0,8,0,1,1,3,0,0,0,1,0,2,0,0,0,0,0,0,0,0,1,0,0,0,3,0,2,1,0,0,1,0,0,0,1,5,1,0,0,0,2,1,0,3,0,0,0,0,0,0,0,0,0,0,1,0,0,0,0,0,0,0,1,1,0,0,0,2,1,0,0,0,0,0,0,1,0,0,0,0,0,0,0,4,0,0,0,1,0,2,0,0,1,1,0,0,3,0,0,1,1,0,0,0,0,0,0,0,1,0,1,0,0,0,2,2,2,0,0,0,0,0,0,0,0,0,0,1,0,0,2,0,0,3,0,0,0,0,0,0,1,0,0,0,0,7,1,0,0,0,0,0,0,0,1,3,1,1,0,5,0,1,5,0,0,0,1,0,1,1,3,0,0,1,2,0,0,0,0,4,0,0,0,0,2,0,1,0,0,0,0,0,0,0,0,0,0,0,0,0,0,0,0,0,0,0,3,0,0,0,2,0,0,1,0,0,0,2,0,3,0,0,0,1,0,0,0,0,0,0,0,0,1,0,0,2,0,0,0,0,0,0,0,0,0,0,0,0,0,0,0,1,0,0,0,0,0,0,0,0,0,7,0,0,0,0,0,0,0,0,0,0,0,0,1,0,0,0,0,0,0,0,0,0,0,0,0,0,0,0,0,0,0,0,0,0,0,0,0,0,0,0,0,0,0
K41 Low Men in Yellow Coats,king,4316,2372,1932,2138,1727,709,1926,1268,1543,1193,1063,1437,852,747,868,797,823,627,531,585,669,687,518,582,145,329,226,435,434,180,341,405,360,351,275,314,352,348,78,366,418,443,321,290,251,281,262,223,317,288,349,316,282,211,175,212,241,193,220,226,225,228,169,228,246,174,165,160,155,189,139,109,149,134,126,114,130,277,112,136,124,116,115,157,142,246,124,65,173,116,87,198,135,63,163,88,160,119,169,96,120,241,146,100,212,114,132,156,113,117,113,146,47,91,104,74,104,97,112,71,135,66,122,163,89,85,63,126,106,89,111,107,78,65,127,100,17,86,79,63,41,74,111,69,76,113,68,78,68,72,81,61,92,69,73,43,33,59,110,69,53,74,114,58,75,50,69,52,78,108,37,34,81,85,39,29,50,42,74,89,51,59,76,27,77,80,53,39,75,35,51,28,66,54,50,68,35,30,22,43,39,77,63,63,33,131,44,37,70,91,154,43,114,28,55,39,46,56,68,43,63,40,47,57,48,39,30,44,30,83,62,31,42,84,53,32,52,47,36,36,24,17,48,29,37,44,33,62,27,15,61,15,32,41,39,53,26,39,53,39,29,38,45,36,66,31,23,28,28,34,40,44,37,30,40,11,19,44,77,31,31,39,43,37,118,97,16,39,18,26,42,24,23,28,35,23,35,31,29,59,58,27,42,14,63,22,59,28,27,26,29,9,12,45,32,33,6,55,32,9,25,44,21,61,10,55,30,57,64,32,48,23,26,44,3,36,14,18,44,32,27,20,33,13,28,8,31,57,29,39,44,25,30,33,49,10,15,48,24,21,24,32,17,14,15,36,19,19,27,13,38,2,28,17,21,54,5,3,74,24,23,49,18,27,12,12,0,28,36,35,21,26,24,58,21,37,27,14,32,14,42,35,23,28,13,15,28,43,14,20,31,25,20,40,20,38,2,50,12,19,31,4,20,22,15,13,11,23,17,21,37,20,18,19,9,6,10,16,4,37,20,21,14,9,21,14,31,21,10,21,47,7,13,40,20,21,29,36,22,21,35,7,4,7,11,38,19,23,5,15,4,20,22,11,14,17,5,6,0,26,9,45,39,5,7,37,16,12,36,12,19,12,22,8,13,7,22,20,3,20,22,8,25,12,15,7,15,18,12,2,12,56,18,21,38,15,0,22,35,23,43,7,25,34,23,16,34,9,13,29,66,18,4,9,21,7,17,32,4,16,16,12,18,65,21,8,2,1,17,11,21,22,39,6,25,37,23,24,12,36,12,40,13,68,12,29,18,11,35,6,29,8,15,16,25,10,9,5,24,24,17,17,17,11,16,109,16,25,10,3,14,17,10,6,11,18,5,14,12,13,48,7,36,4,1,0,67,22,7,9,6,11,24,15,3,16,23,8,12,12,14,2,17,22,18,43,8,15,19,10,6,20,5,75,11,0,18,11,22,9,12,7,32,6,51,39,17,28,1,25,0,17,15,12,2,30,2,2,16,4,6,6,15,9,5,11,21,22,17,7,16,5,2,8,12,18,11,4,9,5,14,19,8,5,27,17,7,12,17,12,9,6,5,70,18,8,8,1,16,4,15,2,12,13,11,2,1,13,10,3,4,18,5,10,8,57,11,16,16,16,7,6,3,2,12,12,7,3,3,17,9,15,1,2,0,29,11,12,3,14,19,10,5,3,0,1,1,25,9,22,9,8,6,8,0,17,10,5,10,61,26,4,21,4,4,58,8,11,11,15,18,10,15,15,0,0,4,23,14,9,5,3,5,16,15,11,18,28,7,10,14,19,2,9,7,44,0,5,2,8,5,12,2,14,7,6,36,4,5,12,5,4,12,6,13,12,2,1,25,35,10,9,2,6,27,20,6,1,13,3,13,0,1,11,15,13,2,14,0,6,44,9,10,9,13,5,10,0,22,8,14,20,15,3,5,9,0,0,4,16,5,7,10,11,9,9,11,0,14,12,8,14,10,1,0,25,5,14,5,7,13,4,9,19,6,7,8,6,9,5,8,5,6,6,10,4,6,9,3,15,14,49,7,3,11,11,22,6,15,6,13,0,12,0,1,0,8,10,11,8,22,2,5,9,5,5,1,1,21,0,2,10,7,0,3,8,14,18,7,13,18,4,24,10,1,0,0,5,8,6,5,8,7,16,3,7,34,11,6,26,0,10,13,0,14,10,4,10,3,6,2,2,15,8,5,13,8,14,2,0,0,24,18,2,8,25,9,0,5,13,5,1,13,8,6,7,1,4,19,0,6,0,8,0,7,15,0,0,7,10,3,0,0,3,22,4,10,2,3,13,0,8,8,1,18,2,4,2,12,15,4,6,10,2,6,10,26,34,3,21,9,12,1,4,19,9,15,4,17,22,6,31,5,3,14,0,4,6,5,8,5,7,0,1,12,2,18,4,0,0,0,4,8,1,51,5,2,0,3,7,1,5,4,6,3,3,2,3,3,0,2,0,10,7,0,8,6,6,23,2,8,4,6,9,4,11,18,11,2,5,6,0,3,9,0,0,3,4,11,3,11,20,12,8,11,5,7,4,10,2,8,140,2,23,4,10,15,13,0,21,10,8,1,7,4,2,25,4,0,6,4,0,7,6,8,0,2,7,1,10,3,2,2,18,0,0,1,15,0,8,0,3,14,3,4,18,23,10,5,2,8,2,2,1,23,16,0,2,18,0,6,10,0,7,0,5,3,22,0,5,39,0,4,2,23,0,0,1,8,9,0,1,11,4,4,0,0,5,11,2,3,0,9,2,29,11,2,3,2,9,4,7,0,4,5,0,2,10,1,8,20,6,11,0,1,2,0,2,1,1,2,5,2,6,0,8,9,3,0,5,17,0,8,17,0,2,5,12,8,4,0,7,19,1,0,3,7,4,0,15,2,2,9,0,9,9,31,5,6,1,0,4,5,8,7,9,4,6,0,22,8,8,5,3,2,22,4,2,13,4,5,0,6,11,0,7,11,30,14,13,8,7,0,0,7,5,1,5,0,11,0,0,3,6,1,10,4,1,1,4,12,7,2,0,2,25,4,22,3,4,5,1,7,4,5,2,6,7,5,0,3,0,9,0,11,2,2,2,11,6,1,5,8,1,0,0,0,5,0,6,0,0,3,24,6,7,0,1,9,7,9,15,5,3,2,3,3,0,7,1,0,3,0,5,0,1,1,0,4,16,16,6,4,8,0,7,1,1,9,18,6,4,1,6,2,5,2,1,0,11,6,6,0,0,2,10,3,1,2,3,6,1,2,11,1,15,2,7,8,3,6,8,0,5,13,0,3,4,6,0,7,13,6,0,5,10,12,1,6,3,4,3,6,2,0,0,4,30,3,3,5,7,2,6,0,4,1,7,0,8,9,8,0,8,4,1,0,2,5,1,10,1,1,0,0,2,0,4,2,21,4,1,3,1,3,6,5,0,2,2,0,2,11,5,15,15,4,5,4,16,1,2,2,2,6,2,3,0,1,8,13,4,7,6,7,3,5,1,8,3,9,23,9,1,9,9,2,1,7,7,5,5,5,4,9,0,3,5,8,11,1,5,6,0,10,19,12,0,7,2,4,5,6,2,2,2,4,3,2,11,0,6,19,16,1,3,0,0,7,1,0,0,0,5,2,3,1,4,14,10,4,4,6,1,7,5,0,5,1,13,0,10,6,0,1,5,1,3,1,1,3,31,1,4,2,2,2,2,0,6,6,1,7,7,3,4,3,3,7,0,3,13,10,3,5,8,2,5,2,3,7,4,0,0,6,0,4,0,9,3,6,5,4,5,1,9,0,2,3,5,0,3,3,5,2,0,0,4,1,2,4,0,8,2,0,8,8,2,2,2,9,0,3,0,0,0,14,0,7,0,2,4,2,5,3,1,0,3,0,9,3,3,3,2,1,0,6,0,9,1,3,2,10,0,4,5,5,2,9,6,0,7,10,3,0,13,1,2,7,1,5,1,2,28,0,6,0,5,1,13,5,10,3,3,1,12,17,0,5,0,1,1,18,5,3,0,0,3,1,1,19,22,0,2,4,5,1,0,5,0,7,1,0,7,1,2,1,4,8,14,1,0,14,1,1,2,5,3,10,4,5,7,27,5,0,1,1,1,4,10,4,10,0,0,13,4,0,0,0,2,0,13,5,4,2,9,5,3,0,3,1,5,2,3,0,4,5,4,6,0,2,13,5,2,4,29,22,2,6,0,4,1,4,0,5,0,0,2,16,9,0,1,0,1,0,2,1,17,9,0,0,1,8,7,0,38,1,2,5,7,4,6,0,2,2,0,6,0,0,4,0,18,4,0,0,1,2,0,1,0,0,1,0,4,5,5,1,7,2,3,2,1,0,17,10,4,0,0,5,0,0,8,0,0,3,0,5,5,0,0,1,1,0,7,0,4,4,1,14,1,0,8,1,2,8,2,0,2,1,0,3,1,3,1,2,0,4,3,1,4,3,14,0,0,0,2,1,2,5,3,4,5,4,2,1,5,0,5,0,1,0,3,1,2,2,1,7,0,3,1,4,0,2,1,0,6,5,8,0,33,0,7,5,4,0,3,3,0,0,3,2,1,6,4,1,0,5,1,0,0,4,1,2,7,7,5,1,0,1,2,9,4,0,0,4,2,0,1,6,0,2,1,1,3,5,7,16,11,3,2,13,1,5,2,0,4,2,2,7,5,0,0,7,1,0,0,17,6,29,0,12,2,7,7,4,0,0,0,0,1,2,1,1,6,0,6,0,0,6,2,0,0,2,0,0,2,0,0,1,0,7,4,1,0,0,1,2,4,0,9,17,0,2,2,0,0,0,1,1,3,5,3,6,1,0,2,10,4,3,1,0,1,2,0,7,4,0,0,0,1,0,3,0,0,5,0,4,0,5,5,0,8,1,0,7,6,4,1,1,1,1,0,5,0,2,0,0,4,1,1,2,0,0,5,1,2,5,0,2,1,1,13,1,0,1,3,1,6,2,0,0,4,0,0,2,2,0,0,2,6,1,2,4,2,2,0,0,3,0,4,4,0,1,0,2,2,2,7,2,0,2,0,0,2,5,4,1,0,3,0,7,0,6,0,2,0,2,3,1,5,2,3,14,3,7,3,1,19,4,0,3,0,1,1,1,4,3,5,5,0,2,2,0,0,0,0,3,1,9,2,0,2,1,4,1,0,5,1,3,11,0,1,2,5,0,6,1,2,11,3,2,0,2,0,1,5,0,3,10,0,3,6,0,1,2,0,3,1,2,2,0,11,0,6,0,8,2,2,3,0,0,6,10,9,0,0,0,3,0,6,7,7,2,0,0,0,1,1,0,1,6,6,2,7,3,0,7,1,2,1,2,0,7,4,1,2,4,0,1,2,3,0,14,1,4,0,2,1,0,0,0,0,0,1,6,0,0,2,1,3,1,0,1,4,1,4,2,4,1,0,1,9,0,0,0,13,3,1,6,2,2,28,4,0,0,0,3,0,0,1,2,0,5,6,0,0,2,5,1,1,1,1,15,0,3,0,2,1,2,1,0,3,22,0,3,0,1,1,0,2,2,2,2,3,0,0,0,1,9,1,2,3,4,2,3,0,9,1,0,0,0,12,5,3,2,2,3,1,1,1,0,3,4,0,0,2,5,0,0,2,1,1,3,0,4,2,7,1,1,5,0,0,0,1,1,1,0,0,10,0,1,7,0,3,0,4,3,0,1,6,1,0,1,6,1,0,2,19,0,0,1,0,3,7,2,2,5,1,5,0,0,0,0,1,2,4,3,2,1,4,0,0,0,0,1,2,7,0,0,0,0,1,0,1,3,2,0,1,0,1,3,0,0,6,2,0,2,1,0,2,0,5,0,1,2,3,0,0,0,1,7,0,1,0,0,2,0,2,1,3,5,1,7,0,3,2,2,0,1,0,1,0,6,3,5,2,9,0,0,10,0,1,1,2,1,6,1,2,1,2,1,3,0,4,0,1,0,2,4,0,1,9,1,3,0,8,1,3,0,0,0,3,3,4,4,2,1,27,8,2,3,3,0,2,2,5,4,0,1,0,4,0,0,0,0,3,1,2,0,1,6,2,3,5,0,11,1,1,2,1,0,0,1,3,1,0,2,9,4,3,5,3,9,5,1,1,0,0,7,2,0,1,2,1,5,2,0,1,0,1,2,1,4,1,1,3,4,0,0,2,1,0,4,2,0,0,0,0,1,0,0,2,1,0,4,0,0,1,3,0,0,0,0,3,0,0,1,0,4,2,0,3,1,3,0,1,9,0,0,4,4,0,0,5,0,0,13,0,0,0,4,0,1,3,1,0,1,0,2,1,4,3,7,0,0,0,1,4,0,1,0,0,1,1,0,0,3,0,4,4,0,0,6,4,2,1,0,0,1,1,2,0,4,2,0,2,0,2,0,3,4,0,0,0,1,0,5,4,0,0,0,1,1,0,0,2,4,1,1,0,0,0,0,0,3,11,1,0,5,3,3,3,0,5,0,0,0,3,0,0,0,0,0,2,4,0,11,0,1,3,3,4,0,0,4,0,4,5,3,0,4,0,0,0,0,1,3,0,1,1,0,0,2,1,0,1,0,0,0,0,0,0,3,2,1,1,0,0,5,1,1,0,4,1,0,1,1,0,0,1,0,0,6,3,0,3,2,3,3,2,0,1,0,2,0,4,2,0,1,0,0,2,1,3,0,0,2,0,1,0,2,0,0,0,3,5,0,8,4,0,0,1,1,3,1,2,5,3,0,16,0,0,3,0,2,2,2,1,0,3,1,0,0,5,4,2,0,1,0,0,2,0,0,1,0,0,4,0,1,0,5,0,2,4,0,3,0,2,0,1,1,0,1,11,0,2,2,5,0,1,0,5,0,1,1,1,3,0,4,0,2,1,4,2,0,3,1,3,0,7,6,1,0,0,44,3,2,3,0,1,2,0,0,3,1,1,0,1,1,0,0,0,0,2,0,0,3,2,6,6,1,1,0,1,0,4,0,0,2,0,0,0,2,1,1,1,0,0,2,2,0,0,0,6,1,0,0,15,0,2,0,0,0,0,0,0,1,0,2,5,0,0,0,2,2,5,4,0,2,10,0,1,0,1,0,1,5,33,0,8,2,3,3,0,21,2,1,0,1,1,1,0,3,0,1,0,0,1,0,2,0,1,0,0,1,2,3,3,2,2,0,0,0,0,0,1,3,0,1,0,1,0,2,1,1,3,0,0,3,2,3,1,0,1,1,1,0,3,1,3,2,0,0,1,0,3,3,1,0,3,2,3,1,1,4,4,0,0,0,4,0,9,1,0,2,2,0,1,4,0,0,0,7,0,2,3,2,0,1,0,0,0,1,4,0,1,0,1,3,1,0,0,0,0,0,0,5,2,0,0,1,2,3,9,2,2,0,0,0,3,0,2,2,0,3,2,0,0,6,0,2,0,0,0,2,1,2,0,0,0,0,0,10,15,0,3,0,0,0,1,4,2,3,2,2,6,0,0,0,5,0,1,0,3,1,5,1,5,3,0,1,2,2,1,1,3,0,1,0,4,1,3,1,0,0,2,7,1,3,0,4,1,1,9,1,7,0,0,3,2,2,3,0,1,4,0,0,2,0,0,1,0,1,3,0,3,0,2,1,0,3,1,5,2,1,1,0,4,0,0,1,0,5,1,0,2,0,1,0,0,2,0,1,0,2,0,4,0,2,4,0,0,2,4,0,1,2,0,0,0,0,0,1,0,0,2,1,1,2,1,0,1,0,0,2,0,0,5,0,0,2,1,0,0,0,2,2,3,1,11,0,0,4,0,0,0,3,2,1,1,0,590,0,0,2,2,0,0,3,0,1,0,2,0,5,0,2,0,2,2,2,0,0,1,1,4,0,1,0,0,4,1,0,0,2,0,0,0,0,0,1,0,2,0,7,1,0,2,0,1,1,0,0,2,0,1,2,0,2,0,1,2,5,3,2,2,0,0,2,1,3,1,0,1,0,2,2,1,0,2,1,0,0,0,2,0,0,0,8,1,0,0,0,3,0,0,5,0,4,0,0,0,4,7,2,1,1,5,1,3,2,1,2,7,1,0,0,0,0,0,0,1,1,0,7,0,14,0,0,5,0,6,2,1,0,0,1,0,0,0,2,0,0,0,6,1,2,0,0,1,2,1,5,0,0,5,0,0,3,1,2,0,0,0,3,1,0,1,0,1,1,0,9,1,0,0,3,2,0,0,0,3,0,1,0,2,2,1,3,0,1,0,1,1,0,6,3,14,4,1,0,1,0,0,0,2,0,8,0,1,2,2,10,0,2,0,0,0,1,5,2,0,0,0,1,1,1,0,0,3,2,0,2,0,5,3,0,0,0,2,0,2,0,0,0,2,1,3,0,0,3,1,0,0,2,4,1,2,2,0,0,0,0,0,0,2,3,3,1,0,5,0,1,3,7,0,1,3,8,0,3,0,0,0,2,2,1,0,0,2,1,1,0,0,3,1,0,0,0,2,2,1,1,1,2,0,0,3,0,0,1,2,2,0,6,0,3,0,0,1,1,0,0,0,0,2,1,0,1,0,0,0,0,0,2,0,0,0,0,0,6,0,6,0,1,3,0,1,1,0,1,1,3,0,2,1,1,0,0,0,0,4,0,0,3,0,2,0,0,1,0,2,2,0,0,0,1,0,0,1,1,1,0,1,0,3,0,1,1,0,4,1,1,0,4,1,2,0,1,0,1,0,0,3,0,1,1,2,3,0,0,1,1,1,0,0,0,0,0,1,0,0,1,0,0,1,7,0,0,0,0,0,2,0,0,4,7,2,0,1,0,8,0,1,0,0,0,0,2,1,0,0,3,1,0,3,2,0,0,0,1,1,1,1,0,0,0,0,0,3,0,0,1,1,0,0,1,1,0,0,2,1,2,0,1,0,0,0,2,0,2,0,7,2,0,0,4,0,1,1,0,1,0,7,0,0,0,0,0,0,20,1,0,0,2,0,0,0,3,1,0,1,2,0,0,2,0,0,1,0,0,2,0,0,0,2,0,1,0,3,1,0,0,0,4,1,6,3,0,0,1,0,2,0,0,6,1,0,0,10,2,0,3,0,0,0,2,3,0,0,0,2,0,5,0,2,1,0,2,0,0,0,5,0,0,0,1,1,3,4,1,1,6,1,0,0,1,1,4,0,0,1,5,0,2,1,0,0,0,0,3,0,3,0,0,0,0,0,0,1,0,2,0,1,0,0,3,0,2,6,0,0,0,3,0,1,1,0,3,0,0,0,0,0,0,2,1,1,2,2,1,0,3,0,0,0,1,1,2,0,0,0,1,11,5,1,0,0,1,0,1,1,1,10,1,0,4,1,0,0,0,1,0,2,0,3,0,0,1,22,5,2,0,1,0,5,0,0,1,2,0,1,0,0,0,0,0,1,0,3,0,1,0,9,7,0,1,1,0,2,1,0,0,3,0,0,0,0,0,0,0,0,0,1,0,0,0,2,0,0,0,1,0,1,1,0,2,4,0,0,1,0,1,0,0,0,0,3,0,0,2,0,0,5,0,2,0,1,0,1,0,0,0,0,2,3,2,213,0,0,0,2,8,3,1,1,3,1,0,0,1,0,0,2,0,1,2,1,0,5,1,0,0,1,1,0,0,1,3,2,0,0,3,0,0,0,0,1,0,2,0,0,0,0,4,0,0,1,0,1,1,8,0,1,3,1,0,1,1,6,1,4,0,0,2,0,0,0,0,1,4,0,0,0,7,1,0,2,0,0,0,0,2,0,0,2,0,1,0,1,0,2,2,1,2,4,1,6,0,1,0,1,0,1,0,0,0,0,3,0,0,0,1,0,0,0,1,1,1,1,2,2,0,0,0,5,1,0,0,0,5,0,0,2,4,0,0,0,0,0,0,0,1,0,1,2,1,0,1,0,0,1,2,4,5,2,0,4,1,0,0,0,3,3,0,1,2,0,0,2,0,4,0,3,0,0,1,0,1,0,1,2,0,0,1,0,0,0,0,0,3,0,0,0,1,1,4,1,3,0,0,0,0,4,1,3,1,1,1,0,0,5,31,2,0,1,0,3,0,0,1,0,1,1,0,2,2,2,0,1,1,0,0,1,0,1,1,0,1,1,1,0,2,0,0,0,1,1,0,0,0,2,0,0,0,0,4,0,1,1,2,0,0,0,2,0,1,1,0,1,0,0,2,0,5,4,0,0,0,0,0,0,0,0,0,0,0,1,0,0,4,0,0,0,0,0,0,0,2,4,0,2,2,0,3,0,0,0,1,0,0,0,0,0,0,1,1,2,0,0,1,0,1,2,0,0,0,1,6,0,0,1,3,0,0,0,2,2,1,0,3,2,0,0,0,1,0,1,0,0,0,3,2,3,0,3,0,6,0,0,0,0,3,0,0,1,0,0,0,1,0,4,0,0,0,0,0,0,0,0,0,0,0,3,0,0,0,3,0,0,0,1,0,0,0,1,0,1,0,0,0,2,2,0,0,3,0,1,0,1,0,1,3,1,0,0,2,1,0,0,0,1,1,0,1,0,0,0,0,0,0,0,2,0,1,1,0,1,0,1,0,0,0,1,0,4,0,0,0,0,0,2,0,1,0,0,0,1,5,2,0,1,0,0,0,0,2,3,0,1,1,0,2,0,2,5,0,3,1,1,0,1,6,0,1,1,0,0,0,0,2,1,0,0,0,0,0,1,1,0,2,0,0,0,0,2,0,0,0,0,4,0,0,0,0,4,0,1,0,3,1,0,1,0,1,0,0,2,0,3,0,1,0,2,0,0,0,0,0,0,1,0,0,0,0,0,0,0,0,2,0,1,0,4,2,0,2,0,0,0,0,3,0,1,3,0,1,0,1,0,0,0,0,0,0,1,0,0,0,0,0,1,0,0,3,0,1,1,0,0,1,1,0,5,2,0,0,0,0,0,0,1,0,1,0,1,0,1,0,1,0,0,0,0,2,0,0,0,0,0,1,0,0,0,0,0,0,0,0,0,0,0,0,0,0,4,0,0,0,2,0,0,2,0,0,0,0,0,0,0,0,1,1,0,0,0,0,1,0,0,0,0,2,2,0,3,0,0,1,1,0,1,0,1,0,1,0,0,1,0,0,7,1,0,1,0,0,11,0,0,0,0,1,0,0,0,0,0,1,0,0,0,0,0,1,0,0,0,0,0,0,0,0,0,0,0,0,0,0,0,0,0,0,0,1,0,0,0,0,0,1,0,1,1,0,0,0,0,0,0,0,0,1,0,0,0,0,0,0,0,0,0,0,3,0,0,0,0,0,0,0,0,2,0,0,0,0,0,0,0
K42 Hearts In Atlantis,king,2718,1436,1198,1248,1246,1623,649,926,1085,756,531,629,636,238,258,557,463,398,319,391,414,399,273,267,485,205,359,151,277,135,194,292,191,133,170,174,237,214,280,247,204,199,214,119,185,198,178,154,105,188,225,99,160,93,114,157,131,109,125,145,142,122,140,75,105,114,70,110,72,121,92,92,94,98,121,83,84,127,78,28,63,95,33,80,114,132,64,59,97,80,67,100,93,50,132,64,80,75,71,63,66,123,92,72,77,67,117,49,69,49,53,47,125,59,78,42,70,53,49,38,75,12,73,71,48,56,42,52,64,38,52,51,61,55,64,60,65,76,41,56,12,51,48,50,73,66,25,51,39,63,47,33,46,32,27,38,29,58,89,29,21,29,62,48,35,18,46,32,26,59,70,35,66,27,18,11,23,23,41,35,47,51,13,17,42,30,27,32,35,28,31,21,39,42,35,42,16,32,5,31,29,39,38,32,26,21,25,24,46,46,31,34,21,15,19,23,18,31,55,30,23,63,30,26,21,22,25,15,13,47,24,16,37,30,12,7,43,13,12,21,21,22,18,18,47,34,25,35,41,11,32,26,24,16,12,26,21,18,29,19,19,50,18,28,55,25,23,17,41,36,18,34,38,17,22,22,25,26,32,20,76,27,20,34,65,10,15,26,14,9,9,13,15,15,20,13,18,39,9,24,29,27,29,17,47,17,13,38,12,10,17,34,5,29,17,20,4,31,10,13,22,37,18,35,4,14,12,24,24,11,48,31,17,16,7,26,62,4,11,20,14,15,11,10,13,8,25,29,16,12,37,12,28,28,20,14,18,29,12,23,19,19,15,3,23,9,9,18,13,18,13,4,14,9,24,28,0,8,22,15,6,25,18,15,5,12,0,16,20,20,5,25,7,36,10,31,28,8,27,13,71,11,8,3,16,11,18,26,10,9,7,11,11,1,14,19,10,9,11,15,17,1,5,8,4,12,15,16,14,23,29,14,7,8,8,3,10,15,1,14,5,6,6,14,15,18,6,9,14,24,12,5,12,25,11,26,6,19,8,14,8,10,1,3,7,11,12,16,0,8,4,3,14,11,9,11,4,6,0,19,18,45,14,6,1,6,6,0,32,4,9,12,4,8,5,2,17,13,25,11,9,8,16,4,6,6,3,19,11,2,7,13,7,10,13,17,0,2,23,12,4,8,14,9,7,9,7,3,18,21,14,20,10,6,9,3,20,23,2,10,13,12,28,17,11,13,0,0,15,18,3,14,12,2,14,17,7,8,8,2,5,23,10,6,5,13,8,5,12,7,6,14,3,9,12,15,12,3,6,1,15,11,2,2,7,8,2,15,5,5,8,10,5,4,8,3,7,7,9,12,10,9,21,3,1,0,16,6,8,8,5,4,6,9,4,4,10,15,8,6,6,4,11,17,8,11,5,17,1,3,7,10,8,36,1,0,12,5,7,10,4,3,14,8,27,28,12,30,9,15,0,13,7,11,3,9,5,2,9,9,7,7,17,7,2,8,15,5,10,8,2,4,4,4,11,18,4,2,13,7,3,4,3,4,8,13,3,9,3,6,8,4,6,11,1,7,3,6,4,2,11,2,8,17,2,9,2,28,12,17,12,12,4,6,7,15,2,4,6,3,17,2,7,2,2,8,7,2,2,18,10,9,14,0,0,9,9,4,13,7,11,20,4,49,0,5,6,10,11,6,4,3,5,3,26,7,8,5,6,20,4,6,10,10,3,32,5,4,0,9,9,6,5,4,3,8,5,3,17,4,2,5,1,3,1,4,10,9,3,1,1,8,2,3,17,10,0,12,12,2,1,1,2,10,4,5,22,2,3,4,6,6,24,0,2,6,1,0,9,5,8,6,5,2,41,49,3,3,8,12,9,0,0,5,4,12,4,9,0,14,5,4,8,1,3,1,3,0,5,8,3,8,1,10,5,6,19,1,7,14,2,2,4,7,0,16,6,0,8,7,21,13,13,1,0,3,5,7,4,9,0,2,6,6,2,9,7,10,3,5,6,6,8,2,6,4,6,0,4,2,4,3,11,5,17,15,10,7,10,3,10,0,9,4,3,0,2,1,13,2,38,1,3,5,4,8,13,0,12,0,46,4,10,0,2,3,12,3,0,8,6,28,6,3,1,5,2,2,2,5,8,6,3,32,4,3,0,5,5,6,0,10,5,5,5,6,3,1,4,6,2,2,10,4,2,4,29,13,2,0,0,13,10,0,1,7,2,1,1,2,1,0,6,4,9,0,1,5,14,0,1,0,3,0,1,21,6,0,10,6,3,3,1,10,2,3,4,1,3,4,0,8,9,0,4,2,6,1,13,4,3,1,3,5,7,15,7,3,6,18,8,2,1,1,6,2,13,0,10,9,5,7,3,2,6,0,6,6,3,2,7,1,0,2,6,1,4,8,0,0,0,2,6,7,25,2,2,0,8,7,2,0,6,5,1,0,17,7,18,0,9,0,10,5,0,4,7,0,12,5,3,3,1,2,11,7,8,2,2,6,2,3,2,7,0,2,2,6,4,2,6,25,1,2,3,1,14,11,0,9,3,16,1,2,1,1,16,0,3,3,6,5,6,2,0,1,6,12,2,3,0,1,5,7,5,0,2,7,13,12,0,1,2,13,0,5,5,10,0,4,0,6,3,4,0,41,5,4,0,0,11,1,0,1,15,3,0,2,4,0,6,7,0,9,2,4,2,0,1,6,19,0,9,2,2,6,1,8,3,7,0,1,3,1,18,0,0,5,0,4,1,4,7,5,8,4,5,3,5,3,4,4,1,3,1,0,2,2,0,3,1,2,7,0,2,6,0,1,3,6,2,6,3,3,1,8,5,4,3,2,1,0,2,1,0,1,1,0,2,2,0,10,10,1,0,7,4,5,0,14,1,1,6,0,7,5,8,2,5,1,0,3,0,1,5,0,2,3,1,5,4,6,3,4,3,1,6,0,6,6,1,0,0,2,0,8,5,13,3,1,14,5,5,0,1,1,5,4,1,0,0,4,2,2,1,5,1,0,1,5,5,7,48,0,2,8,5,10,0,2,1,0,3,5,1,0,13,6,5,0,1,2,2,0,7,0,4,3,2,5,0,10,4,3,3,0,0,5,0,17,3,0,1,14,0,7,25,2,5,5,4,11,1,2,12,1,6,1,0,0,0,0,0,3,0,8,7,0,6,1,3,5,5,7,0,3,0,3,6,10,12,0,0,5,1,0,4,0,4,6,5,5,0,0,0,6,2,0,1,8,6,2,0,3,0,4,2,2,1,1,2,3,0,2,1,0,3,1,0,2,1,1,1,0,7,10,8,0,4,3,4,4,2,4,0,0,2,8,5,0,2,2,1,3,0,5,6,10,0,5,8,6,7,1,1,3,0,0,0,2,6,0,0,0,0,0,0,0,4,9,2,1,1,4,6,1,3,0,9,0,0,4,2,1,3,1,2,4,3,3,3,4,16,4,2,2,3,1,31,3,3,1,2,3,1,2,6,0,4,0,9,11,2,1,1,4,1,0,1,2,1,2,3,1,3,7,0,1,0,5,2,3,2,0,2,11,6,4,7,2,2,1,3,0,1,1,0,1,0,1,0,3,13,16,1,8,2,0,3,2,0,1,0,2,1,3,1,4,11,2,0,3,0,9,5,5,0,0,0,4,3,4,2,0,2,8,1,1,2,4,1,1,1,0,2,0,0,2,3,4,1,0,6,6,0,0,14,4,2,1,1,2,0,0,7,4,1,0,0,1,0,2,4,1,1,2,1,0,4,5,2,0,31,4,1,7,3,1,0,3,10,1,3,0,1,0,2,2,4,0,15,0,0,0,0,0,4,2,1,0,4,0,3,2,0,1,7,0,10,0,0,0,0,7,1,4,1,3,0,4,3,3,2,2,1,0,3,0,0,0,0,3,8,0,2,0,6,2,2,1,0,1,5,1,0,4,1,3,8,1,0,1,1,49,3,4,3,2,0,4,4,9,1,2,1,2,4,0,5,0,1,0,0,2,2,1,6,1,0,0,1,14,0,1,2,1,0,2,3,1,1,0,0,0,2,1,0,3,2,5,1,0,3,0,0,2,5,3,9,5,1,3,2,1,1,4,0,0,3,4,5,3,0,0,8,1,0,2,0,1,1,2,7,5,0,4,6,0,0,5,1,17,1,0,0,4,7,4,1,0,5,3,1,1,5,6,16,2,1,0,1,1,1,1,1,2,0,1,12,1,0,0,0,4,0,2,1,1,0,1,0,5,5,3,0,6,4,1,2,2,8,2,0,10,1,0,1,0,6,0,0,7,2,3,0,0,0,1,3,3,0,2,2,0,5,1,1,3,3,3,2,12,0,0,1,1,2,0,11,1,0,0,0,3,3,0,0,2,0,0,5,2,0,4,0,0,0,0,2,0,1,1,12,6,4,0,0,4,1,0,1,0,3,4,3,1,1,0,0,1,2,2,0,0,0,1,1,1,0,1,211,5,3,4,0,1,2,2,0,1,0,4,0,0,1,6,7,0,0,3,2,0,1,3,1,1,2,3,0,0,0,4,4,3,0,3,7,0,4,1,8,1,2,1,0,0,4,0,0,0,1,0,0,2,7,6,0,0,2,7,7,0,0,0,0,8,0,1,0,0,2,1,2,0,3,10,15,3,2,0,0,0,0,0,0,0,1,5,4,2,0,0,7,1,0,1,4,2,1,0,4,0,2,7,1,3,0,0,1,2,1,6,2,1,1,4,0,1,2,0,0,0,1,1,0,0,0,23,0,3,4,2,6,0,2,0,0,1,0,0,0,0,0,4,0,0,0,2,0,1,2,3,1,0,0,1,5,3,1,4,1,0,3,0,1,2,0,0,0,2,1,3,0,0,0,0,2,0,5,0,0,3,2,0,2,2,0,2,2,0,0,2,1,1,24,0,0,1,2,0,3,0,0,0,0,2,5,1,1,2,1,2,1,2,1,0,0,2,1,1,0,0,17,0,1,0,0,0,2,2,0,3,1,3,1,0,0,2,3,1,0,3,0,1,0,0,4,3,1,0,0,0,1,1,4,1,0,0,8,0,3,9,1,2,2,0,1,1,3,2,1,1,2,3,2,3,2,3,2,0,0,0,6,3,3,0,0,2,2,6,0,3,1,1,1,0,2,0,4,4,1,0,0,2,2,1,1,3,2,1,2,2,1,4,0,3,1,2,1,1,0,0,1,2,1,2,5,0,3,1,1,0,2,0,2,2,2,1,1,2,6,0,0,1,2,1,3,0,1,2,0,3,0,4,0,3,0,0,2,0,3,0,1,2,1,0,2,1,2,0,1,0,1,1,0,5,1,1,0,1,0,1,3,2,0,4,4,0,0,2,1,0,2,1,1,0,13,2,1,1,0,0,0,2,0,0,2,1,1,0,3,0,0,2,1,0,1,1,16,0,0,3,0,0,0,3,2,1,1,0,1,17,8,3,3,0,1,0,0,0,0,3,0,4,1,0,1,2,3,0,0,2,3,0,1,0,0,2,1,2,0,4,0,1,1,0,2,3,1,1,1,1,0,2,4,1,0,0,4,2,2,2,3,5,2,0,0,1,0,1,0,1,0,4,1,6,0,0,0,2,0,0,0,1,3,2,2,0,2,3,1,0,1,2,1,2,3,5,2,1,0,2,0,1,1,2,0,1,0,0,1,5,0,8,0,1,1,1,2,2,0,2,1,1,8,0,8,0,0,1,2,0,0,0,1,2,0,2,4,1,7,0,0,2,1,0,2,1,0,0,1,1,0,1,1,1,2,2,0,0,2,1,0,0,4,7,0,1,0,0,1,0,0,3,0,0,0,1,0,2,0,3,2,0,0,0,1,0,0,1,0,2,2,2,0,0,0,0,0,1,4,3,1,0,0,0,0,3,1,0,5,0,1,1,2,4,5,4,3,6,0,2,0,0,1,4,1,0,1,1,0,1,0,11,0,0,1,1,0,0,0,36,0,0,0,0,2,2,0,0,0,0,2,1,2,0,0,2,1,4,3,1,0,1,1,6,2,0,2,3,1,0,0,0,0,1,4,0,1,0,1,1,0,0,1,6,0,1,2,2,2,0,2,2,0,0,0,3,5,0,1,2,9,0,0,0,0,0,1,0,2,3,2,1,2,1,0,1,0,0,4,1,2,5,0,1,0,0,0,3,0,0,1,1,0,0,0,0,0,9,0,0,1,2,0,0,0,1,3,0,0,0,0,2,1,0,4,0,4,2,0,0,0,3,0,0,2,3,2,4,3,0,0,8,2,0,8,3,1,1,2,0,1,0,0,0,0,0,1,0,1,2,2,1,0,0,1,1,0,3,2,0,0,0,0,0,0,0,1,3,0,2,6,0,2,2,0,0,3,2,1,1,2,0,6,5,0,0,1,2,1,0,3,0,0,1,2,4,0,0,0,0,0,2,0,2,2,1,2,0,0,0,2,0,1,6,0,0,2,0,1,1,6,0,0,1,0,2,1,4,1,0,1,0,4,1,0,0,2,0,1,2,0,0,1,0,0,0,0,0,0,0,1,0,0,1,0,0,0,6,0,1,1,0,0,3,0,0,1,0,0,0,8,1,0,0,0,2,1,0,0,0,3,0,0,0,1,4,1,2,0,0,5,1,0,0,0,9,1,0,0,0,2,0,1,11,0,1,1,3,0,1,2,0,0,0,6,6,0,0,1,0,1,0,2,2,1,0,0,0,0,3,0,1,1,2,4,0,0,3,0,0,1,1,1,1,0,0,0,2,3,0,0,3,0,2,2,0,0,1,0,0,0,0,0,1,3,0,0,1,1,0,0,0,0,0,0,1,1,0,1,3,3,3,0,3,0,0,0,2,0,1,0,2,3,2,1,0,3,1,1,0,4,2,1,1,0,1,0,1,0,1,4,8,3,1,4,0,7,1,0,0,0,0,0,1,3,1,0,6,2,0,1,1,0,2,1,0,0,3,0,2,0,0,0,3,0,0,6,0,0,0,3,0,2,0,0,1,0,5,1,1,1,2,7,0,0,7,1,0,0,0,0,0,0,0,0,0,1,4,0,0,1,2,1,0,2,2,0,1,0,1,0,0,0,0,2,0,0,1,1,0,1,1,3,0,2,0,1,7,0,0,0,0,0,0,0,3,0,0,0,2,2,3,0,0,0,0,3,2,0,1,0,1,0,1,0,0,3,1,0,0,1,1,0,0,0,0,2,1,1,1,1,3,4,3,0,0,1,0,2,0,0,1,0,2,0,2,0,3,1,1,3,0,0,2,2,0,2,40,1,3,0,0,0,1,1,0,1,0,0,0,1,0,0,2,2,0,1,0,1,0,3,4,0,6,0,1,1,1,0,1,0,0,0,0,4,0,1,2,0,4,4,0,0,0,0,0,0,1,0,3,1,0,3,1,0,0,1,2,5,0,0,0,0,0,1,0,9,0,2,0,2,0,1,1,0,1,0,1,1,1,2,0,1,1,2,0,1,1,0,0,3,0,2,0,2,2,0,0,0,1,0,0,1,0,0,0,0,1,2,2,2,0,1,0,0,0,1,1,1,3,0,0,0,7,0,0,0,1,0,2,0,5,0,0,2,0,2,0,0,1,0,2,0,0,2,0,0,0,0,0,0,3,0,2,1,3,0,0,0,0,1,1,2,1,0,3,0,1,2,1,0,0,0,0,1,2,0,5,1,0,1,0,3,1,1,1,0,54,0,1,0,0,1,0,0,1,0,0,9,0,2,0,0,0,1,0,2,0,1,0,0,0,0,3,0,1,0,0,0,0,4,1,1,0,0,0,0,1,0,2,0,0,0,0,0,0,1,0,0,0,2,0,3,0,1,0,1,0,0,0,1,2,1,1,0,1,0,0,1,2,0,1,1,0,3,0,2,2,0,0,1,0,4,0,0,2,0,0,4,0,0,0,0,2,1,0,1,0,0,1,3,5,2,0,0,0,0,0,1,4,0,1,0,0,0,1,0,0,0,0,0,7,7,0,1,0,1,0,0,2,0,2,1,0,1,0,0,0,1,0,3,4,0,0,0,4,1,1,0,0,0,1,0,2,4,0,0,0,0,0,2,1,3,0,2,1,0,0,3,0,1,0,0,1,0,0,0,0,1,2,2,10,1,1,0,0,1,7,0,0,7,0,0,0,0,0,1,0,1,1,0,0,2,0,0,0,1,0,0,0,2,0,0,0,1,0,0,0,0,0,0,1,0,6,1,1,4,2,0,0,0,0,0,1,0,0,0,0,0,0,2,2,0,0,1,0,0,0,6,1,79,0,3,0,1,0,0,1,0,2,1,0,1,1,0,0,0,0,1,4,2,0,0,5,2,0,1,0,1,1,0,0,0,3,0,0,0,0,0,2,0,1,0,6,0,0,0,0,1,0,0,0,0,2,6,1,0,0,1,0,0,0,0,0,0,0,1,0,0,0,0,1,1,1,1,0,0,1,0,1,3,0,0,0,0,0,0,0,1,2,0,0,0,0,1,0,1,0,0,1,0,0,0,1,1,0,0,1,0,3,1,0,2,0,1,0,4,0,0,0,0,0,3,2,0,0,0,0,2,0,0,1,2,12,0,2,0,0,1,1,0,0,0,1,0,0,0,0,0,1,0,0,0,0,1,0,1,0,0,0,1,0,0,0,0,1,0,0,1,1,0,1,0,5,0,1,1,0,0,1,1,1,6,3,4,0,0,2,0,0,0,4,0,0,1,1,12,0,0,0,2,0,0,4,0,0,1,1,0,2,0,0,1,0,0,2,0,3,0,0,0,0,0,1,4,2,2,1,2,0,0,3,0,0,0,0,1,1,4,0,0,1,0,0,4,1,0,0,0,0,0,0,2,1,0,1,0,2,0,0,0,0,1,0,0,1,0,0,1,0,5,1,0,0,0,0,0,0,0,0,7,3,0,0,1,0,0,0,0,0,0,4,0,1,0,0,3,1,1,0,0,0,2,0,0,0,0,0,1,3,0,0,0,1,2,0,0,0,0,0,0,1,1,0,0,0,1,1,0,0,0,0,0,1,0,0,7,2,1,0,0,0,0,2,2,0,0,0,0,0,0,0,0,1,1,0,0,0,3,0,0,2,0,2,1,0,1,0,0,1,4,1,0,1,0,0,1,1,1,0,0,4,0,0,0,0,1,0,0,2,3,0,1,1,0,0,0,0,0,0,0,1,0,0,0,0,0,1,0,2,0,0,0,2,1,0,1,0,1,0,1,0,1,1,1,1,0,0,7,2,0,3,0,1,2,0,0,0,0,2,1,0,0,0,2,0,0,0,0,0,0,14,0,0,0,1,1,0,0,0,1,1,0,0,2,2,0,0,0,1,0,0,0,2,0,0,0,7,3,4,0,2,0,4,2,0,0,1,0,2,0,0,0,0,4,0,0,3,0,1,0,0,1,1,0,0,0,0,3,0,0,0,1,0,0,0,0,0,0,0,0,0,2,1,0,0,1,0,0,0,2,0,0,0,1,5,0,0,0,13,0,0,0,0,0,1,0,0,0,0,0,2,0,1,0,2,0,8,0,0,0,0,1,0,2,102,0,0,0,0,0,3,2,1,0,0,0,0,0,0,0,0,0,0,3,4,0,2,1,0,0,1,1,0,0,1,4,0,0,0,0,1,0,0,0,1,2,1,1,1,0,0,0,1,0,0,0,2,0,0,0,0,1,1,0,0,1,3,0,0,0,0,0,0,0,0,0,1,1,2,0,1,2,1,0,0,0,0,2,0,0,0,0,0,0,0,1,1,5,0,0,0,2,1,0,1,2,0,1,0,0,51,0,0,6,15,0,0,1,0,1,2,0,0,2,0,0,0,1,1,1,0,0,0,0,0,0,0,1,0,1,1,0,0,1,0,0,0,0,0,0,0,0,1,1,1,0,0,0,3,0,0,1,0,0,3,1,1,3,0,0,1,0,0,0,0,0,0,0,0,1,0,1,0,0,1,0,0,0,0,0,0,1,0,0,0,0,0,2,0,0,0,1,6,1,0,2,1,0,0,0,3,0,0,0,0,0,0,0,0,0,0,0,0,1,2,0,0,2,0,0,2,1,0,1,0,0,0,3,0,0,6,0,0,0,1,0,0,0,0,1,4,0,0,0,1,0,1,0,0,0,0,0,0,3,0,1,0,2,1,0,1,0,0,0,0,1,1,0,0,0,0,2,0,2,0,0,0,1,0,0,1,0,0,0,0,0,0,2,0,1,1,1,0,1,0,0,5,1,0,0,0,0,1,1,0,0,0,1,4,1,0,0,0,0,3,1,0,0,0,1,0,0,0,0,0,9,0,0,0,0,3,0,1,1,0,0,0,2,0,0,1,1,0,0,0,11,0,1,1,0,1,0,0,1,2,0,0,0,1,0,1,0,2,0,1,0,0,1,0,1,0,1,0,0,0,2,1,0,1,5,2,0,1,0,0,1,1,0,0,0,2,0,0,0,1,0,0,0,0,1,0,0,0,1,0,2,1,0,0,0,0,1,0,0,0,0,1,0,0,0,1,4,0,1,0,0,0,0,0,1,1,1,0,3,0,0,1,0,0,3,0,0,2,0,0,2,0,0,1,0,0,1,1,0,1,4,0,0,8,0,1,0,0,0,0,0,2,0,1,1,0,3,0,4,0,1,0,0,0,0,0,0,13,1,0,3,0,1,0,1,0,2,1,0,2,0,0,3,0,0,0,0,1,1,0,0,0,0,0,0,0,1,0,0,0,0,0,1,0,0,0,0,0,0,1,0,1,0,2,0,1,0,0,1,0,1,0,0,0,1,0,1,0,0,0,0,1,0,2,0,0,0,2,0,1,1,2,0,0,0,0,5,1,0,0,2,0,1,1,0,0,0,2,1,0,0,0,0,0,1,1,1,1,0,1,0,0,0,0,0,4,0,0,0,0,0,1,0,0,1,1,1,0,0,2,1,0,0,1,0,0,1,4,0,0,0,0,0,0,0,3,0,0,0,0,1,0,0,0,1,0,1,0,0,1,0,0,0,0,0,2,0,0,1,0,0,1,0,0,0,1,1,2,2,0,0,0,0,1,0,0,0,0,0,0,0,0,0,1,0,5,0,0,0,0,1,0,1,0,2,0,0,0,0,0,0,0,0,0,0,0,0,0,0,4,0,0,0,0,0,0,2,0,0,0,0,0,0,0,0,0,0,0,0,0,0,0,0,0,1,0,10,0,2,11,0,0,0,0,0,0,0,0,0,0,0,0,0,0,0,0,0,0,0,0,0,0,0,0,0,0,0,0,0,0,0,0,0,0,0,0,0,0,0,0,0,0
K43 Dreamcatcher,king,12692,5943,4430,4808,4877,1161,4416,3457,3470,3232,1708,3374,2371,397,467,1802,2303,1397,1115,785,1348,1758,1311,1354,232,976,349,1110,965,1125,806,1007,888,817,950,642,799,898,397,954,778,838,1022,832,476,510,685,524,586,775,741,784,548,538,441,462,767,412,442,662,466,354,407,791,359,432,404,421,448,348,358,252,345,309,355,425,330,373,335,367,314,341,360,382,334,302,330,289,332,288,198,306,385,263,279,172,328,252,289,205,243,381,317,251,385,390,445,439,180,343,233,286,140,324,237,281,189,208,191,124,125,208,172,369,136,80,175,212,200,166,222,218,200,114,240,244,75,215,186,152,42,178,208,117,299,164,171,225,135,246,145,136,179,198,200,224,253,58,198,195,124,188,195,273,191,282,176,89,124,203,20,110,223,92,76,98,102,137,168,161,166,128,153,80,134,59,94,123,213,55,132,97,196,146,118,139,27,70,103,63,128,129,104,206,107,597,93,103,126,220,32,162,121,57,115,68,69,140,102,70,119,147,135,98,109,89,52,121,106,148,168,45,101,231,97,21,77,109,63,102,46,40,124,52,69,115,119,212,100,134,139,94,86,37,131,88,73,82,100,109,125,79,117,110,153,48,81,63,171,137,115,85,115,51,68,80,56,86,186,76,82,34,96,59,245,72,82,67,91,97,66,297,78,32,146,53,58,63,34,88,102,83,99,55,152,99,5,38,37,51,89,19,34,122,85,80,63,159,100,88,68,141,37,107,8,106,166,62,56,55,94,61,78,88,122,82,105,22,26,62,72,37,34,91,64,96,103,96,59,48,170,26,99,84,136,6,45,104,70,46,70,58,77,15,51,25,58,37,86,47,88,62,61,29,58,140,49,12,71,102,113,35,79,34,35,10,0,54,44,116,83,53,30,107,75,125,67,36,59,63,69,130,82,47,41,46,59,82,42,50,62,48,95,22,96,83,34,72,54,62,63,9,8,21,38,105,31,44,32,38,86,47,33,42,4,78,70,50,8,64,50,34,39,58,27,40,73,54,26,72,49,43,11,131,70,37,41,16,53,94,39,13,4,7,23,34,59,44,4,49,28,42,28,11,50,45,46,32,0,57,64,52,56,35,23,75,83,30,35,24,36,16,53,27,61,10,57,42,23,46,70,42,43,24,72,28,53,48,64,43,38,62,62,48,79,44,0,29,30,47,66,43,76,21,49,51,42,78,68,48,18,47,33,32,33,10,66,61,26,22,60,17,85,40,34,44,0,32,60,96,79,55,26,35,44,105,47,43,22,3,32,39,30,28,36,33,26,31,24,27,43,29,25,31,29,82,58,3,38,41,66,55,14,48,2,70,26,81,41,15,43,45,13,12,51,17,20,35,5,45,73,113,74,47,35,0,0,34,33,105,24,17,69,25,3,38,66,14,12,579,15,27,16,45,43,95,32,43,15,10,17,64,19,102,24,578,33,31,32,55,26,27,47,22,64,77,25,56,8,39,1,43,33,44,65,78,19,5,70,15,32,32,31,42,54,31,50,26,29,23,81,33,19,14,7,33,44,30,25,14,90,19,33,47,58,32,2,30,45,23,20,4,27,37,24,25,28,5,21,95,52,4,80,44,35,50,3,64,23,26,12,71,6,44,15,81,25,47,28,23,43,52,57,5,29,39,34,15,17,11,44,22,21,22,0,49,5,17,45,41,64,42,4,8,6,3,11,27,34,17,13,38,23,20,13,86,17,2,22,16,25,18,43,46,12,52,43,27,46,23,18,6,31,4,0,38,19,14,19,15,15,17,13,30,30,40,27,36,36,17,22,16,2,23,15,13,0,35,1,16,21,5,10,33,7,19,131,19,21,62,18,46,32,0,31,48,4,2,29,19,23,1,26,32,40,44,17,34,40,42,21,4,81,25,5,27,27,16,0,10,53,19,35,11,34,12,10,0,28,47,42,44,2,10,15,10,2,11,4,40,16,17,13,29,38,28,7,0,28,47,30,43,37,9,0,12,18,28,1,26,25,23,40,37,6,29,17,22,17,22,27,22,1,11,24,31,12,2,21,62,18,17,19,10,10,48,43,15,40,20,30,0,34,0,21,20,35,15,55,29,34,5,15,11,14,38,14,0,65,7,110,10,28,21,8,17,21,11,8,11,7,82,14,26,14,45,8,10,11,31,27,14,31,41,4,16,2,46,24,8,0,34,15,2,2,38,12,4,15,5,9,9,36,2,9,25,35,19,32,4,2,43,45,2,17,25,44,0,32,59,16,35,36,21,12,11,0,24,26,0,16,0,13,2,13,35,0,0,10,34,10,12,12,320,36,30,19,0,24,25,6,27,12,4,19,4,35,5,44,9,26,12,18,10,38,46,24,7,17,39,24,5,8,17,28,14,28,9,6,23,24,25,11,8,13,0,25,10,20,25,4,56,0,5,29,5,9,4,0,0,0,0,18,24,19,13,4,0,15,31,37,3,13,16,6,2,5,40,18,2,14,0,22,11,6,9,30,7,26,9,5,4,15,20,5,14,34,8,21,21,12,24,3,9,0,2,5,7,39,25,15,45,21,18,18,6,13,41,13,9,9,9,11,7,21,33,17,26,40,43,36,6,4,23,11,11,13,9,6,9,40,5,14,25,14,4,6,15,32,11,6,15,10,29,9,4,6,24,3,0,0,14,39,11,15,54,23,2,25,4,11,7,19,11,35,53,0,8,11,0,20,14,0,46,18,16,6,11,10,19,13,0,14,13,24,19,4,22,13,20,0,3,38,8,9,0,0,14,16,11,11,22,30,1,34,18,26,80,7,25,21,46,4,20,17,0,2,26,11,20,9,9,14,1,4,13,1,1,11,9,14,28,21,21,1,17,32,25,6,11,31,0,6,20,0,23,10,2,18,31,1,2,4,15,0,4,25,17,0,14,24,24,25,35,23,17,20,5,24,12,0,3,12,88,7,16,12,10,3,14,15,17,16,9,9,12,6,9,14,6,0,3,6,11,5,17,18,44,12,30,12,23,5,0,4,9,16,17,5,13,1,6,19,14,6,32,9,7,7,20,36,20,8,0,6,32,8,42,13,18,14,29,10,6,5,15,20,15,9,7,4,7,6,3,10,1,22,8,17,15,2,15,38,6,9,0,0,3,0,4,25,0,12,29,8,21,8,13,21,16,15,52,16,7,9,3,3,0,19,9,0,0,0,18,2,49,27,0,21,21,15,36,9,4,0,11,7,22,6,4,10,17,5,11,17,2,0,1,14,18,6,17,0,0,2,9,20,11,16,11,8,3,10,25,1,39,8,23,15,5,12,5,0,16,7,0,44,8,23,2,6,7,13,0,3,21,20,0,8,28,28,5,9,14,0,35,56,46,2,11,17,16,13,13,1,19,7,46,3,10,10,22,2,6,3,4,0,4,0,15,28,1,19,0,0,4,0,4,11,7,9,28,1,0,19,20,9,0,22,15,9,16,8,5,77,17,11,10,8,17,0,3,11,12,5,6,11,1,9,8,10,10,18,7,8,8,8,7,32,4,24,12,37,9,37,13,0,7,11,9,18,6,5,3,9,11,16,6,10,15,13,32,23,0,29,22,20,5,21,24,4,18,14,11,8,2,4,10,0,13,0,34,7,20,9,15,14,0,15,11,0,1,0,15,10,6,13,6,8,7,15,14,8,5,36,4,1,10,0,69,7,19,5,0,13,8,6,2,4,7,13,23,4,6,10,31,4,5,7,15,11,5,26,11,0,0,11,7,16,4,2,7,17,6,16,14,13,17,3,18,14,19,12,2,7,7,6,0,18,23,15,23,39,14,6,24,0,8,19,13,23,11,17,12,5,1,0,5,10,8,4,0,32,2,0,6,21,14,22,2,9,1,6,4,6,6,19,7,13,3,13,14,23,19,3,2,0,43,0,28,3,13,6,13,9,21,25,39,42,4,21,32,49,2,3,9,7,8,43,14,7,24,15,13,0,9,11,5,18,2,9,5,5,29,0,19,1,9,6,22,10,9,5,7,1,11,1,11,9,1,4,2,0,18,1,0,9,4,5,8,14,8,2,23,2,6,3,11,3,9,16,14,0,12,3,1,1,24,24,33,9,3,1,6,6,12,4,5,7,3,18,16,21,0,1,23,8,0,15,0,11,11,0,0,9,5,0,5,0,0,0,57,6,9,22,7,11,6,0,4,1,19,0,11,5,25,25,16,5,0,15,25,9,22,7,2,43,7,3,1,3,3,13,1231,2,4,0,8,7,20,2,10,2,11,2,9,7,7,20,10,0,13,9,11,4,8,6,8,3,10,14,8,0,27,5,5,11,21,8,4,0,20,5,12,0,3,11,7,3,17,0,15,4,2,19,8,6,9,11,7,16,12,2,8,7,40,10,1,9,4,1,6,0,3,5,0,10,14,0,8,3,2,0,3,2,7,4,6,3,21,1,9,6,14,11,1,0,10,4,13,18,3,5,7,13,2,5,97,2,10,12,4,0,0,2,4,12,17,9,2,2,10,12,15,11,2,14,3,6,0,8,0,8,3,16,15,7,0,9,2,3,0,6,4,2,5,5,7,3,1,2,12,3,19,13,8,16,5,5,2,6,61,14,2,6,0,6,17,2,0,9,5,6,2,5,18,22,8,6,0,14,5,3,0,2,6,10,9,20,8,9,17,1,8,9,19,7,9,13,4,12,5,3,4,6,10,4,7,20,9,1,0,9,3,0,0,10,1,5,1,25,0,14,14,17,17,0,0,0,5,3,5,34,17,0,14,0,7,12,7,2,0,16,52,7,9,10,3,4,9,15,3,15,6,6,9,51,10,0,0,14,0,6,7,0,0,3,0,14,9,6,13,7,3,0,8,12,15,3,24,6,7,14,3,16,15,16,3,0,5,2,11,0,0,15,0,17,6,16,8,0,14,0,0,19,11,17,17,10,7,7,3,15,1,18,0,0,5,6,16,21,0,0,0,3,2,5,5,2,1,8,11,4,5,3,5,15,27,2,5,1,6,0,1,14,15,0,2,9,17,1,6,8,4,4,1,4,10,2,11,15,4,5,8,0,9,15,10,5,2,8,8,2,12,10,9,2,2,5,0,18,10,5,10,4,7,15,16,2,1,10,2,0,6,11,6,11,8,2,2,0,6,5,4,4,2,7,28,15,9,4,0,5,18,5,7,10,3,4,5,4,21,25,3,1,2,1,2,1,9,4,6,4,7,2,5,4,9,20,16,9,0,7,7,3,5,2,0,5,2,9,1,6,11,9,2,6,2,12,5,0,1,0,5,6,7,4,6,10,4,1,13,4,11,1,1,5,2,12,6,6,4,2,6,5,0,5,4,13,1,30,11,6,7,5,3,5,39,0,0,6,0,3,15,8,8,8,0,3,4,3,0,5,2,4,0,17,12,2,20,0,5,1,4,2,0,3,11,2,6,1,0,5,7,3,12,3,7,3,10,10,10,5,0,1,1,4,7,9,2,6,6,4,0,5,1,0,0,0,9,1,0,2,5,10,161,6,6,7,0,5,2,26,2,5,2,12,12,3,1,0,7,9,1,12,0,13,5,24,4,4,17,5,8,2,5,15,0,6,0,17,11,19,0,1,2,3,19,2,1,0,10,1,6,4,3,0,3,1,2,1,5,20,11,0,14,14,0,1,6,6,0,13,4,10,1,11,3,4,19,1,0,1,13,4,5,55,0,4,0,3,6,0,2,0,6,6,4,6,5,4,1,5,7,9,1,1,5,1,5,0,4,18,6,12,5,2,13,0,5,4,0,5,7,6,5,5,2,3,5,5,0,0,6,5,4,22,6,2,3,9,6,2,2,5,42,18,9,2,3,2,0,0,17,0,0,4,16,1,7,6,12,2,2,14,5,3,1,0,0,7,4,4,4,10,2,1,6,3,3,7,5,11,6,29,4,18,3,5,2,10,1,9,11,9,6,5,0,7,1,1,2,3,1,1,13,3,4,3,6,6,10,0,2,5,8,22,6,5,0,11,65,11,3,9,0,3,35,4,0,0,3,16,2,5,5,3,3,5,10,3,10,3,8,4,2,60,2,10,3,6,0,4,0,0,1,2,4,5,3,7,5,3,9,0,8,32,0,5,4,6,0,3,1,5,0,7,6,20,2,4,1,4,15,1,3,0,1,2,2,5,3,8,6,2,31,0,3,4,7,19,3,6,4,9,2,9,0,1,4,1,0,9,7,1,0,29,10,0,21,2,4,11,13,5,0,6,6,7,3,0,0,0,6,3,2,7,0,2,6,3,11,1,4,0,1,3,17,3,12,1,5,0,22,3,0,29,1,3,4,0,2,20,5,1,0,12,5,5,1,2,0,15,1,12,0,4,7,2,1,7,6,6,4,0,0,11,1,2,5,3,2,11,13,5,5,6,0,10,3,7,2,12,1,10,2,3,1,5,5,8,2,4,2,6,0,8,5,0,0,3,2,5,1,1,9,0,1,0,0,0,1,6,13,10,6,6,7,4,14,5,9,2,1,0,1,0,5,7,9,2,14,1,14,5,1,1,0,6,1,4,18,5,4,1,3,20,1,13,0,9,4,0,0,1,4,4,10,8,3,7,3,1,0,0,7,0,0,3,0,2,4,1,5,1,7,4,10,9,6,0,3,14,5,0,7,7,19,2,1,0,8,1,8,0,16,2,13,6,11,0,13,6,3,5,8,3,4,3,0,3,5,6,1,1,0,0,5,1,2,11,0,5,0,2,0,1,1,2,4,0,3,15,3,13,7,3,1,0,1,0,0,5,0,1,2,2,4,0,10,0,0,0,10,7,16,13,1,0,0,6,0,0,2,3,2,15,0,8,9,14,6,3,2,1,0,0,12,3,4,6,2,3,5,16,7,2,2,5,11,0,7,0,7,7,3,14,1,18,16,7,4,10,3,2,10,2,2,5,5,5,3,14,0,1,5,1,3,15,3,10,6,0,2,1,14,0,5,1,15,2,0,1,7,0,2,0,4,16,17,4,7,0,0,13,8,2,3,1,1,1,0,7,7,2,2,0,3,1,1,10,7,20,4,2,11,0,6,3,1,2,1,0,2,0,2,1,0,4,4,1,1,2,12,1,0,9,6,1,3,0,4,0,1,2,4,3,2,0,2,8,6,27,3,2,2,8,0,8,6,2,1,1,2,1,1,0,2,8,6,0,0,7,0,1,9,19,5,9,3,7,6,3,5,3,14,1,2,7,8,12,0,10,18,12,2,0,0,7,3,4,8,11,0,9,2,0,5,5,2,0,0,6,1,5,13,0,7,2,15,21,5,9,4,5,9,1,0,3,499,4,0,12,2,1,8,1,0,8,5,3,0,0,3,10,19,2,8,5,0,10,0,2,33,2,4,0,0,3,2,0,12,0,0,0,13,15,3,3,0,8,4,20,2,1,0,1,2,3,5,4,6,8,0,15,5,0,3,2,4,8,5,3,0,1,4,6,2,6,2,5,2,3,4,1,3,1,2,3,0,0,6,11,3,2,2,0,1,2,12,0,4,0,2,7,8,5,3,6,0,5,10,4,4,4,1,0,0,4,4,6,6,5,12,0,7,7,1,9,12,12,2,0,10,0,3,0,0,2,4,9,7,9,2,3,0,1,4,3,6,6,0,14,2,1,4,1,7,8,0,10,2,12,14,3,4,0,12,1,0,2,2,0,3,5,2,1,5,15,1,6,4,1,6,8,3,3,18,0,10,0,1,1,7,2,0,6,0,1,33,1,0,13,1,3,8,14,3,1,4,1,0,5,0,12,2,0,3,2,0,3,5,4,1,1,5,9,1,1,4,4,3,7,1,8,0,7,2,0,4,0,4,13,1,12,6,7,0,4,0,15,3,6,0,5,2,3,4,16,8,0,6,4,2,2,5,3,1,0,3,3,2,2,8,6,1,12,0,5,1,7,6,11,3,2,20,9,7,0,4,4,1,0,0,0,5,4,0,1,0,4,4,3,3,8,3,6,1,0,3,1,11,0,4,1,4,3,16,0,1,6,3,2,0,3,2,0,1,3,2,0,2,1,6,1,0,6,0,9,1,7,0,4,5,8,21,5,3,14,7,7,1,9,12,2,12,1,0,2,2,1,4,1,7,12,2,2,1,6,3,9,18,4,0,0,2,2,0,1,0,2,13,4,7,8,3,1,4,7,4,0,2,2,11,2,16,0,9,6,11,2,0,13,0,5,2,3,0,2,4,3,2,8,0,0,0,8,0,3,7,0,8,1,4,1,7,12,4,10,5,1,0,3,0,0,3,15,0,5,2,0,7,2,2,2,1,3,5,0,6,4,9,8,5,2,3,0,0,4,0,7,3,7,0,1,0,14,1,1,2,8,11,13,2,3,15,0,0,7,6,4,2,0,0,0,4,3,0,10,0,3,1,3,0,3,10,1,3,5,1,1,0,8,3,6,3,1,0,1,5,10,4,5,0,1,0,11,0,13,2,3,0,4,4,3,4,3,1,0,8,8,0,3,2,3,0,1,1,1,2,0,3,1,1,1,0,15,3,13,0,6,4,8,0,0,2,6,0,7,4,14,3,1,0,1,8,3,0,5,4,1,2,5,4,11,0,0,2,1,0,11,1,2,2,8,27,0,0,1,0,0,8,5,0,3,2,2,1,0,4,1,9,3,2,1,1,2,2,1,0,9,1,8,0,1,1,1,3,2,0,8,9,3,4,0,0,1,3,1,1,4,7,1,0,9,12,0,2,1,2,7,2,2,4,0,4,5,7,5,2,7,6,2,1,2,3,0,0,2,1,9,0,1,3,11,6,0,2,0,1,0,1,1,4,45,3,1,12,0,18,10,4,3,4,0,0,1,4,3,8,1,0,6,6,0,1,6,2,0,0,0,2,0,11,2,1,0,3,5,1,1,4,2,3,3,1,1,2,0,0,3,2,4,3,6,4,1,1,1,0,5,0,1,8,1,0,2,1,3,4,1,0,0,7,4,2,11,7,3,0,2,7,4,7,3,6,4,2,2,4,3,1,0,0,1,7,2,13,3,0,21,6,3,1,3,3,0,0,2,7,0,1,3,0,8,1,10,5,3,3,3,3,1,0,7,7,2,6,1,4,4,2,1,0,0,0,5,2,0,0,2,3,11,3,1,9,2,0,5,0,4,0,5,7,1,0,6,0,1,1,1,0,6,4,7,1,5,4,3,0,0,2,10,4,9,13,0,3,0,6,3,0,5,2,0,0,2,2,2,16,0,2,1,4,4,3,10,16,4,2,0,0,3,10,3,5,7,2,1,0,0,1,0,11,9,1,5,4,6,0,16,0,8,2,2,0,1,7,3,3,5,2,7,23,7,0,2,0,3,0,4,1,10,2,3,0,10,6,0,0,3,0,0,3,0,7,0,1,0,2,4,7,0,14,6,2,5,1,2,2,1,5,0,1,0,0,1,0,0,3,0,0,5,0,7,2,10,0,0,0,0,0,3,2,4,0,4,0,3,0,0,0,1,0,10,0,2,14,5,0,3,0,7,0,6,0,9,2,0,0,2,0,2,4,2,0,0,3,0,2,1,1,1,0,4,15,1,1,2,11,0,3,2,2,6,5,3,0,2,1,6,4,7,4,3,6,2,2,0,5,3,0,1,4,0,4,2,3,4,3,0,0,13,1,3,1,0,7,5,0,0,1,5,5,2,0,0,13,2,4,0,5,1,5,2,4,2,12,2,10,4,1,1,3,7,0,1,2,1,5,1,5,2,0,4,0,3,0,0,2,1,8,2,1,1,1,3,1,0,0,3,0,5,47,1,9,1,6,8,2,2,4,1,0,3,0,5,4,0,0,6,2,0,2,8,6,0,1,4,3,3,10,0,3,2,3,11,3,15,0,2,1,2,0,3,10,1,0,2,7,4,3,0,0,1,2,0,6,2,0,1,1,0,0,5,5,7,3,3,1,8,2,0,4,6,10,0,9,6,1,3,0,5,12,2,2,5,0,3,0,1,5,6,7,1,14,2,2,5,1,3,2,0,0,5,0,0,0,0,0,3,0,6,0,2,0,9,0,2,8,2,0,0,14,6,3,3,1,0,1,0,2,1,4,0,4,7,3,1,0,3,0,6,4,1,14,2,2,0,8,2,3,0,2,0,1,2,0,6,6,3,2,3,2,0,3,6,1,0,1,4,1,2,1,0,2,4,3,1,2,5,4,1,3,1,2,2,3,2,12,0,0,0,1,20,2,0,2,0,0,9,0,0,3,0,20,20,2,1,0,4,4,3,2,7,9,2,0,3,4,8,1,3,0,3,3,1,0,2,0,0,1,3,1,1,0,2,5,1,0,3,0,9,0,3,1,5,2,11,3,2,2,1,0,1,1,1,3,12,2,1,7,3,5,0,0,1,0,0,2,1,1,1,4,6,0,3,3,1,1,0,1,1,1,0,1,1,3,7,0,2,12,0,0,11,3,0,4,1,3,2,1,4,14,2,0,0,4,3,3,2,2,0,2,2,9,0,1,0,6,0,2,3,1,3,6,4,5,3,7,1,1,8,1,2,0,2,9,2,6,1,0,1,0,9,0,0,2,4,7,2,0,4,2,0,1,5,5,7,1,1,1,4,1,10,7,2,1,4,1,0,0,0,0,0,6,0,5,5,1,0,2,1,3,1,0,8,1,4,1,5,0,0,1,9,1,5,2,2,3,7,4,0,0,1,2,0,2,1,4,1,0,3,0,0,5,1,2,1,1,13,0,0,1,0,16,4,0,0,3,4,0,2,0,2,185,0,0,1,0,1,0,4,4,0,0,1,3,0,11,0,1,5,4,1,1,1,3,0,0,0,1,2,13,3,2,0,2,6,1,2,2,6,2,2,4,1,1,0,0,1,13,6,1,1,5,0,2,9,0,3,1,1,1,3,1,0,0,3,0,1,6,0,2,0,2,1,1,0,1,1,1,1,0,2,1,2,1,1,8,1,1,0,1,1,0,3,1,0,0,1,4,0,3,6,1,0,1,0,6,1,0,5,2,2,0,10,2,2,1,0,0,0,1,2,6,0,2,6,2,1,1,6,1,0,0,0,0,2,0,0,2,2,2,0,0,5,2,0,2,1,1,19,1,0,1,20,0,2,1,3,5,2,3,0,0,0,0,3,1,0,2,9,0,9,0,0,0,3,0,0,2,7,1,0,1,0,2,0,0,1,1,0,1,9,0,0,2,0,0,0,0,0,0,0,0,0,0,0,0,0,0,0,0,0,0,6,0,0,0,0,0,0,0,0,0,0,0,0,0,0,0,0,0,1,0,0,0,0,0,0,0,0,0,0,0,0,0,0,0,0,0,0,0,0,0,0,0,0,0
K44 From a Buick 8,king,7157,3325,2785,2790,2814,2052,1789,1987,2323,2356,1082,1379,1597,243,275,1164,1016,743,631,727,879,926,717,607,461,532,484,469,759,358,450,567,587,412,368,418,451,545,398,577,543,631,657,420,376,429,522,320,307,511,508,367,352,284,262,322,363,275,291,475,303,230,212,198,229,289,148,322,142,231,272,132,205,244,225,209,195,256,202,124,196,277,120,296,238,252,164,198,224,167,166,186,161,132,253,123,246,128,156,150,166,250,199,136,185,132,217,168,135,207,150,175,140,166,138,191,123,124,142,52,169,64,189,179,61,103,102,204,112,146,121,191,166,134,118,132,101,129,86,157,19,86,136,81,178,140,93,145,110,178,126,103,109,105,137,44,50,55,96,78,43,95,170,234,106,199,93,77,110,120,117,86,158,53,128,36,52,61,79,108,75,114,73,52,64,71,85,72,142,57,73,65,102,110,70,80,85,41,27,55,69,95,63,116,53,17,71,86,81,139,30,74,66,26,57,54,63,65,95,51,53,84,68,70,71,87,41,38,30,101,63,30,71,89,59,22,47,83,40,48,46,32,119,56,90,55,65,105,67,76,69,42,47,40,44,55,56,48,48,51,79,95,47,55,82,19,67,41,58,60,62,61,63,10,77,37,52,57,60,43,36,6,79,54,149,3,68,5,22,57,35,45,12,44,55,61,31,67,9,51,63,29,64,27,49,84,9,9,23,17,32,40,7,65,32,40,33,57,43,38,31,87,57,89,2,49,42,42,18,49,105,51,36,47,63,86,57,21,33,73,35,24,26,26,59,21,35,51,29,49,91,15,60,41,83,22,31,65,49,37,43,53,37,5,33,7,28,28,23,35,29,22,42,19,34,80,13,25,70,40,23,35,12,35,16,36,0,36,22,35,46,33,37,60,46,67,20,23,35,42,35,37,26,18,33,27,29,52,18,30,42,18,38,9,29,38,14,62,21,18,73,1,5,23,17,35,42,43,30,43,69,28,25,31,1,34,15,31,3,50,34,33,16,35,20,24,17,30,21,42,33,15,31,74,31,40,23,5,17,49,35,4,0,15,10,53,36,24,5,17,8,15,17,17,23,13,14,12,0,20,30,24,34,32,6,33,24,9,30,13,15,20,48,19,20,7,33,22,8,33,25,35,17,20,43,15,23,19,25,21,11,28,32,15,10,16,0,23,19,38,37,27,34,17,24,28,11,19,40,45,25,16,19,9,21,0,32,54,6,23,17,11,52,48,16,16,0,6,11,50,21,27,24,11,30,9,21,39,14,2,47,25,22,5,15,27,16,1,15,12,19,33,34,25,26,26,16,12,13,12,23,17,13,15,15,32,5,54,11,29,20,21,12,15,33,21,6,24,10,26,14,14,57,12,10,0,0,17,13,22,30,11,39,13,4,15,31,10,24,32,9,20,7,18,34,47,26,38,21,4,16,20,43,30,9,0,19,15,17,13,11,9,16,9,60,31,25,16,0,46,18,29,28,36,18,50,12,13,15,14,13,15,30,15,2,8,11,11,11,4,8,20,13,6,6,12,14,28,15,3,17,5,15,20,17,17,2,17,7,5,27,9,5,17,4,23,7,1,9,12,32,5,16,33,7,18,3,21,10,14,8,27,0,12,13,81,10,24,29,13,12,33,5,4,6,10,40,2,11,19,24,8,9,2,0,31,22,11,3,27,38,25,4,11,2,2,20,24,18,25,6,6,10,8,4,14,26,12,10,12,15,10,34,22,18,44,12,5,7,20,16,1,17,5,0,15,11,17,7,9,6,4,4,12,11,24,39,15,16,11,7,4,4,14,4,6,2,12,2,11,22,1,4,16,10,10,40,15,7,26,6,18,17,0,20,25,2,3,11,35,4,8,8,21,10,7,6,11,13,14,24,0,8,10,13,8,13,21,2,7,42,10,15,5,26,7,10,0,12,10,18,11,0,9,8,3,40,14,7,29,16,9,7,17,13,16,4,1,16,18,15,13,20,11,0,14,6,16,9,16,19,12,14,9,5,41,17,11,15,12,11,2,12,13,11,20,4,129,12,16,9,3,4,6,22,14,20,20,13,8,26,0,7,2,11,4,4,9,24,4,16,0,6,13,10,14,6,0,21,1,22,10,8,0,2,15,14,8,8,15,11,16,7,6,7,2,3,6,9,31,14,9,11,3,2,14,1,20,12,1,0,12,9,1,2,10,5,1,7,13,0,3,17,4,1,18,7,20,9,7,0,28,13,25,18,22,13,2,20,2,11,7,18,20,9,7,0,9,26,0,20,0,13,2,22,11,0,0,9,28,4,3,2,2,5,12,18,0,13,18,2,12,41,0,18,9,16,2,48,10,14,16,5,7,13,19,17,3,6,19,14,5,0,7,16,6,27,17,12,9,18,10,11,2,2,0,7,7,13,2,12,6,0,9,12,4,16,2,0,0,0,2,5,5,6,11,10,0,10,5,17,1,3,2,3,3,4,21,4,4,0,0,9,5,4,12,13,6,19,5,15,9,6,4,15,8,26,4,8,10,5,7,1,14,0,0,13,3,18,8,11,33,2,22,11,3,13,21,23,1,10,6,9,4,10,18,14,15,3,37,13,9,5,10,7,31,9,14,12,5,30,0,10,7,8,3,4,10,4,5,1,4,7,8,0,9,0,10,0,1,2,1,6,7,14,11,2,2,5,2,8,7,11,2,13,41,0,4,4,0,15,16,0,12,4,32,1,18,2,5,25,0,7,6,10,6,1,1,2,8,0,3,17,9,3,0,0,3,10,6,4,10,8,1,13,6,15,22,6,8,10,14,1,6,8,0,4,18,4,6,4,9,19,0,0,6,0,4,14,9,15,3,16,22,7,0,13,7,0,13,17,0,4,7,1,18,12,2,9,10,0,8,20,6,0,10,10,3,0,38,18,3,7,18,16,19,11,3,6,15,0,6,4,5,5,10,1,17,1,9,3,3,14,5,3,8,1,1,7,5,1,2,2,6,0,5,12,8,3,14,14,10,41,0,15,10,10,6,0,6,1,26,8,5,0,6,5,2,18,5,12,25,12,0,8,13,1,8,10,7,15,5,8,8,1,0,11,12,9,2,3,2,9,5,3,2,12,9,8,13,3,8,9,40,6,0,0,27,0,29,1,0,8,7,8,9,1,4,12,3,14,9,5,2,3,2,0,0,5,3,10,0,0,9,7,12,2,0,7,0,2,10,4,1,0,4,4,8,15,2,4,5,0,5,8,0,1,2,6,6,2,6,0,0,5,30,9,3,10,4,7,7,3,7,0,8,5,50,5,8,3,13,1,5,4,0,8,5,10,1,2,11,4,0,4,21,17,0,6,6,8,8,3,9,0,1,4,10,2,1,7,6,10,11,14,13,11,24,1,9,2,14,2,4,6,2,0,0,1,9,6,3,3,0,0,7,0,3,2,1,3,6,0,0,7,7,7,0,3,0,3,10,3,5,9,7,4,9,7,7,3,1,171,2,4,3,4,1,5,7,5,4,7,15,8,11,8,0,14,4,10,11,5,8,12,1,2,2,4,9,3,10,7,2,8,4,2,9,10,12,15,8,4,0,11,6,12,1,12,7,3,6,13,1,3,3,1,8,0,5,0,11,13,166,10,5,13,0,12,12,1,9,0,7,5,5,4,10,9,6,13,8,1,1,12,7,0,4,0,5,1,5,3,0,2,5,0,16,3,3,8,1,1,0,9,1,5,0,3,7,15,1,21,8,0,0,0,10,9,1,4,6,10,2,7,3,7,5,3,5,9,13,2,4,7,4,4,0,17,4,5,7,8,5,2,3,3,3,6,5,4,2,9,2,11,2,5,7,4,5,9,0,12,3,0,5,5,0,2,4,9,1,4,3,4,2,20,5,8,0,12,8,7,12,6,6,0,5,0,10,46,9,2,4,18,0,10,226,17,4,24,8,16,0,1,9,11,4,25,3,10,3,16,10,0,111,5,0,9,0,1,4,0,2,1,12,0,6,4,12,4,6,5,4,1,10,4,3,4,0,4,2,1,6,2,0,3,3,18,3,7,3,1,12,1,4,5,3,5,15,7,14,0,7,1,1,1,6,9,24,4,1,7,6,2,4,5,6,4,6,5,4,10,2,3,12,7,0,9,4,15,4,0,0,4,1,0,6,0,0,0,24,6,7,0,6,5,1,0,6,3,21,0,19,2,11,3,6,3,0,11,5,3,19,1,0,19,5,0,5,3,1,2,1,4,2,1,4,1,2,0,5,1,1,2,5,0,9,12,3,0,1,14,4,0,5,4,8,8,12,1,6,0,1,3,23,5,1,1,4,0,16,7,7,0,0,5,2,6,2,0,4,3,2,10,11,4,3,2,2,17,300,0,8,4,15,6,5,15,3,4,0,0,1,17,0,9,3,0,1,2,2,0,4,36,6,8,6,1,5,2,4,2,0,1,4,1,6,3,11,3,7,10,6,3,2,1,18,4,8,4,8,1,0,1,4,1,6,2,7,0,2,6,8,2,3,0,6,4,1,6,0,3,1,3,25,4,1,6,3,3,0,0,6,3,10,0,6,4,1,10,3,0,21,19,7,3,1,2,4,7,3,8,5,3,0,9,6,5,0,13,0,4,7,1,8,5,2,4,3,6,6,0,1,1,10,1,14,5,5,8,6,2,1,11,3,11,6,3,0,5,2,3,2,5,2,1,9,8,9,0,1,1,0,0,1,14,0,3,0,13,2,27,6,1,7,0,0,0,3,5,7,8,5,2,5,0,0,7,10,0,0,10,2,0,5,0,2,0,3,5,5,1,2,2,1,4,3,0,0,0,0,2,8,0,0,2,2,2,3,7,7,7,2,0,5,2,5,4,2,3,1,2,0,4,2,8,1,0,1,3,4,0,0,7,0,2,1,16,6,0,8,0,0,6,1,4,2,2,6,3,2,7,0,2,0,0,2,0,1,1,0,0,0,10,3,106,2,3,0,4,7,5,2,0,11,2,8,5,7,0,4,4,0,6,3,0,0,1,9,0,5,2,3,2,0,4,5,0,3,6,1,3,1,2,5,3,1,3,2,0,0,6,7,1,1,2,0,4,0,1,1,2,2,4,2,7,2,1,2,5,1,1,1,4,1,2,34,3,0,1,1,5,2,1,1,4,14,3,0,3,0,29,1,2,1,0,0,8,3,2,5,3,3,3,1,5,3,7,2,11,7,9,5,1,1,0,2,13,7,1,0,1,1,1,2,7,7,1,1,1,5,3,1,2,3,0,3,0,2,2,36,0,7,8,1,7,7,3,5,0,8,1,5,0,1,3,2,8,0,2,0,8,0,2,8,3,2,0,2,11,3,2,6,1,3,3,1,0,2,0,0,4,11,1,3,17,0,2,1,1,0,0,6,0,0,7,4,2,6,0,3,0,3,0,0,1,19,1,5,2,0,1,1,0,27,0,3,0,2,3,4,2,0,0,1,3,4,4,2,5,5,2,0,10,0,2,0,0,1,0,1,2,5,10,0,0,9,3,1,3,4,9,1,0,10,4,0,2,0,0,4,3,0,7,0,3,0,6,0,0,2,2,0,0,3,10,0,6,4,2,4,3,2,0,0,13,0,0,0,0,7,13,2,0,4,1,7,4,0,2,1,8,4,0,4,3,0,1,2,0,0,1,4,1,1,8,1,2,12,0,1,0,6,1,0,0,0,4,0,0,0,0,0,0,3,2,2,1,5,5,1,6,6,3,0,1,1,0,4,2,0,5,6,0,7,1,4,5,2,9,0,0,3,2,5,6,0,1,7,2,1,0,2,1,2,11,5,0,4,2,12,0,4,0,4,1,4,2,0,20,0,0,3,0,0,5,2,0,6,0,3,2,5,4,1,6,0,0,0,51,0,1,3,2,6,0,2,0,1,6,3,1,0,14,16,0,1,3,0,4,1,6,3,6,2,5,0,3,7,1,9,1,1,3,3,3,3,1,2,3,9,0,2,0,0,0,1,11,0,8,4,2,0,1,7,0,4,0,0,0,8,5,8,13,6,3,0,4,2,0,4,2,10,7,3,6,0,3,5,2,0,0,2,1,0,5,14,3,0,5,0,3,4,0,4,1,2,3,3,0,0,2,4,3,0,8,1,0,6,3,4,3,7,1,2,0,0,4,0,0,3,3,0,1,3,1,3,3,1,10,0,4,12,2,3,4,0,2,11,4,0,5,3,3,0,2,3,3,6,1,1,9,0,7,0,5,0,1,0,0,0,0,6,0,2,2,0,4,4,2,3,0,1,0,1,0,0,4,2,5,0,0,12,0,0,5,0,1,1,0,26,3,2,0,0,0,2,4,1,2,1,3,0,6,0,7,3,0,1,2,2,2,0,0,0,2,3,14,3,1,2,6,4,2,3,1,1,3,0,8,1,2,8,1,5,1,3,2,2,4,0,2,0,13,4,4,7,0,0,1,3,9,1,0,19,2,1,2,0,1,1,1,3,3,7,3,4,2,2,4,1,0,2,0,1,0,7,1,1,1,0,0,3,4,0,1,0,9,1,1,8,1,1,0,4,1,1,7,0,3,0,0,0,0,4,0,4,5,2,2,1,0,9,0,7,0,0,9,0,3,1,2,0,1,4,4,8,6,3,1,0,6,1,0,1,4,1,0,3,0,1,1,3,0,4,5,7,1,6,0,9,3,2,0,8,2,0,1,0,0,1,1,0,0,0,0,6,5,0,2,1,2,0,2,4,0,4,2,1,0,0,1,0,2,1,1,1,0,1,0,0,1,1,2,5,2,0,0,9,1,0,0,6,1,2,3,3,0,0,1,0,0,1,1,1,1,0,2,0,5,1,0,1,1,1,0,1,0,1,5,5,8,7,5,5,1,1,0,5,0,6,0,0,2,1,2,0,3,1,0,3,0,6,2,7,0,5,0,9,1,4,3,1,8,1,2,0,10,1,0,2,0,1,1,2,2,2,1,1,1,0,4,0,0,2,5,0,6,8,0,5,1,0,3,4,4,1,1,0,0,0,3,9,3,0,0,6,0,7,10,0,5,14,2,1,3,5,3,0,0,0,0,1,0,0,1,1,2,6,2,2,1,3,1,0,3,3,1,5,0,2,0,0,1,2,1,0,0,0,0,8,6,3,0,1,0,2,4,1,0,0,0,0,5,0,0,0,1,2,0,0,0,1,0,2,1,2,1,8,0,0,0,1,0,5,5,2,4,0,3,0,7,9,10,0,3,0,5,4,5,1,2,3,4,1,0,9,4,0,6,0,4,1,1,3,3,1,1,5,0,3,3,2,4,7,0,0,4,1,3,1,0,0,0,5,1,2,0,3,2,0,4,0,14,0,3,2,0,0,0,0,7,7,2,3,1,7,6,1,0,4,1,0,0,4,2,3,2,9,1,2,6,11,5,0,0,0,2,1,0,4,8,1,4,2,0,1,4,20,5,1,0,2,0,1,2,1,0,5,2,0,7,9,1,0,2,0,4,1,2,4,16,1,3,0,2,1,0,10,0,0,0,2,0,1,4,3,3,0,3,5,0,1,3,0,0,0,1,0,3,0,3,1,0,1,5,0,2,0,2,0,0,4,0,3,0,0,1,2,2,1,0,4,2,1,0,0,0,4,1,0,3,2,0,6,0,1,7,0,3,2,5,2,1,1,0,2,1,2,2,0,0,0,1,1,0,3,1,1,4,2,0,10,6,0,4,6,0,4,1,1,3,2,2,1,0,2,0,3,0,0,4,0,2,4,4,2,1,2,2,0,2,0,3,0,6,2,2,0,3,0,0,0,1,3,2,3,1,1,4,2,17,0,0,0,1,0,5,0,0,0,6,2,3,2,0,0,3,0,1,0,2,0,5,0,0,1,1,2,0,1,1,4,2,5,5,0,0,4,1,2,0,2,2,3,4,0,10,0,1,0,6,2,7,4,2,8,0,1,1,0,0,1,0,0,1,0,2,0,0,1,3,5,1,2,0,1,2,2,2,4,0,2,0,0,0,5,2,2,1,1,0,1,1,2,1,0,1,2,0,0,7,0,2,2,4,0,8,0,4,0,1,4,9,0,2,6,5,1,4,3,0,9,0,3,5,1,4,0,0,4,3,2,16,0,1,2,1,1,2,7,2,0,0,4,8,0,2,0,2,1,1,0,3,0,4,0,4,1,2,0,0,0,3,5,0,1,4,4,1,0,1,0,1,1,0,0,1,0,0,1,3,0,0,0,3,7,4,0,0,11,1,0,0,2,2,17,16,0,0,0,1,0,0,1,5,0,1,7,3,8,2,0,0,6,0,4,0,3,2,11,4,1,4,0,3,0,12,5,1,0,5,0,0,1,11,0,6,1,2,0,5,1,2,4,4,1,5,4,9,2,0,0,0,1,0,1,0,1,2,1,3,0,0,3,1,4,0,0,3,0,0,0,12,4,3,2,2,3,7,1,1,0,0,0,1,1,7,0,3,1,0,1,1,1,3,1,0,7,4,0,0,0,4,9,0,1,2,1,0,1,3,0,2,0,1,1,0,0,1,3,4,1,260,0,0,0,1,7,0,1,1,0,0,3,6,0,8,3,2,5,2,3,3,1,0,2,0,0,4,0,1,3,3,0,1,0,0,0,0,6,0,0,1,2,6,3,3,0,0,4,3,0,0,1,4,0,2,4,2,0,1,0,0,1,2,0,2,2,1,0,1,2,1,1,1,4,0,0,3,7,2,1,8,5,0,0,2,2,3,7,0,2,0,1,1,4,3,0,0,0,3,1,0,1,2,0,5,1,3,4,3,0,0,1,0,2,0,3,0,3,1,0,1,6,5,0,2,2,1,5,1,1,0,6,3,1,2,1,0,0,1,1,0,2,6,2,0,62,1,3,0,21,2,0,1,0,0,0,1,2,3,0,0,0,0,1,0,0,3,0,4,7,1,4,0,0,0,0,2,0,0,7,0,0,3,1,16,1,0,0,0,3,1,0,2,1,3,0,2,1,0,0,1,0,1,12,4,0,2,3,1,0,0,5,0,4,3,0,18,0,0,7,4,3,0,1,0,2,1,0,0,0,1,3,1,3,0,1,4,1,1,0,4,0,3,2,1,2,1,0,2,0,0,0,1,0,2,0,4,0,6,0,0,3,2,0,0,1,0,0,3,0,1,0,2,0,3,1,3,0,3,0,1,1,2,4,0,0,0,0,6,9,1,0,0,0,0,0,2,0,1,4,0,0,1,1,1,9,1,1,0,0,2,2,2,0,4,3,1,0,5,0,0,1,2,0,3,0,0,1,0,6,5,5,2,1,1,0,3,0,2,0,0,0,0,5,3,0,0,0,3,24,4,0,1,2,0,1,1,0,2,0,2,0,0,12,0,0,0,0,0,3,0,4,1,1,1,50,5,1,0,11,1,1,4,0,0,0,0,3,0,0,0,1,0,0,0,3,0,2,2,1,2,1,4,0,0,0,2,0,3,1,3,0,0,0,1,0,0,0,4,0,2,0,0,0,0,0,1,1,2,0,1,0,2,1,1,3,1,1,0,1,2,0,0,0,1,0,3,1,3,0,0,2,0,0,0,7,0,0,0,1,3,6,4,0,0,0,4,2,0,1,0,1,0,6,0,1,1,0,0,0,0,0,2,2,2,2,0,0,3,1,4,0,0,0,2,2,0,2,0,0,3,0,0,1,7,3,0,2,0,0,3,1,0,18,1,2,5,10,3,0,2,0,0,1,1,0,2,1,0,0,1,0,2,0,1,0,2,2,0,3,2,0,0,0,2,0,0,1,2,0,0,5,2,5,7,2,1,2,1,0,2,1,1,5,0,1,2,1,0,2,0,0,0,0,0,2,1,9,0,4,0,2,3,3,1,0,0,0,0,0,1,1,0,1,10,0,0,3,0,0,3,0,0,6,3,1,0,0,0,2,2,1,0,1,3,0,1,7,0,0,5,11,0,5,3,2,3,0,1,0,0,0,0,0,1,0,0,3,2,4,0,1,2,0,1,2,1,0,0,0,1,1,0,0,0,0,1,0,2,0,0,0,11,0,0,13,3,2,0,0,19,7,2,1,1,0,0,1,1,0,8,3,3,1,1,0,1,0,4,4,0,6,2,4,0,2,33,2,0,0,0,0,0,0,1,1,0,0,2,2,0,0,3,2,0,0,1,0,0,0,0,0,4,1,2,1,5,0,0,0,0,0,3,6,0,2,0,0,0,1,3,2,1,0,0,1,0,0,0,0,0,4,0,0,0,0,1,1,1,1,1,1,1,0,3,2,0,1,0,3,2,2,0,0,3,1,0,1,4,0,0,0,1,0,0,0,0,0,0,1,1,0,1,4,7,2,2,1,0,1,0,1,2,1,1,2,1,114,0,1,1,0,0,0,0,0,1,0,0,2,0,1,0,8,0,3,0,1,0,1,0,1,0,4,2,0,0,0,0,0,2,3,0,1,1,3,0,0,1,2,1,3,0,2,2,0,1,0,0,0,1,0,0,2,0,1,0,2,1,0,2,0,1,0,0,3,1,0,3,2,1,0,1,0,1,2,0,2,3,0,1,1,7,0,2,0,0,0,2,0,0,538,0,0,2,2,0,0,3,2,3,16,0,0,1,1,0,0,3,0,0,1,0,2,4,1,1,0,0,5,1,0,21,0,1,2,2,2,2,1,0,1,1,0,0,3,0,0,0,0,0,0,1,1,0,1,1,0,3,0,0,0,3,1,0,3,1,0,0,0,1,15,0,0,0,1,0,0,0,0,0,0,0,0,0,4,1,0,0,4,1,0,1,3,1,5,0,1,3,1,1,1,0,4,0,0,1,0,0,3,0,1,0,0,15,1,8,1,1,0,1,2,1,0,6,0,1,3,2,0,1,0,0,0,1,0,0,0,3,4,0,1,0,0,2,1,1,6,0,1,1,0,0,0,0,0,0,1,0,1,3,1,0,1,4,1,0,0,1,0,3,0,2,0,1,1,1,0,0,1,0,1,0,0,0,10,0,0,1,1,0,0,2,19,1,0,0,0,0,0,1,1,0,2,2,5,0,1,1,0,0,0,0,0,0,3,1,3,3,1,0,3,1,0,0,1,0,0,8,0,0,0,6,0,0,0,1,0,1,0,0,0,0,0,3,0,0,0,1,0,3,0,0,0,2,1,0,0,2,0,0,0,0,2,1,0,0,0,0,0,1,0,0,1,0,0,0,0,0,0,1,0,0,0,3,0,0,0,1,0,0,0,1,0,0,0,0,0,0,0,0,0,0,1,0,0,0,0,0,0,0,0,0,0,0,0,0,0,0,0,0,0,0,0,0,0,0,0,0,0,0,0,0,0,0,0
K45 DT1 The Gunslinger,king,4847,2025,1165,1505,1550,505,1362,1077,964,862,613,1102,573,237,207,457,620,493,327,349,400,371,314,477,101,351,140,333,178,170,235,263,165,200,208,218,221,199,61,215,163,215,267,213,73,140,159,125,184,171,181,224,130,159,155,141,190,107,109,65,130,106,109,155,128,110,133,155,71,152,43,49,79,85,40,101,76,56,72,84,56,58,270,80,100,145,86,45,86,36,49,94,150,101,59,58,59,74,52,76,74,69,41,65,104,89,78,121,47,49,91,67,31,97,65,37,82,38,102,17,65,99,91,130,19,34,77,36,55,45,62,85,29,36,84,37,14,139,68,39,8,33,23,24,28,50,44,79,22,25,44,42,60,30,59,15,52,36,59,51,22,76,16,28,43,74,61,28,27,34,5,36,25,36,4,23,24,47,69,32,39,13,64,29,44,3,12,33,46,24,16,19,46,25,44,88,58,9,32,5,22,85,31,67,14,0,19,187,8,16,37,27,20,19,38,39,28,45,30,42,25,20,52,43,9,97,21,26,22,13,58,32,60,63,35,2,24,34,53,24,16,6,16,17,32,29,14,57,21,51,22,58,18,47,39,12,19,9,36,57,49,5,16,29,18,29,18,34,21,42,32,15,19,14,19,22,16,9,58,20,20,20,29,27,63,15,11,14,22,35,15,10,0,16,29,12,10,7,2,10,20,22,7,13,67,9,3,14,41,32,61,7,21,17,21,50,8,21,27,6,45,16,9,284,5,14,41,8,8,13,16,13,13,23,11,7,37,21,27,9,14,22,14,0,6,37,13,2,19,14,14,38,10,19,61,1,3,10,12,8,13,44,26,10,15,26,7,15,9,14,21,19,7,10,6,39,24,3,25,11,14,27,8,23,5,0,0,27,21,25,8,10,10,0,22,17,22,14,8,13,5,42,20,11,14,3,13,13,8,14,17,14,22,27,19,74,14,8,10,11,8,0,0,11,12,21,6,7,4,1,12,7,3,25,0,53,15,24,0,4,23,5,11,13,7,10,34,25,5,19,25,12,3,10,12,9,12,8,33,9,14,0,0,6,2,3,20,28,0,28,1,21,6,14,15,13,13,9,0,13,6,26,21,15,14,23,17,17,17,2,51,8,30,10,9,15,13,9,8,10,31,13,0,23,14,5,1,10,19,2,21,35,11,25,9,20,0,14,21,3,33,8,14,7,24,3,16,6,19,6,1,18,13,7,23,1,13,12,5,9,47,4,3,15,17,34,0,11,5,2,16,17,10,1,14,10,22,6,2,0,4,6,6,9,3,11,10,8,8,14,8,12,12,16,5,0,11,2,8,2,7,15,9,9,1,10,32,9,54,10,18,2,11,4,2,7,5,18,7,8,10,38,7,5,6,2,0,16,4,4,7,1,17,6,5,9,12,2,5,18,4,3,8,11,15,3,3,22,35,19,0,6,4,37,16,0,8,16,8,20,10,6,11,8,0,11,3,7,0,6,0,12,17,7,39,31,13,2,25,1,1,8,19,4,0,17,23,16,2,15,9,8,2,3,5,12,7,25,13,6,10,6,7,4,9,6,0,24,7,8,3,5,2,9,0,2,11,0,13,10,12,3,9,22,5,7,4,9,2,13,4,13,16,22,2,2,3,38,10,8,11,1,3,9,23,12,0,4,7,5,10,2,17,33,0,4,8,4,5,15,12,3,0,15,0,7,14,18,7,4,4,7,13,15,1,31,0,0,9,3,8,11,9,13,6,1,9,3,10,11,7,4,1,4,0,1,3,17,2,4,9,5,9,11,13,3,18,1,2,2,4,11,1,21,14,4,0,6,1,6,1,5,20,9,9,13,36,3,3,11,15,7,12,1,14,2,1,0,9,6,9,0,8,8,11,8,7,15,3,2,1,0,0,5,0,39,11,7,0,3,21,2,14,26,13,7,2,0,13,1,17,13,1,5,3,2,1,1,1,5,21,1,8,13,19,20,0,0,2,12,10,2,12,3,0,3,2,11,9,16,19,6,4,8,1,10,3,1,6,12,7,6,2,0,11,6,13,0,20,11,0,0,11,3,7,3,4,4,16,6,8,0,11,0,4,6,16,0,19,6,10,0,2,3,7,4,2,0,3,3,5,7,4,5,2,3,9,18,1,7,2,1,2,9,7,6,1,6,6,0,3,12,8,0,0,22,4,3,2,16,0,9,5,0,1,4,2,3,4,5,0,0,6,5,8,21,11,7,4,0,4,5,15,0,0,4,0,0,3,5,5,33,3,6,3,12,0,2,6,0,12,0,0,0,43,16,0,0,0,4,0,2,8,3,0,7,7,0,2,4,0,5,0,0,3,0,8,9,2,1,0,5,8,0,5,0,9,7,1,7,6,0,0,5,20,2,4,7,1,1,5,7,12,6,2,0,4,13,8,6,6,2,0,1,3,16,0,1,0,0,2,0,6,2,13,4,1,0,4,42,0,2,4,0,1,1,0,2,9,1,1,0,8,1,10,1,10,2,6,2,3,14,9,2,2,13,6,11,3,7,11,2,11,3,0,0,0,6,7,12,13,4,0,2,21,0,14,4,1,0,3,0,10,5,17,27,6,2,0,11,5,2,1,7,9,3,23,0,1,3,5,0,13,6,2,7,0,2,3,5,2,4,1,5,0,3,0,2,1,0,0,3,7,4,2,5,10,1,7,0,1,10,9,3,9,1,0,4,8,0,8,3,0,5,9,1,7,2,0,2,14,0,4,2,28,1,2,2,9,5,0,6,8,23,0,0,0,3,2,4,7,5,9,2,8,5,3,9,3,4,6,7,2,2,5,0,0,4,1,2,6,4,9,0,0,0,0,0,0,1,0,0,9,6,0,12,0,0,2,2,5,0,3,6,0,3,7,3,1,1,0,1,1,6,0,0,7,2,0,0,3,5,3,10,7,0,5,6,1,2,0,8,2,0,0,3,2,5,0,0,5,6,5,4,2,14,0,2,10,1,0,0,0,12,0,3,6,14,5,1,5,2,0,0,12,11,4,3,4,1,3,6,8,1,0,12,1,1,1,4,11,21,0,0,7,2,1,8,5,0,13,1,1,1,17,3,1,4,3,0,0,4,5,0,2,2,2,0,8,3,0,5,8,0,2,0,0,1,0,0,1,0,4,17,1,2,0,6,0,8,3,1,17,1,0,2,4,0,7,0,0,0,0,1,0,13,0,0,0,0,0,2,2,1,0,2,16,1,3,0,7,1,0,1,0,0,0,1,7,1,3,1,0,3,1,3,2,9,8,21,6,0,0,1,1,6,0,3,8,1,5,10,0,14,2,0,4,0,7,1,0,6,2,0,2,0,11,0,3,4,1,0,6,7,0,0,6,2,2,1,1,1,3,6,0,3,4,1,0,3,2,1,0,0,2,12,0,0,8,2,8,0,0,0,0,10,0,3,1,1,0,7,6,1,14,2,0,0,0,0,4,8,5,2,10,5,1,2,1,6,2,5,0,0,6,0,2,0,0,0,4,3,0,5,5,1,0,0,5,1,4,10,8,2,0,2,7,1,13,7,3,7,2,0,2,0,30,2,2,0,5,8,2,0,2,2,6,2,14,2,0,19,3,22,1,1,1,1,5,8,0,8,1,0,5,10,17,0,3,3,2,0,0,1,7,0,1,1,15,7,2,9,0,1,1,6,0,6,0,4,1,4,5,0,0,2,2,1,3,2,1,0,1,0,3,3,4,5,0,8,1,0,8,0,0,0,22,3,4,3,0,1,16,16,5,5,0,1,0,9,4,7,5,0,2,7,10,0,4,19,1,8,3,3,0,4,0,1,0,1,5,3,11,1,22,11,0,6,2,1,0,0,4,0,0,0,1,2,0,0,25,6,2,1,5,1,23,2,3,0,0,10,0,0,2,11,3,0,0,18,3,5,15,0,4,0,1,1,5,6,1,0,13,0,5,1,0,3,14,2,2,8,19,13,0,0,1,6,6,2,1,3,8,4,0,2,0,6,2,14,7,1,2,5,3,1,0,11,0,0,1,1,0,2,1,0,0,3,2,1,3,0,1,1,0,7,5,0,1,1,6,10,0,11,0,0,2,1,8,0,3,0,1,2,5,0,2,1,12,5,3,2,2,0,9,0,6,0,3,6,3,4,0,0,2,0,2,1,0,0,1,20,4,2,2,6,8,2,0,1,0,2,0,3,57,0,3,5,3,0,12,0,7,1,3,1,3,1,1,2,5,3,6,0,1,2,0,4,0,6,27,2,0,4,10,1,10,0,5,0,0,4,1,1,4,1,0,0,2,3,2,3,0,0,2,0,1,0,0,0,0,8,0,2,0,1,3,0,0,0,0,4,2,0,2,2,2,1,2,0,7,0,0,1,2,4,2,0,2,1,0,0,0,6,2,0,1,8,0,0,0,0,0,4,0,7,1,1,0,1,2,3,0,0,5,2,0,1,1,5,2,0,2,1,6,1,1,0,3,11,1,3,0,0,0,0,2,3,1,3,0,2,4,2,8,0,1,3,2,2,11,0,4,1,0,0,0,0,2,0,9,0,1,1,1,0,0,0,1,1,0,4,1,2,1,2,3,1,1,2,3,6,2,0,1,0,2,1,2,0,2,0,2,3,0,6,5,1,1,6,5,5,2,0,1,3,6,1,4,3,4,3,0,3,6,4,2,11,1,3,7,0,0,3,3,0,5,2,0,3,0,0,1,2,0,1,2,3,0,10,2,0,0,10,6,9,0,0,0,5,3,1,0,2,3,15,1,0,4,3,0,0,2,7,9,3,0,0,1,2,0,0,0,2,1,1,0,0,0,0,1,0,2,8,0,0,7,0,0,0,2,1,2,1,0,1,2,4,1,0,1,0,5,0,7,2,0,7,0,0,3,1,0,0,2,0,11,1,17,5,0,7,0,0,8,0,6,0,0,0,6,0,1,0,6,0,0,5,1,3,4,0,0,0,3,0,0,1,0,0,0,3,3,0,2,8,1,3,3,4,0,8,0,0,3,7,0,0,1,4,1,1,8,6,3,0,0,1,1,2,2,1,1,0,1,2,1,0,1,0,1,5,5,1,0,0,0,0,2,0,1,1,11,1,0,3,5,0,1,0,1,0,0,3,0,9,6,11,0,0,0,2,1,1,0,1,1,2,0,6,0,0,0,13,1,0,4,1,4,0,8,1,0,1,1,1,0,0,0,0,5,0,0,8,1,1,2,1,10,5,1,1,3,1,1,6,2,0,0,0,7,1,2,3,0,0,0,1,6,2,0,0,0,0,6,9,0,7,2,1,1,4,0,2,0,0,0,2,3,0,1,0,2,0,0,0,1,7,0,0,9,5,0,5,0,0,0,1,0,0,6,2,0,1,0,0,0,0,7,0,1,0,1,0,2,0,8,5,2,4,0,4,0,1,30,0,0,0,0,2,7,0,0,0,0,1,2,0,0,9,2,8,1,0,0,4,5,2,1,4,0,1,0,0,0,1,17,3,0,0,0,0,0,10,0,0,0,0,1,0,2,2,1,0,1,1,3,15,0,0,0,5,1,0,4,0,3,2,7,3,6,1,3,2,0,3,14,0,0,0,1,0,2,2,0,0,0,0,0,0,0,1,8,7,1,5,0,1,0,4,3,5,1,2,0,2,2,0,3,2,4,0,8,4,4,0,3,2,1,2,0,2,3,3,0,3,0,0,2,0,0,2,0,0,0,3,0,10,0,0,0,3,1,1,1,0,0,1,2,3,0,0,1,0,4,2,0,8,3,0,4,0,0,0,0,0,4,1,2,8,0,0,0,2,1,0,2,2,0,3,1,6,0,3,1,1,1,1,0,3,0,0,0,4,0,0,8,5,0,1,0,9,0,1,2,2,1,0,0,0,2,3,0,1,1,7,1,0,2,1,2,3,3,4,1,6,2,4,1,0,4,3,6,10,1,0,3,0,0,0,0,0,3,1,0,5,2,0,7,1,3,1,0,0,1,0,0,0,1,0,1,0,0,0,0,0,3,0,0,0,0,5,1,0,2,1,2,1,3,0,1,7,2,0,3,2,3,1,1,2,2,0,0,0,4,0,3,1,1,0,1,2,3,0,0,4,0,3,3,0,0,0,0,0,2,0,0,1,4,0,1,2,4,13,1,5,0,0,0,0,1,0,1,0,0,0,0,0,1,2,0,1,5,0,0,0,2,0,1,0,0,0,8,1,0,0,0,0,0,0,5,0,0,1,1,0,2,2,0,1,0,0,0,1,0,0,2,0,1,2,1,4,0,2,0,1,0,3,2,0,3,2,0,23,2,0,1,2,0,0,0,0,3,3,0,1,1,2,0,0,1,2,0,0,0,0,2,1,0,5,1,0,0,7,0,0,7,6,0,0,0,0,4,2,3,1,0,0,7,0,0,1,9,1,1,1,0,1,4,1,3,0,1,0,2,0,2,4,1,0,0,2,3,0,0,2,0,1,7,0,1,0,0,1,2,2,0,1,2,0,1,5,3,0,0,0,0,2,3,10,0,2,1,2,3,0,0,0,2,5,0,1,1,0,2,1,0,0,2,0,4,0,0,0,3,0,5,4,1,3,0,1,1,0,0,0,0,0,0,0,2,1,0,5,1,0,3,1,2,0,0,2,4,1,0,1,1,0,5,0,0,10,0,1,0,0,0,2,2,1,0,5,0,0,1,1,0,0,0,0,0,0,0,1,0,1,0,2,0,0,1,1,4,0,0,1,1,3,1,1,0,0,5,1,10,8,3,2,0,0,0,0,1,0,5,4,3,2,0,1,0,0,0,2,2,4,4,1,0,0,4,0,0,0,1,0,2,0,2,0,9,3,0,0,0,0,0,1,2,1,0,0,0,1,0,1,0,4,0,2,0,2,0,0,8,2,3,0,1,1,0,0,2,2,1,3,0,6,1,4,0,1,1,1,0,1,1,0,0,0,0,0,0,0,3,0,1,1,0,0,1,0,0,2,0,0,0,2,0,0,0,0,0,0,0,0,0,1,0,0,0,0,6,3,5,1,0,0,0,1,0,2,2,2,0,1,0,0,0,1,1,1,0,0,0,2,0,1,0,0,1,1,2,4,0,0,14,0,1,0,0,19,0,0,3,0,1,0,0,0,0,5,1,2,0,2,3,1,6,1,6,0,1,0,1,1,0,1,0,0,0,0,0,0,0,1,1,1,1,0,0,1,0,0,0,4,3,1,0,1,0,0,2,0,1,1,1,0,0,3,0,0,2,0,2,1,4,2,3,1,0,0,1,4,2,6,0,4,0,5,2,1,3,0,3,2,0,0,4,0,7,1,1,1,0,3,0,0,2,6,0,0,0,0,8,0,0,12,0,0,2,0,39,3,23,0,0,0,0,6,0,1,0,0,0,4,1,3,1,3,1,3,9,0,0,0,0,0,1,2,0,1,0,0,5,0,0,0,0,1,1,0,4,1,0,1,1,4,0,1,0,1,1,10,1,4,1,1,0,1,0,3,3,1,1,4,0,0,0,2,0,0,0,1,9,3,4,0,1,0,0,0,0,2,0,0,0,0,1,3,0,2,2,0,0,1,4,0,0,0,1,0,1,1,0,13,0,0,1,1,1,2,1,2,0,0,0,2,2,0,1,0,4,5,0,0,2,5,1,1,0,0,0,1,0,2,0,0,5,0,0,0,0,0,2,0,0,0,5,0,0,0,1,0,1,0,0,2,0,12,0,0,0,0,0,0,0,1,0,0,1,0,4,0,4,2,1,0,1,1,0,0,0,0,1,0,0,1,2,0,2,1,0,0,0,0,3,0,3,0,0,0,0,0,3,0,1,0,0,0,0,0,14,2,1,1,1,0,0,0,0,0,0,0,3,0,3,0,1,3,0,2,0,3,1,6,0,0,0,1,0,0,0,1,3,1,6,0,2,11,0,1,1,0,0,0,0,1,0,0,0,0,0,0,0,1,1,0,1,0,0,1,0,2,2,0,0,0,0,0,1,1,3,0,0,0,4,0,0,1,6,1,1,0,0,2,1,0,0,6,0,0,1,0,1,0,1,0,4,0,1,0,0,0,1,0,1,1,1,3,2,2,4,3,0,0,0,0,0,0,0,0,1,0,0,0,0,0,1,0,2,0,2,0,0,0,0,0,1,0,2,2,9,7,1,4,1,1,1,9,1,0,0,0,0,2,0,0,2,2,0,0,0,0,2,0,0,0,0,0,2,2,3,1,0,1,1,1,1,0,0,3,0,0,0,2,0,0,1,2,0,0,0,0,0,1,0,0,0,0,0,0,1,0,0,0,0,2,0,0,0,3,2,0,3,0,0,0,0,1,0,0,4,1,0,0,2,1,0,0,1,12,1,1,4,0,0,5,8,2,0,3,0,0,0,2,0,0,1,1,2,0,3,1,1,0,0,1,0,1,0,0,1,0,3,0,3,1,6,0,0,4,0,1,1,0,8,0,5,1,0,0,0,0,0,2,1,0,0,4,0,0,2,0,0,0,0,0,0,3,0,2,1,0,0,0,0,2,0,0,9,0,2,0,0,2,1,0,1,0,0,0,0,0,1,0,0,0,0,0,2,1,0,0,0,0,0,0,0,0,1,0,1,0,2,0,0,1,9,0,0,1,1,0,1,0,1,1,0,1,1,5,3,1,3,1,0,0,0,0,0,1,1,1,0,1,0,0,0,3,1,0,3,1,2,1,1,0,1,0,2,1,1,0,4,2,1,0,1,1,0,2,1,2,0,4,2,1,0,3,0,6,8,1,0,0,0,0,0,0,0,1,0,0,0,0,0,0,0,0,0,2,2,0,1,0,1,1,0,0,4,1,0,0,0,0,0,3,0,0,4,0,1,8,0,0,6,4,0,0,0,0,0,1,0,3,0,1,0,1,0,0,0,0,1,4,0,1,0,0,0,6,3,1,2,0,0,0,0,0,3,0,0,0,0,1,3,0,2,1,0,1,0,3,6,2,1,0,1,0,1,2,0,0,1,0,1,0,0,1,0,0,1,0,0,0,0,1,2,0,2,1,0,3,0,0,0,4,0,5,2,0,3,0,3,2,3,1,0,0,1,2,0,0,2,1,0,0,0,0,3,0,0,0,0,0,1,0,0,0,0,0,3,2,0,2,7,0,0,0,0,1,3,0,0,0,0,1,1,1,0,1,1,0,0,0,1,4,0,0,0,0,2,0,1,0,0,0,0,0,5,0,0,0,0,0,0,4,0,2,0,0,0,0,6,1,3,1,0,0,0,0,0,1,1,0,3,0,1,0,0,0,1,0,2,2,1,0,0,0,6,0,1,3,0,0,1,1,1,1,0,0,1,5,4,0,0,0,2,0,2,2,4,0,1,0,0,0,0,0,0,0,0,2,0,2,0,0,1,0,0,4,0,2,0,0,0,0,1,1,1,2,0,1,0,0,0,1,0,4,0,1,0,0,0,2,4,1,0,0,1,0,0,1,0,0,0,0,0,0,3,0,0,0,0,0,0,2,2,0,0,5,2,1,1,0,3,0,0,0,2,0,0,0,3,0,0,0,1,0,5,5,0,0,1,1,0,0,5,0,0,0,1,2,1,0,2,0,2,0,6,1,3,0,1,0,1,0,0,0,0,1,0,3,0,1,0,0,1,1,1,0,1,0,1,1,0,2,0,1,1,1,3,0,0,0,1,5,0,3,0,0,0,1,1,1,1,4,0,0,2,0,0,0,1,0,0,1,0,0,2,5,0,0,1,0,0,0,0,6,1,5,1,1,0,1,2,1,3,0,3,0,0,0,0,0,1,3,0,0,0,0,1,0,5,0,0,0,1,0,5,0,0,0,1,1,0,0,1,5,1,3,0,0,0,0,3,3,2,0,0,2,0,0,0,0,1,0,1,0,2,2,1,0,2,0,2,1,3,0,0,0,1,0,0,4,0,0,4,0,0,1,0,1,5,0,0,0,1,2,4,0,0,6,0,1,1,0,0,0,0,5,0,0,0,2,0,0,1,0,2,0,0,0,2,0,0,0,0,0,0,0,5,1,0,0,9,1,2,0,3,0,0,0,0,2,0,3,0,2,0,2,1,1,0,3,4,0,0,1,1,1,6,1,0,2,0,0,0,7,0,2,0,1,0,4,2,1,0,0,2,17,0,0,2,0,4,0,0,2,0,0,2,0,0,0,1,7,1,0,3,2,1,0,1,0,1,0,2,0,0,0,0,0,5,0,6,3,3,0,1,0,0,0,0,0,0,0,0,0,1,0,14,0,2,7,1,0,0,4,0,1,1,0,0,1,0,0,0,0,2,2,0,0,0,0,0,5,1,0,0,0,2,1,1,0,0,0,1,0,0,0,0,0,0,1,1,0,5,1,0,3,2,0,0,0,0,4,0,1,0,0,1,0,1,0,0,4,0,0,0,0,0,0,0,0,0,3,0,0,0,0,0,0,0,0,0,3,0,2,1,0,2,1,0,1,0,1,0,1,0,0,0,1,3,2,0,0,0,1,0,1,0,0,0,0,0,0,2,1,0,2,1,0,2,0,0,1,1,2,0,1,1,0,0,1,9,0,0,1,1,0,0,2,0,0,0,2,1,1,0,1,1,0,3,13,0,0,2,0,0,0,0,9,0,1,2,0,0,0,0,2,4,0,1,0,2,1,0,0,1,0,0,0,4,0,0,1,0,4,0,0,0,0,0,0,0,0,0,1,0,0,0,0,0,2,0,0,0,0,0,0,0,0,6,4,0,32,0,3,1,0,0,0,0,0,0,2,0,3,0,0,0,2,4,0,0,1,0,1,0,0,0,1,0,5,0,1,0,1,0,2,0,1,0,0,0,0,0,2,0,0,0,2,1,3,0,0,0,1,0,3,0,3,0,0,1,1,0,0,3,0,0,0,0,0,0,0,0,0,0,0,2,3,0,0,1,0,0,0,0,0,0,0,2,7,0,0,1,2,0,1,0,0,1,3,2,0,0,0,0,0,0,2,0,0,0,0,0,0,8,0,0,0,0,3,8,0,0,0,0,0,0,2,1,0,0,2,1,0,3,0,0,0,0,0,0,0,2,1,0,0,2,0,1,3,0,0,0,1,0,0,0,0,0,0,2,0,0,0,0,2,1,2,0,0,0,0,1,3,2,0,0,0,3,0,0,0,0,0,0,0,1,0,0,0,0,0,1,1,3,0,0,4,0,0,0,2,0,0,0,0,0,0,0,0,0,0,0,0,0,0,0,0,0,0,0,0,0,0,0,0,0,1,0,0,0,0,0,0,0,0,0,0,0,0,0,0,0,1,0,0,0,0,0,0,0,0,0,0,0,0,0,0,0,0,0,0,0,0
K46 DT5 Wolves of the Calla,king,12929,6671,5196,5325,5582,2369,4046,3303,3363,3579,2473,2891,2540,1068,1108,1794,1954,1511,1405,1929,1540,1932,1455,1349,556,1243,709,1409,948,1035,910,797,1083,1046,1186,922,945,1002,673,1188,1127,819,1065,875,498,754,832,704,778,874,690,1006,588,491,427,550,655,524,823,522,461,442,509,587,536,580,570,409,519,456,297,252,427,474,221,462,388,398,364,386,319,497,416,509,414,499,336,351,384,280,426,391,372,197,390,226,284,367,371,314,274,417,237,327,497,283,360,323,214,283,472,366,304,298,295,217,166,332,271,186,384,301,190,352,80,235,309,259,202,300,308,283,234,252,321,276,161,262,241,198,71,199,226,159,288,184,186,317,203,205,186,222,197,233,203,194,197,148,272,217,256,177,211,215,186,217,201,115,191,222,154,133,243,141,21,199,124,189,225,214,173,139,243,112,177,72,88,150,257,116,112,123,224,212,87,179,80,84,121,59,120,144,219,210,92,75,112,135,106,164,68,120,151,91,130,142,121,174,137,84,88,138,161,99,103,126,94,138,124,171,156,86,117,264,151,45,58,105,134,166,78,104,100,89,111,128,142,223,108,144,122,80,109,67,106,97,93,83,115,182,124,128,84,107,141,54,97,142,153,201,117,116,138,59,136,81,133,129,196,115,61,44,214,76,250,87,52,32,71,78,59,156,2,87,109,60,57,76,51,81,88,73,45,80,155,139,22,31,57,150,158,55,52,126,140,104,52,87,106,95,137,141,64,183,58,34,132,84,62,65,83,122,122,65,137,75,96,164,96,72,48,60,72,25,43,40,53,86,59,63,148,45,109,60,129,13,75,71,36,55,81,222,112,48,63,65,56,51,103,66,79,39,84,32,88,120,48,57,120,127,30,78,57,71,16,8,0,112,117,99,4,66,84,86,77,111,69,44,71,65,19,93,50,20,68,43,44,58,39,95,41,37,58,162,96,166,39,61,28,46,55,17,17,59,38,63,37,46,59,51,92,62,27,46,10,59,55,69,2,82,42,39,91,81,48,72,54,77,38,69,66,27,17,117,79,52,67,81,42,46,107,44,0,48,20,35,72,73,18,82,28,52,44,44,32,51,35,25,0,37,53,86,67,58,50,41,90,126,56,22,63,24,61,26,51,6,45,41,12,82,48,52,11,53,53,36,83,57,40,43,38,75,54,63,80,118,0,37,59,18,94,40,53,14,89,43,55,70,59,76,20,68,60,38,97,8,43,110,19,37,51,33,87,44,55,54,0,38,42,32,43,73,34,11,49,90,47,63,34,3,64,48,45,9,69,46,28,21,40,27,81,45,34,51,31,18,78,34,22,20,35,68,22,40,35,93,79,59,27,19,39,58,26,26,44,54,28,47,16,46,32,30,66,34,35,1,3,39,17,58,53,19,70,33,61,25,46,21,17,71,24,11,15,62,42,43,73,54,57,13,2,41,8,55,33,1,20,24,40,41,30,26,51,21,64,53,38,20,9,59,0,40,46,35,60,84,37,6,38,11,33,32,25,42,11,47,49,32,27,47,49,52,26,29,24,43,35,37,25,38,22,21,14,22,69,37,9,38,21,50,27,19,51,25,6,66,14,3,47,21,91,4,38,70,30,43,15,57,26,23,30,98,86,31,17,48,27,74,40,28,20,4,47,13,33,38,18,8,41,36,33,17,8,32,1,33,30,12,56,41,58,22,152,56,2,13,6,54,46,28,9,25,17,28,13,78,14,9,11,5,61,10,52,47,35,52,50,21,46,42,30,19,36,4,0,24,12,44,8,21,23,22,28,32,39,33,22,12,27,28,26,28,2,34,27,57,1,29,13,27,20,6,30,40,29,15,136,34,32,4,23,42,30,7,27,71,6,2,26,35,33,11,11,20,34,26,11,13,40,66,31,5,22,28,5,21,24,29,1,35,28,15,19,9,46,15,29,0,49,10,61,24,14,10,18,15,27,5,8,34,28,19,24,33,38,49,11,1,21,40,22,65,27,8,0,19,5,32,12,24,29,10,40,28,7,33,38,29,17,39,20,22,16,8,25,39,43,1607,34,46,19,22,15,18,37,25,51,16,26,28,39,0,21,3,13,5,14,11,69,46,24,7,12,15,17,19,7,3,44,3,29,26,29,24,0,78,29,28,13,42,22,22,9,10,22,88,5,37,21,9,35,34,32,5,5,32,42,21,36,45,0,22,32,0,13,47,23,14,31,12,13,1,40,13,14,49,15,27,6,2,3,46,19,2,7,136,26,0,29,38,18,69,26,42,30,23,0,13,14,0,11,0,22,0,31,53,0,0,7,24,24,15,4,6,4,19,21,2,11,28,5,28,3,0,37,0,46,22,11,34,8,15,33,10,45,10,26,8,18,18,21,14,4,26,43,27,17,26,21,11,35,14,24,1,42,0,59,22,48,19,13,19,0,3,37,8,27,12,0,0,0,2,28,30,5,16,7,0,10,26,7,3,14,12,17,0,9,50,13,5,16,0,32,22,6,22,19,18,29,10,19,13,2,26,29,12,22,14,13,44,24,27,4,20,0,0,8,43,28,10,22,50,12,31,50,9,28,45,13,2,13,0,23,14,30,30,25,25,30,30,40,18,8,29,10,14,32,46,31,6,11,8,23,17,14,9,3,13,18,20,10,23,6,38,0,4,1,23,6,7,1,21,14,16,21,58,13,22,26,1,24,40,25,17,25,13,1,10,23,0,29,55,0,43,16,25,8,10,1,5,19,0,17,23,46,7,3,8,13,17,0,11,17,60,8,0,0,9,6,16,12,27,31,5,26,30,13,34,7,12,30,48,72,29,68,0,4,17,6,11,14,9,12,1,0,5,0,6,18,11,10,11,15,18,1,96,17,7,1,18,19,0,11,19,0,10,15,4,14,21,3,6,3,7,0,9,32,11,0,9,4,19,27,8,35,14,31,24,10,8,0,19,6,72,11,19,1,30,1,5,36,28,18,23,8,21,4,8,19,6,7,4,5,37,0,27,19,67,10,31,14,18,2,0,14,14,23,14,12,14,5,22,17,8,2,28,1,14,4,12,24,45,2,0,16,17,14,42,12,18,25,16,19,15,13,11,39,18,12,3,1,14,7,0,43,3,8,11,21,24,0,17,21,3,20,2,41,1,0,9,4,0,8,46,10,30,16,22,48,18,16,13,14,8,7,4,4,0,23,4,0,0,0,24,0,17,5,0,27,0,8,19,9,5,0,20,7,20,19,15,48,2,6,15,9,6,3,1,12,15,9,7,0,4,1,20,10,6,18,22,6,9,2,13,17,18,17,24,17,12,19,15,0,13,23,0,34,0,14,0,10,21,8,0,1,29,36,0,3,18,16,10,11,18,1,7,2,24,3,1,11,19,15,22,1,16,17,18,3,23,8,18,15,10,12,6,1,3,13,8,16,4,0,0,0,10,0,4,8,3,11,29,7,1,21,23,3,0,12,5,7,17,10,5,30,24,9,12,5,17,2,2,11,0,20,3,10,3,9,8,27,13,14,57,10,9,9,6,28,2,18,9,17,15,24,1,10,16,15,27,3,17,13,8,16,22,27,4,12,15,18,26,7,0,8,15,16,3,32,13,6,37,15,28,17,13,3,6,1,6,0,18,7,76,17,12,30,0,17,11,7,2,0,20,10,3,14,9,31,10,35,26,21,1,28,8,2,15,0,17,5,12,4,0,17,21,5,6,2,0,13,1,9,6,6,42,4,10,5,7,11,8,25,12,2,1,4,7,11,3,4,13,14,8,41,13,2,11,1,10,4,30,22,4,6,5,9,0,28,13,4,51,27,34,3,11,0,15,8,10,17,15,13,2,6,16,0,10,19,14,5,0,13,11,0,10,20,1,10,10,32,6,10,5,2,2,26,19,38,1,1,23,6,8,7,14,4,7,0,17,8,7,28,7,0,0,23,7,20,17,4,13,45,0,7,28,12,9,17,8,7,8,26,16,0,27,13,25,9,3,6,9,5,4,3,17,0,13,7,24,20,9,12,27,8,9,7,11,10,0,8,2,15,12,12,1,4,5,4,6,2,6,4,8,3,10,5,2,6,12,14,21,0,31,42,4,4,21,10,8,5,1,1,5,4,2,11,10,27,6,7,20,22,12,6,29,8,0,11,19,15,15,0,0,11,2,0,4,0,2,1,25,17,8,1,14,9,8,0,4,5,19,2,7,9,18,25,22,29,0,16,23,17,18,12,8,32,14,9,2,3,11,7,29,4,2,0,8,2,32,4,8,0,22,8,9,2,12,10,5,0,14,17,12,0,15,3,9,16,2,5,9,0,10,16,0,14,0,1,7,0,22,9,6,0,9,10,3,4,7,0,12,10,0,24,12,15,23,13,4,6,0,0,3,18,20,11,2,23,3,10,17,0,3,1,0,2,8,0,4,8,1,0,13,0,19,1,5,4,5,7,6,4,2,1,10,0,9,5,10,6,0,6,5,11,15,12,17,6,20,5,8,0,0,1,21,6,20,2,16,7,12,15,22,12,3,7,8,1,0,7,1,8,0,3,4,5,1,5,7,11,1,6,7,3,17,2,2,0,54,11,22,4,10,8,8,7,4,11,2,7,52,16,3,3,0,6,6,3,0,5,9,6,18,3,19,21,21,6,7,17,12,1,0,1,13,5,9,18,13,9,4,4,7,4,37,15,17,2,13,17,11,5,8,5,2,15,13,17,9,0,3,19,13,0,0,11,19,2,1,15,3,1,24,14,9,0,2,0,18,3,12,6,24,5,18,0,1,11,4,1,0,7,42,10,8,0,3,1,11,9,8,7,7,4,3,18,17,0,1,7,0,5,10,0,0,1,5,6,12,10,12,8,4,0,9,11,16,7,9,5,2,16,0,11,9,6,16,0,2,3,16,2,0,10,0,20,3,36,13,0,20,2,0,26,9,11,5,2,4,6,3,2,0,11,1,0,6,1,4,14,0,0,3,5,2,2,2,4,5,5,3,8,5,1,10,1,18,7,6,2,15,0,8,12,4,0,0,10,8,3,9,7,11,6,0,4,6,4,4,4,2,3,0,2,2,9,2,2,4,10,3,4,6,5,5,2,0,11,0,5,4,11,8,2,7,22,7,11,4,4,10,4,8,7,9,14,5,7,1,0,2,11,7,9,7,10,21,9,1,2,0,21,11,29,4,7,8,11,1,1,6,0,9,2,3,3,4,3,1,12,5,7,23,1,1,5,26,24,16,13,1,3,13,8,30,10,3,0,0,21,8,3,4,10,11,3,1,3,3,1,8,0,12,20,12,8,11,7,6,11,47,2,7,3,2,2,4,3,11,8,1,15,11,4,1,6,11,11,0,14,15,4,6,30,3,1,21,0,2,7,1,6,7,3,5,3,3,18,1,0,0,4,1,17,0,7,9,3,19,0,4,0,6,263,4,1,0,3,10,9,5,0,13,7,1,6,5,5,8,18,8,9,0,1,4,3,5,22,5,22,6,1,4,8,0,4,4,0,1,16,1,3,11,1,0,8,4,10,0,2,3,33,6,6,7,5,12,10,2,0,9,1,1,4,0,9,24,8,3,4,11,4,15,1,3,18,1,11,3,4,6,13,34,6,2,2,2,9,0,0,11,5,7,6,25,4,2,4,7,2,7,1,8,0,5,5,0,5,11,22,0,16,4,12,4,16,7,3,2,3,3,0,23,1,6,1,0,4,1,2,4,0,0,0,7,9,5,4,10,5,4,0,14,1,0,0,6,2,2,0,1,7,4,6,4,0,4,6,9,6,0,3,3,11,8,17,4,2,6,3,0,0,2,4,8,22,9,2,7,3,23,0,4,2,5,2,1,3,17,2,0,0,6,3,0,7,6,1,16,2,6,7,2,12,4,2,0,0,12,23,5,1,11,2,4,3,2,17,5,7,7,4,2,8,3,8,6,8,0,10,3,7,117,11,9,9,0,2,0,3,0,16,3,0,5,7,6,14,4,1,5,0,0,0,4,0,3,9,0,2,23,6,1,4,4,13,3,9,0,0,11,5,2,13,3,8,12,24,2,4,13,11,6,8,12,24,3,11,2,5,0,0,0,5,1,6,8,9,1,4,2,4,13,3,6,0,5,8,2,9,0,2,4,10,0,1,5,5,8,0,2,2,12,1,4,0,3,4,1,0,4,10,2,2,3,0,5,9,3,31,9,13,12,1,2,9,1,7,16,8,0,13,4,2,0,0,10,0,3,4,0,1,8,5,0,2,6,5,7,0,0,1,13,5,4,2,0,7,7,1,11,1,4,0,0,1,14,6,3,9,2,0,34,1,0,12,4,4,5,2,0,8,3,1,1,0,4,4,0,9,3,1,1,8,1,10,7,0,10,8,0,3,4,0,0,16,11,0,6,5,6,14,11,8,5,1,0,8,0,3,2,11,2,3,5,0,4,1,3,7,2,8,3,15,2,13,14,2,0,3,4,6,5,0,1,0,3,3,0,1,1,4,2,6,12,7,2,8,2,8,16,4,6,0,2,0,4,9,8,1,5,1,3,0,3,3,0,7,5,1,25,0,8,5,6,2,1,2,40,8,2,10,0,10,25,3,5,8,7,13,5,3,5,0,1,0,0,11,0,0,1,0,1,9,3,1,3,0,0,0,1,11,6,0,4,5,4,4,0,0,2,1,2,1,7,3,18,1,16,0,1,2,0,6,6,27,1,4,0,5,5,4,74,1,0,1,6,0,0,6,0,2,0,7,6,12,2,8,1,0,2,15,2,11,1,11,2,0,6,0,0,6,0,3,0,16,2,1,8,0,0,2,8,5,6,7,1,0,3,1,0,0,4,0,8,7,1,6,8,8,6,2,4,1,4,0,20,4,2,1,0,5,11,29,11,4,11,6,7,0,10,0,1,11,6,8,1,3,14,9,3,1,14,5,14,0,2,1,8,11,1,12,67,1,3,5,4,4,6,8,0,0,0,4,5,5,5,1,6,0,0,5,11,0,4,5,9,2,12,0,7,0,0,4,6,1,1,0,0,5,0,5,8,14,1,0,0,3,5,5,7,17,16,9,3,0,1,1,4,1,1,0,1,0,7,3,4,1,4,3,4,1,1,0,0,23,9,1,11,0,6,0,8,9,0,6,0,0,0,4,14,17,1,3,0,1,0,41,39,1,8,4,0,5,1,0,4,18,2,0,2,1,1,7,11,6,3,5,2,0,8,0,1,9,8,3,5,5,5,1,0,10,2,0,9,3,0,11,6,2,4,0,0,7,3,3,14,7,5,0,0,3,2,6,10,2,5,1,8,12,3,4,0,9,6,0,0,3,3,8,6,0,1,4,10,2,2,2,11,0,0,3,4,13,0,5,5,8,0,6,0,31,23,22,2,1,8,3,3,0,20,0,0,0,4,3,4,3,8,6,6,11,3,4,0,2,1,7,5,3,1,10,6,7,2,0,2,3,5,7,4,7,1,3,5,5,11,1,5,3,51,1,9,3,10,1,3,4,2,3,4,4,6,0,13,6,0,2,9,0,6,0,5,15,2,9,8,3,0,4,12,3,6,3,1,0,0,9,4,6,2,11,0,0,7,11,0,3,2,6,1,4,2,0,6,1,0,10,8,2,10,0,1,1,1,1,4,6,3,5,5,3,2,1,3,2,6,12,0,3,2,7,3,1,2,1,6,1,1,0,1,8,1,1,3,2,3,1,0,11,1,1,0,7,4,7,5,4,14,0,1,4,3,1,2,0,0,0,3,1,1,17,1,1,3,7,0,2,3,0,0,4,2,8,1,9,2,5,0,5,3,3,0,4,1,8,2,3,5,2,1,3,1,8,0,7,1,4,0,0,0,9,8,7,3,2,0,6,1,0,0,2,0,16,2,6,3,3,3,8,5,0,18,2,34,2,13,0,4,1,1,3,2,10,3,44,1,2,8,6,6,5,2,4,1,1,6,0,6,5,0,0,2,0,4,5,0,0,0,5,6,1,7,3,5,3,2,0,4,4,8,10,5,0,2,4,6,3,9,8,1,1,3,0,8,2,5,3,9,0,5,1,7,6,1,4,0,12,2,2,0,3,0,1,2,5,7,10,4,5,2,3,16,0,9,2,1,1,1,4,2,2,8,12,0,3,1,1,4,3,3,26,4,4,2,2,0,1,0,5,2,3,6,6,2,7,4,9,1,1,0,0,1,1,8,0,3,7,0,3,0,9,4,10,1,0,1,2,3,2,3,13,3,3,1,10,0,2,1,1,14,4,2,5,7,12,2,7,7,4,0,2,0,0,0,8,0,7,12,27,0,3,4,1,1,1,5,0,4,7,17,10,4,4,0,1,0,5,38,5,2,2,1,5,2,21,0,0,5,6,84,10,1,5,5,4,10,11,4,1,2,0,0,0,4,2,3,3,4,1,2,2,0,3,12,0,0,0,5,5,0,4,2,6,6,1,2,3,5,5,1,1,1,1,0,5,0,7,3,4,0,5,2,3,5,0,0,0,5,5,2,11,8,1,0,0,3,2,2,1,6,1,1,0,2,0,2,0,0,12,4,2,0,0,10,11,0,1,8,5,26,0,0,11,9,3,0,6,4,11,1,0,6,4,2,0,2,1,0,1,1,7,7,4,0,2,1,14,0,0,0,3,0,1,1,6,2,0,2,2,7,4,0,1,3,4,0,8,5,3,2,8,0,0,4,0,3,11,4,14,3,2,1,3,0,0,4,1,1,7,10,7,1,6,5,1,8,3,0,10,6,1,2,0,10,11,8,30,1,3,3,4,5,0,2,0,0,1,0,8,6,3,1,4,1,2,10,0,1,0,1,7,3,4,2,3,5,0,1,0,5,3,1,5,2,0,3,40,4,1,0,4,13,0,5,4,4,0,0,0,9,0,5,2,0,2,4,2,0,0,1,9,1,0,7,0,0,0,0,2,2,4,9,5,2,0,0,0,0,2,0,1,6,1,2,8,2,5,8,2,9,0,4,0,1,0,4,3,0,1,4,0,9,1,2,4,2,2,1,0,2,1,0,0,2,2,6,5,0,8,1,2,3,1,4,0,9,2,5,2,3,1,0,6,5,0,5,8,4,4,1,2,1,13,3,1,5,1,10,2,1,2,0,0,2,5,4,0,0,12,3,8,4,0,7,2,0,5,0,0,6,6,3,2,2,5,3,3,3,2,3,6,0,2,0,3,1,2,0,3,3,28,4,3,10,0,1,0,5,3,0,2,1,0,0,1,1,4,10,2,2,49,4,4,2,8,4,4,5,1,0,1,1,4,3,7,6,4,0,0,3,1,10,10,2,2,4,3,0,15,26,3,1,2,4,2,1,2,6,2,0,3,14,10,0,0,0,0,0,3,1,30,2,4,0,9,0,0,0,3,1,0,1,0,6,3,0,2,1,5,11,0,4,4,8,2,1,0,1,0,6,0,0,0,1,0,1,0,8,0,3,15,9,9,7,2,5,0,1,11,0,1,5,1,0,0,0,0,0,1,0,2,0,7,0,2,5,0,0,4,12,3,2,3,0,10,1,0,1,4,6,1,3,0,0,0,0,2,1,13,3,1,0,3,1,4,2,0,0,0,4,2,0,8,5,15,1,1,0,10,6,1,3,3,0,27,3,2,0,3,1,0,69,0,0,0,0,4,15,0,0,2,0,3,2,0,5,11,4,0,0,1,1,4,0,0,4,2,2,0,7,2,1,59,3,3,4,5,8,3,9,0,3,4,0,2,3,3,4,2,5,1,1,15,1,1,0,0,3,1,6,12,3,0,1,1,3,6,2,4,1,5,0,27,7,0,4,7,1,1,1,2,0,15,5,4,3,1,0,5,8,1,1,11,0,6,0,1,5,4,9,5,1,2,0,14,2,5,0,5,5,6,0,3,1,1,0,2,2,8,4,3,1,1,0,0,7,5,1,0,0,2,5,2,2,1,0,3,0,4,4,6,4,7,11,0,9,2,0,6,0,13,4,2,2,0,1,2,2,0,2,1,10,5,4,2,2,4,0,1,1,0,0,7,2,0,0,0,0,0,0,1,6,4,3,12,0,0,236,1,0,2,6,13,4,1,16,0,1,1,1,8,2,2,7,5,5,2,2,0,1,0,2,1,4,4,1,0,5,3,3,2,1,0,3,2,2,2,4,2,13,4,1,1,1,7,0,0,1,0,1,4,2,0,1,4,17,8,0,3,2,1,3,0,2,4,1,1,8,0,1,2,1,13,4,2,149,2,0,2,0,6,1,0,11,9,2,0,0,0,0,5,1,6,3,2,1,1,2,4,7,5,1,8,1,0,0,18,0,0,0,4,2,0,1,4,4,1,0,3,1,8,3,3,0,0,1,0,3,4,2,4,3,2,6,7,4,1,2,14,4,4,0,9,0,1,1,1,1,1,3,3,9,0,4,0,3,0,1,0,0,3,2,0,2,0,6,3,1,0,0,0,1,2,0,0,3,1,9,1,1,2,4,0,45,1,12,1,2,22,6,0,6,2,3,4,2,0,1,0,1,5,1,0,2,3,2,6,2,1,0,11,2,7,0,1,2,0,6,2,1,2,1,3,0,6,0,1,1,0,0,0,3,0,1,3,4,3,2,0,3,1,2,3,5,1,0,2,6,0,2,0,3,0,1,1,1,6,2,1,4,0,0,2,0,32,0,6,6,14,1,1,7,6,1,3,8,4,0,6,0,0,1,2,0,1,0,0,2,1,0,4,0,5,1,6,4,0,1,3,1,0,0,3,9,2,7,1,11,1,0,6,2,0,5,0,2,3,0,3,0,2,25,3,1,0,0,1,8,0,1,4,3,0,3,0,1,0,0,0,1,0,29,3,0,0,0,5,0,1,0,3,1,3,7,4,2,1,2,1,16,3,5,0,5,0,1,2,0,1,2,5,0,2,8,2,0,0,2,2,4,2,1,1,2,2,3,0,0,1,1,0,2,2,51,0,0,2,5,3,0,0,1,0,2,7,1,0,0,0,0,0,7,1,2,0,0,0,1,5,5,0,2,2,5,9,3,4,2,0,1,0,0,1,3,2,4,33,0,4,0,0,0,2,0,0,0,1,0,0,0,4,7,0,4,1,1,0,0,0,1,7,0,1,2,14,0,2,0,0,2,2,0,0,1,0,0,0,0,3,53,1,0,9,0,0,0,0,0,0,0,0,2,0,0,0,0,0,0,2,0,0,0,0,1,2,6,0,0,0,0,0,0,1,0,0,0,0,0,0,0,0,0,0,0,1,0,0,0,0,0,3,1,0,0,0,0,0,0,0,0,0,0,0,0,0,0,1,1,0,0,0,0,0,0,0,0,0,0,0,0,0,0,0,2,0,0,0,0
K47 DT6 Song of Susannah,king,6994,3473,2789,2781,3033,1390,1378,1888,1978,1910,1421,1175,1433,1122,1028,995,1149,779,726,845,757,997,712,430,328,590,443,521,448,474,549,463,575,567,681,483,441,469,231,596,533,401,480,468,305,328,435,345,360,482,347,390,324,279,219,249,408,290,392,299,227,249,257,311,327,283,263,201,261,209,179,181,245,176,184,218,170,180,236,201,132,208,210,296,188,246,212,202,184,136,195,224,232,154,201,132,133,160,136,166,127,222,133,147,258,202,173,191,120,181,192,132,94,170,167,152,87,168,157,65,128,167,118,187,75,80,151,117,134,124,158,150,115,92,152,130,55,103,102,114,47,113,104,105,143,99,90,165,86,111,77,107,97,122,77,54,68,42,98,76,127,110,100,122,106,132,90,73,71,84,30,76,133,89,25,84,69,83,102,99,56,63,151,66,85,26,43,69,134,46,82,44,93,75,89,97,33,41,152,33,64,105,98,144,67,45,39,106,66,52,43,56,86,50,59,38,53,70,86,36,53,84,96,58,61,43,53,98,67,66,93,39,47,142,72,85,56,68,114,81,20,57,82,41,37,47,56,97,60,75,65,30,51,17,59,61,37,57,75,140,69,83,60,35,103,32,59,54,45,56,93,52,71,14,34,40,33,80,86,66,45,15,95,61,114,69,33,22,37,26,29,42,14,42,55,33,52,31,34,30,36,34,32,39,77,55,17,29,20,69,84,14,55,61,58,42,20,87,46,50,63,81,28,57,71,15,94,70,37,51,52,70,73,46,58,48,30,17,44,36,28,25,29,12,33,26,66,44,27,33,98,21,52,32,74,13,47,47,22,25,30,99,55,35,34,34,38,28,32,25,52,20,36,26,31,65,32,21,34,30,30,40,18,45,7,4,0,62,42,49,9,33,85,31,51,55,28,24,40,41,5,69,31,12,43,21,21,27,21,50,31,14,18,51,37,65,34,44,10,26,39,1,4,27,30,41,18,27,23,27,34,33,12,24,6,25,21,34,2,22,22,24,30,36,18,18,39,45,21,41,42,17,11,59,31,19,25,74,23,18,43,18,1,36,11,16,41,32,2,39,15,14,25,26,25,23,11,14,0,69,28,34,30,42,31,17,43,51,25,16,15,10,21,18,20,3,22,14,6,40,22,35,30,24,25,11,41,25,41,15,22,47,24,20,58,63,0,16,32,8,34,18,33,15,26,28,36,33,45,48,98,49,28,28,39,1,21,53,14,10,26,19,50,41,58,21,0,4,23,26,20,52,7,6,17,26,28,31,11,4,58,18,22,1,20,33,10,14,84,6,34,31,24,20,17,10,24,8,17,21,26,45,11,13,40,50,31,40,21,13,20,19,22,6,12,25,4,19,11,21,16,39,37,10,4,0,2,25,11,20,15,7,35,10,9,13,11,15,6,18,10,20,9,18,12,25,34,31,21,6,6,25,10,30,16,9,20,20,18,24,18,24,26,14,15,28,20,7,12,45,0,26,35,36,28,30,20,5,19,7,10,15,15,22,9,39,34,20,8,13,66,31,15,17,3,9,10,29,16,14,22,22,14,13,56,14,12,18,16,18,27,7,15,27,5,40,15,0,7,10,39,6,29,29,29,24,18,36,9,9,10,36,11,14,15,28,13,39,24,5,11,14,8,9,13,19,13,4,9,18,21,9,2,18,0,28,5,6,33,19,15,14,80,9,4,0,19,27,22,7,5,1,5,14,3,46,5,4,7,1,33,10,33,18,42,12,24,15,27,17,27,4,25,2,11,10,4,14,17,18,11,10,9,15,19,28,26,8,8,27,4,16,2,18,13,29,0,22,5,5,17,5,15,18,18,18,58,18,13,23,11,12,25,42,30,15,2,12,17,10,36,16,20,20,14,9,8,19,12,32,24,14,9,13,15,25,8,21,1,30,26,10,12,8,17,7,10,0,15,17,26,30,6,6,12,11,5,12,17,20,9,10,9,8,4,38,18,0,13,18,15,18,8,3,0,28,7,10,3,14,14,17,23,17,6,11,6,18,7,18,12,9,11,5,16,11,29,707,20,19,7,27,8,7,30,12,17,13,14,18,16,0,13,3,9,3,6,9,28,13,10,13,3,12,8,21,7,2,23,0,16,18,10,4,6,31,11,8,6,15,19,21,12,6,12,29,6,6,14,11,13,11,11,2,0,22,12,16,21,32,0,22,10,8,7,23,8,17,15,7,9,13,22,10,11,19,7,6,9,6,1,35,10,1,13,42,13,0,15,40,6,24,12,19,11,7,2,9,8,0,10,0,10,1,1,18,1,0,2,11,14,7,2,2,10,29,14,0,6,13,2,6,6,0,27,1,21,3,11,25,14,38,11,3,17,3,14,6,5,21,4,9,8,13,28,26,17,13,12,14,15,10,10,0,7,0,10,9,21,15,5,30,0,5,21,9,10,3,0,0,0,3,11,16,12,6,5,0,2,16,2,5,5,6,3,2,5,26,4,1,12,1,23,7,5,9,12,14,19,7,3,4,6,15,11,11,5,13,11,21,13,9,0,9,0,0,4,4,12,5,18,23,18,21,14,10,18,24,25,1,6,2,15,11,7,18,14,7,5,5,26,22,5,11,5,1,8,13,3,8,3,1,8,13,7,4,1,4,4,35,3,11,8,10,1,2,2,21,3,20,0,10,7,13,8,15,4,6,9,0,7,15,5,8,5,8,0,4,6,0,13,17,0,22,8,11,6,7,2,7,12,0,6,18,9,3,1,14,13,17,1,5,8,13,2,0,0,9,10,4,5,10,9,3,17,31,9,24,3,9,8,17,5,15,7,0,4,26,0,10,8,3,12,0,5,2,0,3,2,5,4,9,1,11,5,35,19,6,2,2,8,0,3,8,0,9,8,2,4,8,3,9,5,2,0,1,19,6,0,27,8,4,10,9,13,8,4,13,4,8,0,10,5,3,2,7,4,12,7,14,6,9,9,10,8,27,4,1,8,7,4,0,10,11,2,18,15,38,12,5,8,10,2,1,9,5,4,6,4,10,2,1,7,4,3,11,9,3,7,12,12,20,5,0,9,27,7,13,6,16,6,5,3,5,3,3,13,9,10,2,3,4,7,0,20,1,9,5,9,11,0,10,18,3,6,1,0,4,0,3,1,0,1,32,12,20,5,3,33,7,4,7,7,12,2,2,5,0,2,0,0,0,0,4,1,8,0,0,10,0,7,13,4,2,0,6,3,5,3,2,19,9,2,8,5,4,2,1,8,5,6,3,0,1,5,12,9,7,2,9,8,1,2,9,3,14,10,10,8,6,13,9,0,7,19,0,30,3,21,3,2,12,8,0,1,6,5,0,2,5,10,6,7,8,0,3,6,15,5,0,10,8,10,9,6,4,12,12,0,5,5,14,6,17,3,3,0,0,0,8,5,2,0,0,0,7,0,6,8,2,3,4,6,7,10,6,1,0,2,1,1,5,2,5,17,14,5,7,2,7,0,3,3,5,6,6,6,1,3,3,17,4,8,11,2,8,2,0,3,3,14,13,10,8,6,0,5,2,12,2,5,6,4,1,8,6,10,6,6,8,12,17,2,0,3,1,15,0,20,22,4,22,16,3,21,20,2,2,3,3,1,5,1,10,6,5,13,0,7,2,7,0,0,10,8,6,8,7,10,4,7,16,5,1,16,7,0,3,0,9,1,7,4,0,3,11,3,2,2,0,9,1,0,2,2,3,4,3,3,11,3,4,14,11,1,1,4,5,8,4,8,3,6,1,42,5,4,3,1,7,5,18,5,3,3,5,0,0,23,8,3,22,26,14,3,7,0,5,14,7,27,6,7,0,7,5,0,1,4,9,2,0,3,7,3,1,15,0,8,6,17,8,10,6,1,2,12,3,29,1,2,3,5,6,3,3,3,6,0,6,5,8,12,1,16,2,13,3,21,7,2,2,26,0,8,18,7,2,12,4,3,5,4,12,0,3,3,5,9,4,2,7,13,5,1,4,0,3,6,6,10,6,6,5,6,3,7,12,7,0,3,0,15,8,7,12,8,3,1,8,1,1,2,4,9,6,0,0,6,3,8,0,0,12,5,0,2,9,4,7,1,1,6,4,10,1,6,4,188,3,9,12,5,9,3,14,7,4,7,8,12,7,0,0,6,5,0,1,0,0,0,15,14,4,1,9,1,6,0,2,2,20,0,12,7,10,11,2,12,2,8,9,7,8,9,1,21,13,2,4,1,4,7,35,3,0,0,5,2,13,2,5,4,8,1,9,1,18,10,12,0,21,8,3,2,1,2,9,4,2,2,3,0,3,1,1,4,0,0,1,0,14,5,4,0,4,1,0,2,7,0,5,4,0,12,20,1,7,3,11,6,1,0,12,2,14,13,0,17,4,3,2,0,4,7,0,3,9,0,5,0,1,0,15,0,11,3,1,11,0,0,6,0,7,2,0,0,6,6,7,3,4,4,2,17,2,14,4,0,6,3,4,0,0,2,7,1,9,1,7,1,4,3,15,20,4,5,4,0,0,5,23,5,2,1,11,4,0,5,11,2,0,3,4,3,2,6,5,0,29,5,4,2,2,5,4,4,0,7,4,3,11,8,0,5,0,4,17,2,0,1,4,4,8,0,18,5,1,5,5,7,6,0,0,0,6,1,2,5,5,5,9,5,4,2,13,8,11,6,1,11,7,1,3,3,0,10,5,6,3,0,2,7,7,0,0,6,7,11,1,3,1,15,16,5,1,0,0,1,11,1,8,5,16,5,15,0,5,14,7,3,3,4,7,25,3,0,1,1,3,3,4,5,4,7,2,1,6,0,2,4,0,5,11,0,0,1,4,3,4,2,6,5,1,0,10,5,1,8,3,1,0,7,1,6,4,4,6,0,4,0,6,0,0,7,0,10,3,22,2,0,7,0,0,3,2,4,4,2,4,2,3,4,0,5,0,0,8,3,1,49,0,0,0,2,7,1,8,4,0,2,3,2,4,1,3,1,17,2,5,0,12,3,5,10,4,0,0,8,6,1,5,6,10,4,0,1,1,1,2,5,0,2,0,1,6,4,9,2,4,4,3,2,5,2,2,0,0,8,0,1,7,5,3,1,10,18,12,3,0,4,1,1,3,4,10,2,4,4,4,1,0,0,3,5,2,2,13,3,3,1,0,6,4,11,0,6,4,7,0,0,5,14,4,3,4,1,3,13,3,3,2,3,19,1,0,3,7,23,6,3,0,4,5,2,17,0,2,0,0,5,7,0,3,3,5,1,0,5,2,0,15,1,24,2,9,3,2,2,1,0,7,4,3,1,0,0,2,1,5,6,3,7,3,3,0,2,7,5,2,5,8,2,0,2,2,3,3,1,0,5,2,3,3,3,4,6,17,10,2,2,1,9,0,13,0,8,5,3,12,0,1,0,8,209,3,0,1,0,1,3,2,1,5,1,0,3,1,3,5,4,11,5,0,0,2,1,5,17,0,6,8,0,2,2,0,6,0,0,2,3,0,1,1,0,0,5,4,2,0,4,0,12,4,2,0,10,1,2,0,0,2,22,2,1,0,3,4,5,1,5,11,3,3,0,3,10,6,8,3,3,8,8,11,19,3,1,3,2,0,0,8,3,2,4,4,0,1,2,1,1,7,1,5,1,10,10,0,1,3,3,0,5,1,6,2,5,16,0,4,1,1,3,6,0,3,0,0,10,0,0,3,0,0,0,3,4,5,2,0,1,5,1,8,4,3,1,3,1,5,0,2,3,3,3,3,1,3,6,2,6,0,0,1,23,9,4,7,6,6,5,0,0,1,4,9,8,10,0,2,2,2,0,7,2,2,0,1,0,33,0,0,0,2,0,0,0,2,0,10,0,9,1,2,6,4,3,0,0,1,1,2,2,2,8,2,1,3,2,0,5,0,3,3,9,1,1,1,1,0,5,2,8,53,9,1,7,1,1,0,1,1,4,2,1,3,0,5,13,1,5,6,0,1,2,1,1,0,1,0,1,12,0,3,0,2,7,0,0,0,0,5,5,3,5,0,2,0,10,4,1,10,7,3,8,6,5,0,2,2,6,0,0,1,4,1,7,3,3,2,0,2,2,1,0,7,0,3,4,3,1,0,5,1,5,0,2,2,2,3,1,4,0,6,1,4,2,0,7,0,5,1,4,1,2,9,0,1,3,3,29,3,5,1,5,4,4,0,0,13,0,0,6,0,3,0,1,0,0,15,6,1,11,6,0,0,1,3,4,3,0,0,0,5,6,0,2,0,5,1,1,6,1,4,0,0,5,3,1,1,5,0,0,15,3,0,5,2,3,3,0,0,13,5,1,3,0,3,4,1,10,1,8,0,3,12,3,0,0,6,3,0,0,0,0,0,13,11,0,0,10,1,11,1,6,0,2,0,2,4,1,0,9,1,0,0,0,1,1,2,8,3,2,0,5,2,4,5,1,0,2,5,5,4,3,5,2,2,1,1,1,0,5,6,9,4,6,1,2,1,5,7,1,3,0,1,0,1,3,5,0,4,0,2,1,1,1,0,7,0,0,7,0,0,2,2,1,0,1,39,7,0,0,0,1,10,2,4,0,4,5,1,3,0,0,3,0,0,8,0,0,2,1,5,1,8,0,8,2,0,0,4,6,2,0,1,2,1,3,2,1,6,0,6,0,6,3,5,2,5,0,2,4,0,4,6,3,0,4,0,3,1,5,46,3,1,1,3,0,0,5,3,2,0,1,1,1,3,0,1,0,0,7,3,6,3,2,3,0,8,0,0,5,8,3,2,3,2,0,4,1,0,0,1,6,5,0,1,0,0,1,0,0,3,1,1,3,0,3,5,4,3,0,1,0,1,0,11,2,2,3,2,4,2,4,2,1,5,1,4,0,8,0,0,6,4,8,3,7,2,2,0,2,7,4,7,2,3,0,2,8,1,1,2,0,5,3,8,5,0,7,0,0,1,1,0,1,2,6,2,0,0,4,2,0,1,3,4,1,5,1,1,1,3,4,2,0,0,0,0,0,0,7,2,8,1,0,0,2,1,0,10,2,12,1,2,0,0,5,2,1,1,0,0,0,1,1,1,5,5,2,2,0,1,1,0,11,1,2,41,0,1,0,1,4,2,5,1,0,0,1,5,10,0,0,1,0,3,19,27,2,0,7,1,0,0,0,1,1,0,0,5,3,1,2,2,2,4,0,4,0,4,0,1,3,4,4,2,3,0,2,1,6,8,3,1,3,0,10,1,2,2,1,0,4,0,1,7,4,1,1,0,0,0,0,3,1,0,4,3,2,0,3,0,1,0,2,0,7,0,6,1,0,1,0,4,0,0,4,3,0,0,1,0,5,1,4,3,10,0,2,0,7,10,5,1,0,2,2,0,0,4,6,0,0,1,0,3,0,1,5,5,5,6,4,0,0,0,2,1,1,7,3,2,7,0,0,0,5,3,5,3,3,0,0,1,0,0,0,1,0,18,1,7,0,1,0,1,2,0,2,3,5,2,2,15,2,0,0,16,0,6,1,1,1,2,5,4,1,0,5,4,2,9,0,0,0,1,3,2,1,0,2,0,1,4,5,0,0,0,0,0,0,1,0,1,0,1,4,3,2,2,4,0,0,1,1,2,4,1,4,31,0,2,2,0,1,18,8,0,1,1,8,3,0,3,0,6,1,1,0,0,2,7,5,3,1,3,4,0,4,4,1,2,5,1,5,4,0,5,1,5,1,8,1,0,0,1,0,2,0,1,2,1,1,4,5,0,0,0,0,0,2,0,0,0,0,2,0,0,5,4,0,0,1,6,2,2,1,9,0,1,2,0,3,0,5,1,1,0,0,3,10,2,6,4,0,0,8,0,4,0,1,0,7,1,5,2,5,1,3,3,4,2,1,5,2,4,0,7,0,3,0,0,5,1,17,0,8,1,2,0,1,0,7,4,0,5,0,2,7,0,0,0,0,0,1,0,1,0,2,6,10,4,1,2,5,3,0,0,2,6,1,1,0,1,7,4,4,11,4,1,1,0,1,2,2,2,3,5,0,4,1,8,0,0,8,0,2,2,0,0,14,1,4,2,0,4,3,1,4,0,4,2,0,2,0,0,1,0,0,3,0,0,3,0,1,0,0,3,1,0,9,2,2,2,0,0,3,0,4,0,3,9,1,1,2,4,1,5,0,0,0,0,1,5,0,0,2,3,2,0,2,0,5,1,1,2,0,0,0,3,3,0,0,0,6,3,0,2,2,3,0,0,3,4,8,0,6,1,0,2,2,0,0,3,0,17,5,33,0,7,2,1,1,0,0,2,2,1,4,8,4,5,0,0,1,0,1,33,5,0,1,0,3,1,20,2,2,2,2,8,5,0,5,5,0,4,2,8,1,0,0,0,0,4,2,3,6,0,1,1,2,1,2,10,1,0,0,2,1,0,6,1,4,4,0,2,0,3,7,0,1,0,2,0,2,0,5,0,2,1,2,1,2,5,1,0,0,0,2,1,7,3,4,1,0,0,0,2,5,0,1,0,0,15,0,2,0,0,2,4,2,0,0,5,6,0,1,2,2,6,0,0,1,4,0,0,3,2,4,0,0,1,3,1,0,3,1,0,0,0,4,2,0,2,1,1,6,0,1,0,1,1,6,0,2,1,0,2,0,3,3,0,2,2,6,1,3,3,3,3,2,0,0,0,2,2,2,3,10,0,2,1,0,1,2,3,1,0,2,7,0,0,8,3,0,0,1,0,0,1,1,1,0,8,0,4,5,1,1,1,7,0,0,1,0,0,1,0,3,2,0,1,1,0,0,2,0,5,0,0,2,1,0,2,1,2,0,7,2,12,1,1,2,1,0,2,4,2,0,0,5,10,0,9,4,1,0,0,0,4,0,0,1,0,3,2,2,0,0,1,3,1,1,1,1,0,0,0,1,1,1,2,1,0,0,0,1,0,1,0,0,7,0,1,2,2,5,3,0,2,0,1,2,0,4,1,1,1,2,2,1,0,0,1,2,1,1,0,0,0,4,0,0,3,1,3,1,0,3,2,0,3,2,1,0,3,1,1,3,0,0,0,2,2,2,3,0,4,0,3,0,0,2,0,1,2,3,1,1,0,1,0,5,0,0,5,0,0,3,1,6,0,0,1,1,0,0,0,0,2,3,0,1,0,6,0,3,0,0,0,5,3,1,2,1,5,1,0,0,1,11,1,5,4,0,1,0,2,5,0,5,1,0,0,0,2,0,5,0,2,6,6,1,1,2,2,1,4,0,0,0,0,1,2,0,0,5,0,0,0,0,5,6,3,3,0,3,0,10,4,4,0,0,1,2,4,2,1,1,0,0,14,5,0,1,0,1,1,0,3,1,5,2,0,4,1,0,0,0,0,0,8,0,2,0,0,1,0,1,9,0,2,0,1,3,0,7,0,0,4,0,0,0,0,0,0,0,4,0,0,5,7,3,0,7,1,0,0,2,0,0,0,3,0,0,0,1,0,0,0,0,2,2,0,1,5,2,0,0,7,2,4,2,2,6,0,0,2,2,1,0,2,0,0,0,1,0,0,1,0,5,0,0,5,0,1,2,2,0,1,2,2,3,2,2,0,0,0,0,0,0,0,1,0,22,0,0,1,4,0,0,19,0,1,0,1,1,4,0,0,0,1,0,1,0,3,2,1,0,4,0,3,0,0,0,4,2,3,0,1,0,0,11,4,0,4,2,3,0,5,0,2,3,0,0,0,0,2,2,3,4,2,2,0,1,0,0,3,0,6,0,0,0,0,0,0,3,0,2,1,2,1,4,1,0,0,5,0,0,2,0,0,4,2,2,1,1,1,7,2,0,0,0,0,0,1,0,2,0,2,0,2,1,0,5,0,0,0,1,3,3,0,1,1,3,0,1,2,2,2,1,0,2,0,2,3,6,0,3,0,0,6,0,1,1,0,0,0,1,4,3,0,2,5,0,5,0,0,4,0,1,2,0,1,2,0,1,1,0,1,1,0,2,5,3,2,4,0,2,1,0,0,0,1,0,1,0,0,1,0,0,0,1,6,5,0,0,5,1,0,0,5,18,5,0,6,0,0,2,2,0,3,0,4,1,2,0,0,2,0,2,2,2,0,1,1,0,4,0,4,0,2,0,0,1,1,1,1,0,1,1,5,3,0,4,0,3,4,0,1,2,0,0,0,1,1,0,1,0,1,2,2,0,0,0,4,1,9,0,3,0,0,5,0,0,55,2,0,0,0,0,0,0,8,6,1,5,9,0,1,3,0,1,2,0,0,0,6,1,1,4,1,4,0,0,0,9,0,1,2,0,0,0,0,1,1,0,13,1,1,1,4,2,0,0,2,2,0,1,1,1,1,0,3,0,0,0,1,5,10,2,0,1,0,1,2,4,1,0,1,4,3,4,2,0,4,0,1,0,1,4,3,0,0,0,2,0,1,1,0,0,0,2,2,0,1,0,4,0,1,7,2,1,1,0,7,0,1,1,0,1,2,1,0,0,0,0,3,0,0,3,1,0,3,1,1,4,0,0,3,12,1,0,0,2,1,0,2,3,2,1,0,2,0,0,1,0,0,0,0,2,3,4,1,1,9,0,2,0,2,2,0,0,5,0,0,2,0,0,2,7,5,0,1,0,3,1,1,0,1,5,0,4,0,8,0,1,9,4,3,0,2,3,3,3,0,5,2,2,1,1,1,0,1,5,3,2,1,0,0,2,0,1,1,6,0,0,2,1,0,0,0,1,3,1,0,0,3,1,0,0,1,0,0,0,0,1,0,0,0,5,3,1,2,1,1,0,3,0,0,0,3,1,2,0,0,0,0,0,0,0,4,0,0,0,0,4,3,0,1,3,5,3,0,1,1,0,2,0,3,4,2,1,5,0,2,3,0,0,0,0,0,0,2,1,0,0,0,2,2,1,0,1,3,1,0,0,1,2,2,0,0,4,13,0,0,1,3,6,0,1,0,0,2,4,0,0,0,0,1,0,2,1,0,0,0,0,0,2,1,1,0,1,0,2,2,4,0,0,0,0,3,0,1,3,2,1,2,2,0,0,0,0,0,1,0,1,2,0,0,0,0,0,3,2,1,0,0,2,1,4,1,0,5,3,0,11,0,0,4,2,2,0,1,0,0,1,0,0,4,0,0,4,0,0,0,4,0,0,0,1,3,0,1,0,3,0,0,0,0,0,0,3,0,5,1,0,0,0,0,0,0,0,0,2,0,1,0,0,0,0,0,0,0,2,0,0,0,0,0,1,0,0,0,0,0,0,1,0,0,0,0,0,0,0,0,1,1,0,0,0,0,0,0,0,0,0,0,0,0,0,0,0,0,0,0,0,0
K48 DT7 The Dark Tower,king,15301,7926,5972,5967,6666,1900,4781,3861,4256,4139,2416,3665,3242,2175,1667,2134,2648,1927,1669,1524,1827,2152,1755,1567,470,1370,629,1332,985,894,1105,846,1122,1114,1220,1072,1010,982,636,1460,1184,835,1054,974,439,804,844,807,1109,1062,767,1089,795,650,548,644,907,519,741,514,560,375,494,771,481,646,623,399,432,547,264,213,408,464,223,629,431,446,426,438,273,400,402,388,426,497,390,465,479,357,369,433,505,272,348,275,317,335,373,419,373,523,210,376,600,431,457,421,204,327,448,449,213,454,368,293,244,370,354,112,346,353,182,493,145,230,345,290,279,237,313,293,195,211,311,278,149,292,246,214,127,205,287,109,316,241,232,419,200,202,154,244,253,262,187,211,196,121,262,214,187,181,211,309,217,410,203,169,177,255,97,125,266,115,55,157,164,216,278,238,158,147,261,147,196,47,67,192,328,114,134,113,294,174,198,247,89,119,96,75,114,171,211,389,138,26,103,117,116,92,76,112,121,106,159,100,146,145,181,96,140,165,204,94,161,124,101,150,132,149,213,68,83,284,158,126,87,147,264,163,38,80,106,59,121,129,121,220,70,166,116,76,144,43,116,111,70,115,156,264,239,74,62,100,200,78,124,153,138,173,113,101,144,44,119,101,99,103,231,156,90,32,171,89,271,73,70,45,103,109,77,110,7,89,91,103,105,91,34,100,91,92,28,93,174,150,18,26,56,200,147,30,42,122,182,114,55,195,127,111,139,117,67,227,87,36,141,75,85,85,71,112,95,84,147,52,89,38,67,64,51,54,54,35,34,91,105,46,81,73,241,64,94,122,165,13,62,108,71,53,48,206,105,26,77,54,91,60,80,52,97,67,63,46,87,175,80,11,92,79,70,71,73,98,43,6,1,147,91,136,36,50,77,31,86,152,96,75,79,52,21,155,100,47,66,42,68,64,42,124,64,48,109,48,104,197,57,104,50,52,86,12,12,50,44,70,50,69,46,30,66,62,34,46,9,152,71,106,12,54,92,56,103,99,47,52,55,89,53,91,82,60,20,162,62,56,50,48,61,55,69,14,0,38,23,64,99,91,19,95,34,47,43,35,51,72,53,27,0,64,60,95,80,113,49,80,77,114,35,49,89,38,61,47,49,11,44,45,11,93,42,56,21,35,65,37,86,94,64,18,51,98,65,78,84,133,0,64,37,31,94,52,91,24,61,53,69,47,68,103,112,85,60,39,85,4,44,118,41,46,69,51,83,41,59,87,0,20,34,37,43,96,18,15,65,76,57,72,20,7,44,31,41,61,48,39,32,33,87,38,77,38,32,48,26,34,62,7,24,39,80,96,64,43,10,150,55,55,32,17,55,56,33,15,37,49,30,38,29,39,79,72,121,66,57,0,3,58,28,66,34,16,120,28,5,58,44,17,12,36,26,32,24,63,47,56,32,52,46,9,14,50,29,34,36,0,48,43,51,66,29,23,46,38,11,59,36,32,23,44,0,56,49,33,70,91,38,10,63,15,28,37,49,57,5,46,69,28,32,36,69,44,45,43,20,47,28,61,30,19,39,27,33,13,66,23,7,36,33,29,37,19,48,41,9,59,35,2,34,37,71,7,72,60,42,62,16,62,15,26,35,96,23,23,18,43,30,111,44,33,26,46,49,17,48,52,22,7,26,48,53,25,12,47,0,29,9,24,52,24,59,52,97,27,10,6,46,67,28,21,18,19,27,18,10,129,13,4,19,24,62,28,116,23,34,19,34,26,52,46,49,16,28,40,1,38,30,43,10,33,33,30,27,29,27,49,56,37,19,43,16,33,11,52,22,17,1,37,18,33,24,4,31,48,44,38,185,36,37,11,31,38,52,20,46,19,1,0,19,27,46,15,33,48,55,32,6,46,31,22,37,36,23,37,2,39,19,27,0,25,34,18,19,37,46,32,10,0,36,22,57,50,5,17,25,29,21,6,15,51,21,24,21,56,21,64,17,0,21,49,41,40,49,6,0,5,7,42,20,27,31,22,39,40,14,49,33,31,12,44,20,32,3,7,27,44,84,658,38,66,20,30,22,20,34,20,43,16,46,26,34,0,55,0,24,18,34,14,74,33,19,5,10,33,18,21,8,1,47,7,23,33,23,34,8,44,37,19,12,21,28,24,14,17,32,35,11,14,18,14,55,27,21,5,4,33,3,40,25,99,0,49,39,9,13,68,14,26,13,25,10,95,72,15,21,47,11,12,13,5,2,54,29,2,12,64,23,0,22,38,18,45,19,40,12,23,0,23,19,0,18,0,21,0,45,54,0,0,18,10,20,14,5,66,17,34,29,0,8,33,27,32,5,0,26,4,55,9,23,23,17,28,29,10,39,28,43,11,7,53,17,12,11,32,33,17,33,26,7,17,66,11,23,2,19,0,26,31,18,37,13,39,0,7,43,15,3,5,0,0,0,3,21,36,12,27,6,0,9,21,31,7,3,10,8,14,10,68,10,7,29,0,33,19,23,11,20,16,31,11,5,18,22,16,14,24,29,27,24,50,24,28,16,25,0,1,4,6,38,12,29,47,65,46,35,16,22,34,16,1,11,1,34,16,30,31,27,20,20,22,52,33,6,34,10,12,48,8,25,4,26,2,24,26,13,13,16,15,9,32,5,22,17,14,0,15,11,44,1,0,2,13,53,15,19,54,18,23,26,0,20,21,31,14,29,41,2,4,27,0,40,55,0,51,25,33,22,44,5,18,10,0,13,14,42,14,0,10,20,23,3,12,37,38,8,0,0,23,13,14,46,10,28,4,39,16,27,42,14,18,42,63,7,21,27,0,4,28,5,14,13,8,21,0,5,12,0,2,16,16,4,12,13,36,1,72,45,14,12,6,28,0,9,16,0,18,21,7,22,14,1,4,2,18,0,20,50,11,0,10,28,20,28,14,25,27,20,3,6,16,0,13,18,35,8,11,7,12,5,2,21,30,19,19,20,14,10,15,17,12,15,2,8,22,8,27,14,66,20,7,30,20,2,0,6,10,9,23,11,8,4,8,34,14,1,24,5,20,15,8,31,44,7,0,9,18,23,43,22,4,28,14,16,11,20,13,12,25,18,0,6,13,24,0,41,12,10,6,22,15,3,32,25,3,6,0,0,5,0,3,0,0,14,82,8,54,21,19,46,19,11,20,6,22,16,1,20,1,16,3,0,0,0,12,1,47,4,0,13,3,11,26,5,9,0,25,9,29,14,21,17,7,2,16,13,7,2,16,25,17,8,14,0,3,3,41,15,10,27,36,17,2,2,16,2,27,2,27,28,4,19,18,0,12,18,0,73,6,27,6,5,19,17,0,4,36,32,0,5,21,20,12,14,27,0,2,23,37,9,18,12,9,8,22,2,20,14,16,2,13,4,23,8,25,7,10,0,1,2,11,42,1,3,0,0,24,0,8,13,4,11,9,5,10,46,18,6,0,11,6,26,17,25,5,54,45,38,10,1,21,5,8,18,3,11,7,12,3,30,6,20,10,16,13,11,7,10,0,24,2,23,14,32,17,9,3,5,12,35,34,4,21,9,2,14,43,28,12,4,11,18,36,10,0,16,20,32,3,30,16,8,24,17,36,15,21,6,9,6,15,0,24,12,7,20,17,38,0,23,17,31,3,0,11,13,11,16,14,24,18,30,15,9,1,40,18,0,11,0,30,5,21,17,0,22,13,9,4,37,1,26,1,14,2,13,24,12,15,3,17,12,18,41,13,0,1,20,12,14,7,4,16,26,2,61,14,6,4,3,14,9,29,14,1,5,10,7,0,49,26,4,82,30,25,4,19,9,25,6,12,19,13,25,4,24,6,9,21,22,21,1,0,14,9,0,2,19,1,21,7,21,22,12,1,7,11,30,14,44,2,4,16,17,9,6,11,8,11,0,28,13,8,38,9,6,1,10,5,26,30,11,22,40,0,1,27,17,12,25,2,2,3,32,24,2,15,7,6,27,7,5,12,2,5,8,20,0,13,10,19,25,4,11,10,20,9,9,16,9,1,16,3,3,8,6,10,16,5,6,8,3,7,4,16,3,9,6,2,14,9,14,18,1,20,9,3,2,24,19,13,3,1,8,7,21,10,16,11,286,4,16,20,10,13,19,14,14,4,8,23,15,24,0,0,12,6,0,7,0,1,1,41,47,8,1,15,7,5,0,7,2,15,0,13,32,20,43,15,2,4,27,4,20,11,9,4,50,19,4,4,5,11,11,15,35,3,7,16,10,23,3,15,36,15,7,21,9,11,9,25,0,14,18,11,53,3,10,5,6,2,9,17,0,5,14,3,9,0,1,11,0,38,13,6,0,16,15,5,0,14,0,9,10,0,23,27,6,14,10,6,10,0,2,7,10,31,32,1,29,7,0,9,0,6,2,0,8,11,0,7,2,1,1,12,5,20,3,4,13,5,2,7,1,8,30,3,0,17,18,30,23,3,23,5,19,3,2,13,4,17,11,7,0,0,4,8,1,17,6,21,4,22,21,39,37,4,8,12,6,14,18,14,11,4,5,2,14,0,8,6,8,1,6,8,1,5,4,13,0,14,4,22,21,20,3,10,13,4,7,4,10,10,18,4,1,0,7,7,8,0,16,16,10,2,9,32,15,17,6,11,20,15,1,0,8,7,6,10,34,12,8,12,2,10,13,50,8,10,2,15,28,14,10,9,15,7,22,11,16,6,0,4,9,19,0,1,16,5,0,8,12,1,8,34,19,10,0,9,1,9,5,15,9,20,6,23,0,9,17,9,3,0,11,31,37,7,0,1,9,6,11,10,7,11,4,0,12,8,0,2,9,0,7,19,0,0,0,1,4,10,9,8,10,3,0,18,10,19,4,15,15,4,24,0,7,14,18,7,1,6,4,17,0,0,16,0,23,7,48,10,0,26,3,0,29,29,11,12,5,14,3,1,8,0,13,0,0,9,4,18,18,0,3,0,2,7,3,7,2,2,3,8,3,5,3,8,3,44,7,5,0,6,0,4,17,28,0,0,13,25,4,11,8,17,11,0,2,5,4,4,13,1,4,0,2,14,14,7,6,1,39,3,6,14,2,12,0,0,17,0,14,3,17,6,7,20,23,2,15,5,11,13,3,8,11,53,14,13,6,0,2,1,5,4,6,13,13,51,10,1,3,3,7,7,9,7,19,1,20,5,3,17,62,4,6,3,4,8,8,4,9,12,9,43,4,8,5,18,26,10,14,1,4,4,2,23,4,3,5,0,14,10,6,6,9,8,2,1,3,3,2,12,0,17,10,16,3,8,9,11,0,15,1,20,4,0,4,5,6,5,8,3,14,15,1,0,10,22,2,1,23,22,7,12,3,2,1,10,1,1,6,5,3,1,2,4,12,1,43,7,16,0,2,1,4,0,23,14,4,27,0,8,1,5,299,0,7,5,3,2,11,4,2,5,6,6,15,1,7,17,10,13,14,0,2,10,6,18,7,4,10,3,1,4,5,0,0,1,0,4,9,0,4,6,16,0,7,8,4,0,4,10,25,4,8,4,6,6,3,0,0,14,4,13,8,0,11,13,9,2,16,16,3,8,0,12,23,1,7,4,3,6,11,21,48,7,1,4,7,3,0,4,9,5,6,26,0,1,3,2,2,11,13,15,0,18,18,0,11,4,12,0,10,10,16,1,13,13,1,25,6,7,3,42,4,7,0,0,10,1,0,5,0,1,0,4,2,18,4,11,1,1,5,3,4,3,1,2,4,1,1,0,20,5,10,9,1,8,7,6,12,0,3,1,2,7,10,10,12,12,0,0,0,2,5,14,39,11,1,3,4,4,5,5,0,3,3,2,5,76,0,0,0,15,0,0,3,1,1,14,4,42,7,6,12,17,8,1,0,3,3,4,3,10,6,10,1,0,11,4,14,3,12,4,7,22,9,9,10,5,17,7,15,75,14,3,8,4,2,2,0,3,6,1,2,6,4,14,16,7,5,11,0,1,1,4,3,5,18,0,0,6,10,7,11,0,5,9,0,0,2,7,6,1,8,1,1,6,19,6,8,19,8,8,9,7,51,1,7,8,3,1,1,2,5,0,6,25,9,1,7,2,7,5,1,5,0,11,19,8,4,0,0,0,9,0,5,6,6,7,4,6,4,13,9,6,0,3,1,2,1,6,13,3,3,10,0,0,5,3,23,2,31,18,0,1,22,1,4,7,1,0,19,8,2,0,1,13,0,4,20,0,2,17,7,0,6,7,3,5,0,0,3,6,2,1,3,0,3,8,6,14,2,13,0,3,13,10,4,1,14,2,0,31,4,0,4,11,5,0,5,1,10,4,4,2,0,9,8,0,6,4,6,2,3,2,10,8,1,5,14,2,1,3,0,0,25,28,3,5,3,2,23,6,8,5,2,0,5,0,11,5,13,2,6,6,0,6,1,6,14,1,10,15,11,2,8,5,5,0,4,4,12,9,0,10,3,6,7,0,0,0,5,7,10,17,5,6,3,1,4,13,3,7,0,7,0,2,13,9,4,0,4,6,4,3,1,0,8,1,2,6,6,1,5,11,9,1,9,20,14,2,0,0,10,20,7,4,8,6,8,8,1,0,1,2,0,0,12,3,6,0,1,10,6,40,4,7,14,0,0,2,17,6,0,7,8,3,3,1,1,5,3,10,2,9,4,10,12,23,0,13,6,3,6,4,10,1,3,0,1,22,3,48,7,6,1,12,0,0,8,0,1,1,10,7,3,30,2,5,0,6,17,0,21,13,12,4,0,1,0,0,4,1,4,12,4,6,0,10,2,0,0,7,6,13,12,3,0,2,5,0,0,7,8,6,9,0,7,4,18,6,0,0,0,3,0,33,2,12,6,7,8,5,5,5,6,12,4,6,0,12,0,0,18,8,27,1,19,11,2,2,6,16,9,17,0,2,3,17,5,4,4,8,3,7,6,9,6,3,4,0,0,8,5,0,5,11,1,4,1,0,5,5,0,7,5,7,0,9,6,4,0,4,18,4,2,1,0,3,1,0,9,3,11,1,0,1,4,7,13,7,9,18,3,6,0,1,1,2,4,7,0,4,0,4,4,2,2,4,4,6,5,4,3,0,11,5,1,30,0,17,0,5,5,1,0,0,0,4,3,7,13,2,3,2,11,7,43,20,6,3,31,0,1,0,0,13,0,6,0,4,10,2,3,17,9,5,10,3,2,12,0,2,4,10,4,1,6,11,4,0,20,17,0,7,6,0,19,10,5,7,1,0,21,3,1,12,10,1,2,0,4,1,4,10,4,32,5,10,8,6,13,0,7,5,0,1,7,1,15,5,7,13,1,14,0,0,3,2,0,0,3,1,12,1,7,11,12,0,7,0,51,17,2,5,2,8,4,3,0,13,0,0,0,5,2,3,1,10,8,5,22,5,2,1,0,0,2,2,5,4,10,2,7,10,0,2,4,18,5,8,4,3,1,3,10,4,12,2,0,28,4,13,0,8,1,0,1,2,8,3,5,1,5,7,3,0,10,24,0,4,40,3,7,7,15,10,5,0,4,7,5,8,2,0,0,1,13,5,4,7,4,0,1,4,4,2,3,8,4,2,2,6,2,7,0,2,9,8,1,3,1,5,5,4,2,7,7,4,7,10,1,10,3,0,6,13,3,0,9,5,7,5,1,9,7,4,1,0,0,2,2,2,4,2,0,4,9,1,34,1,2,1,8,0,11,9,3,15,0,9,4,4,2,0,0,3,0,4,3,0,6,0,3,7,8,6,3,5,0,0,3,1,5,0,2,10,5,2,2,3,1,2,5,5,8,0,7,4,0,3,0,1,20,0,11,1,4,2,1,277,13,2,11,9,0,0,3,1,7,0,3,0,11,5,4,5,7,11,16,10,2,13,4,30,4,5,0,7,1,6,2,6,13,2,44,2,11,7,12,6,12,4,7,3,0,11,0,5,5,0,0,2,0,5,3,0,3,0,4,3,2,9,1,3,4,1,3,0,0,25,4,7,0,4,13,16,1,18,14,4,1,1,2,6,4,8,7,12,0,7,3,5,4,3,14,0,11,4,4,0,9,1,5,3,2,3,16,8,2,3,5,7,2,7,4,3,1,1,1,1,8,3,16,1,0,2,2,6,9,1,11,1,0,1,2,0,4,0,5,6,7,10,5,1,2,3,2,5,0,0,0,0,1,10,0,3,6,16,2,0,5,0,5,1,2,6,0,1,5,0,19,0,0,2,13,10,2,7,0,7,0,0,10,4,16,5,7,4,1,4,1,0,1,1,3,13,5,2,6,7,5,0,8,3,15,5,0,5,2,14,13,4,12,2,1,0,3,103,11,0,7,0,9,2,25,0,1,4,11,43,6,2,2,10,2,5,23,8,3,2,0,0,0,12,9,7,3,3,3,1,3,7,10,21,2,4,0,0,2,0,2,1,9,4,1,2,2,4,8,5,0,0,0,0,6,0,11,23,5,0,9,0,2,3,2,4,0,1,8,4,13,0,3,1,0,3,0,10,1,7,0,0,1,1,1,3,27,0,10,7,7,0,1,7,2,0,0,6,1,6,0,0,3,11,5,0,8,1,2,1,4,2,14,7,0,9,0,0,2,4,7,4,2,6,2,0,7,2,2,3,6,0,2,3,3,0,0,3,5,7,3,0,6,2,3,2,5,1,3,2,21,0,1,0,3,2,1,10,15,1,4,1,2,1,4,2,0,2,0,9,3,3,16,7,0,9,6,0,5,4,0,1,1,9,3,11,5,2,2,5,5,12,0,1,0,0,0,2,3,3,6,5,1,5,0,4,0,3,0,1,6,4,13,3,5,5,1,10,5,13,4,2,5,0,0,6,3,3,3,0,4,14,0,1,10,7,0,1,1,9,0,5,2,0,0,4,3,0,2,1,13,3,0,5,1,2,0,0,1,7,1,13,8,1,5,1,0,0,8,0,1,7,2,0,3,2,10,10,3,6,1,1,9,4,3,9,7,1,2,3,0,9,3,1,13,1,0,6,0,2,2,0,1,7,0,8,6,0,17,5,0,0,35,4,0,9,1,3,1,0,5,0,11,7,3,3,2,5,6,5,3,0,15,6,6,13,0,6,1,0,1,0,2,16,11,11,1,0,8,0,6,9,0,9,6,0,3,0,1,6,10,4,5,1,9,1,0,36,2,0,5,1,2,4,0,8,0,2,4,8,18,7,6,2,3,2,0,6,4,0,4,4,0,0,2,1,1,10,2,5,1,6,1,7,6,8,4,9,1,0,5,4,2,3,4,1,19,0,0,3,3,5,10,5,6,2,0,0,32,2,10,1,1,1,3,3,4,4,5,0,8,38,14,0,0,5,3,1,3,1,6,3,12,0,11,1,0,0,5,0,0,8,0,5,0,2,0,0,5,15,0,7,1,1,3,1,0,1,2,15,0,0,0,0,0,2,1,6,0,5,10,8,7,8,3,6,0,0,5,1,0,5,1,0,1,0,4,0,2,1,4,0,12,2,2,10,5,0,3,2,4,4,7,0,6,2,0,4,3,2,0,3,2,0,0,4,2,1,17,10,7,0,2,11,6,5,1,1,0,10,1,4,4,3,3,2,1,0,4,5,2,1,8,0,5,3,0,2,5,2,0,15,0,4,1,1,1,9,0,1,4,0,4,5,0,5,6,3,3,4,4,3,2,0,0,10,7,2,1,5,3,5,12,8,9,13,3,11,2,17,4,1,10,1,4,2,1,2,3,16,1,1,6,2,0,0,0,10,1,9,5,6,3,3,1,1,12,5,6,0,2,0,8,6,2,4,6,0,1,5,2,0,4,1,3,3,3,0,7,7,0,0,6,1,0,5,3,5,6,7,0,3,0,0,14,2,18,0,3,2,2,8,2,8,3,0,2,2,5,1,2,0,7,0,0,9,2,0,2,0,0,1,1,4,1,0,8,1,1,6,2,0,8,13,0,10,3,0,7,0,6,5,6,1,6,2,4,1,4,6,10,4,0,9,3,1,6,1,3,0,0,0,5,4,0,0,0,0,5,0,9,0,6,9,13,3,1,11,6,0,2,2,9,4,3,8,1,2,0,8,6,3,0,6,9,11,2,2,0,2,8,8,1,13,3,1,1,7,4,0,1,4,0,3,8,3,2,6,6,0,6,2,0,0,5,1,3,0,9,2,6,3,0,1,5,15,3,8,9,6,3,0,4,2,3,2,2,5,0,0,1,1,17,7,0,79,5,3,4,0,2,2,0,15,5,0,0,1,3,0,2,0,5,2,0,0,2,9,4,9,5,0,7,2,0,0,6,0,1,1,2,4,6,1,3,10,1,2,1,0,7,4,11,2,0,3,8,1,3,2,9,2,0,0,1,6,6,2,8,9,1,6,3,0,0,1,1,5,0,4,11,2,3,4,1,4,0,0,0,1,6,3,0,0,0,7,1,1,3,0,1,2,4,1,0,4,1,50,2,4,1,7,0,7,0,10,2,6,3,3,1,1,4,2,0,0,0,14,0,2,2,1,0,3,6,2,7,2,0,6,28,2,2,0,0,2,2,3,7,3,4,0,6,2,6,0,1,3,1,0,4,1,7,0,8,4,5,4,0,5,4,2,3,2,4,0,3,0,0,2,1,7,0,13,0,2,3,3,1,2,3,0,2,0,10,0,1,3,4,5,2,2,17,10,8,0,2,5,2,2,2,1,0,1,0,2,0,5,0,3,1,0,5,2,5,5,1,2,7,4,0,0,0,13,2,6,0,9,1,0,4,0,0,0,0,1,0,3,2,0,3,6,3,3,0,2,0,9,1,5,1,4,0,3,0,3,0,1,0,3,7,13,3,4,0,0,11,1,24,4,5,2,6,5,3,2,0,7,0,14,3,6,1,7,3,0,5,0,6,0,5,2,2,8,3,0,0,4,3,3,1,1,1,3,2,2,0,3,2,0,1,3,5,36,2,0,6,6,2,0,0,0,0,1,6,0,0,2,0,13,0,5,6,2,0,1,0,5,5,2,2,0,6,2,7,0,1,2,0,0,12,0,1,2,4,2,0,7,3,0,2,2,1,0,1,0,0,2,0,0,6,2,2,6,1,0,0,1,6,2,15,1,3,6,12,0,7,1,0,12,5,3,0,2,0,0,0,2,1,2,3,0,9,0,0,0,6,0,0,0,5,3,0,2,4,1,1,0,2,0,0,0,1,0,10,3,0,0,0,0,0,0,2,0,3,0,0,0,0,0,1,0,0,0,2,0,0,1,0,0,1,1,0,0,1,0,0,1,0,0,0,0,0,0,0,0,5,1,0,0,0,36,0,1,0,0,0,0,0,0,0,0,0,0,0,0,1,0
K49 The Colorado Kid,king,1592,942,745,843,683,410,560,478,484,490,356,349,530,402,222,369,218,220,226,426,257,295,153,141,56,120,86,159,135,109,118,164,165,123,111,215,101,162,118,223,167,141,135,125,91,128,167,123,103,149,109,63,97,54,72,66,129,112,112,125,73,88,81,59,46,79,52,65,60,111,55,29,52,47,79,63,87,83,60,38,58,57,68,106,64,57,50,33,59,21,50,42,65,20,89,46,43,41,50,37,52,108,36,48,56,62,54,38,47,37,32,54,29,25,29,7,32,38,27,42,76,18,38,27,10,41,40,47,34,50,28,29,72,33,43,40,23,11,36,46,12,45,43,22,72,56,38,56,39,72,28,26,24,22,17,25,14,14,28,15,23,9,39,48,8,6,19,23,31,16,14,35,59,21,14,12,16,14,43,41,25,22,37,39,21,12,20,6,31,20,10,10,27,23,13,17,7,26,18,8,21,16,27,35,4,19,8,7,18,20,1,9,30,15,18,13,23,8,27,15,16,20,26,13,14,9,13,13,3,20,8,11,8,7,14,13,7,8,10,23,11,17,10,9,19,7,28,23,20,59,18,10,15,5,6,11,7,16,16,6,25,9,18,30,36,4,19,17,21,14,5,21,16,12,16,16,12,7,20,24,0,11,5,24,36,6,8,2,10,11,5,46,3,20,17,13,9,13,6,25,9,8,7,13,6,34,19,9,4,10,8,7,11,18,25,5,6,7,16,6,6,30,8,13,18,1,8,14,10,2,10,21,11,7,2,8,10,1,9,11,6,10,12,15,4,16,12,15,5,13,25,9,11,13,9,3,24,13,5,17,16,28,16,1,6,12,5,10,8,6,10,1,18,1,28,15,19,10,10,15,2,9,12,14,10,10,0,11,11,4,0,3,50,0,11,26,2,9,13,6,15,7,12,4,8,4,4,28,6,12,16,9,9,13,4,5,5,8,9,7,13,0,2,23,5,12,9,4,5,15,3,1,6,11,0,8,5,8,7,15,5,5,9,10,4,8,4,12,3,15,7,3,6,25,17,10,4,5,5,8,12,3,0,6,8,17,4,4,4,4,3,2,8,16,3,13,4,5,0,2,8,9,6,4,0,1,8,1,16,9,0,4,8,3,5,1,5,9,1,16,6,5,17,2,7,7,11,4,9,18,6,16,7,3,3,11,0,8,10,2,6,15,2,10,5,5,8,14,10,14,22,1,4,6,9,2,6,14,1,3,7,1,19,10,8,2,0,1,17,2,0,13,7,1,5,5,8,11,4,4,17,24,5,7,4,7,5,0,5,4,3,6,3,1,3,2,2,2,7,8,2,9,7,3,5,3,3,9,0,2,9,6,4,17,7,5,3,1,4,13,2,9,8,1,0,0,0,3,6,6,0,9,4,3,13,3,5,1,4,8,1,4,5,8,3,10,1,9,7,2,2,4,0,6,3,0,10,1,6,1,6,4,1,3,9,16,9,6,0,6,0,1,4,3,2,4,3,3,9,3,4,10,3,4,0,8,2,10,2,2,0,1,3,4,7,4,0,1,4,2,18,1,6,0,6,2,7,2,1,5,4,3,1,23,0,12,3,0,0,5,6,1,1,8,10,5,0,10,19,2,2,2,0,4,10,39,2,4,22,5,1,0,2,4,1,3,17,1,4,8,2,4,2,3,0,2,1,4,0,1,7,9,5,0,11,0,0,5,6,3,1,2,4,15,2,2,10,5,2,5,4,2,8,2,5,13,7,0,21,12,11,7,8,0,4,5,6,3,2,8,1,1,3,3,1,2,1,3,11,0,1,2,14,3,3,3,0,4,1,1,9,0,3,10,1,4,25,3,6,0,1,3,6,1,4,12,1,1,2,14,4,7,0,6,5,0,0,2,3,11,7,0,1,6,0,2,2,11,2,2,4,2,0,2,10,0,5,0,2,6,3,7,35,0,3,0,4,0,4,5,0,3,0,4,1,7,2,0,4,2,4,5,8,7,17,0,0,6,3,10,6,4,4,20,5,2,8,4,4,1,6,0,1,4,1,8,1,0,0,2,0,0,2,0,6,3,3,1,3,5,3,0,6,0,0,1,3,7,10,5,1,1,1,0,2,2,1,1,11,0,0,6,2,0,5,3,2,1,7,0,4,0,2,4,1,4,2,3,1,1,1,3,2,13,1,2,3,0,4,0,0,3,3,5,8,5,2,2,1,4,1,0,4,2,0,3,1,8,0,6,0,6,7,19,2,43,0,0,1,2,1,0,2,0,1,2,0,1,6,0,0,0,7,0,1,19,0,1,2,1,1,0,11,0,3,2,5,0,1,3,2,3,1,3,0,2,3,1,0,2,1,1,1,4,0,16,6,0,3,2,4,2,0,1,13,24,2,1,7,0,0,1,2,0,0,0,2,4,0,21,2,1,0,4,3,0,3,3,0,0,0,2,0,2,0,15,2,2,2,1,5,1,12,1,1,0,1,7,2,2,3,0,4,0,0,5,3,4,5,1,0,6,0,2,0,1,5,1,4,1,1,2,0,2,0,0,2,0,4,0,2,6,0,3,1,0,1,8,4,0,1,0,3,0,1,1,2,6,4,1,2,6,5,5,0,13,0,1,5,0,2,1,1,2,3,0,0,1,0,3,0,2,0,5,0,1,4,2,0,0,0,3,1,0,0,4,0,5,1,0,2,0,0,1,1,0,8,4,1,0,5,25,0,0,3,7,0,1,0,2,5,0,6,2,0,0,1,1,5,2,0,0,1,1,0,0,0,4,3,2,6,4,0,0,2,0,3,2,1,2,4,10,1,6,2,0,0,5,1,2,0,8,1,0,0,3,0,2,0,1,1,0,2,1,1,0,0,1,31,17,4,0,1,4,0,0,1,25,3,1,0,1,2,0,0,10,5,0,0,1,0,6,5,2,4,4,6,3,2,2,0,2,2,1,0,2,3,2,1,2,1,1,4,0,4,4,0,0,1,0,0,0,0,1,0,1,0,7,0,7,1,1,1,0,0,5,1,4,0,1,0,3,2,2,0,1,4,0,0,1,1,1,3,0,1,4,1,2,1,1,2,0,6,4,0,1,0,3,4,1,0,2,0,0,1,3,3,2,0,1,6,2,1,2,7,0,0,0,0,1,0,0,3,6,5,1,0,0,26,1,3,0,1,3,0,6,1,0,0,0,0,0,0,0,0,0,0,0,1,0,1,2,3,2,0,0,3,0,4,0,3,0,0,0,4,1,0,0,0,1,4,0,0,0,5,1,2,0,1,3,4,1,4,5,0,5,10,7,1,2,3,1,0,3,0,0,0,5,9,0,0,0,0,0,3,1,6,0,2,0,0,2,0,1,0,1,0,3,1,0,5,0,2,0,0,1,1,0,2,3,3,2,2,1,1,4,0,0,0,3,1,3,7,0,0,1,0,1,0,1,2,0,0,0,0,2,2,0,1,0,1,1,2,1,1,6,0,2,1,2,1,3,4,0,1,0,2,1,2,2,8,0,9,3,2,5,4,0,0,0,4,1,1,1,2,1,0,0,0,1,0,0,0,8,1,2,0,0,1,6,4,4,3,0,1,1,2,0,2,0,1,1,2,14,4,0,1,0,0,0,0,4,7,43,1,2,2,0,3,0,0,1,0,0,1,0,3,3,3,5,0,4,0,1,1,1,0,0,0,0,0,2,0,0,2,1,1,0,0,4,3,2,2,0,0,0,1,2,2,4,1,0,0,2,0,0,3,0,3,0,0,0,1,13,0,1,0,1,2,0,0,6,1,0,1,0,1,0,1,1,0,6,0,2,0,2,0,3,0,0,1,1,3,0,0,0,0,3,2,2,4,0,0,2,0,0,1,0,0,3,2,0,1,0,5,0,0,3,0,6,2,1,1,6,0,0,1,1,0,5,1,2,1,1,3,0,4,1,2,2,3,0,3,0,1,1,1,1,0,0,5,1,0,1,0,1,1,4,2,0,0,1,0,3,0,1,0,1,2,0,0,16,2,0,1,1,1,2,4,0,0,0,0,0,1,9,2,0,1,1,0,1,2,2,0,1,1,0,1,5,0,1,0,1,2,0,1,0,2,1,0,0,1,2,2,0,4,1,1,2,4,2,0,0,0,3,2,0,1,1,0,0,0,0,1,0,0,3,0,0,0,1,2,3,0,1,0,0,0,1,1,5,0,2,1,8,2,1,4,0,0,0,3,0,1,3,2,1,0,0,2,1,0,1,0,26,0,0,4,1,2,1,0,0,0,1,0,0,10,0,0,0,1,1,0,0,3,1,1,0,0,0,2,0,2,0,2,0,1,4,0,4,0,0,0,0,0,0,0,0,0,1,0,0,2,0,1,0,0,0,1,0,0,0,0,0,0,2,2,0,2,0,0,1,1,0,0,2,0,1,7,0,0,1,2,1,0,5,1,1,0,3,5,0,0,0,0,2,0,0,0,1,0,0,2,5,0,1,0,1,0,3,0,0,0,3,0,2,0,0,0,0,1,1,0,1,0,0,3,3,0,3,1,2,2,0,1,0,2,0,1,0,0,1,1,0,0,1,0,0,0,0,0,2,0,6,1,0,0,1,0,1,1,0,0,0,0,3,0,0,0,1,0,1,0,1,6,0,0,2,5,0,0,0,0,1,0,3,1,0,2,4,0,1,3,3,1,3,1,0,2,1,1,0,1,0,0,0,3,1,0,1,3,1,0,0,0,1,0,0,0,0,0,2,0,0,0,0,0,4,3,0,1,0,0,1,0,0,6,1,0,0,0,1,0,1,0,0,0,2,0,1,0,0,1,1,5,0,0,0,0,0,3,1,0,0,1,0,0,4,0,1,0,2,0,1,2,2,0,2,0,0,1,0,0,1,0,0,0,1,0,0,0,0,0,0,2,0,0,0,0,1,0,1,0,1,1,0,2,1,0,0,0,0,1,0,0,0,2,0,0,0,0,0,5,2,0,2,2,0,5,0,1,2,0,0,0,0,3,3,0,1,2,0,5,1,0,0,1,4,0,5,0,4,1,2,0,2,1,1,0,3,1,0,0,0,0,1,0,0,0,1,0,1,0,1,0,3,0,0,1,5,0,1,1,1,1,1,0,0,0,0,2,1,0,1,0,1,1,0,0,0,2,1,2,0,2,4,5,0,1,0,0,0,0,3,0,1,0,1,0,0,2,2,1,0,1,2,0,0,1,2,2,2,1,0,1,2,2,1,0,1,0,4,0,0,0,3,4,0,0,1,1,0,0,0,1,0,0,0,2,0,0,1,0,2,1,7,0,1,0,0,0,0,4,0,0,2,0,1,1,0,1,1,0,6,0,0,6,0,2,1,0,0,0,0,6,0,0,0,1,0,0,1,0,1,1,0,0,0,1,0,0,2,2,0,0,2,0,1,0,1,0,2,1,0,0,0,2,17,1,0,0,0,1,1,1,0,0,2,0,0,0,0,0,6,0,1,0,0,3,0,3,1,0,0,0,0,0,0,0,1,1,0,1,0,0,0,2,0,2,3,2,0,0,0,0,0,0,0,0,4,0,0,1,0,1,3,0,0,0,0,0,2,0,0,0,0,0,0,0,2,1,1,6,1,2,14,1,0,0,1,0,2,1,2,0,0,0,0,0,0,0,2,0,0,0,0,1,1,0,0,1,1,0,1,0,0,0,2,0,0,1,2,0,1,0,0,5,0,1,0,0,0,0,0,2,0,0,1,4,0,0,0,2,0,0,0,1,0,0,0,1,0,0,1,0,1,0,0,0,0,0,0,1,1,1,0,0,0,3,2,0,3,4,0,0,0,0,0,0,0,0,0,0,0,0,0,0,0,0,0,0,2,0,0,2,2,0,1,0,0,0,0,0,0,0,0,9,2,0,2,0,6,0,0,0,0,0,0,0,1,0,1,1,2,0,3,1,6,6,4,0,2,0,0,0,0,0,1,0,1,0,0,0,0,0,0,0,0,0,0,0,0,0,0,0,2,0,0,0,0,0,0,0,0,1,1,1,0,0,1,0,0,2,0,0,1,5,1,1,1,0,0,0,0,0,0,1,0,3,0,0,0,0,5,0,0,0,1,1,0,0,0,0,22,1,0,2,0,1,0,0,1,1,0,0,3,1,0,0,0,0,0,2,0,0,0,1,0,1,1,0,6,0,0,0,0,0,0,1,0,0,1,0,1,1,0,0,5,0,0,0,0,1,0,0,3,0,0,0,0,0,2,0,0,0,0,0,0,0,0,1,1,1,0,1,0,1,0,7,0,0,0,0,0,1,0,0,1,1,0,0,5,1,0,1,1,0,0,0,0,1,1,0,0,4,0,0,0,2,0,10,0,1,5,0,2,1,4,0,0,0,0,0,0,0,0,0,2,0,0,0,0,0,2,0,0,0,0,0,6,0,3,3,0,0,0,0,0,0,1,0,0,0,0,1,3,0,0,0,0,0,3,0,0,0,0,0,1,0,0,0,0,1,1,0,2,0,0,2,2,0,0,0,1,0,2,0,0,0,0,0,0,2,0,1,0,0,0,2,4,0,0,1,1,0,0,2,0,0,0,0,0,0,1,0,1,1,0,0,0,0,0,0,0,0,0,4,0,0,0,1,0,2,4,2,0,0,0,0,3,0,0,0,1,0,3,0,1,0,0,2,1,0,0,0,2,0,4,0,0,2,3,1,4,0,0,0,0,0,2,2,0,0,0,0,0,0,0,2,0,0,0,0,1,0,15,1,6,0,0,0,0,0,1,2,0,0,4,0,0,0,3,0,0,0,0,0,0,0,0,0,0,1,0,1,0,0,1,0,0,0,0,0,0,1,0,0,0,1,1,0,0,0,1,0,1,0,0,1,2,0,1,0,3,0,2,1,1,0,1,0,0,1,3,1,1,2,0,0,1,1,0,0,0,0,9,0,0,1,0,0,0,0,1,1,2,0,0,1,0,0,0,1,0,0,0,1,0,0,0,0,0,0,2,1,1,0,0,0,0,0,1,0,1,0,0,0,0,1,0,0,0,2,0,0,0,0,4,1,0,0,2,0,0,0,4,2,0,0,2,0,0,0,0,1,2,2,1,0,0,0,2,1,0,2,0,1,4,0,0,0,0,0,0,1,1,0,0,1,0,1,0,0,0,0,0,5,0,0,0,0,0,1,1,0,0,0,0,0,0,1,0,0,0,2,0,0,0,0,1,0,0,0,3,0,1,3,0,1,1,0,1,0,0,1,0,4,3,2,0,0,1,0,0,0,1,0,0,6,0,0,0,0,0,0,1,0,0,0,0,2,1,0,0,0,0,1,0,1,1,0,0,0,0,0,1,0,0,1,0,0,0,1,0,1,1,0,0,0,0,0,7,0,0,0,2,0,0,0,2,0,0,0,2,1,2,1,0,2,1,1,0,0,0,0,0,1,0,1,0,1,0,0,0,0,2,4,1,0,0,0,0,0,0,1,0,1,0,0,0,1,1,0,0,0,0,0,1,0,0,1,0,1,0,2,0,0,0,0,0,0,0,0,0,1,8,0,0,0,1,0,0,1,0,0,2,4,0,1,0,1,0,0,0,0,0,0,1,0,0,1,0,0,0,0,0,0,0,0,1,0,0,0,0,0,0,0,0,1,0,0,0,0,0,0,0,2,0,0,0,4,1,1,0,0,1,0,1,0,0,0,0,0,0,0,1,0,0,1,0,0,0,4,1,0,0,0,0,0,1,1,1,1,0,0,0,0,0,0,0,0,1,0,2,0,0,0,0,2,0,0,0,1,0,0,0,0,0,1,0,1,5,0,1,0,1,2,1,1,2,1,1,0,0,0,0,2,0,0,0,0,0,0,0,0,0,0,0,0,1,1,0,6,0,0,2,0,0,1,0,0,0,2,5,2,0,0,0,0,0,0,2,0,1,5,1,1,0,0,1,1,0,1,0,0,0,0,0,0,0,0,1,0,0,0,0,0,0,1,1,0,0,1,0,1,1,0,0,0,0,0,1,0,0,0,3,1,0,0,0,0,0,3,0,0,0,0,1,0,0,0,2,0,1,4,0,0,0,0,0,0,1,0,0,0,1,0,2,0,0,0,1,0,1,2,0,0,0,0,1,0,0,2,2,0,0,0,0,0,0,2,0,0,3,0,0,0,0,0,0,0,0,0,0,0,2,0,1,1,3,0,0,0,0,0,0,2,0,0,0,0,0,0,0,0,0,0,0,1,0,0,0,0,0,0,0,0,0,0,2,1,2,0,1,0,1,1,1,0,0,0,0,0,0,4,0,0,2,0,0,0,0,0,0,0,2,0,5,0,1,1,1,0,0,0,0,0,0,2,0,0,0,0,0,4,0,0,1,2,2,0,0,0,0,0,0,0,0,0,0,0,0,0,0,1,0,0,0,0,0,0,0,0,18,0,2,0,0,1,0,0,0,0,0,0,0,0,0,0,0,0,0,0,0,0,2,0,1,1,0,0,0,3,0,0,0,0,1,0,0,0,0,0,0,1,1,0,3,0,0,0,0,0,1,0,0,0,0,0,5,1,0,0,0,0,0,0,0,1,0,0,0,0,1,8,0,0,0,0,0,0,0,3,0,0,0,0,0,0,1,2,3,0,0,0,0,0,1,1,1,0,0,0,0,2,0,0,3,0,0,0,1,0,1,4,11,0,0,0,1,1,1,0,0,4,0,0,1,0,0,0,0,0,0,0,1,0,1,0,0,0,0,1,1,1,0,1,0,0,1,0,0,0,0,4,0,0,0,0,0,0,0,0,0,0,0,0,0,1,0,3,0,2,1,0,0,0,0,0,0,0,1,0,1,0,0,4,0,2,1,1,0,0,5,0,3,2,0,0,0,0,0,0,0,0,0,0,0,0,0,0,2,0,0,0,0,0,0,0,0,0,1,0,0,0,1,0,0,0,0,1,0,0,2,0,0,4,0,1,0,1,1,0,0,0,0,3,2,0,0,0,0,0,0,0,0,0,1,0,0,0,0,1,0,0,3,0,0,0,1,0,0,0,1,0,2,1,0,0,0,0,2,0,0,0,1,0,0,1,0,0,0,1,0,0,0,0,0,2,3,2,0,2,0,1,0,0,1,0,0,1,0,0,14,0,1,0,0,0,2,1,0,0,1,0,0,1,0,0,0,1,0,0,0,0,0,0,0,1,0,0,0,0,0,8,2,0,0,0,1,2,0,0,0,0,0,0,2,0,2,0,0,0,0,1,0,0,0,0,0,0,1,1,1,0,0,0,0,0,0,0,1,0,0,1,1,1,0,0,1,0,0,1,0,0,0,0,0,0,0,0,0,0,0,0,0,0,0,0,0,1,6,0,0,1,1,1,0,2,0,0,0,0,0,1,29,0,0,0,0,0,0,0,1,0,0,0,0,5,1,0,3,2,0,0,0,1,0,0,3,0,0,0,0,0,0,1,3,0,0,1,1,2,0,0,0,0,0,1,0,0,0,0,0,0,0,0,0,0,0,0,0,0,0,0,0,0,27,1,0,0,0,1,0,2,1,0,0,0,0,0,0,0,0,0,0,0,0,4,0,0,0,0,0,0,0,0,0,0,0,1,0,0,2,3,0,2,0,1,0,0,0,0,2,0,0,0,0,2,0,0,0,0,1,1,0,0,1,0,0,0,1,0,0,0,2,1,0,0,2,0,0,0,0,0,0,0,0,0,0,0,0,0,2,0,4,0,1,0,0,0,0,1,0,0,0,0,0,0,1,0,0,1,0,0,0,0,0,1,0,1,0,7,2,0,0,0,0,0,0,0,0,0,0,0,1,1,0,0,2,0,0,1,0,0,0,0,0,0,0,0,1,0,0,0,1,0,0,0,0,0,0,0,0,0,0,0,0,0,0,0,1,6,0,0,0,0,1,0,0,0,0,0,0,3,0,0,0,0,0,0,0,0,0,0,0,0,0,0,1,0,0,0,0,0,0,0,0,0,0,0,0,0,0,0,0,0,0,3,0,1,0,0,0,0,0,1,0,1,0,0,0,0,2,0,0,0,0,0,0,0,0,0,0,0,0,1,0,0,4,7,0,0,0,0,2,0,0,0,0,0,0,1,1,1,0,0,1,0,0,1,1,0,0,0,0,0,0,0,3,0,0,0,0,0,0,0,0,0,0,0,0,0,0,1,2,0,0,0,0,1,0,0,1,0,0,1,0,3,1,0,0,0,1,0,0,0,0,0,0,0,0,0,0,0,0,0,0,8,0,0,0,0,0,0,0,2,0,0,0,0,0,1,0,1,4,1,0,1,2,2,0,1,0,1,0,0,0,0,1,1,0,0,0,0,0,0,0,0,0,0,0,1,0,0,2,2,0,1,0,0,1,0,0,0,4,1,0,0,3,0,0,0,0,0,0,0,2,1,0,0,0,0,0,0,0,0,1,0,0,1,0,0,0,0,1,0,0,1,0,0,0,1,0,0,1,0,0,0,0,0,0,0,1,0,0,1,1,0,0,0,0,0,0,0,1,0,0,0,0,0,5,1,0,0,0,0,0,2,0,1,1,1,0,0,0,0,1,0,0,0,0,0,0,0,1,0,0,0,1,0,0,0,1,0,0,0,5,0,0,0,0,0,1,2,0,0,0,0,0,0,0,0,0,0,4,0,0,0,0,0,0,1,0,0,0,1,0,2,0,0,0,1,0,1,2,0,2,0,1,0,0,0,0,0,0,1,0,0,1,0,0,0,0,0,0,0,0,0,1,0,0,1,1,0,0,0,0,0,0,0,0,0,0,0,0,0,0,0,0,1,1,0,0,0,0,1,2,0,0,0,1,0,0,0,1,0,0,0,0,1,0,0,0,0,0,0,0,0,0,0,0,1,2,0,1,0,0,8,1,0,0,1,0,0,0,1,0,1,0,0,0,0,0,0,0,6,0,0,0,0,0,0,0,0,0,0,0,0,0,3,4,0,0,0,0,2,1,0,0,1,1,0,0,0,0,2,0,0,0,0,0,0,0,0,0,0,0,0,1,0,0,0,1,6,0,0,0,0,0,0,0,0,1,0,0,0,0,0,0,0,0,0,0,3,0,0,1,0,0,1,0,0,0,1,1,0,0,0,6,0,0,0,0,0,0,0,0,0,0,0,1,0,1,0,0,0,0,0,0,0,0,1,2,0,0,0,0,0,0,0,0,0,0,2,0,0,0,0,0,0,0,0,1,0,0,0,0,0,0,0,0,0,0,0,0,2,0,0,0,0,0,0,0,0,0,0,0,0,0,0,0,0,0,0,0,0,0,0,0,0,0,0,0,0,0,0,0,0,0,0,21,0,0,0,0,0,0,0,0,0,0,0,0,0,0,0,0
K50 Cell,king,7179,3141,2634,2796,2743,952,2255,1795,1923,1700,1041,1414,1245,531,709,1106,1199,861,600,1186,835,915,699,526,195,479,222,968,530,281,511,541,524,463,443,475,584,482,354,574,564,443,547,445,240,270,342,267,304,442,338,535,334,253,264,260,418,257,292,300,268,289,248,294,167,206,286,241,205,240,236,170,162,211,164,219,193,233,184,148,177,203,362,293,221,322,175,167,204,157,124,225,199,128,242,126,194,170,111,161,71,296,207,143,285,128,232,185,126,154,169,114,171,297,136,100,135,100,132,166,200,65,135,163,67,68,119,124,99,82,169,141,158,107,165,84,56,128,128,98,58,96,122,88,180,124,108,180,80,155,66,90,96,104,93,58,52,92,114,104,82,75,109,82,113,120,94,78,53,104,27,27,119,50,40,62,33,77,72,149,41,59,97,69,73,41,41,84,168,47,89,65,94,72,51,99,11,40,132,17,62,124,100,116,62,107,53,33,81,74,31,67,39,67,91,83,62,84,39,39,65,64,94,82,62,104,46,31,41,81,74,79,72,113,71,25,68,67,118,66,33,26,60,25,41,59,44,81,46,111,74,28,60,46,67,36,37,54,66,52,83,52,45,91,71,17,38,62,65,79,46,52,88,35,62,45,33,48,106,53,40,38,57,44,174,128,61,23,52,39,46,17,186,53,61,57,57,37,19,60,44,49,67,28,118,53,5,57,23,61,30,15,23,50,32,64,28,76,53,61,22,94,27,67,13,63,48,16,43,36,65,39,48,66,90,45,44,4,17,46,46,19,31,21,36,36,60,67,33,45,77,41,47,34,70,7,36,53,38,21,30,54,28,12,33,19,34,23,97,22,37,27,32,47,21,62,19,23,32,25,15,42,19,42,16,12,0,38,34,34,19,24,10,47,28,71,37,17,22,49,36,84,30,34,27,23,31,46,22,33,44,25,24,47,20,42,22,39,32,18,41,0,8,19,12,56,23,43,29,27,67,29,18,26,6,50,23,41,0,33,35,23,32,22,31,18,26,22,35,47,37,15,16,70,24,16,32,15,33,55,25,5,0,25,13,5,43,46,4,25,23,22,17,10,22,15,17,24,0,46,21,43,53,37,16,25,36,16,28,15,37,6,17,23,24,8,38,35,10,25,27,21,49,30,29,14,41,24,33,6,19,30,25,26,15,24,0,14,19,30,34,20,45,20,34,18,24,17,17,39,6,25,27,19,39,4,28,34,13,11,43,20,50,21,50,38,0,6,14,23,39,20,17,51,35,32,31,28,14,1,28,25,20,4,37,27,9,17,28,16,48,38,16,25,11,11,21,6,9,11,24,29,5,37,1,37,8,26,15,9,24,13,21,3,15,20,19,15,14,42,20,31,39,22,12,0,0,20,23,15,10,26,27,16,3,33,26,6,6,27,14,32,14,8,15,25,15,32,12,5,8,25,14,9,18,0,34,21,19,12,18,10,58,8,38,41,22,9,4,19,0,8,9,18,31,29,19,8,36,6,11,14,23,19,2,29,17,5,8,10,15,19,16,7,5,14,8,13,19,9,26,15,21,9,29,30,13,14,10,20,13,4,6,31,11,10,6,1,2,30,18,7,32,19,17,11,13,37,7,13,0,31,5,23,6,46,10,45,18,19,23,45,25,2,15,21,25,4,14,10,16,5,10,8,0,50,11,15,85,17,22,22,2,72,1,8,27,23,17,53,13,6,5,15,2,28,10,1,19,7,25,6,36,23,34,15,18,4,49,25,13,7,10,19,1,5,7,12,8,16,14,10,9,8,20,18,14,18,13,26,7,5,0,15,16,10,0,19,0,18,10,12,11,13,68,12,64,7,24,8,12,16,16,23,18,17,10,0,20,6,6,0,13,17,21,6,10,31,9,12,12,9,15,13,9,20,12,9,0,11,21,10,7,14,24,3,10,0,15,26,13,25,5,3,5,47,12,6,0,38,19,10,18,13,35,23,4,0,12,28,20,10,13,9,0,26,7,30,10,13,8,12,22,16,4,17,12,19,10,11,17,10,4,8,8,11,11,0,12,48,9,15,10,15,12,16,26,10,18,14,16,0,41,0,10,10,5,7,51,8,17,2,2,11,9,10,3,0,27,5,29,17,15,0,2,16,12,11,3,24,9,35,24,7,23,26,11,3,10,7,8,16,22,11,2,16,24,17,6,12,0,9,12,1,54,20,8,3,4,11,5,1,12,16,5,10,7,9,24,21,1,46,11,1,14,14,14,0,14,7,7,11,13,20,15,10,0,13,15,0,6,0,2,0,9,16,6,0,0,13,9,4,5,10,4,9,21,2,9,4,2,13,18,0,26,0,15,5,13,11,15,10,3,5,10,4,14,3,7,19,13,6,123,9,21,2,22,16,0,5,9,4,1,4,6,0,12,9,5,10,2,15,0,4,20,39,6,2,0,0,0,0,10,6,13,12,7,0,13,14,5,8,4,14,9,15,2,28,8,2,11,0,12,8,3,5,14,9,17,5,23,8,5,12,3,8,24,5,18,11,10,10,2,5,0,0,3,8,12,9,13,32,3,21,15,2,24,31,10,0,9,6,16,7,9,12,15,6,5,6,18,18,2,13,6,5,14,11,8,3,31,1,10,16,9,4,1,10,27,16,0,12,8,22,0,1,1,18,2,1,0,20,6,3,12,15,1,6,6,1,7,8,0,7,7,10,0,8,4,0,21,23,0,14,35,8,10,2,85,11,6,0,5,7,9,5,8,2,11,9,0,4,12,6,2,0,0,11,7,7,20,10,13,3,16,3,1,12,4,16,19,18,1,8,4,0,0,5,0,2,10,3,10,0,5,3,0,0,5,7,4,7,10,8,3,4,25,6,1,25,4,0,14,8,0,4,12,4,9,6,2,4,21,3,0,8,18,9,0,11,5,29,18,7,10,15,20,13,9,4,0,8,2,8,12,10,1,3,0,7,7,5,10,3,7,11,7,3,5,6,19,0,6,5,1,23,7,33,4,17,11,9,0,1,7,3,3,6,4,7,2,10,6,7,3,10,1,10,31,10,10,21,3,0,3,13,2,18,12,51,15,2,2,6,15,5,4,7,1,0,2,2,18,0,13,2,6,15,13,1,1,4,12,3,5,0,0,13,0,2,0,0,6,23,4,11,6,14,7,6,12,10,5,5,0,8,6,0,10,3,0,0,0,7,0,8,2,0,4,11,2,10,3,6,0,8,8,6,0,9,12,22,3,3,3,5,5,3,13,9,8,3,0,0,0,22,5,2,7,11,9,1,2,19,4,17,1,3,8,4,11,5,0,8,3,0,3,8,6,4,3,9,3,0,0,21,10,1,8,3,15,3,5,9,0,9,5,13,10,5,6,1,8,7,12,14,2,16,1,10,3,15,1,11,6,7,0,1,2,12,10,0,3,0,0,13,0,6,6,4,13,1,9,1,19,16,4,0,16,0,5,15,7,7,7,10,8,3,8,6,4,3,5,0,3,0,8,2,5,6,13,4,2,13,11,3,8,0,27,1,23,17,19,12,20,6,1,2,11,1,4,5,4,2,5,5,25,7,13,13,8,11,8,0,7,5,14,5,23,7,2,8,7,10,9,3,3,3,0,6,0,10,16,33,8,6,10,0,8,8,106,0,0,3,3,4,4,8,12,3,10,6,5,1,11,5,0,5,1,13,4,6,10,0,5,6,1,0,2,3,6,1,3,0,8,6,4,1,3,7,17,1,18,4,0,0,1,6,10,0,7,5,11,0,1,8,0,7,1,12,5,5,5,1,9,6,7,0,11,1,2,18,8,16,3,7,1,5,2,13,15,8,8,1,8,0,3,2,10,4,1,0,5,1,0,3,3,0,8,3,18,3,14,1,1,2,21,13,7,3,9,4,5,6,3,7,0,8,0,10,1,21,1,2,4,0,7,6,13,4,4,22,13,0,1,0,12,4,19,6,5,3,4,10,0,11,20,3,11,1,8,5,6,1,2,8,0,3,7,16,3,1,2,4,3,13,1,6,1,0,2,1,1,5,1,6,5,7,19,4,9,4,3,8,2,9,4,1,5,3,4,10,0,6,7,3,3,2,11,14,1,1,2,5,3,0,5,5,4,1,7,5,3,6,10,14,3,1,5,2,11,7,0,0,11,3,0,5,0,0,2,12,10,4,1,20,6,5,0,3,2,4,1,2,2,8,13,5,5,0,9,10,4,2,1,3,14,6,8,6,1,4,6,2,13,0,0,1,4,12,0,5,0,9,8,6,1,35,7,54,0,2,4,2,1,4,2,6,5,7,7,9,0,4,4,5,4,0,1,2,0,10,2,0,0,2,7,3,802,3,0,8,1,1,11,5,7,2,2,0,5,7,0,12,1,10,8,0,6,2,0,6,0,2,5,0,1,4,0,8,0,1,0,11,0,5,3,1,5,8,6,4,1,11,1,2,0,6,1,11,4,5,12,3,3,5,1,1,2,8,10,1,3,0,4,2,2,9,2,5,1,9,10,17,3,5,2,2,2,1,9,17,7,0,8,0,14,0,5,1,2,0,1,3,0,5,0,3,1,32,0,8,0,4,9,6,4,0,3,0,6,5,15,2,3,0,6,23,5,0,1,0,6,3,1,8,6,2,6,6,15,1,1,0,5,3,2,0,5,7,2,4,1,1,1,6,5,9,3,8,20,4,1,5,1,2,8,6,5,2,0,0,1,6,0,0,7,4,3,3,5,0,4,7,1,3,0,0,1,10,2,12,6,12,0,2,0,2,10,10,1,0,3,4,1,7,0,0,1,2,1,5,6,3,4,7,0,1,0,2,2,0,6,5,0,0,1,1,4,11,6,10,23,2,0,2,6,16,8,2,0,3,4,1,6,4,8,4,0,1,2,5,0,0,7,0,2,7,16,3,0,7,1,0,11,17,2,0,1,2,4,0,5,0,5,0,0,4,0,3,5,0,0,0,3,2,2,6,0,3,2,7,1,1,0,7,0,8,3,4,0,4,0,2,5,4,0,0,0,15,0,2,0,0,4,1,2,3,1,1,5,1,4,0,0,10,2,4,15,11,7,2,5,7,6,3,0,0,1,0,1,19,11,3,6,7,16,0,2,0,7,5,1,2,1,7,9,2,2,0,0,4,7,1,2,2,5,9,4,8,1,0,9,3,0,1,2,2,5,0,6,11,8,5,2,5,3,0,5,2,5,3,4,22,3,6,11,0,19,2,7,0,4,9,4,3,1,2,0,1,3,5,2,1,2,2,0,4,7,0,6,3,0,0,1,1,1,12,6,6,2,3,19,25,18,2,13,2,5,2,7,1,6,4,1,0,12,1,7,2,14,2,2,6,1,1,1,3,0,2,3,2,3,6,0,5,8,22,0,0,6,6,8,2,3,0,7,3,3,4,0,3,2,1,2,0,3,1,2,0,0,7,0,8,1,1,2,1,1,4,17,3,7,0,0,2,2,11,0,0,1,2,4,2,3,7,0,1,0,13,3,1,2,4,9,0,0,0,3,0,4,2,8,1,2,1,1,4,8,0,0,8,2,0,3,0,1,4,10,1,8,9,2,8,0,3,15,0,2,2,7,9,7,1,0,1,0,48,14,1,0,7,4,1,4,10,0,2,1,2,14,4,7,7,0,6,12,0,0,3,6,1,1,2,3,0,6,3,1,0,0,0,0,9,5,2,0,0,6,0,3,2,0,0,0,4,2,4,0,3,4,4,6,0,1,1,1,2,5,4,1,5,4,8,5,5,0,1,8,0,3,0,1,4,15,5,2,0,0,6,4,0,0,0,1,8,9,5,0,0,4,2,1,3,9,6,5,1,1,0,3,0,0,1,0,0,16,4,2,4,0,8,4,3,4,3,3,1,0,0,1,0,1,6,2,5,1,0,3,5,4,4,8,6,0,4,1,7,2,0,5,1,1,8,6,5,4,5,5,0,6,3,2,1,0,6,3,4,5,0,4,6,0,3,2,2,0,1,5,0,0,22,29,7,0,1,3,1,0,0,0,2,3,2,2,2,0,3,6,0,3,7,9,2,2,5,9,3,2,6,3,0,2,0,1,0,3,0,3,0,1,1,1,1,0,0,3,2,3,3,3,0,1,1,2,0,1,4,2,0,3,0,5,7,2,2,1,0,7,2,0,14,5,4,0,2,1,4,0,4,8,3,3,3,1,1,10,0,0,1,2,0,6,8,0,1,7,8,0,4,1,2,0,4,1,0,1,2,1,4,0,0,1,3,2,2,6,0,4,5,4,4,0,3,15,1,3,0,1,2,4,2,0,10,4,0,5,2,1,1,4,5,9,1,0,0,5,2,0,4,0,1,5,0,1,0,2,2,2,6,2,1,0,1,0,0,5,8,1,4,1,1,6,4,5,2,1,0,1,2,6,0,2,5,4,1,1,0,2,4,3,1,1,0,1,1,5,2,0,0,1,1,1,3,0,5,4,1,5,5,0,0,3,3,6,4,3,2,4,16,5,4,3,2,0,1,0,3,2,0,1,10,1,5,1,3,3,0,2,2,1,5,2,1,0,0,1,3,9,0,1,2,1,0,2,1,1,6,6,2,4,1,2,0,0,3,0,0,4,3,0,1,1,1,0,3,5,1,17,4,0,0,2,3,0,2,0,6,0,1,2,4,0,3,1,5,2,5,1,7,0,7,2,2,6,0,4,2,0,0,3,11,3,1,0,2,2,6,2,0,0,0,2,0,1,0,0,0,0,2,0,1,5,0,19,11,5,0,0,1,0,0,1,1,0,0,1,1,2,6,0,0,1,5,0,1,7,2,0,1,1,0,0,1,0,2,11,0,1,3,14,3,2,0,0,3,0,12,2,4,3,2,6,6,3,2,2,3,2,4,0,2,0,3,7,0,10,1,12,4,0,0,5,7,3,7,3,0,2,3,6,2,2,2,3,4,4,6,0,0,26,0,0,1,2,1,2,1,0,5,1,0,1,1,1,2,1,1,4,7,0,2,0,0,8,2,0,1,1,2,1,0,4,7,2,1,0,0,1,0,1,1,1,4,0,0,0,0,2,1,5,0,0,0,0,2,1,1,2,9,2,1,1,1,1,0,4,0,0,2,1,1,0,2,0,0,0,0,0,0,6,4,1,3,19,1,0,6,3,1,1,1,7,0,0,0,0,4,8,3,0,2,1,0,2,2,4,5,4,0,0,6,0,0,3,4,5,0,5,2,8,0,3,8,7,3,5,0,2,4,0,1,0,0,2,0,0,3,3,1,2,0,1,2,2,10,6,1,0,4,0,3,0,0,6,1,2,1,3,0,4,5,2,0,3,2,1,0,5,3,0,0,0,0,4,3,2,6,0,0,2,0,14,9,0,7,6,2,2,3,0,8,0,0,0,1,4,1,0,2,3,2,18,1,2,0,0,0,1,0,1,5,5,0,3,3,0,0,0,54,3,1,4,0,0,0,3,2,9,1,0,2,3,2,0,3,0,0,1,1,1,2,4,3,1,3,2,0,2,4,0,0,0,3,3,0,2,0,5,0,0,4,0,1,0,1,0,0,0,3,0,3,0,47,0,0,4,0,0,4,1,0,0,0,0,4,0,2,6,6,4,1,5,3,2,1,0,0,3,0,1,0,3,4,3,3,2,6,3,0,1,3,4,3,4,0,0,0,401,1,5,0,1,1,1,1,0,1,4,3,5,2,1,0,3,0,5,0,0,6,0,1,4,1,1,15,8,0,0,0,0,0,1,0,2,0,7,0,6,2,0,0,2,0,2,0,0,1,1,0,3,2,0,5,3,1,0,1,0,5,0,2,23,1,5,0,2,0,1,1,0,0,0,0,4,7,0,0,3,0,1,0,2,0,2,0,3,2,2,4,0,0,0,3,1,11,0,1,0,1,2,3,1,1,2,2,0,0,0,0,0,1,3,2,0,8,1,2,0,2,3,0,0,0,0,0,5,0,2,0,1,1,2,6,1,2,5,0,0,2,3,20,2,1,0,2,3,1,0,2,3,1,0,0,0,3,4,0,0,3,0,0,7,2,0,0,0,0,3,1,4,0,1,1,3,3,2,1,11,7,1,1,2,0,1,0,0,0,37,0,2,4,1,0,7,0,7,0,1,1,0,19,1,0,1,0,0,0,3,0,1,3,0,5,1,2,5,4,1,1,0,0,1,0,1,3,0,3,1,3,0,0,0,0,3,5,2,3,1,3,4,2,8,1,0,2,5,1,1,2,0,2,5,1,0,12,6,0,6,4,0,0,2,0,0,2,4,3,4,1,3,2,5,0,2,0,20,6,0,1,0,4,1,4,3,1,0,0,1,12,6,0,3,0,1,1,6,0,0,0,4,0,5,1,2,10,0,0,2,3,0,2,0,0,0,3,1,2,0,0,0,3,3,0,7,4,0,3,3,26,0,0,14,0,5,2,4,2,3,0,1,1,0,0,0,0,0,0,5,0,2,0,1,4,3,0,1,0,1,1,0,1,4,1,1,4,0,1,0,12,0,1,0,2,0,0,14,0,0,0,13,0,3,0,0,25,2,0,1,2,0,10,0,0,1,4,1,0,1,2,0,0,0,1,1,1,0,4,0,0,1,0,3,1,1,0,0,1,0,4,0,4,3,0,2,0,0,1,0,0,0,2,2,1,0,0,4,0,1,3,1,0,2,0,1,1,0,1,2,0,0,0,0,1,0,3,2,2,3,1,1,0,0,0,4,1,0,0,0,0,1,3,0,5,0,0,1,2,6,0,2,2,3,0,0,3,0,0,1,0,4,1,0,0,0,3,2,5,0,8,0,1,4,1,1,0,2,1,0,4,0,4,4,1,0,0,0,1,0,7,1,0,2,4,0,1,5,3,0,0,2,0,0,1,0,0,0,2,0,0,0,1,1,0,1,1,0,4,0,0,1,3,3,7,5,0,0,0,2,0,8,0,0,3,1,0,1,2,1,2,1,1,0,2,1,1,7,1,1,0,3,3,0,1,2,0,1,0,1,1,1,6,1,0,1,1,0,0,4,0,0,1,0,3,1,0,0,2,2,2,1,0,0,0,5,1,22,0,6,2,0,0,1,0,7,2,1,0,0,2,2,0,0,0,0,3,2,0,0,0,3,0,1,1,0,6,0,0,1,0,0,3,1,1,0,1,3,2,1,1,0,0,9,0,0,1,2,0,3,8,3,3,3,2,0,8,1,1,0,0,0,1,10,0,0,0,0,5,0,1,0,5,0,18,2,3,1,1,0,1,1,1,4,1,0,2,3,2,2,0,0,1,0,7,2,2,5,2,3,0,3,0,2,2,0,0,0,4,3,1,2,1,3,2,6,0,4,1,1,1,0,3,1,2,3,0,7,113,0,4,4,0,0,2,0,3,1,1,0,0,4,1,0,4,4,2,1,1,1,0,1,4,0,0,0,3,0,0,1,5,1,0,1,2,4,5,1,2,0,0,0,1,0,2,1,0,1,0,2,0,3,0,1,0,0,2,1,15,7,0,1,1,3,2,0,0,5,1,0,0,3,0,0,2,4,0,1,2,1,0,1,5,0,0,2,2,10,0,0,5,0,0,0,0,3,0,2,1,2,1,11,0,1,4,0,3,2,2,0,1,3,0,0,2,0,0,2,0,0,1,0,0,4,0,5,0,0,0,9,1,20,0,2,1,1,0,0,4,7,3,0,0,0,1,0,2,7,2,2,13,4,0,0,6,2,2,6,1,1,1,0,1,0,0,0,0,0,0,0,8,0,1,1,2,1,2,0,0,2,0,1,0,0,0,0,0,0,5,0,1,0,6,1,0,0,0,1,2,2,0,4,1,0,0,1,0,0,7,1,3,0,1,0,2,0,0,4,1,6,0,0,0,1,0,3,3,2,0,0,0,2,0,1,0,1,0,2,8,2,0,1,0,0,9,1,0,3,0,0,2,0,1,1,1,1,3,0,3,1,0,3,0,4,8,1,0,0,3,0,0,3,2,3,2,0,6,2,3,1,0,1,1,3,0,2,1,0,0,0,0,2,2,0,0,2,1,2,0,0,0,4,0,0,1,0,1,1,0,1,0,0,0,1,0,0,1,3,1,0,0,0,1,4,4,3,1,0,0,0,12,0,0,1,1,0,2,0,0,0,1,0,0,1,0,0,0,11,1,0,0,0,2,1,0,0,0,1,0,4,5,6,1,2,0,0,0,0,5,1,0,0,5,0,1,7,1,2,0,3,0,2,0,0,2,0,0,0,3,0,0,1,1,0,0,1,2,0,0,0,6,0,3,4,2,2,0,0,0,0,0,2,0,4,1,1,0,4,1,0,1,1,0,1,0,1,0,2,4,2,1,0,1,3,0,5,4,0,2,3,1,1,24,1,21,2,0,1,4,3,2,0,1,2,0,2,1,0,4,1,0,0,1,2,0,0,0,0,2,2,0,1,0,0,0,0,0,0,2,0,3,0,3,2,4,0,2,0,2,1,2,0,1,0,2,2,0,0,3,0,7,0,1,1,0,4,1,0,0,1,6,0,3,6,0,1,0,1,0,0,4,1,1,2,0,1,4,7,1,0,4,0,0,4,0,1,0,1,1,1,0,0,4,2,1,2,9,0,0,1,1,0,2,1,1,0,0,0,2,4,0,0,3,5,1,2,0,2,0,3,2,2,0,0,0,3,0,6,0,2,2,4,3,0,0,0,1,1,0,0,0,2,1,0,0,0,0,2,1,3,0,2,1,0,0,0,9,1,0,0,2,2,0,0,0,1,0,0,0,0,0,2,0,1,2,5,0,0,1,2,2,0,1,0,2,0,1,0,1,0,0,0,1,0,9,1,1,0,0,2,0,0,0,5,1,2,1,0,1,0,2,0,6,0,0,0,0,0,0,0,0,1,0,1,3,1,1,0,0,0,0,6,1,2,2,0,0,3,0,0,0,1,0,0,2,2,2,0,0,1,1,4,0,0,0,1,1,0,0,0,2,2,1,0,0,0,1,22,0,0,17,0,0,1,0,0,1,12,1,0,0,0,0,1,2,1,0,0,0,0,3,2,0,0,1,2,0,0,0,3,0,0,0,3,0,0,1,1,1,0,1,1,0,4,1,1,1,22,0,3,1,0,2,0,3,0,1,0,0,0,0,0,0,1,0,3,0,0,0,2,0,0,0,0,0,0,0,0,4,0,1,0,0,0,0,1,0,9,0,0,0,0,0,0,0,1,0,1,0,1,0,0,5,2,0,2,0,25,0,3,3,0,0,0,0,0,0,0,0,21,1,0,0,0,0,0,0,0,0,1,1,0,0,0,0,0,0,0,0,0,0,0,0,0,0,0,0,0,0,0,0
K51 Lisey's Story,king,9762,5359,4298,3939,3908,1609,1992,2808,2524,2892,1734,1527,2413,3965,3066,1545,1806,1272,1114,642,1156,1470,1024,879,362,757,530,491,791,952,687,747,813,765,793,664,410,776,228,830,826,669,751,565,445,666,657,575,536,691,647,389,445,371,324,332,689,345,458,553,427,263,280,547,293,472,213,347,321,326,283,250,334,306,222,359,271,323,255,271,229,408,112,333,305,157,300,306,374,266,181,324,378,194,294,247,223,178,265,245,279,442,243,214,375,212,346,303,212,261,279,179,63,164,236,116,190,195,175,89,102,248,149,246,150,173,295,206,181,152,132,146,194,116,240,185,40,156,167,132,123,147,168,138,358,166,137,240,168,225,167,163,129,154,155,312,346,166,125,71,85,104,170,245,125,200,154,116,173,147,48,154,167,123,72,76,108,159,183,199,159,137,195,94,118,116,82,106,140,88,70,82,158,114,93,145,69,63,50,56,92,96,143,223,73,50,95,50,96,164,29,154,18,71,104,53,106,71,140,62,76,104,119,75,172,143,64,95,66,166,142,41,43,205,52,245,99,71,125,77,81,64,82,83,126,96,80,168,52,125,118,84,67,22,78,75,52,83,88,99,138,87,129,77,133,97,62,82,59,112,82,91,112,66,79,51,60,78,146,90,87,53,109,94,230,9,56,167,61,54,36,259,84,46,88,69,61,62,186,73,140,48,68,41,71,124,29,35,20,52,66,23,39,94,75,53,35,70,96,25,56,93,42,88,188,40,83,46,56,51,41,65,76,41,47,68,76,8,64,58,60,62,51,38,65,38,54,25,46,37,113,12,102,56,128,33,45,96,53,36,53,21,109,15,54,21,54,62,31,51,47,34,60,77,42,98,41,32,141,153,44,51,35,17,33,9,0,85,85,62,23,95,79,30,52,92,64,33,47,46,23,151,58,41,59,34,57,65,49,66,26,44,89,20,90,45,36,87,30,26,85,5,19,35,25,37,30,68,43,41,51,34,26,39,20,18,63,51,56,50,20,39,28,41,38,43,49,47,30,52,26,30,5,98,86,52,37,60,26,39,46,54,943,9,22,28,47,16,92,47,13,25,66,23,37,43,28,14,0,20,29,55,46,51,28,101,29,16,49,17,49,24,43,16,36,9,36,33,5,58,27,17,33,23,49,23,31,63,58,20,23,49,30,48,13,56,0,25,26,25,54,37,63,27,49,31,32,90,76,48,12,30,49,32,34,5,37,67,12,34,39,20,76,23,39,39,0,3,23,35,27,45,27,5,37,10,34,48,23,11,25,32,26,73,30,36,27,50,20,15,25,23,26,79,33,13,29,88,14,26,46,56,18,46,4,41,23,45,8,25,34,40,21,13,29,23,11,12,25,35,69,79,69,13,19,0,0,49,8,116,34,14,62,35,4,20,30,13,14,22,17,28,48,27,25,62,95,23,52,22,8,35,13,35,16,0,39,16,80,40,28,14,18,10,17,38,25,21,23,45,30,41,29,39,32,55,31,10,38,9,14,14,25,23,31,41,57,33,26,27,35,40,13,29,21,26,38,12,26,10,34,18,25,28,52,22,1,17,19,34,21,10,29,29,36,35,20,7,48,16,85,6,30,24,31,12,10,24,11,12,7,18,4,25,16,29,17,27,26,17,18,10,24,4,22,28,21,2,14,17,35,15,21,28,0,78,21,7,19,23,34,38,5,30,2,2,18,30,40,8,43,86,36,11,5,51,19,29,17,44,9,15,48,15,11,23,47,15,12,34,34,9,33,63,1,12,8,15,15,9,24,27,11,36,29,41,16,45,44,27,30,9,183,15,3,38,0,19,2,8,22,7,12,32,22,8,92,11,3,21,19,16,46,3,32,59,4,0,16,26,17,15,6,25,36,8,6,18,13,12,43,9,29,15,2,34,16,18,0,10,52,14,20,13,34,13,11,0,16,13,25,35,25,8,8,33,2,6,36,71,13,15,16,18,14,43,21,1,24,37,25,22,40,7,1,11,4,17,4,24,25,20,46,20,9,31,30,16,20,28,14,7,15,5,25,33,25,2,27,35,30,4,14,10,18,21,38,10,18,23,21,0,21,1,3,12,12,5,57,36,20,8,3,13,14,48,3,4,48,2,22,11,15,0,5,9,25,13,12,28,19,8,8,26,16,9,9,19,15,19,23,24,38,6,3,30,18,25,57,8,0,30,17,9,5,28,7,8,5,9,18,12,28,25,10,27,13,24,20,8,4,53,19,0,13,22,28,0,26,19,8,12,29,16,24,4,1,24,24,0,19,0,13,0,33,28,0,2,7,29,9,12,6,43,36,12,28,0,6,19,8,21,29,1,9,3,27,18,27,14,10,20,12,12,15,10,24,4,7,38,21,9,17,12,12,27,3,22,10,17,25,26,19,8,5,0,12,17,10,23,7,6,0,4,13,8,12,5,0,0,0,5,20,30,8,20,2,0,11,7,10,10,25,10,7,3,29,51,7,1,32,0,18,20,5,17,13,5,23,12,3,7,22,14,7,8,19,9,13,24,22,12,1,18,0,0,4,29,17,28,45,34,3,32,4,10,24,28,2,2,8,4,25,3,20,8,13,7,40,5,37,16,19,25,14,8,8,3,26,9,4,0,16,11,14,3,3,12,1,22,16,5,5,22,0,4,2,34,0,0,12,12,16,84,17,47,0,0,16,0,19,12,6,3,14,17,29,6,7,0,27,14,0,21,1,17,12,11,3,20,37,0,8,5,36,0,1,8,14,7,0,3,15,11,7,0,0,5,10,8,24,9,14,2,24,7,31,21,4,6,5,15,5,10,23,0,1,3,3,21,21,2,16,0,1,5,0,6,9,8,5,9,21,10,16,56,8,7,7,18,13,0,10,20,0,5,13,4,7,26,1,4,16,3,0,32,19,20,0,13,7,21,7,10,24,12,23,5,5,15,0,2,15,121,14,14,7,22,2,34,7,16,8,13,16,30,1,8,12,12,3,0,4,8,8,15,28,22,17,17,21,12,4,0,21,12,3,13,4,6,2,9,5,3,19,13,2,5,3,9,10,19,11,0,16,29,10,38,11,3,4,3,7,11,10,15,14,12,17,6,10,18,20,0,9,9,11,11,6,14,4,11,19,22,21,0,0,26,0,12,2,2,19,31,8,8,4,4,23,7,12,25,11,9,18,6,17,0,15,1,0,0,0,11,0,18,16,0,11,15,3,22,19,6,1,10,6,6,6,7,125,10,6,24,20,13,11,5,4,12,4,26,0,0,6,16,8,4,21,12,5,0,3,11,11,19,9,23,17,6,8,4,0,23,12,0,17,25,19,2,4,26,9,0,4,18,11,0,25,40,23,8,3,11,0,4,10,32,2,2,14,9,5,25,3,7,9,11,10,6,9,18,9,15,13,5,0,0,4,31,18,1,0,2,0,5,0,4,15,4,4,2,0,55,19,9,1,0,0,1,7,13,5,25,13,27,4,7,1,11,7,6,11,13,23,0,13,17,77,14,12,7,14,23,8,13,10,1,12,0,9,9,24,7,29,6,2,28,10,12,19,18,11,6,7,5,1,5,9,7,14,17,10,0,6,23,28,4,26,6,16,16,11,15,5,10,6,9,2,13,5,16,17,4,12,10,10,0,15,12,9,0,0,13,9,14,8,6,16,4,20,11,4,3,20,5,0,11,1,19,2,7,9,0,35,11,3,12,3,3,11,0,2,1,4,6,4,8,1,11,9,6,14,11,0,0,1,9,13,1,7,6,10,15,12,9,2,5,3,27,7,27,8,6,17,3,7,0,29,4,12,37,17,29,2,3,1,8,0,3,20,6,11,6,11,0,6,17,5,6,6,0,2,9,0,13,29,0,21,4,19,3,13,9,6,1,19,8,28,1,1,13,15,8,3,3,3,17,0,7,18,4,10,8,23,0,13,13,9,5,4,10,27,0,0,12,10,3,28,4,12,4,18,11,0,5,1,7,10,1,9,10,1,0,1,15,0,5,11,12,12,3,8,7,4,9,6,3,10,3,6,1,1,8,35,0,5,9,4,4,110,3,6,10,1,2,4,2,7,10,12,14,0,6,3,1,2,42,18,25,1,2,23,5,10,0,33,5,12,1,11,20,15,5,0,9,4,0,12,12,33,19,0,0,2,6,0,5,0,0,1,17,7,8,1,8,5,6,0,2,0,10,0,8,0,27,16,13,4,0,10,10,6,6,3,25,25,4,3,2,8,3,5,0,225,0,4,3,5,23,1,13,1,13,8,9,4,0,16,6,0,5,9,1,0,1,7,3,8,18,1,2,1,5,1,0,4,1,12,8,0,21,8,4,0,10,3,3,1,3,0,6,9,0,17,9,1,5,7,6,17,16,0,6,5,15,8,0,5,2,6,1,0,10,5,0,2,10,0,12,7,3,0,11,1,10,6,0,12,3,0,19,17,14,2,4,1,11,5,13,17,6,18,0,5,2,6,1,2,6,8,12,0,0,16,5,4,9,3,8,3,12,18,31,12,3,0,1,1,3,0,0,3,6,3,6,9,5,5,6,9,0,3,2,1,3,0,11,0,2,3,11,1,17,0,12,14,0,7,5,10,56,6,10,3,0,3,5,1,0,8,2,3,3,0,13,16,0,2,3,9,2,0,0,3,5,2,2,15,7,12,12,8,6,4,21,10,2,13,7,12,5,0,3,8,6,4,4,15,1,0,0,3,9,0,0,16,10,2,2,29,0,3,14,12,7,0,0,0,10,1,3,9,6,1,19,0,3,12,7,2,0,14,74,10,3,0,0,7,2,2,5,8,4,4,3,32,2,0,8,5,0,7,5,0,0,1,0,6,7,3,9,10,4,0,9,2,26,7,26,3,1,20,0,16,3,0,1,0,1,7,5,5,0,5,1,16,4,32,5,0,7,0,0,10,8,10,3,12,2,6,0,4,0,7,0,0,8,2,1,22,0,0,0,3,6,8,3,3,2,0,20,8,2,8,5,1,14,2,4,0,5,20,0,6,5,0,0,6,11,5,0,1,2,10,1,2,9,2,6,4,7,0,0,4,5,5,5,2,22,3,1,1,17,4,7,2,0,3,0,5,10,6,15,7,9,7,6,5,3,4,0,0,15,6,8,31,52,7,0,5,0,2,4,6,0,8,8,17,5,2,0,4,7,0,5,8,1,13,5,8,8,4,7,5,2,8,4,0,10,22,5,3,8,2,5,2,8,17,7,4,2,4,9,2,12,4,1,9,1,18,10,7,3,7,0,1,1,7,8,0,29,0,5,4,1,7,12,9,4,1,11,4,6,12,0,9,4,2,6,6,3,1,1,5,0,7,2,3,3,17,7,0,5,4,1,1,7,1,0,4,4,3,1,2,4,15,2,4,0,3,6,0,4,24,0,6,10,6,10,1,2,0,3,2,4,0,4,0,1,4,5,2,5,0,5,0,2,6,9,1,9,3,0,0,4,4,24,6,3,17,6,3,2,10,1,3,2,0,1,1,0,1,2,1,0,25,47,3,0,1,11,14,0,4,4,3,8,3,6,0,9,3,0,5,0,2,7,6,0,0,7,1,5,0,3,10,0,2,3,5,6,10,4,13,4,2,15,0,7,0,6,9,0,4,6,2,3,4,1,0,6,2,3,0,11,9,0,5,5,4,1,4,1,5,6,12,4,5,1,1,2,0,7,1,3,0,0,1,0,1,6,0,1,0,4,3,4,4,10,0,6,3,4,7,0,10,0,4,8,1,4,14,4,4,12,0,9,5,0,7,0,3,4,4,14,6,1,0,7,2,0,0,0,7,5,21,13,0,4,5,24,0,3,2,6,5,0,1,41,5,0,0,3,0,0,6,4,0,11,1,12,5,13,4,4,4,0,0,6,10,7,1,3,1,8,2,5,8,15,5,10,3,3,11,3,4,4,1,70,4,0,4,1,11,2,6,0,6,6,1,3,3,2,3,2,2,6,2,3,1,2,0,0,1,1,1,1,5,1,2,5,8,37,17,10,11,13,0,0,0,8,7,0,8,0,1,2,7,7,3,9,2,6,3,1,6,2,5,1,5,0,2,58,2,1,6,6,1,0,17,1,1,5,9,20,1,3,11,0,12,0,1,2,2,0,8,8,24,3,2,3,3,10,0,5,1,2,4,2,3,6,5,2,1,33,0,3,4,14,22,2,2,5,36,2,5,1,0,5,4,0,7,1,6,0,2,5,0,5,3,0,10,3,4,0,5,10,5,4,0,1,0,5,4,3,3,0,3,3,2,13,0,3,0,1,18,2,1,5,4,1,0,22,22,0,5,10,6,4,6,3,6,9,3,2,3,3,1,2,4,2,11,2,13,1,5,4,0,6,4,6,2,2,0,0,12,8,0,11,3,8,12,15,5,2,1,0,3,8,5,1,21,0,8,0,0,3,3,3,12,1,3,0,4,2,1,7,1,0,1,4,6,4,41,5,11,3,2,1,1,0,8,3,8,20,2,0,4,3,2,1,3,0,0,2,0,4,2,1,3,3,1,4,2,2,3,0,9,0,1,10,5,2,1,20,7,6,8,0,8,4,0,0,4,21,0,5,1,7,1,1,0,0,0,5,0,0,5,0,3,1,1,6,1,2,3,8,2,3,0,5,7,2,0,3,0,4,4,2,1,4,0,0,0,6,2,9,1,6,0,2,2,1,6,3,9,0,0,0,6,3,1,2,9,0,0,9,6,0,1,1,0,2,9,1,1,2,4,1,0,1,0,0,8,6,9,0,0,8,0,0,3,7,1,1,2,4,2,2,0,0,1,4,9,0,12,2,0,1,5,0,0,3,1,2,4,0,3,1,8,4,1,0,0,1,0,5,2,1,1,8,10,3,3,8,4,2,2,7,0,6,0,0,42,10,23,1,22,10,2,2,5,4,3,8,15,3,7,13,4,13,2,1,1,4,1,4,4,1,3,3,0,0,6,9,1,2,4,16,2,0,2,4,0,5,2,0,2,15,0,3,0,1,3,3,0,0,4,0,0,0,6,4,8,0,1,3,0,7,5,1,40,6,6,8,0,1,0,2,2,1,0,2,0,9,4,2,6,3,0,9,1,7,5,0,9,8,6,3,0,2,1,0,2,0,0,0,0,4,6,1,7,2,1,2,2,4,10,4,1,5,0,1,1,1,0,6,0,3,0,6,4,0,2,5,2,4,1,2,5,8,0,0,4,4,4,0,4,4,2,0,7,5,6,3,1,0,9,7,0,2,2,29,13,0,0,2,1,2,15,0,5,2,5,12,6,4,5,5,10,3,5,3,0,5,3,0,5,0,1,0,0,0,2,4,2,1,6,3,1,0,0,1,3,6,8,8,1,0,2,0,3,29,2,1,0,0,2,2,0,12,0,0,0,1,3,4,2,2,8,5,9,8,6,3,1,0,2,1,1,6,11,27,5,3,0,0,12,5,7,2,0,1,3,3,4,0,3,0,14,0,7,3,0,3,1,0,0,7,6,9,8,2,1,2,1,0,1,16,0,4,0,3,6,2,3,3,3,0,3,8,1,0,1,3,0,2,7,3,3,2,4,1,1,4,4,1,6,6,4,3,0,4,0,4,3,0,6,0,4,8,0,10,1,0,2,4,8,3,3,0,24,3,1,10,0,6,5,0,4,2,2,1,0,0,0,1,1,0,0,1,2,0,3,2,0,4,0,1,5,4,0,12,4,1,17,4,1,6,0,1,0,2,1,0,6,1,0,8,0,2,5,3,1,3,4,1,4,2,0,0,1,0,33,0,1,2,9,0,1,2,0,0,3,0,2,2,0,3,1,2,2,16,0,0,4,1,11,2,0,0,1,1,2,5,2,0,2,2,3,0,6,0,4,0,2,5,4,7,0,1,7,4,2,28,8,0,0,5,0,1,0,2,11,2,8,0,5,0,2,4,14,1,5,3,0,4,0,6,1,0,0,0,0,5,4,0,2,0,1,2,3,6,17,6,3,2,2,1,2,10,0,0,0,3,0,2,1,5,4,1,4,1,0,4,0,1,3,0,0,1,17,6,12,0,6,0,9,5,0,0,2,0,2,0,6,4,3,6,3,2,4,2,1,2,9,2,1,0,1,1,2,5,14,0,18,4,5,1,7,4,2,0,0,7,0,0,1,0,5,5,2,29,9,6,1,10,2,3,0,3,1,1,0,13,0,2,4,4,3,0,14,0,6,0,6,0,0,4,0,2,5,0,0,0,10,0,5,2,0,2,0,0,2,4,10,6,10,4,2,1,0,1,0,2,5,0,3,2,4,0,0,0,2,0,0,6,0,3,2,8,6,4,6,1,1,0,2,10,4,0,3,1,3,3,11,1,0,1,5,6,4,0,4,2,1,1,15,4,4,2,0,0,0,2,4,2,4,0,1,1,1,0,2,22,0,2,1,1,5,0,8,1,8,7,0,2,2,3,12,2,0,0,1,0,3,1,7,2,3,1,4,6,1,0,3,0,0,3,2,2,3,4,2,1,1,3,3,5,2,0,1,0,0,1,1,2,0,0,10,1,2,0,0,9,4,0,1,12,1,3,0,0,0,7,2,0,0,0,0,5,1,2,7,0,0,2,0,0,3,0,7,4,1,0,0,6,2,1,2,1,3,0,3,1,4,0,2,4,5,3,0,1,0,1,2,4,2,0,0,0,7,1,1,0,7,1,5,2,14,1,4,4,1,1,3,0,2,0,5,6,4,2,11,8,1,3,3,0,18,5,3,2,23,4,4,5,2,9,1,2,3,3,0,2,0,0,1,0,5,0,1,4,2,0,4,4,0,9,0,0,5,2,7,9,6,1,2,2,5,8,7,1,0,2,0,4,3,2,4,0,1,7,0,7,8,0,0,0,0,3,1,4,1,0,0,5,0,1,0,4,4,0,1,1,1,3,0,0,5,1,2,7,2,2,0,0,0,0,2,0,7,9,1,0,5,0,1,4,4,0,1,1,0,1,2,1,1,2,7,0,0,21,2,0,1,0,7,2,2,5,2,0,2,4,2,18,7,0,3,1,0,2,0,5,0,4,4,1,2,0,0,0,7,4,2,10,4,1,0,3,4,0,15,2,2,12,0,2,2,0,0,1,7,0,3,2,0,0,2,1,9,0,1,1,1,0,3,1,0,2,2,2,3,0,2,0,0,2,2,0,1,10,1,0,1,5,3,0,3,2,12,2,4,2,1,2,0,2,1,2,0,5,1,0,0,5,0,6,2,4,0,2,0,1,7,3,0,5,1,0,6,3,5,1,5,1,5,1,1,2,1,3,7,9,4,0,0,0,1,0,11,0,0,0,3,1,0,0,0,0,3,27,7,0,0,2,4,1,1,3,8,3,3,0,4,2,0,0,1,0,0,8,0,4,1,8,0,0,4,10,0,4,0,0,5,2,5,2,2,7,0,1,0,0,0,0,0,6,0,0,4,3,27,2,3,0,0,0,2,2,0,1,1,0,1,0,4,0,2,0,2,0,5,1,0,2,3,0,1,0,6,2,1,0,4,2,16,1,1,0,4,0,1,0,0,1,0,0,11,42,2,0,6,7,0,1,2,2,0,1,4,0,3,2,10,2,0,2,2,1,0,5,4,5,4,3,0,0,1,0,2,8,0,1,0,0,0,3,0,0,5,1,4,1,0,0,6,1,0,1,2,5,3,1,0,2,2,5,0,7,0,1,2,2,0,6,2,18,1,13,12,4,1,1,0,3,1,3,2,9,1,0,7,0,2,0,0,3,2,1,0,3,0,2,2,3,1,0,7,0,2,0,0,10,1,3,4,2,0,2,4,0,3,0,1,2,4,0,8,5,1,6,19,3,5,22,1,0,6,1,1,2,0,1,4,5,5,0,4,2,1,0,5,14,1,1,14,1,0,0,2,0,1,1,0,3,5,1,1,0,1,3,1,2,0,7,4,0,3,2,7,2,5,1,0,11,1,1,6,0,2,2,2,2,1,0,2,5,2,2,0,0,0,1,2,0,2,2,2,1,0,0,3,3,0,0,0,0,3,0,4,1,2,2,4,1,2,4,3,0,0,3,0,5,2,0,5,0,6,2,2,1,0,6,7,5,1,0,3,2,2,2,4,11,7,1,0,0,7,9,0,2,0,1,1,4,0,1,0,0,2,0,2,0,6,1,0,2,1,1,2,1,0,0,5,6,6,2,2,2,0,1,1,0,2,7,0,20,0,5,1,1,15,6,1,0,0,0,0,0,0,1,0,32,0,5,2,0,9,1,5,2,3,2,1,0,0,1,0,11,10,2,3,1,0,0,1,0,1,0,5,2,0,3,3,1,0,1,4,0,5,1,0,0,2,1,6,2,5,2,1,1,0,2,0,10,5,2,10,3,0,0,8,0,0,1,0,4,1,3,0,2,3,1,0,4,0,0,0,0,4,0,0,3,0,4,5,0,1,0,2,3,0,0,0,5,1,6,1,1,9,0,1,0,0,4,6,0,1,0,0,1,3,6,2,1,0,1,0,0,2,1,0,10,2,2,4,2,8,0,4,1,0,2,4,1,1,2,5,1,2,1,7,1,0,6,0,0,0,0,0,1,4,2,9,6,5,0,0,0,3,1,1,1,1,0,5,1,0,0,1,1,0,4,2,1,3,1,0,4,2,1,1,0,3,2,1,3,9,6,1,2,11,3,3,1,3,2,1,2,3,1,1,1,0,0,1,0,1,0,3,0,0,1,1,1,1,1,4,0,0,0,0,2,3,3,0,7,0,0,0,0,0,1,0,0,1,2,3,0,5,8,3,0,0,6,1,4,0,0,16,3,3,0,12,2,0,0,0,1,0,3,8,0,0,0,7,3,0,0,2,2,2,5,0,2,3,0,0,6,0,2,1,2,2,5,2,0,2,0,2,19,2,2,0,0,3,3,4,0,1,0,0,0,0,0,0,0,1,3,2,1,3,0,5,1,0,12,0,2,0,0,2,1,2,0,0,1,0,1,0,0,3,1,0,2,0,2,1,0,0,0,5,0,11,0,0,3,0,2,5,0,0,2,2,2,1,6,1,0,2,2,1,0,0,0,0,0,0,0,2,13,0,6,5,2,0,1,2,0,2,1,0,0,16,0,1,1,0,1,1,4,0,4,0,0,0,0,1,1,4,0,4,0,0,0,0,0,0,3,2,0,0,0,1,1,0,1,3,0,0,1,2,0,1,9,0,0,1,0,0,1,3,0,0,0,0,0,0,0,0,0,0,0,12,0,0,0,0,0,0,0,0,0,0,0,0,0,0,0,0,0,0,0,0,0,2,0,0,0,0,1,0,0,0,0,0,0,0,0,0,0,0,0,2,0,0,0
K52 Blaze,king,4398,2066,1558,1789,1236,302,2239,1153,1577,1083,626,1203,640,129,125,717,658,474,386,467,445,465,249,617,50,190,104,419,407,106,267,441,216,216,237,182,333,205,81,308,245,303,350,240,147,285,182,122,265,335,296,193,157,193,145,143,176,87,124,162,231,91,106,168,130,141,108,203,48,129,146,73,112,76,226,84,133,180,100,82,129,58,122,155,99,168,86,43,99,97,73,137,111,62,81,81,140,98,128,78,100,156,94,58,99,63,110,132,58,67,80,84,17,97,100,65,97,63,108,37,68,38,180,98,76,45,64,58,63,36,76,104,64,89,69,47,9,78,71,35,89,33,50,56,68,111,57,51,66,71,54,46,94,52,56,37,14,52,78,61,37,70,77,51,53,55,41,38,28,45,2,44,49,35,62,31,30,61,36,82,59,41,29,43,44,28,30,28,75,32,31,22,56,44,36,52,18,40,17,24,24,48,86,58,33,30,39,29,61,148,17,51,13,25,27,38,58,35,27,41,31,37,37,40,42,43,17,42,24,31,26,51,38,43,24,1,32,31,18,23,10,2,40,26,37,54,45,48,45,46,30,25,21,42,42,31,16,31,29,18,48,29,41,48,37,8,28,8,41,34,34,23,15,31,39,16,16,19,40,27,57,31,28,19,59,14,23,47,15,29,41,6,23,28,28,24,33,19,3,29,49,19,47,33,114,15,56,22,17,8,18,4,16,22,12,24,24,41,30,21,16,29,27,45,1,40,13,21,22,31,49,9,37,35,76,40,35,7,7,14,23,19,14,21,12,15,25,56,31,20,31,20,22,27,33,6,18,29,18,16,26,25,6,7,11,24,21,23,11,16,20,19,23,25,35,36,4,15,53,3,24,26,24,16,7,40,0,19,20,29,20,20,13,47,22,26,22,20,21,15,21,20,29,12,21,10,19,18,12,15,47,14,52,21,15,8,4,34,8,8,19,8,6,5,8,15,15,13,7,11,22,32,11,17,1,23,22,10,0,28,15,10,9,20,13,21,14,10,15,18,20,9,11,30,11,17,16,22,12,31,15,5,0,10,7,22,20,14,4,17,10,10,9,35,22,14,14,11,0,27,8,14,25,19,8,31,9,15,15,9,15,16,21,6,10,9,8,54,5,12,37,10,11,8,6,3,17,17,35,16,20,27,4,25,11,8,0,10,16,31,17,18,18,17,11,11,19,5,25,13,114,11,18,1,7,2,17,18,7,17,34,11,12,15,32,7,0,2,10,28,10,6,14,19,12,5,7,6,10,7,21,21,9,22,6,15,18,12,126,8,19,9,15,22,19,20,21,7,5,13,24,10,8,16,3,18,7,19,11,14,14,17,8,20,16,5,3,11,4,15,20,27,15,3,11,0,21,15,4,3,8,3,10,12,2,12,26,3,4,13,14,16,4,15,21,23,8,28,10,12,20,12,11,73,6,0,15,10,19,15,12,4,13,1,13,25,13,14,6,16,0,11,11,6,7,7,3,7,7,5,4,11,13,2,8,11,9,9,20,6,7,12,4,3,7,15,2,13,6,2,13,9,4,11,15,7,1,8,11,8,7,8,4,23,16,21,5,1,4,14,3,8,22,11,9,4,0,7,10,18,20,8,9,8,7,83,7,12,10,11,8,25,26,0,11,15,35,3,7,14,8,6,1,1,0,9,10,6,13,7,19,16,2,15,2,0,13,6,7,8,12,9,14,6,2,14,7,3,4,3,14,10,12,19,6,21,5,9,4,7,10,5,32,12,0,9,8,2,37,9,8,2,1,11,10,10,9,16,9,4,26,9,1,11,14,16,13,11,15,7,8,4,6,9,4,6,21,3,0,22,5,4,12,4,9,6,4,0,7,13,16,6,4,15,19,12,6,11,15,15,6,1,19,12,1,11,8,8,0,3,15,4,5,16,20,7,0,0,8,6,3,11,3,0,4,7,0,1,3,7,7,2,10,6,3,9,5,0,17,13,12,9,12,44,0,6,1,16,0,8,10,4,2,8,7,14,15,8,6,7,11,8,14,6,9,5,5,0,3,9,6,0,13,3,2,16,7,6,14,2,6,0,7,0,5,13,7,4,11,17,12,0,7,5,10,5,2,1,10,9,18,7,12,24,2,8,2,19,19,4,4,11,10,4,8,4,1,2,6,11,5,22,9,16,6,7,5,6,1,4,0,6,3,0,4,6,2,1,2,4,0,156,4,10,2,9,7,6,4,0,2,19,14,1,6,24,6,0,2,32,2,1,5,10,9,11,0,2,9,0,2,1,3,0,3,9,0,0,2,16,4,11,0,103,19,5,13,0,0,5,2,4,16,6,0,0,8,9,23,9,20,9,14,1,7,13,5,3,4,5,9,2,3,1,13,8,15,5,19,3,4,15,2,4,2,0,16,12,3,5,1,7,0,2,5,3,13,1,0,0,0,9,5,7,7,4,3,0,4,19,2,3,7,5,4,2,3,4,2,7,1,0,5,6,3,6,5,3,20,1,6,6,6,7,5,13,6,5,2,5,2,9,9,2,0,0,1,9,14,10,8,17,13,8,6,0,15,15,22,7,11,7,5,3,17,14,9,7,1,14,2,3,5,10,2,4,6,3,5,0,8,3,5,0,4,7,2,7,2,6,3,3,3,24,0,4,0,4,0,0,5,8,7,3,4,7,5,1,5,0,17,4,11,5,13,16,0,1,5,0,5,3,0,3,0,7,2,5,0,4,8,0,3,5,12,5,1,1,13,4,0,6,11,6,5,0,0,4,5,3,13,8,3,2,15,7,1,8,4,6,2,1,1,4,5,0,2,3,3,6,8,4,7,1,0,4,1,1,4,0,3,2,13,1,1,3,7,4,0,3,7,0,2,7,2,4,1,1,13,8,2,2,17,8,0,0,4,4,0,2,9,20,7,5,3,7,8,3,6,9,0,9,3,1,9,1,4,5,1,5,6,4,3,4,3,1,3,2,10,2,6,3,2,6,2,7,12,17,12,5,9,8,0,1,8,4,4,11,0,3,4,3,3,0,6,8,9,5,2,4,6,31,8,0,3,9,12,7,3,17,7,1,1,5,8,0,1,6,0,2,0,8,3,1,12,2,2,0,8,0,5,4,4,12,14,0,0,14,0,15,0,0,4,28,8,3,1,7,6,3,8,25,4,0,2,12,1,0,1,1,0,0,0,8,0,2,1,0,2,2,2,6,13,6,0,1,9,3,0,5,5,8,0,0,6,4,3,10,3,7,2,2,0,0,6,10,1,2,12,4,6,3,2,7,0,10,12,22,3,1,6,8,0,12,1,0,1,5,9,4,4,2,2,0,2,4,14,0,7,2,2,0,2,3,0,0,9,14,2,9,1,8,5,8,1,1,3,14,1,4,5,11,0,1,4,0,0,0,4,1,3,0,0,0,0,13,0,4,8,5,0,2,1,5,6,6,6,0,1,4,3,10,5,6,5,1,7,4,1,5,1,3,6,2,6,1,5,0,3,3,11,5,2,3,9,6,7,0,4,0,5,7,8,2,3,2,0,1,3,8,0,5,5,0,8,0,3,4,1,3,4,7,4,0,1,1,12,0,1,8,0,8,5,2,3,0,3,0,1,7,0,19,13,475,1,2,2,0,4,5,1,1,0,5,2,1,2,6,5,2,2,8,2,0,4,3,0,1,1,4,2,10,15,0,1,2,1,2,0,0,3,1,2,1,1,13,5,1,1,4,0,0,7,7,0,2,2,1,3,3,7,3,3,0,1,1,1,6,1,2,13,6,4,2,4,1,4,0,1,20,3,0,2,2,1,1,3,2,4,6,10,2,9,2,14,0,0,2,5,4,2,0,4,0,0,7,6,0,10,2,7,1,6,3,0,4,2,6,6,0,0,1,6,8,3,2,0,4,0,9,3,3,4,0,6,0,8,20,3,3,1,16,6,0,3,3,5,2,11,7,4,3,7,7,0,3,4,0,3,5,2,3,1,5,0,1,0,8,0,4,0,9,4,5,1,2,3,7,1,1,0,2,0,6,3,0,5,1,3,1,4,4,1,0,3,3,2,0,1,0,1,5,0,4,5,1,2,0,8,7,2,1,1,0,3,3,1,1,1,0,3,4,7,2,5,5,2,0,3,4,3,3,0,0,4,0,0,1,0,0,2,18,3,4,0,1,4,2,0,1,0,3,0,2,2,1,8,4,4,0,4,7,4,2,2,0,13,1,2,3,4,0,0,1,2,0,0,1,0,7,0,1,1,5,22,5,3,2,10,13,0,1,1,0,2,4,4,2,0,8,16,3,0,0,1,0,4,0,0,0,0,0,2,5,0,1,0,0,0,1,0,6,3,1,11,0,4,1,3,0,27,0,0,6,3,1,3,4,2,2,1,1,0,1,2,0,4,3,0,3,1,0,0,0,0,1,5,4,7,1,4,3,5,4,0,0,0,0,0,6,3,1,3,17,4,0,7,4,4,4,8,0,0,0,3,3,0,11,0,4,1,4,4,5,7,3,8,0,0,0,1,3,1,1,0,6,8,0,1,1,2,0,4,3,1,1,0,11,2,2,3,2,0,2,1,4,1,0,2,1,1,8,1,3,4,0,4,1,6,0,7,0,1,2,3,0,2,1,1,1,18,3,0,0,1,0,3,1,8,10,19,3,5,1,3,6,2,8,1,3,2,2,0,0,1,6,0,1,11,10,0,0,0,2,0,0,0,5,2,1,10,2,5,3,1,11,1,0,0,2,2,1,2,3,0,6,0,3,3,6,0,0,6,1,2,0,0,0,1,1,0,0,8,3,3,2,0,9,0,0,10,0,1,1,0,0,0,0,2,2,4,1,1,3,0,2,10,4,6,2,0,7,2,0,4,4,1,0,0,1,2,0,0,0,4,0,5,0,9,3,0,9,0,0,9,2,7,1,0,5,1,2,3,0,1,0,0,1,0,1,0,0,0,0,2,1,9,1,1,0,0,5,4,0,11,10,5,3,5,1,0,2,2,1,4,3,0,0,1,3,0,8,0,4,1,0,0,4,0,3,4,2,0,0,0,4,0,2,7,2,2,0,1,1,6,2,4,0,1,0,1,3,4,1,0,2,7,14,9,1,2,0,0,2,5,4,1,5,1,2,1,2,0,0,4,3,0,2,0,1,1,0,0,1,1,0,4,1,5,2,1,9,2,3,1,1,1,3,3,9,2,4,2,2,0,0,4,0,1,4,1,0,3,2,5,0,0,1,2,0,1,0,0,2,5,1,3,0,1,0,0,6,0,3,1,9,3,1,3,1,0,12,5,4,1,0,0,2,6,0,0,2,2,0,2,2,0,8,6,7,6,1,2,0,0,2,1,1,1,3,1,3,2,2,2,8,2,6,4,0,3,0,1,4,0,0,2,10,2,1,0,1,4,1,2,0,1,2,0,2,1,0,0,3,3,4,0,2,0,3,1,2,0,0,0,7,1,2,2,0,0,1,0,1,2,0,0,2,0,0,0,0,4,4,0,0,0,2,2,0,3,0,4,3,1,0,9,0,0,1,0,2,6,1,0,0,4,2,7,3,2,0,0,7,0,0,3,1,8,3,3,3,1,8,0,3,2,36,0,16,0,6,2,6,1,0,2,1,1,0,5,6,7,3,0,2,7,0,1,1,0,0,1,3,3,0,2,4,0,0,0,1,0,3,0,1,0,0,2,0,0,0,0,0,0,1,2,5,2,2,1,1,0,4,2,1,2,3,3,2,1,0,3,3,4,1,2,2,2,0,1,0,1,2,0,4,1,0,0,8,1,3,0,1,0,11,1,0,0,0,1,1,4,3,3,1,1,2,1,3,0,0,0,6,0,0,3,1,0,2,0,1,0,0,2,2,1,0,0,5,5,0,1,1,1,1,3,0,0,1,1,2,2,1,1,1,5,2,3,2,2,0,3,1,3,2,3,18,1,5,0,2,0,0,0,1,0,4,1,0,0,0,0,6,2,2,5,0,0,3,0,25,2,1,0,12,1,3,0,0,2,2,12,5,3,3,2,1,2,4,1,4,3,4,3,1,3,3,1,8,8,0,1,1,1,1,4,0,1,0,4,1,0,4,1,2,0,2,3,1,0,0,2,1,0,0,0,5,1,1,0,1,2,6,2,3,0,1,1,0,0,0,4,1,2,1,0,0,2,0,3,1,2,4,1,1,1,0,0,5,0,0,0,2,1,0,0,1,3,2,0,0,3,1,2,0,4,3,1,3,0,0,0,1,2,1,0,0,10,0,0,0,0,2,0,1,0,3,0,11,1,2,0,14,1,0,13,1,0,1,2,0,8,0,1,0,0,0,3,2,1,1,5,0,1,2,2,5,0,0,0,0,1,0,0,0,3,3,0,3,2,0,0,2,3,1,1,0,3,5,1,7,1,0,4,0,0,1,2,0,2,1,0,0,7,0,3,1,0,0,0,2,0,2,1,3,0,0,4,0,0,0,0,0,5,7,3,2,0,3,5,5,3,1,0,1,0,1,4,1,0,4,1,5,0,1,0,0,3,0,1,4,2,0,1,1,0,1,1,0,3,0,0,0,1,1,0,1,11,2,0,1,0,0,0,5,0,0,0,0,2,1,0,1,0,1,0,1,1,1,0,2,8,2,0,1,4,0,1,1,2,3,2,1,0,2,0,3,1,2,0,3,3,0,0,14,0,0,2,0,0,2,0,19,0,0,0,1,0,0,1,0,0,0,1,0,0,20,0,8,0,0,3,1,0,1,2,1,0,8,0,0,0,0,0,2,0,0,0,1,0,0,0,1,2,3,2,0,0,1,0,0,0,0,2,0,1,0,0,4,3,3,0,1,0,0,0,2,0,0,0,1,1,2,2,2,0,2,0,2,0,0,0,1,7,1,1,1,0,0,0,1,3,1,1,2,0,4,2,1,6,3,2,0,2,1,0,2,11,1,2,0,0,0,5,1,4,0,0,1,0,0,1,3,0,1,2,1,5,6,0,3,0,0,2,1,0,0,5,4,0,0,3,2,0,0,0,0,0,3,2,1,1,2,2,0,0,1,1,1,0,2,0,1,0,0,1,0,3,1,0,1,3,2,2,1,10,0,5,1,0,1,0,2,2,1,2,0,0,0,2,0,0,3,1,2,2,2,0,2,1,2,2,0,0,4,0,5,1,1,0,0,3,0,2,1,3,4,2,1,0,2,0,1,0,1,2,0,3,4,5,0,3,2,4,9,1,0,1,4,2,0,0,2,0,0,0,4,1,1,2,0,3,2,1,3,2,2,0,4,0,2,2,0,2,1,8,0,1,0,2,1,0,0,0,1,1,0,5,1,1,0,3,1,1,10,0,4,0,0,1,0,5,3,0,1,0,1,2,0,0,2,0,0,0,3,7,1,1,2,5,0,2,5,2,0,0,0,1,4,1,0,5,0,3,1,0,1,6,2,0,0,1,4,0,0,2,2,4,0,0,0,1,9,0,1,1,0,1,0,3,4,1,0,1,2,0,0,0,2,0,1,0,5,0,2,0,44,1,0,0,1,1,0,0,0,0,2,4,4,2,1,0,0,0,0,0,0,1,3,2,0,0,6,0,1,0,0,1,5,2,0,0,0,0,0,3,3,3,0,1,0,1,1,0,1,2,1,1,0,2,1,0,1,4,0,0,3,0,0,4,5,0,1,1,3,1,1,2,0,1,0,0,0,1,5,0,0,4,6,1,0,1,0,2,1,0,1,0,0,0,0,0,1,1,6,3,2,0,7,3,0,1,3,0,0,1,3,0,0,1,1,0,0,2,4,1,0,2,2,0,0,0,0,0,0,0,1,3,0,0,0,0,0,0,1,1,0,2,0,0,0,2,0,0,0,4,0,0,1,1,3,3,4,0,0,6,1,0,0,6,2,1,0,2,1,2,0,3,0,0,0,2,3,1,1,0,6,0,0,0,0,0,1,1,0,3,0,0,0,0,3,0,1,2,0,2,0,1,3,2,6,1,0,0,0,2,0,1,4,3,3,1,1,1,2,0,0,1,0,0,0,0,7,2,0,33,0,1,1,0,0,0,0,2,3,2,0,4,4,0,1,1,1,1,3,1,0,1,0,1,3,0,3,2,0,1,1,0,0,3,3,0,0,0,0,0,0,1,0,1,1,0,1,4,3,0,3,2,0,0,0,0,0,0,1,0,0,1,7,1,1,1,0,3,1,0,0,2,1,1,0,2,3,0,1,3,0,7,0,0,1,0,0,0,3,0,2,8,1,0,0,0,1,0,1,4,1,2,1,0,1,0,1,2,0,0,1,1,1,2,1,3,1,11,0,0,0,1,3,1,0,0,0,1,1,3,0,0,1,4,1,2,0,2,2,4,0,3,3,1,4,0,0,0,0,3,0,1,2,1,0,4,0,1,11,0,1,0,0,3,0,2,1,2,2,3,2,36,0,1,0,0,0,1,0,0,1,4,2,2,0,1,1,0,1,1,0,0,1,1,0,2,0,1,1,0,0,0,0,0,1,1,1,2,0,0,0,1,0,1,0,5,2,0,0,1,0,0,2,0,2,0,0,1,2,1,0,0,0,0,2,0,0,1,0,0,0,0,0,2,0,7,0,3,0,10,1,1,0,1,2,3,0,0,1,2,3,0,0,0,2,1,0,1,0,0,0,2,0,0,1,0,3,1,0,1,1,0,1,0,0,2,3,0,0,0,0,1,0,1,1,1,0,4,3,0,0,1,0,0,0,0,4,3,0,0,0,3,0,0,3,2,15,0,0,1,0,0,0,10,0,1,1,0,0,1,1,0,0,0,1,1,0,1,0,0,5,1,1,0,0,0,1,1,1,0,0,1,5,0,0,0,1,0,1,0,2,0,0,1,3,0,1,0,0,0,1,0,1,2,0,3,0,0,0,0,2,0,1,0,1,0,1,0,1,0,1,0,0,1,0,1,3,0,1,0,0,1,4,0,0,0,2,1,1,0,1,4,0,0,2,0,1,0,1,0,0,1,0,0,0,1,0,2,1,2,1,1,0,1,1,0,1,0,0,0,5,1,2,0,1,0,0,2,0,1,2,0,0,0,2,0,0,1,1,0,0,0,2,0,0,6,0,0,1,3,1,0,0,2,2,1,2,0,3,1,0,0,0,0,0,6,0,0,0,0,3,0,0,0,0,0,7,1,0,1,0,1,0,1,1,4,3,1,0,0,1,0,0,3,1,2,1,1,0,2,1,2,1,1,2,0,1,1,0,1,1,1,4,0,0,6,1,1,1,0,0,3,0,0,0,0,3,0,7,0,1,0,1,1,2,3,2,0,0,2,0,1,23,0,1,1,16,2,0,1,0,2,0,0,3,3,0,1,0,1,42,0,0,0,0,0,1,0,0,0,0,0,0,2,0,0,0,3,0,1,2,0,1,0,1,0,1,0,0,0,1,0,3,0,2,2,1,2,0,0,0,0,0,0,2,0,6,1,0,1,0,0,0,0,0,1,0,6,3,0,5,0,0,2,0,1,0,1,0,2,2,0,0,1,1,2,0,0,0,0,1,0,0,0,1,1,0,5,3,0,1,0,2,0,1,0,1,0,0,3,0,1,0,4,0,0,1,2,1,3,1,0,0,0,2,0,0,0,0,1,2,0,5,0,0,4,0,0,0,0,2,1,0,0,0,1,0,5,0,0,0,0,4,0,0,0,0,0,1,1,0,0,4,0,1,0,0,2,0,6,1,0,2,1,3,0,0,0,0,1,0,0,1,1,1,0,0,2,2,0,1,1,1,6,1,0,0,0,1,0,0,10,0,1,2,0,0,0,0,1,2,1,0,2,2,0,0,0,1,1,0,0,6,3,0,2,1,2,0,0,0,1,0,0,4,1,0,1,1,0,0,0,2,1,0,0,1,0,0,0,4,3,2,0,0,0,0,2,1,1,0,1,0,1,0,3,1,3,1,0,5,7,0,0,0,0,1,1,0,3,0,0,0,0,1,3,1,0,0,1,0,2,0,0,0,0,0,1,0,0,1,0,0,1,0,3,1,2,0,6,3,1,1,1,1,0,0,0,1,1,0,0,2,0,2,1,0,5,0,0,1,0,1,0,1,3,2,0,1,5,0,0,1,1,0,0,1,0,0,1,0,1,1,0,0,4,1,1,0,3,2,0,2,0,0,0,0,0,0,3,3,0,0,2,0,0,1,0,0,1,4,0,1,0,0,1,0,1,0,1,0,0,0,3,0,0,0,0,0,0,1,0,0,3,1,0,0,2,2,2,0,0,4,0,1,2,0,2,0,1,0,0,0,0,0,2,1,0,0,0,4,0,5,0,1,0,0,0,0,0,0,5,0,3,0,0,0,0,1,0,1,0,1,1,3,0,0,0,3,1,2,1,0,1,0,0,0,0,0,0,4,0,0,0,3,3,0,0,0,0,0,0,1,2,0,1,0,1,0,0,1,2,3,0,0,3,4,0,0,0,2,1,2,0,0,0,0,0,2,2,0,4,0,0,3,2,2,0,0,0,0,2,1,0,0,2,0,0,0,0,1,2,2,1,0,2,0,0,0,0,0,0,0,0,0,1,2,2,0,0,3,0,2,0,0,0,0,0,0,0,0,0,0,0,0,1,1,0,0,0,1,0,4,0,3,0,0,1,0,0,1,0,0,1,2,0,1,0,1,1,4,2,2,0,1,0,1,0,2,0,1,0,0,0,1,0,0,0,1,0,0,1,0,4,0,0,0,0,1,1,0,0,0,1,0,1,0,0,1,0,1,0,1,4,0,0,6,1,1,2,1,2,2,0,1,0,2,0,1,1,0,0,1,0,0,0,3,0,0,0,0,0,2,0,0,0,1,0,2,2,2,0,0,0,0,0,1,2,0,0,0,5,0,0,0,3,2,1,0,0,0,2,1,0,0,0,1,0,0,0,1,0,0,0,2,2,0,1,0,0,0,0,0,0,1,2,0,0,0,1,0,0,0,1,2,0,1,4,0,0,0,0,4,0,0,0,0,0,0,0,0,0,0,0,0,0,0,0,0,0,0,2,2,1,0,2,1,1,0,0,1,0,0,3,2,0,0,0,1,1,0,0,0,0,2,2,1,0,0,4,0,1,0,1,1,0,1,0,0,0,0,0,0,0,0,3,0,0,0,0,1,0,0,0,0,2,0,0,0,0,0,0,0,1,0,0,0,2,0,0,0,0,0,0,0,0,0,2,0,1,0,1,0,0,0,15,0,1,0,6,0,0,0,22,0,0,0,0,0,0,0,5,0,2,0,0,0,0,0,0,0,1,1,0,0,0,6,2,0,0,0,0,0,0,0,0,0,0,0,0,0,0,0
K53 Duma Key,king,10926,5678,4765,4739,4184,7474,1655,3018,3976,3601,2357,1125,2508,1698,1736,1839,1604,1407,1277,1506,1424,1831,917,552,2305,858,1425,561,864,811,758,884,941,764,774,865,716,774,469,1040,820,778,845,754,511,703,524,574,515,858,691,464,561,420,513,391,647,528,659,551,498,483,344,426,504,423,213,327,396,448,320,428,360,369,288,397,277,468,276,260,302,422,208,544,307,399,248,327,336,271,271,283,380,210,453,225,246,256,319,221,227,541,291,278,432,210,403,330,268,315,281,242,160,265,309,92,192,194,224,132,265,192,215,261,171,207,246,251,186,231,202,247,273,185,291,192,132,202,219,174,183,168,54,195,350,203,164,246,192,296,181,208,193,137,164,85,129,101,170,43,125,180,259,244,109,235,150,129,163,204,374,94,212,152,54,110,167,118,181,232,124,164,207,108,106,92,95,89,191,84,104,91,151,124,104,129,55,128,95,58,134,155,201,182,74,66,99,120,124,261,41,98,15,82,131,63,98,94,117,78,99,135,145,70,156,126,92,132,108,181,119,60,103,166,101,87,112,78,90,83,71,83,90,78,69,90,89,152,64,141,133,200,73,46,110,86,113,66,125,107,186,61,72,102,159,79,81,109,97,100,106,97,165,66,81,86,89,70,105,116,73,108,94,141,193,24,72,67,63,53,47,108,92,63,88,92,81,92,120,90,121,49,117,63,127,90,19,154,32,74,72,173,67,89,59,74,52,172,78,50,84,148,42,35,51,58,90,65,49,47,110,89,71,70,79,87,64,22,72,95,45,33,46,27,64,47,68,71,57,64,116,14,108,47,98,61,50,111,47,53,67,79,88,12,72,69,59,33,59,48,47,26,53,65,41,84,28,45,120,65,61,193,42,68,31,14,0,70,53,100,31,67,59,61,53,90,52,55,81,73,22,63,52,63,57,58,39,74,61,78,30,27,56,15,57,38,35,67,35,54,83,8,99,49,30,73,31,86,56,59,95,56,72,56,8,23,35,56,34,70,38,45,25,73,48,57,29,44,31,89,67,22,36,121,60,93,50,39,20,41,97,10,2,11,23,32,86,33,9,27,23,33,47,29,53,47,25,24,0,47,38,57,41,40,46,43,34,27,55,29,69,36,83,23,42,19,36,57,9,32,39,38,20,21,65,32,22,61,34,31,35,65,18,33,62,47,0,30,80,45,101,33,69,42,27,32,56,51,58,60,81,42,46,46,36,85,45,68,15,40,43,25,99,28,50,54,0,19,42,54,27,52,34,3,42,43,37,55,31,11,31,45,32,15,47,52,30,11,26,25,9,31,40,35,24,24,23,29,37,42,41,51,41,35,473,39,20,46,63,15,33,34,18,30,25,31,14,16,23,28,39,61,80,27,26,0,0,44,34,42,19,30,72,24,10,27,35,19,27,22,9,23,16,40,28,56,52,47,56,13,17,56,15,11,27,9,58,35,48,44,37,20,26,13,20,65,46,26,24,26,0,22,66,51,35,27,17,6,29,22,28,25,51,21,32,39,41,45,19,27,63,41,29,28,15,19,18,31,32,20,23,23,27,14,35,20,21,26,26,27,34,17,6,39,32,24,10,4,30,16,57,8,29,20,56,18,79,24,27,24,8,39,4,21,20,30,17,39,41,17,12,15,47,24,17,30,26,9,3,31,50,12,17,14,0,41,29,14,30,21,44,165,6,20,3,22,5,30,33,18,9,5,18,20,8,45,29,16,19,10,45,13,26,22,17,11,26,15,13,34,35,26,16,44,0,20,11,26,88,35,20,12,5,26,30,35,19,25,14,22,28,17,20,27,8,14,0,25,2,19,19,36,22,31,24,9,106,25,10,19,19,16,27,6,27,30,4,1,17,8,21,9,8,23,35,29,40,17,23,31,37,14,4,25,0,25,24,18,9,43,36,25,28,20,44,13,20,0,10,19,33,30,127,13,8,13,19,9,3,36,24,6,20,28,36,50,13,0,30,49,36,25,31,9,2,12,3,36,27,21,33,19,20,36,3,20,35,13,9,31,24,5,2,11,28,18,14,23,9,37,30,10,14,14,36,31,24,10,19,38,24,0,36,0,13,17,15,21,60,7,24,20,10,26,18,64,8,1,37,14,44,38,17,0,7,29,18,23,26,29,25,69,4,9,14,11,9,8,17,23,24,18,33,3,11,23,12,23,23,10,0,29,22,4,30,48,9,11,10,31,29,5,27,12,8,27,12,30,12,6,2,77,19,3,10,34,29,0,17,9,8,13,25,28,21,29,5,30,26,0,13,1,24,0,14,54,0,0,6,22,14,14,3,6,7,7,29,1,38,32,7,17,5,2,7,5,25,2,29,19,16,176,21,13,27,9,22,6,24,27,15,17,16,10,41,16,21,3,15,37,26,12,12,3,8,0,14,17,22,18,6,43,0,9,17,13,14,11,0,0,0,4,18,23,11,20,4,0,9,19,19,32,16,10,5,16,2,31,14,4,47,0,18,18,6,12,36,8,26,11,8,21,9,15,9,14,28,14,21,15,19,18,5,32,0,1,3,18,30,5,26,53,5,12,15,11,21,36,1,1,7,19,32,1,7,34,22,8,17,17,27,19,7,14,7,19,62,4,16,4,14,0,7,19,19,5,2,24,11,8,5,7,4,18,1,19,2,28,0,0,1,17,9,53,19,38,0,5,12,0,16,7,11,13,12,18,1,6,13,0,18,18,18,18,11,149,16,21,14,22,32,0,13,12,25,3,1,5,17,15,0,2,22,5,8,0,0,13,14,10,22,13,9,7,34,17,29,21,5,19,14,11,6,17,7,0,4,4,11,21,5,4,11,0,4,10,0,5,8,14,1,13,14,6,40,25,19,64,4,13,23,0,14,16,0,13,18,41,12,9,6,7,6,6,0,28,33,18,0,34,8,31,19,12,23,29,33,7,14,133,0,29,12,35,1,17,4,11,2,22,21,9,23,10,11,29,2,3,7,9,7,0,3,15,8,17,17,39,19,9,27,8,12,0,6,13,13,4,0,7,0,11,11,10,33,22,9,24,5,18,14,24,9,2,12,22,23,8,13,3,10,11,15,40,16,5,11,19,12,26,9,14,18,0,29,10,15,5,7,17,1,10,21,7,15,0,0,35,0,1,1,0,18,40,9,18,3,14,12,13,20,21,11,22,17,16,14,0,13,2,0,1,0,9,1,8,120,0,24,13,16,22,16,22,3,4,10,7,10,22,31,10,9,8,12,11,3,0,8,24,25,10,0,0,4,21,3,3,11,9,18,4,4,12,0,20,5,16,10,10,16,20,0,12,21,0,16,6,15,4,7,6,14,0,2,24,25,0,16,12,22,18,9,13,0,0,34,10,6,5,19,6,14,11,6,10,40,17,3,15,8,16,9,7,7,2,1,3,5,7,17,0,1,0,0,12,0,7,22,24,10,5,6,11,14,15,6,0,1,1,8,11,12,14,24,25,15,23,1,36,9,7,7,9,8,1,10,9,21,9,22,7,13,12,11,15,5,0,3,6,10,32,6,16,74,6,3,4,13,6,41,24,8,3,13,6,0,9,11,12,14,12,9,0,12,20,22,1,17,5,2,16,15,10,22,14,14,6,3,10,0,31,14,9,7,18,21,0,17,24,0,1,0,10,4,14,8,14,40,8,11,15,3,1,13,4,0,13,2,48,4,14,27,0,8,16,3,12,2,8,11,1,3,1,11,1,8,10,5,21,9,0,10,12,0,0,2,9,8,1,7,40,16,61,10,9,3,11,16,4,10,25,6,3,28,3,7,0,14,12,10,35,30,10,6,17,0,12,3,12,26,12,23,3,18,0,2,9,8,5,5,0,13,10,0,4,13,0,17,6,17,2,12,4,2,3,8,7,7,7,7,14,16,16,6,10,5,3,0,11,3,9,18,9,4,1,15,2,18,23,6,40,19,0,8,26,7,1,25,2,6,5,16,18,0,10,5,2,16,3,4,10,5,6,2,10,0,13,12,21,7,14,5,6,14,7,11,4,13,0,7,2,8,9,19,2,5,5,0,3,47,4,12,19,1,8,5,5,12,12,23,14,1,20,5,0,6,10,12,28,3,6,3,5,6,3,15,5,5,1,10,9,19,1,12,14,3,0,15,8,20,10,0,0,8,16,0,110,0,0,0,19,87,10,0,8,5,3,0,12,4,17,0,14,11,11,28,12,25,0,11,16,3,12,9,12,25,9,2,4,7,8,3,1,117,20,4,5,7,18,0,10,4,10,9,14,2,6,16,3,0,2,24,7,1,5,9,8,4,27,10,10,0,22,1,1,8,2,3,2,0,25,12,10,0,8,1,1,101,7,0,11,1,0,11,9,4,5,6,10,15,1,1,9,2,10,18,2,8,2,5,1,0,5,4,0,3,5,0,24,0,2,0,10,0,6,1,12,3,5,4,3,18,13,15,5,0,10,3,19,9,7,3,8,13,6,7,33,1,11,9,11,0,0,5,5,3,24,4,7,2,10,10,30,10,10,5,4,5,3,2,2,7,2,2,12,7,3,9,8,5,0,12,6,4,8,3,14,5,9,5,3,11,9,6,8,15,2,7,6,5,6,11,4,3,0,60,9,5,0,2,3,8,9,0,16,9,4,11,6,24,4,1,0,1,10,3,4,25,10,2,6,5,2,5,19,7,13,11,5,12,10,3,5,5,21,2,7,14,2,0,2,25,12,0,0,14,8,3,0,12,2,7,13,9,7,0,0,0,11,39,5,1,6,1,20,0,4,13,12,2,0,3,24,2,6,0,2,10,10,7,4,5,3,4,3,3,2,0,0,10,0,13,23,0,0,2,2,4,10,13,7,31,4,0,5,10,15,20,7,1,5,13,0,24,7,1,5,0,8,4,9,0,164,8,0,11,6,24,7,0,9,2,3,7,7,9,7,21,7,10,2,3,2,6,0,0,6,15,0,18,0,0,13,10,7,5,5,2,7,1,22,4,4,5,2,2,13,3,4,2,2,2,2,23,1,0,0,8,22,3,10,6,7,10,0,9,9,2,14,11,6,3,0,0,7,7,5,5,9,3,2,4,14,5,14,2,0,3,0,9,6,8,3,1,7,19,3,5,3,5,6,6,15,6,50,4,4,9,1,2,4,9,6,2,6,9,9,7,0,3,0,4,0,2,0,9,5,10,1,11,8,10,13,4,5,18,8,3,6,1,20,12,7,4,8,1,7,23,10,8,8,2,3,1,13,3,10,3,4,5,25,6,2,5,3,4,0,7,3,1,7,1,7,8,1,6,16,14,2,5,29,8,10,1,0,5,5,3,5,10,5,11,18,2,0,6,5,4,2,15,7,1,16,1,2,4,6,0,2,2,5,6,4,6,7,13,2,1,1,9,0,2,7,1,0,10,8,8,15,3,9,5,4,3,0,2,2,2,5,4,5,3,8,2,15,4,0,2,18,0,5,4,0,9,5,8,26,7,9,7,3,3,8,19,0,2,2,0,1,6,1,2,1,11,0,3,11,19,0,2,4,13,4,4,3,12,7,11,1,0,2,6,0,5,0,5,4,10,2,1,19,0,5,0,2,5,2,8,1,9,10,7,2,0,11,22,5,7,0,0,10,11,0,3,5,1,2,4,7,0,1,9,18,0,7,13,0,10,2,12,0,9,4,3,0,9,3,2,7,0,0,0,11,2,3,0,0,5,0,8,9,0,0,0,6,1,4,4,9,2,18,3,2,6,2,13,8,2,8,4,2,10,6,6,1,8,9,1,20,4,0,0,4,0,8,8,0,2,2,0,0,0,1,5,6,18,20,2,4,7,27,1,5,1,9,1,1,5,1,3,0,0,9,1,0,0,2,0,6,1,6,6,4,3,3,2,1,0,7,3,1,1,3,7,1,0,3,6,5,7,5,8,2,4,0,7,3,3,3,3,5,17,3,8,18,5,0,14,4,2,1,6,3,2,8,2,11,2,5,1,8,0,0,2,5,0,2,9,0,1,5,53,18,0,0,3,5,0,0,0,2,9,4,15,6,15,3,6,7,5,6,3,2,3,18,39,2,3,10,3,5,2,0,3,1,3,5,3,1,18,3,1,3,2,1,0,2,17,4,1,0,2,8,5,0,4,9,4,6,2,3,5,11,85,6,1,0,1,3,1,4,4,9,6,9,0,7,10,12,18,2,2,9,0,1,5,47,3,4,11,1,9,7,17,0,0,2,0,14,2,0,4,6,1,0,6,3,3,4,0,0,1,12,1,9,4,1,0,6,4,11,0,6,0,0,4,6,3,5,4,2,0,15,29,0,8,4,5,59,10,2,16,3,97,0,0,2,4,0,3,4,12,9,11,2,10,5,6,10,6,7,2,1,0,0,2,26,0,3,5,7,11,2,7,2,2,1,5,0,11,2,3,0,3,2,1,3,2,1,18,3,5,0,9,1,4,3,1,0,3,3,13,1,2,2,7,5,6,1,2,2,1,0,6,13,0,6,5,1,2,10,3,0,0,1,0,11,1,4,2,1,1,5,4,0,1,0,5,2,1,13,4,1,9,3,7,1,11,0,7,4,0,0,1,6,8,2,1,5,6,0,4,0,0,1,0,0,6,2,1,2,3,2,2,33,4,5,5,1,0,0,8,6,0,17,4,24,10,4,0,6,3,8,78,8,2,10,2,8,0,3,3,2,2,4,1,5,1,1,1,1,6,2,1,13,1,3,3,0,3,0,2,0,4,3,0,76,6,2,0,2,2,0,15,8,7,0,0,0,1,0,4,2,2,2,4,7,4,3,1,0,1,5,5,10,8,5,0,3,4,0,0,1,1,3,14,0,6,4,8,1,5,1,0,1,0,14,4,3,3,18,2,1,3,4,3,4,8,17,0,7,0,0,11,6,12,1,21,8,4,0,3,6,4,9,5,3,1,4,11,4,2,1,4,5,4,7,7,1,8,6,0,1,14,6,1,7,6,4,1,0,4,3,1,3,3,1,8,12,2,5,1,3,4,5,2,2,1,1,1,0,4,4,13,2,1,2,0,9,2,0,5,8,2,5,2,2,2,5,0,8,0,2,0,10,5,2,4,3,2,5,7,37,7,0,12,8,0,3,0,11,0,4,1,4,3,2,0,0,11,5,7,9,0,2,3,76,5,3,1,3,17,4,3,6,0,12,1,9,0,3,7,5,5,3,25,5,0,6,3,4,0,0,3,5,1,1,7,2,3,0,6,8,7,18,7,0,9,3,5,2,23,1,31,3,0,2,7,5,5,0,2,1,1,6,4,42,3,9,16,9,3,3,9,22,1,2,3,3,11,10,3,0,2,6,0,4,3,4,3,0,7,3,8,4,4,7,7,0,2,0,3,19,3,0,20,10,0,0,0,27,1,0,0,8,5,3,0,2,5,2,4,7,7,268,1,0,2,3,3,5,8,1,8,1,0,1,4,3,7,7,1,1,2,0,7,3,3,6,0,7,10,8,2,12,2,0,3,0,1,9,2,17,5,2,3,1,2,19,0,5,0,6,1,4,6,7,11,0,4,14,1,4,4,5,0,0,5,1,1,2,8,0,0,8,4,3,4,3,6,17,5,6,1,2,0,1,1,5,3,8,6,8,0,0,0,2,3,5,5,0,1,5,1,14,1,21,2,2,0,2,4,1,6,3,2,12,34,1,0,0,1,2,7,4,4,3,0,2,7,7,3,8,3,5,3,2,1,3,4,9,7,4,3,0,0,2,0,22,1,2,8,2,3,2,3,0,2,1,1,0,6,1,3,0,2,1,6,0,0,6,0,0,3,0,1,6,2,2,1,2,3,10,3,0,7,1,1,0,0,0,2,4,2,0,8,0,11,1,15,2,5,0,3,4,4,3,2,7,1,1,3,4,1,15,2,1,17,7,2,8,0,6,4,2,13,0,0,14,0,2,14,3,7,1,2,5,0,3,4,0,0,1,9,4,0,0,1,0,5,3,3,3,3,1,9,2,2,2,2,4,1,4,2,6,4,3,2,0,7,3,3,0,0,4,2,1,1,11,1,2,2,3,1,0,2,0,3,4,2,0,3,2,5,0,3,5,1,12,9,3,4,4,1,2,4,0,7,0,4,5,3,4,11,0,6,12,2,1,3,5,5,0,1,10,0,0,8,0,8,4,0,5,6,7,3,11,3,1,2,0,0,2,0,23,0,1,4,6,0,0,4,0,4,0,4,1,1,7,4,0,16,1,0,1,16,0,1,1,0,3,1,5,0,5,3,2,5,3,1,0,1,4,1,24,4,0,11,2,1,9,2,2,0,4,1,1,44,1,35,9,4,9,3,1,0,0,4,6,3,0,3,0,3,4,5,0,0,4,50,15,7,2,6,2,3,4,7,7,3,4,0,0,0,5,2,2,3,0,2,0,4,0,4,11,3,1,1,4,6,0,5,2,5,2,1,6,20,6,6,0,0,0,4,0,2,1,2,24,1,0,0,5,7,0,5,1,18,2,3,1,3,1,4,4,2,6,1,11,0,4,1,1,1,1,0,4,1,0,12,7,6,1,0,9,0,0,0,6,8,4,0,0,3,13,2,0,6,1,2,3,0,0,7,1,0,3,1,0,6,0,5,2,1,1,0,4,0,1,0,1,4,0,3,1,8,3,2,0,1,10,1,1,3,2,1,3,5,8,3,3,5,0,1,0,10,4,9,3,0,1,6,2,1,5,5,2,1,2,4,5,0,0,8,4,8,0,0,1,4,7,1,3,0,3,7,7,4,2,1,0,3,1,0,2,2,0,1,0,0,4,0,1,2,3,1,5,0,5,0,1,2,1,3,0,22,2,2,12,4,6,2,1,19,4,1,2,1,5,6,0,2,7,0,7,4,4,0,0,0,1,0,4,2,0,1,0,4,8,1,5,0,0,1,1,0,2,2,0,1,2,34,5,4,0,12,1,0,0,1,0,1,7,0,1,1,0,3,13,0,0,0,3,2,0,0,2,2,1,9,1,0,6,17,0,1,2,6,0,0,0,0,0,0,1,5,2,5,0,8,1,4,2,1,24,0,2,2,1,2,1,1,0,6,3,5,5,5,2,3,0,3,0,8,13,1,0,2,4,2,0,2,0,2,46,6,0,3,0,4,7,1,16,1,9,1,0,0,4,1,0,3,3,2,0,5,10,3,3,3,0,3,14,3,1,1,3,3,0,1,4,11,1,10,1,2,0,0,5,2,0,0,2,0,0,3,2,0,5,4,3,2,3,0,8,5,5,1,6,1,11,6,2,3,1,2,3,6,0,0,1,7,9,8,0,9,1,2,0,10,33,9,0,0,3,2,6,2,6,1,0,4,41,4,0,0,2,4,11,4,4,10,3,2,0,1,1,0,0,0,1,0,3,0,3,0,0,1,2,17,7,0,9,2,4,6,3,1,0,0,6,3,0,0,4,0,0,0,7,0,0,4,4,0,6,2,4,1,0,4,7,1,1,0,0,1,0,2,0,1,0,5,0,6,1,0,7,1,0,1,1,4,2,2,1,3,2,3,1,1,3,3,1,4,0,0,1,1,2,65,3,7,0,5,4,1,2,1,8,0,1,1,1,5,5,17,0,3,2,0,0,0,1,6,13,4,0,0,1,0,0,3,7,0,0,2,54,1,2,1,0,3,2,4,3,0,3,17,3,0,1,5,6,4,0,0,4,2,4,1,4,0,1,43,7,2,5,1,11,8,1,0,3,3,0,52,4,1,3,1,13,0,0,7,1,2,0,1,3,1,3,0,1,0,2,1,2,4,0,3,2,2,0,0,1,4,5,3,1,3,10,2,0,2,5,4,1,3,0,6,2,2,1,10,0,11,0,3,3,3,1,1,0,0,1,4,2,2,1,10,0,1,0,12,0,0,0,3,0,3,2,1,0,1,1,2,0,3,0,1,0,1,0,0,1,8,1,0,0,5,0,0,1,5,4,4,6,2,0,2,0,1,7,0,1,9,3,2,1,10,2,5,4,1,7,0,2,1,0,2,2,0,0,0,1,0,0,0,0,1,2,3,1,8,5,5,1,2,3,2,0,0,1,2,3,3,4,2,0,4,2,2,4,0,6,6,3,2,0,0,1,0,6,2,1,2,7,5,2,1,8,0,0,0,0,4,0,1,1,1,0,4,1,1,0,5,2,2,0,7,1,2,4,0,1,6,8,2,7,10,1,5,0,2,0,0,2,3,2,0,1,0,1,12,4,4,0,3,0,3,0,4,0,0,2,1,0,10,1,5,0,1,1,4,0,0,0,0,11,1,4,5,0,3,2,2,0,3,0,2,2,4,0,2,0,4,1,1,0,6,0,1,0,0,1,2,0,6,2,20,0,6,3,0,5,1,4,1,3,1,14,2,0,1,0,0,1,1,6,1,3,1,4,3,3,0,7,0,2,0,2,0,1,1,1,0,3,1,2,0,22,4,8,0,0,0,2,4,14,4,1,2,5,0,1,0,3,2,2,0,2,0,3,4,3,10,0,0,5,0,2,0,4,2,1,2,4,6,2,0,6,7,3,3,0,0,3,1,2,2,0,1,1,1,0,0,0,1,0,0,0,3,0,1,13,3,10,0,1,2,0,4,2,2,0,2,1,2,1,0,2,2,1,0,1,0,1,1,3,0,1,2,1,4,0,6,0,0,3,4,3,0,2,13,3,5,1,15,3,5,1,3,0,11,2,2,1,22,0,3,4,3,0,1,2,1,1,3,0,6,0,0,0,0,6,1,0,0,0,2,0,0,0,0,1,0,1,1,3,0,0,3,5,3,0,1,2,0,8,2,3,3,7,0,0,0,2,3,3,0,2,1,12,1,5,0,0,4,1,0,1,0,4,1,0,0,3,0,6,1,5,0,3,0,5,5,0,3,0,2,1,4,1,3,8,0,0,0,1,1,6,2,1,1,4,4,0,0,1,3,0,27,3,2,4,5,1,3,2,0,2,0,1,2,2,3,3,1,1,0,6,0,2,3,2,1,1,0,4,3,0,0,0,3,2,3,0,4,1,0,0,2,0,3,0,1,3,1,4,3,1,0,0,4,0,0,0,0,0,0,1,8,0,1,5,7,0,0,0,6,0,1,7,5,0,7,0,3,0,1,1,0,2,0,7,0,0,2,0,2,7,3,0,3,0,0,0,1,0,0,0,1,1,0,0,1,1,0,0,0,0,0,136,0,0,0,1,1,0,0,0,0,0,2,1,2,0,1,0,0,0,1,0,1,0,0,0,0,0,2,0,0,0,0,0,1,0,0,0,0,0,0,0,4,0,0,0,2,2,0,0,0,0,0,0,0,0,0,0,0,0,0,0,0,0,0,0,0,0
K54 Under the Dome,king,17699,8521,7836,6880,6231,2925,5650,4478,5638,4885,3414,3769,3397,3002,2943,3109,2871,2108,1878,2400,2101,2804,1613,1617,649,1496,845,1421,1604,1233,1156,1530,1411,1653,1572,1355,1271,1092,844,1322,1581,994,1283,1175,747,1030,817,783,979,1199,1112,940,825,655,674,708,993,689,958,898,863,697,665,909,683,552,582,644,731,648,678,549,442,522,597,603,519,651,491,533,427,607,284,658,438,595,474,519,495,515,311,600,510,313,525,327,440,399,579,409,298,717,559,390,660,382,595,405,441,328,390,294,222,404,425,310,300,311,246,435,416,469,379,390,211,255,287,348,266,292,393,372,383,259,437,310,182,362,286,243,147,255,301,344,491,358,274,495,353,376,221,216,306,257,245,292,286,176,249,231,236,231,336,308,326,183,248,207,175,266,101,154,353,255,159,162,130,172,270,377,179,150,278,137,246,177,129,192,414,104,225,126,248,169,99,240,105,140,139,84,200,195,183,214,177,165,128,137,161,1044,102,208,100,115,194,99,208,179,148,133,132,227,226,124,181,155,159,109,221,173,170,123,137,232,156,154,128,156,131,121,131,117,131,119,128,151,184,227,163,186,276,92,107,94,151,163,99,158,151,132,175,162,117,153,299,70,125,96,186,164,130,110,198,169,165,120,106,161,176,134,94,74,149,90,307,152,135,95,138,238,94,162,155,118,128,140,146,148,117,182,206,108,164,97,182,177,49,123,42,124,91,35,87,131,106,136,65,146,130,196,119,286,85,154,113,84,247,53,83,126,170,106,131,114,182,122,136,62,88,144,88,71,94,65,104,83,178,93,102,124,187,68,118,101,140,25,59,161,109,73,80,107,107,46,75,86,117,68,158,92,61,71,86,79,80,148,57,86,103,133,75,158,99,101,64,176,0,68,141,84,92,90,47,72,122,165,112,65,103,109,97,146,114,62,101,74,74,121,57,140,120,59,75,691,79,57,75,109,55,65,141,28,31,67,68,85,73,106,91,64,145,100,44,63,5,190,71,64,51,94,91,85,140,88,101,54,53,84,66,85,79,35,77,193,125,66,78,34,60,113,114,58,0,61,24,83,103,59,54,73,45,55,90,40,70,55,41,40,0,52,41,115,139,109,44,73,75,271,75,55,87,42,61,43,59,28,99,56,23,48,61,59,72,56,90,61,77,58,75,58,65,72,87,54,98,74,0,70,92,105,81,73,118,73,62,64,111,74,86,66,11,44,64,54,69,8,67,96,18,54,76,17,127,53,86,59,0,5,71,130,54,84,45,81,79,67,62,81,36,13,55,75,46,75,77,88,56,46,63,24,134,93,77,89,62,45,62,17,41,43,68,98,39,58,61,72,46,96,30,27,78,61,24,22,56,37,31,44,30,62,105,38,127,34,92,0,3,44,33,62,32,27,78,50,48,56,80,16,25,26,30,61,40,46,66,78,102,92,51,13,46,53,38,49,39,0,62,87,51,36,48,21,54,24,75,88,50,40,26,105,4,42,48,70,91,77,43,35,63,25,62,39,54,57,116,45,54,53,79,49,69,45,38,30,19,55,41,32,40,28,82,49,70,39,104,45,3,38,36,44,60,18,30,54,22,57,23,8,31,38,72,16,56,64,79,41,23,90,63,13,14,115,7,41,17,114,51,64,39,41,32,113,47,39,25,52,38,27,42,28,49,44,16,10,0,58,23,17,40,59,92,60,19,125,58,7,85,44,56,57,9,23,58,21,31,56,58,7,33,18,97,23,38,73,52,193,39,14,29,39,38,32,66,59,0,52,34,35,91,40,25,17,8,68,42,81,66,37,63,66,44,11,4,57,13,15,2,35,18,25,54,19,20,56,76,34,241,61,72,36,30,16,51,5,45,63,33,4,55,30,30,8,53,46,55,45,26,62,38,57,65,93,54,31,65,49,25,33,0,31,51,16,21,16,40,6,25,0,34,44,40,71,7,9,11,25,13,39,7,47,35,24,106,32,46,53,21,0,44,51,55,58,30,27,3,10,3,52,12,34,24,29,19,61,18,45,41,54,17,33,25,28,16,32,28,33,24,2,24,31,34,21,22,28,39,59,36,28,39,11,43,0,58,0,24,46,19,23,112,46,30,8,27,28,31,24,12,0,70,6,73,30,38,2,28,34,28,29,16,97,17,54,61,18,19,23,28,22,18,40,43,22,38,11,11,50,8,25,40,26,0,28,33,128,14,54,15,4,16,45,30,312,42,38,25,44,19,40,37,36,0,89,29,13,30,72,44,114,29,60,34,21,42,35,36,25,3,25,23,0,17,1,46,11,51,54,0,0,7,63,27,28,25,3,27,52,32,1,18,38,22,36,54,1,28,36,32,9,68,33,20,38,11,22,39,8,40,25,40,58,22,24,135,15,53,3,67,20,11,43,35,48,29,35,32,0,58,19,12,32,26,25,0,30,17,19,18,17,14,0,0,1,15,33,9,18,20,0,10,24,21,3,23,6,12,7,17,50,9,3,25,0,41,51,14,20,48,19,58,23,13,11,11,40,23,31,51,13,29,32,40,21,9,16,0,1,14,66,48,43,30,60,17,37,39,22,25,66,6,66,38,68,35,47,28,55,34,24,26,20,34,36,24,10,7,14,26,93,20,12,55,8,15,29,33,7,147,48,11,10,8,26,11,50,1,18,11,47,2,4,5,43,13,16,24,34,18,4,27,0,5,28,5,8,33,59,2,10,15,0,60,46,0,24,49,69,7,19,16,28,25,0,20,24,81,55,6,16,34,31,6,7,22,19,13,0,0,10,22,31,96,87,33,8,43,40,19,37,7,22,33,35,0,36,19,0,13,22,5,9,18,9,27,0,13,33,1,25,29,37,21,11,24,32,21,10,62,28,28,17,32,0,15,20,0,32,41,4,37,23,2,6,46,10,0,9,30,16,1,72,22,33,37,23,29,45,40,14,26,33,0,30,28,47,32,38,13,23,5,16,29,32,23,23,23,34,9,9,16,15,11,4,9,13,20,29,43,81,16,27,28,19,33,0,20,10,18,27,8,14,0,28,4,13,27,35,37,19,7,14,33,44,17,0,13,82,5,39,14,22,25,13,18,15,21,10,20,30,18,10,6,12,13,0,76,14,60,19,27,26,10,31,22,20,14,1,0,29,0,102,38,0,24,44,14,29,32,29,54,58,30,42,15,2,4,46,10,1,19,23,0,0,0,23,0,26,4,0,19,38,10,19,14,23,0,16,14,29,13,31,20,20,13,22,13,12,4,8,16,36,23,20,0,0,4,35,12,30,26,36,26,6,25,32,5,38,13,50,14,19,22,27,0,16,28,0,17,53,29,10,13,33,19,2,21,63,20,6,25,17,35,33,12,13,0,14,5,20,8,5,20,18,45,11,40,20,12,47,6,51,11,34,7,28,10,14,0,11,5,18,29,3,3,0,0,17,0,9,14,3,13,14,8,11,20,27,13,0,35,3,6,41,16,26,28,29,32,27,9,26,14,17,11,20,11,3,12,2,29,20,27,13,15,18,25,14,12,22,66,14,29,61,51,20,8,6,3,2,12,8,43,25,21,7,16,21,27,11,28,34,24,22,20,0,17,25,29,10,26,46,8,15,22,19,17,11,22,33,5,17,2,29,41,19,13,19,9,0,14,24,1,63,0,12,12,20,24,17,25,14,24,29,26,1,35,6,0,15,0,23,1,26,25,0,19,11,5,6,6,3,10,6,6,2,3,11,5,8,22,28,22,10,27,8,0,3,1,5,19,4,17,18,15,5,19,22,5,20,7,23,25,31,5,3,17,4,21,0,26,5,15,29,105,12,8,33,4,15,12,23,34,28,30,11,17,0,14,12,19,17,13,4,19,13,0,26,25,19,21,7,13,6,27,4,6,8,28,24,14,0,37,13,33,38,7,13,52,8,0,26,39,66,5,22,8,11,27,26,36,4,16,26,32,0,10,14,20,17,34,7,51,18,19,29,0,15,13,15,22,9,18,8,16,3,2,19,2,14,4,16,12,55,13,7,16,10,41,10,31,0,7,5,1,13,28,1,3,5,18,3,10,27,11,14,34,17,1,14,5,12,16,17,0,5,4,8,10,19,21,37,6,5,5,3,4,38,29,9,7,3,14,14,8,13,8,48,13,0,17,7,25,18,0,0,27,7,0,9,0,3,1,49,10,30,20,16,17,8,0,9,0,39,1,18,5,34,26,19,18,3,21,12,11,53,21,7,61,17,5,9,9,3,16,145,18,1,4,5,4,25,4,11,1,20,4,19,38,15,18,42,0,8,12,4,1,8,14,5,26,38,17,13,0,8,7,11,11,7,3,9,0,20,18,18,1,14,12,5,4,5,0,9,7,2,27,10,11,17,10,13,23,34,2,16,15,29,15,9,24,14,33,7,0,12,24,0,14,15,0,9,1,4,0,10,16,11,6,37,6,6,5,17,7,13,1,4,8,17,1,18,6,12,11,17,14,5,11,46,4,21,9,12,1,0,5,15,47,23,18,16,1,28,14,21,24,8,6,8,11,3,14,9,20,8,1,21,10,0,10,13,6,1,5,9,15,11,6,18,6,5,12,15,8,21,7,20,26,3,6,7,15,40,34,9,10,0,10,21,12,0,14,2,2,14,8,26,18,7,5,2,28,12,1,0,9,8,7,13,15,13,17,17,20,4,11,36,27,14,7,12,24,15,0,12,8,6,3,11,14,14,0,0,11,16,0,2,25,12,11,0,27,1,14,25,10,14,1,0,23,22,4,24,23,25,4,20,0,10,12,14,1,1,13,35,2,9,0,3,11,14,7,17,20,6,10,16,20,40,0,0,13,0,24,11,0,0,7,8,29,13,21,20,20,3,0,12,43,25,15,15,7,8,11,11,15,9,10,4,0,5,7,18,1,1,18,0,10,4,27,16,0,36,0,0,12,13,22,6,3,13,4,5,10,0,17,0,0,11,0,8,10,301,54,0,17,9,5,10,6,0,7,10,11,22,15,6,17,20,8,20,0,28,5,9,9,17,0,0,8,6,21,2,13,8,16,1,20,5,5,21,21,16,7,5,2,26,9,17,35,7,19,4,6,32,13,8,6,3,7,0,4,34,43,12,12,18,37,12,12,6,14,13,0,7,16,7,10,24,22,1,1,13,12,8,18,10,6,44,18,1,2,1,7,18,0,6,8,4,12,9,7,18,15,14,4,5,19,9,8,15,17,23,13,18,10,4,25,16,16,14,16,6,12,6,3,13,4,12,15,1,9,15,14,11,17,7,14,11,5,10,6,16,0,2,12,9,5,20,15,10,4,13,27,9,3,0,25,6,21,2,18,13,12,8,14,9,12,11,11,1,11,10,7,11,18,17,5,12,5,6,4,5,6,8,11,18,28,1,10,4,3,4,7,5,3,0,14,11,16,20,0,7,14,4,13,0,3,6,9,4,3,11,2,13,13,18,4,2,6,7,9,11,9,0,1,9,22,51,23,8,9,32,12,8,30,1,5,4,0,23,10,18,2,12,4,0,5,9,16,0,13,6,24,7,6,2,11,13,15,4,0,7,5,22,20,0,15,10,14,2,4,2,12,26,0,10,29,1,10,7,7,19,12,1,1,16,20,15,4,4,0,15,12,5,9,3,2,3,1,14,4,12,20,14,0,40,16,0,8,14,8,0,4,4,11,5,9,4,10,4,2,2,2,14,13,3,0,1,7,35,1,22,0,1,0,9,1,9,3,9,4,6,8,12,6,3,4,1,3,12,2,1,13,4,17,9,5,7,9,11,9,0,0,13,3,10,16,3,1,19,4,7,0,4,5,5,16,9,8,5,8,2,3,5,6,7,4,9,3,49,9,0,0,9,94,0,4,5,2,22,4,14,6,3,9,4,9,2,0,5,10,3,4,16,4,8,0,8,7,9,17,7,10,3,37,19,4,6,6,835,14,1,8,0,5,30,7,0,5,20,0,8,7,2,10,8,3,12,4,5,6,8,0,0,4,6,0,5,10,1,10,18,50,13,5,11,7,12,40,0,0,20,13,4,10,5,6,11,10,8,4,17,3,19,8,19,13,5,18,18,10,0,9,6,7,1,13,3,7,4,6,2,3,11,28,12,1,7,26,2,5,0,9,4,4,0,3,13,6,7,1,2,9,9,3,7,0,2,16,2,9,4,5,9,2,6,0,3,8,19,15,3,9,22,3,4,9,5,2,9,3,0,9,18,2,0,2,26,24,15,1,1,11,11,9,0,8,8,5,7,0,0,3,15,29,1,5,0,7,9,9,6,0,8,0,0,6,14,7,8,9,2,0,31,2,0,11,1,5,5,0,15,14,2,6,0,18,41,9,3,5,5,35,0,20,9,8,13,1,13,6,3,1,3,0,0,7,10,7,14,0,8,18,21,19,6,3,0,5,10,16,8,8,2,8,2,0,4,11,5,11,3,3,1,12,3,12,8,1,0,2,9,2,7,0,10,9,5,6,2,3,1,4,17,3,8,4,14,19,37,20,7,5,9,0,8,0,6,7,4,5,13,10,19,14,7,6,0,10,10,4,20,14,1,3,8,10,1,10,0,15,1,3,0,2,8,0,24,8,11,5,1,7,0,2,14,0,0,6,1,3,14,29,10,1,16,16,15,7,7,0,1,20,4,0,8,11,22,12,0,1,3,6,13,0,19,3,16,14,6,0,12,6,15,4,6,11,9,0,0,4,6,10,4,3,0,0,7,7,2,1,0,5,0,12,6,0,15,10,1,0,4,9,3,16,5,11,3,0,1,1,0,10,6,4,14,6,5,1,9,1,0,0,10,7,6,16,3,0,0,7,0,0,8,3,8,21,0,14,25,21,17,1,32,0,4,0,27,13,8,7,3,7,18,9,11,11,12,17,7,1,13,0,7,22,11,5,9,26,12,1,34,9,9,8,27,7,2,6,12,4,10,14,3,3,8,5,15,7,0,22,6,0,4,7,36,1,6,1,13,1,0,13,2,7,3,7,5,14,11,3,6,0,1,19,11,1,0,3,0,6,0,7,12,7,6,2,16,3,11,3,2,7,31,15,2,2,6,10,7,1,9,0,1,0,2,5,6,1,7,3,7,5,12,3,0,14,9,5,9,0,3,1,4,11,0,7,16,0,4,13,13,7,9,4,1,12,0,6,13,3,3,9,2,4,2,0,2,25,6,0,14,7,2,7,4,12,6,4,2,18,5,0,1,5,12,5,2,9,5,11,8,12,13,12,20,2,0,9,9,2,5,4,6,12,1,1,11,9,5,7,0,9,3,0,14,3,6,6,17,8,15,11,11,18,4,7,3,4,111,6,17,3,3,3,7,0,3,12,13,1,0,0,3,9,523,16,10,6,0,5,0,24,38,1,1,1,14,4,3,0,15,0,1,0,14,21,4,5,2,11,18,11,14,3,0,2,1,2,3,3,6,17,19,8,10,0,1,5,5,8,9,5,7,3,12,7,2,9,1,3,0,7,16,0,21,6,1,11,2,5,7,8,11,7,0,7,1,0,15,0,2,0,7,5,2,6,8,11,0,6,14,5,8,13,8,1,14,8,5,12,21,4,0,1,3,17,1,4,4,8,2,0,6,2,6,0,0,6,10,9,13,6,9,5,5,1,5,5,10,8,7,2,6,2,3,5,0,36,0,9,12,10,6,15,4,0,3,68,4,2,1,2,4,17,8,2,10,13,3,12,7,2,59,9,2,9,8,3,19,2,9,5,4,1,1,14,7,6,1,1,1,7,1,3,3,19,14,1,2,9,0,2,8,11,0,6,8,2,19,10,12,1,4,7,2,5,5,3,4,15,4,3,2,0,19,6,2,12,2,0,0,8,6,5,10,4,0,11,1,33,0,9,0,5,5,7,4,4,16,1,9,7,14,0,16,2,2,1,17,2,3,5,5,7,3,7,0,32,11,1,0,13,12,7,20,10,12,0,4,6,0,0,2,1,5,5,0,1,0,6,2,13,12,9,1,3,2,0,6,0,17,7,5,0,1,8,5,1,3,6,4,1,0,2,2,4,0,4,8,0,1,2,4,8,1,6,0,2,3,6,0,2,4,23,12,5,4,7,15,7,3,5,7,3,11,8,1,19,25,1,5,5,48,17,0,6,5,4,0,6,10,5,1,0,11,2,14,1,0,20,4,6,7,5,5,7,6,0,9,2,0,8,0,3,5,0,3,9,13,7,3,2,0,4,3,4,2,1,3,10,5,20,2,10,1,5,1,6,1,1,18,1,5,14,20,20,6,13,7,2,1,0,1,0,14,6,1,2,4,5,0,4,1,15,5,5,11,3,8,6,6,3,9,9,1,5,0,3,17,10,1,3,1,2,0,17,4,1,4,14,7,14,10,5,4,7,3,1,7,4,3,0,0,0,5,12,5,5,1,6,2,4,7,8,12,1,3,9,1,8,1,6,1,5,3,3,2,0,6,10,2,6,3,0,0,3,3,17,2,6,1,4,11,2,1,4,2,0,4,4,1,10,1,3,5,0,2,3,12,0,1,0,4,0,0,0,1,5,0,7,5,3,68,0,13,3,0,6,2,1,6,1,0,3,17,9,0,4,14,2,2,4,1,4,1,0,2,0,0,11,4,16,3,4,0,1,2,2,2,4,23,4,0,1,4,9,8,3,5,4,8,8,2,1,4,8,15,4,6,5,2,6,1,4,2,4,0,7,8,6,7,1,2,1,12,4,9,2,2,2,4,1,1,14,11,19,1,4,1,3,1,3,8,1,6,3,14,68,8,2,2,12,2,0,17,2,0,6,5,8,15,3,1,7,3,29,5,224,10,0,2,4,6,18,3,9,11,5,9,3,8,1,7,0,2,2,3,8,13,1,0,15,10,0,1,8,7,0,0,3,0,2,37,4,1,3,2,58,0,3,1,11,2,1,1,1,2,0,0,0,5,2,9,12,1,0,10,3,0,16,0,18,18,2,1,9,3,10,7,1,7,0,3,2,1,10,2,23,1,3,7,4,8,2,0,3,9,5,5,6,3,3,0,0,8,5,9,7,0,2,8,0,2,5,2,0,10,5,4,1,0,4,0,7,2,4,11,2,7,5,8,26,0,19,8,7,2,1,37,1,0,1,0,3,1,13,1,2,0,12,3,13,7,0,5,0,1,4,1,0,11,11,7,3,1,5,1,3,5,1,1,13,4,10,1,4,6,3,0,2,4,8,3,4,25,5,0,0,10,7,1,16,3,0,0,10,7,2,13,1,4,0,12,3,11,3,4,3,1,2,0,6,4,5,4,4,11,11,0,2,1,4,23,14,8,3,4,4,0,6,0,4,3,2,1,1,3,5,2,6,3,10,20,6,0,6,5,2,33,1,0,3,3,2,0,2,26,1,0,2,0,0,16,0,5,0,0,5,1,16,5,0,7,9,6,3,0,1,1,0,10,0,1,0,8,0,3,3,2,0,2,7,6,3,5,3,3,0,0,1,0,0,5,5,0,2,0,3,0,1,6,6,3,9,1,4,12,6,0,5,13,2,2,6,0,8,13,5,0,3,0,6,1,2,0,3,0,2,4,18,8,5,0,5,15,1,3,2,16,0,3,4,0,7,6,2,0,2,1,5,6,1,6,1,4,4,4,0,2,8,1,7,13,2,9,4,3,1,7,8,1,2,0,4,3,0,10,9,2,2,5,4,3,7,0,0,11,4,5,0,8,0,2,4,3,6,8,4,13,7,10,0,3,8,2,0,5,4,6,1,4,0,2,9,0,4,0,2,3,3,12,4,2,5,5,4,1,1,1,5,5,8,0,0,11,3,2,12,4,1,8,7,0,8,2,1,3,2,2,1,1,1,12,2,4,3,0,1,10,2,4,3,4,1,2,5,4,16,0,6,9,3,3,13,10,4,0,1,1,3,0,4,3,5,4,4,8,2,3,6,2,6,4,5,5,7,2,7,4,19,15,10,5,4,1,0,4,6,12,2,0,4,6,7,0,5,2,3,3,22,9,7,3,0,6,2,3,7,6,2,4,41,0,7,0,0,0,0,0,1,0,4,4,6,10,6,1,1,355,1,2,0,4,1,7,5,1,4,20,0,6,1,2,7,6,7,8,1,4,3,7,12,11,3,6,9,12,3,16,11,8,0,11,0,1,8,4,1,0,3,3,5,2,2,2,4,2,1,0,6,1,2,6,0,0,3,3,2,32,4,3,4,4,1,0,0,4,3,10,0,1,0,6,15,2,0,1,1,0,1,0,5,0,0,3,2,11,0,0,5,3,0,5,15,2,4,0,4,14,0,6,4,2,3,4,1,0,0,4,4,1,10,0,7,1,3,4,0,9,5,0,2,6,2,1,2,5,11,0,0,4,3,3,6,3,1,4,4,4,3,9,3,0,2,6,4,1,2,4,0,1,17,4,6,6,2,4,0,1,0,1,3,0,1,2,0,4,2,0,13,0,4,0,0,0,0,9,4,0,0,12,2,8,2,2,0,4,6,6,3,0,0,5,2,8,4,1,0,9,0,2,8,0,5,4,6,7,10,3,1,4,15,2,6,0,0,7,1,9,3,1,6,1,6,5,1,4,5,3,1,0,4,2,0,0,7,3,1,5,1,2,6,4,8,12,5,0,6,1,0,3,3,2,2,5,0,6,6,2,2,7,1,2,1,0,6,0,5,1,9,1,2,1,10,1,12,0,8,3,13,7,3,0,0,3,5,1,4,2,5,2,4,0,0,2,1,2,6,3,10,1,0,0,4,16,2,1,0,3,0,0,4,1,9,114,0,4,1,5,5,0,11,6,4,2,2,1,0,5,0,1,9,4,0,3,3,11,10,1,0,1,3,21,1,10,0,0,15,3,2,3,11,3,2,3,2,3,0,1,0,10,2,3,1,2,0,1,4,0,4,1,1,3,5,3,0,0,2,9,9,13,0,9,2,3,3,4,0,1,4,4,1,3,1,6,2,2,12,12,1,0,1,0,2,2,1,1,1,7,3,2,1,0,3,3,1,1,0,16,5,4,0,1,1,1,6,4,7,1,0,10,4,2,2,5,2,3,17,5,1,0,1,1,0,0,1,0,3,8,2,6,7,1,5,1,2,1,0,2,4,0,11,1,1,1,8,125,4,49,1,7,2,5,0,7,0,0,0,0,2,0,2,0,6,0,0,0,2,2,0,0,1,0,0,1,1,4,1,0,0,2,0,3,8,0,1,0,0,0,0,0,0,0,6,0,1,0,1,0,0,3,25,0,4,0,9,0,7,0,0,0,0,1,0,0,0,0,0,0,0,0,0,0,1,0,0,0,4,1,0,1,0,1,0,0,0,0,0,0,0,0,0,0,0,0,0,0,0,0
K55 1922,king,2523,1516,1344,1134,942,1742,620,795,839,863,513,427,680,424,537,455,438,383,343,256,269,483,295,195,527,215,385,145,246,192,172,185,180,232,149,310,131,212,178,184,286,174,201,199,116,204,146,159,235,187,204,83,144,135,96,112,137,139,123,131,124,131,74,92,134,98,75,90,76,106,81,60,76,105,95,99,75,87,55,61,74,65,82,93,102,57,65,88,116,85,63,72,109,36,81,67,71,33,88,74,85,76,65,72,101,62,92,70,53,34,85,69,48,57,56,36,68,119,44,19,42,81,88,74,38,64,43,50,46,57,57,86,67,67,99,55,62,63,60,51,62,46,34,30,81,63,34,98,60,26,54,26,45,57,39,28,28,30,33,7,28,22,43,52,29,42,45,29,40,37,69,42,70,38,20,13,41,39,57,40,38,23,43,25,41,43,17,29,46,21,17,21,60,16,15,29,23,26,28,19,41,28,19,41,18,54,24,13,29,21,31,27,17,22,26,13,26,14,35,36,22,26,33,17,20,10,28,12,38,10,13,11,28,17,28,22,25,15,12,11,21,38,29,21,28,25,12,55,13,43,48,27,22,13,30,15,10,29,27,21,34,10,10,26,21,21,14,25,15,27,24,19,46,15,27,24,34,29,33,41,17,7,26,23,36,13,15,31,20,6,23,19,1,32,13,22,35,16,33,40,29,14,0,8,33,16,53,27,4,17,27,39,13,29,38,33,6,24,9,13,13,30,21,33,8,6,34,10,5,9,22,17,9,20,20,17,19,5,19,15,9,10,18,11,8,15,24,0,13,6,22,7,20,17,20,3,17,24,11,24,9,9,16,9,8,10,9,8,11,16,21,12,3,20,7,32,9,38,21,18,3,15,8,9,8,9,0,15,30,7,5,16,5,0,10,28,12,17,21,12,27,42,9,15,33,6,16,19,10,19,17,16,25,20,13,33,4,16,4,3,33,0,2,22,6,11,1,32,15,9,10,20,11,5,2,11,13,10,1,13,9,3,15,7,11,2,4,9,21,13,9,9,8,27,20,9,14,10,9,10,18,0,0,23,5,14,14,2,5,8,3,2,10,3,10,13,5,3,0,2,9,10,7,14,9,15,11,2,22,2,12,11,15,14,5,2,8,11,2,10,23,14,5,4,9,7,3,11,8,3,7,5,4,15,6,10,0,8,18,6,11,8,13,11,6,11,20,14,14,9,4,14,7,20,5,0,17,7,4,9,10,4,9,11,5,11,0,5,4,2,7,10,15,16,10,15,2,3,5,0,13,10,9,12,12,9,3,0,12,1,53,4,2,9,4,10,9,7,9,14,6,8,5,9,2,14,1,8,5,11,16,7,7,13,6,22,3,5,3,14,10,13,27,3,5,0,1,5,4,7,8,0,15,10,7,8,15,5,11,9,11,6,7,6,13,2,10,6,8,1,16,9,4,7,4,0,15,11,4,20,1,0,10,4,0,9,16,3,4,6,6,4,10,7,8,15,6,2,5,2,4,11,8,6,6,2,9,9,10,3,18,4,3,2,5,5,9,4,3,0,1,3,5,10,3,9,0,6,12,3,9,2,2,13,13,6,4,0,9,11,11,2,9,8,13,12,13,7,7,3,1,14,0,4,7,7,4,5,9,9,0,35,1,0,7,5,7,2,5,6,8,14,11,3,0,7,0,3,2,5,6,8,1,7,40,0,3,9,8,9,7,0,7,5,2,15,3,6,2,1,8,9,12,0,2,5,7,0,9,7,13,17,1,0,0,8,7,4,9,7,0,5,4,13,14,16,1,5,11,3,15,6,0,6,9,7,0,3,1,5,6,9,24,12,1,3,41,9,7,4,7,9,13,11,6,3,1,0,7,24,4,3,1,15,8,0,0,1,1,1,5,0,0,2,1,6,10,10,0,17,2,6,2,7,18,8,7,0,7,1,6,8,0,2,1,1,4,2,5,12,10,1,5,3,10,5,4,0,7,7,5,1,7,13,0,7,2,8,5,5,9,6,7,15,2,7,7,6,4,7,1,1,3,3,3,10,2,0,5,7,2,1,1,1,28,7,9,5,6,1,4,0,5,0,5,1,3,11,13,5,3,1,4,4,5,2,1,0,10,2,2,2,2,0,4,2,3,7,7,3,4,1,1,0,3,4,1,6,7,0,9,8,13,2,1,2,30,3,10,6,0,11,3,0,3,17,1,7,1,7,7,0,4,15,1,6,1,3,2,0,0,10,3,1,2,6,8,0,5,6,3,2,4,7,3,2,1,5,1,0,5,0,7,0,3,4,0,0,2,4,2,10,13,12,3,5,6,1,3,3,5,7,0,1,4,0,7,3,2,16,6,1,4,1,6,4,5,12,3,11,3,3,0,2,1,2,3,10,24,2,8,3,12,0,3,0,5,3,4,7,1,2,0,2,2,5,10,7,0,0,0,0,6,2,0,6,2,0,1,2,0,0,3,1,36,2,1,6,3,4,3,0,3,3,4,2,4,2,6,2,4,3,1,14,4,7,6,1,1,3,8,1,3,3,0,0,2,0,7,4,13,9,0,3,3,9,6,3,0,1,3,0,4,2,6,6,0,7,5,17,12,4,1,2,1,1,4,1,3,2,4,0,3,5,2,0,2,1,1,2,16,0,1,10,0,6,2,3,1,0,63,3,3,4,1,6,1,3,1,0,1,2,2,0,8,3,0,2,6,0,9,6,0,4,3,6,2,3,0,9,1,0,1,4,5,1,1,0,1,1,0,5,3,13,1,0,0,0,2,0,5,6,6,2,10,5,3,7,2,2,2,6,0,8,0,0,1,6,3,3,5,7,3,0,0,2,0,1,6,4,2,1,4,5,0,2,0,4,0,2,1,0,0,2,0,2,4,0,6,8,17,0,1,0,0,1,4,3,0,1,6,7,3,10,0,9,7,4,2,0,0,7,4,1,4,3,0,10,2,1,4,4,4,2,2,1,2,3,4,0,6,0,1,1,2,0,7,4,6,0,7,6,0,0,3,5,4,1,4,1,1,3,1,0,4,2,3,8,12,2,7,7,2,0,5,0,1,0,2,0,3,1,3,0,5,1,0,5,2,9,0,2,2,0,11,3,4,0,4,5,6,7,5,15,1,0,0,0,0,4,0,0,0,4,8,8,0,1,5,2,4,4,1,1,6,0,0,0,4,0,0,0,0,6,0,6,1,0,0,1,0,1,3,3,0,5,0,0,2,5,6,0,1,7,1,1,0,2,3,5,6,1,0,0,1,4,0,5,7,1,4,0,1,5,0,7,12,7,3,2,11,8,0,10,0,0,0,0,6,0,1,1,3,0,3,6,2,0,1,3,1,2,6,3,0,6,3,0,1,2,1,1,0,3,0,4,2,0,3,4,2,8,0,4,1,2,0,0,4,2,4,1,1,0,0,0,0,4,1,14,2,2,1,1,1,2,3,0,0,1,0,1,1,1,3,5,1,4,0,7,1,0,0,1,1,0,0,3,1,2,6,6,5,3,1,1,1,0,4,2,7,6,8,3,1,0,2,0,8,7,0,1,5,2,5,1,0,0,5,1,2,7,4,0,1,3,4,0,9,2,0,9,1,4,8,3,1,3,2,3,0,3,2,6,2,5,0,0,6,3,0,0,0,1,4,4,1,1,1,1,3,2,1,0,6,0,0,3,0,3,0,0,7,0,0,1,1,0,1,0,4,0,1,0,2,5,3,1,1,3,4,0,1,2,2,0,0,1,5,0,0,3,12,0,0,2,0,0,3,7,4,5,6,2,0,2,6,0,5,1,0,16,5,0,1,1,0,6,0,1,0,2,1,0,1,0,0,0,3,4,0,0,10,1,0,36,4,0,4,2,2,2,1,2,0,4,1,2,1,0,2,2,0,0,1,1,2,0,0,3,0,2,0,1,0,0,2,3,3,4,0,20,5,0,0,0,12,1,3,2,2,3,3,2,0,0,2,1,3,1,0,0,1,0,1,3,0,3,1,1,2,2,3,0,4,3,0,1,0,1,3,0,0,0,10,0,0,1,3,0,2,2,2,1,5,0,1,2,4,2,1,5,1,0,0,0,2,6,3,4,1,3,2,0,3,1,4,0,0,1,0,4,3,0,0,3,4,0,0,2,2,2,0,0,0,2,0,0,0,0,0,6,1,4,0,7,3,0,0,4,1,3,0,0,1,2,2,1,19,1,5,2,2,3,7,6,7,0,2,1,0,1,7,210,1,0,0,1,2,2,1,1,0,2,0,2,3,1,5,1,0,0,1,0,1,0,0,1,3,1,9,1,0,1,0,0,1,0,1,3,0,16,6,0,0,5,2,0,0,0,0,4,2,0,3,2,1,2,3,3,1,0,0,4,1,0,0,0,2,1,0,5,0,0,0,0,4,0,0,1,0,2,0,1,0,1,0,5,9,0,1,1,0,5,0,0,0,1,0,3,1,0,6,3,1,0,3,6,2,3,3,1,0,0,1,1,2,7,2,12,0,6,0,1,4,1,1,5,1,1,0,1,6,6,0,1,4,0,0,2,2,0,1,4,0,3,0,5,0,0,4,4,0,6,1,4,2,1,6,0,0,41,1,1,1,0,2,5,0,0,0,4,0,2,1,4,3,0,0,0,2,1,0,0,1,3,1,0,3,3,1,3,1,0,0,3,3,0,0,5,1,2,2,0,4,2,0,3,5,3,0,0,3,7,0,1,0,0,1,0,0,0,0,2,1,4,0,0,0,4,0,0,1,12,1,3,0,1,12,4,1,0,2,2,0,2,0,0,0,1,0,4,1,1,3,0,2,2,0,0,0,0,5,2,0,0,0,2,0,4,1,3,10,3,0,6,2,5,0,0,0,0,4,2,6,1,2,1,0,1,2,0,0,0,6,0,1,0,6,1,0,1,0,0,0,1,2,0,1,0,0,0,0,0,0,0,0,1,0,0,1,0,0,1,1,2,0,0,1,0,0,0,5,0,2,2,0,0,6,0,0,1,0,0,0,0,0,0,3,0,1,3,2,0,0,0,1,1,0,2,2,3,1,0,0,6,1,0,0,1,7,0,1,0,2,0,2,0,0,0,2,1,3,1,5,4,1,7,1,0,1,3,0,2,10,1,0,3,1,0,3,0,1,0,0,1,3,6,5,2,0,0,0,2,0,0,0,1,2,0,7,2,0,5,1,1,1,10,0,0,3,1,10,0,1,0,3,2,4,3,0,0,0,3,1,3,1,7,0,1,1,4,3,1,2,1,1,0,0,4,0,0,0,5,2,5,2,2,1,0,3,1,1,7,0,4,0,0,3,3,1,1,0,1,2,5,0,3,0,0,8,0,0,1,0,1,0,4,0,1,0,0,1,2,0,2,1,3,0,0,0,0,0,0,0,0,2,0,0,5,0,0,0,4,0,0,1,0,1,1,2,0,0,0,1,0,0,0,0,1,1,0,0,0,0,8,1,3,1,7,2,1,2,0,0,1,0,0,0,0,3,0,0,1,0,0,0,0,0,0,1,4,0,0,0,0,2,2,1,0,0,4,1,0,0,0,0,1,5,0,1,0,2,1,0,1,1,0,2,0,1,2,0,1,0,5,0,0,2,0,0,7,0,1,0,6,0,3,0,4,0,2,2,0,0,4,4,2,1,3,0,0,2,1,3,2,1,0,4,1,0,0,2,0,0,3,0,0,0,0,0,1,0,0,0,1,0,1,0,2,0,1,0,0,0,1,1,1,1,1,2,0,0,0,6,0,0,1,3,0,0,0,0,0,11,2,0,0,0,2,5,1,0,0,0,2,1,1,0,1,0,6,0,2,2,0,0,0,0,1,1,0,0,0,0,0,1,3,0,3,0,1,1,1,0,1,1,0,0,1,2,0,0,4,2,3,6,1,3,3,2,2,5,1,0,6,0,2,2,0,0,4,2,0,3,2,1,0,1,4,0,0,1,0,0,0,0,0,2,0,1,1,0,1,0,1,0,1,1,0,2,0,0,0,1,1,4,3,0,0,0,5,10,0,0,0,1,1,0,1,0,3,7,0,2,3,3,0,1,0,1,0,0,2,1,0,2,1,0,0,1,3,0,4,0,2,0,1,1,0,2,0,0,3,2,0,0,0,2,2,1,3,0,0,1,1,0,1,0,1,0,0,0,0,2,0,0,1,1,0,2,4,4,2,0,1,3,0,1,1,0,0,3,4,0,0,0,0,2,0,0,0,0,0,1,0,1,0,2,0,0,0,0,2,2,3,1,0,2,0,0,3,1,1,0,0,3,19,0,9,0,1,0,12,0,0,0,1,1,0,1,0,2,0,0,0,0,0,3,1,1,0,1,0,2,1,0,7,0,2,1,0,0,0,0,0,2,4,1,2,10,3,3,0,5,0,0,0,0,0,1,2,0,0,3,0,1,0,0,0,1,0,2,0,1,3,0,2,1,0,1,1,3,1,0,1,2,2,0,0,0,0,0,0,1,2,2,0,1,2,1,1,1,0,0,1,0,1,3,0,0,0,3,3,1,2,0,0,0,0,0,0,2,0,3,3,1,0,0,0,1,0,0,0,0,1,0,0,1,0,0,1,0,0,0,0,0,0,1,0,0,0,1,0,0,0,0,1,0,1,0,1,3,0,0,0,0,1,0,0,0,1,3,1,0,1,0,3,0,2,0,0,2,0,1,1,0,0,2,0,0,0,0,0,3,0,1,2,2,0,1,0,0,0,2,0,0,0,1,0,0,3,0,0,5,0,0,1,0,6,0,0,0,1,0,0,4,0,0,2,1,0,0,0,1,1,2,0,0,0,1,0,0,2,0,1,1,0,1,4,0,2,0,0,0,1,0,4,0,0,0,0,1,1,3,1,4,1,1,1,0,0,0,0,0,3,3,0,0,2,0,0,1,2,2,2,0,0,0,0,0,0,2,0,0,1,1,0,0,0,0,0,0,1,0,0,0,0,0,1,0,0,0,3,0,0,3,1,0,2,0,0,0,0,3,1,1,0,0,0,1,0,1,2,0,0,0,0,1,1,1,1,0,5,0,0,0,1,0,0,0,1,0,2,0,0,0,1,2,4,0,2,2,0,0,0,6,0,2,2,2,0,0,2,0,2,4,1,0,0,1,1,1,0,3,0,0,1,1,0,1,0,1,0,2,0,0,1,0,0,0,0,3,0,2,0,2,1,0,6,0,0,0,0,0,0,2,2,1,1,1,1,1,1,0,1,0,0,1,1,0,0,0,1,1,0,1,2,0,6,0,0,1,0,0,0,0,0,0,2,0,1,0,2,0,0,1,0,1,0,1,2,0,1,4,1,0,0,0,4,2,0,0,0,1,0,3,0,0,0,1,0,1,4,21,0,0,1,3,2,0,2,0,0,0,0,0,2,0,0,2,0,0,4,3,0,0,0,0,0,0,1,4,0,1,4,0,0,2,2,1,0,0,1,3,1,6,0,0,0,0,0,1,0,0,1,4,0,1,0,2,2,1,1,2,0,1,4,0,4,0,1,0,0,0,1,3,2,1,0,1,4,0,2,1,0,0,0,0,0,0,21,3,0,0,1,3,0,1,0,1,4,0,2,0,3,0,1,0,3,1,0,0,1,0,0,0,0,0,2,0,0,1,0,0,0,0,0,1,0,0,1,3,2,0,0,0,1,0,1,0,0,1,0,1,0,1,2,0,0,0,1,0,0,3,1,1,0,9,0,0,1,1,1,3,0,1,0,0,57,0,0,1,0,0,1,1,1,0,1,0,0,1,0,2,0,2,2,0,0,4,3,0,0,0,1,4,2,2,0,1,1,0,0,0,0,2,0,2,0,0,0,0,0,0,1,1,0,0,0,6,0,0,0,0,1,2,1,1,0,0,0,2,3,1,0,0,2,0,2,0,0,0,4,9,1,0,0,0,0,1,1,5,0,3,0,0,0,0,2,0,0,0,1,0,2,0,0,0,0,1,3,1,4,1,0,0,0,0,0,1,1,2,2,0,2,2,0,0,1,8,0,1,1,0,0,0,1,0,1,0,2,0,5,3,0,6,0,2,1,0,0,0,4,0,0,0,1,1,0,2,0,2,2,1,1,0,0,0,0,0,2,2,2,2,0,1,0,0,0,3,0,0,0,1,0,0,0,0,0,0,2,1,0,1,0,0,0,0,0,1,0,4,0,1,0,0,0,3,3,0,0,0,6,1,0,0,0,0,1,1,1,8,0,0,0,1,1,2,0,0,1,0,3,0,2,2,0,0,1,2,0,0,0,0,1,0,0,1,3,1,0,0,0,0,1,0,1,0,0,8,1,1,0,1,0,0,0,3,0,2,0,3,0,0,2,2,0,0,0,4,0,1,0,1,0,2,1,1,0,0,0,0,0,0,2,6,0,0,3,0,0,1,0,0,0,0,2,1,0,1,0,0,0,1,0,2,0,1,0,0,0,0,0,5,0,1,1,2,0,2,0,1,1,0,0,0,0,0,1,1,0,1,0,3,0,2,0,5,2,0,1,1,1,2,3,0,2,0,0,4,3,0,0,0,2,3,0,0,4,0,43,0,0,0,2,1,0,0,0,3,1,0,0,2,1,0,0,0,0,0,0,1,1,0,0,0,1,0,0,0,2,0,0,0,1,2,0,0,0,1,1,0,1,0,1,0,0,0,0,0,0,2,1,0,0,3,1,11,1,0,0,1,0,0,0,2,1,1,0,0,0,0,0,1,0,0,2,4,1,0,6,1,1,6,2,1,2,1,0,1,3,1,0,0,0,0,0,0,0,0,0,0,1,0,0,4,0,0,0,0,0,0,2,0,0,1,0,1,3,1,2,0,0,0,0,0,2,1,0,0,0,0,1,0,2,1,2,0,0,0,1,0,1,0,0,0,0,0,3,0,0,1,0,0,0,0,1,0,0,0,4,0,1,1,1,0,1,0,0,0,0,3,3,0,0,0,1,2,0,0,0,0,1,1,0,0,0,1,1,1,0,0,0,0,0,0,2,1,0,0,0,0,0,0,0,0,2,1,0,1,1,0,1,0,0,0,1,0,0,1,0,0,0,0,1,0,1,0,0,1,1,0,0,2,0,2,0,0,0,0,0,0,0,0,0,0,0,0,0,0,0,0,1,0,1,0,0,0,0,0,3,2,0,0,0,1,0,1,3,0,1,2,0,1,0,0,1,0,1,0,2,1,2,1,4,0,0,0,2,2,0,0,0,0,0,1,4,4,5,0,0,0,1,0,0,0,1,0,0,1,0,0,0,0,1,3,1,3,0,0,0,2,2,3,1,1,0,0,0,1,0,1,2,0,0,2,0,0,0,0,0,1,2,0,0,0,0,2,0,0,0,0,1,0,0,0,1,0,0,0,0,0,2,0,0,0,0,1,0,1,1,0,1,0,3,0,0,0,2,0,2,0,0,0,0,0,0,0,1,0,0,1,1,2,0,0,0,0,0,0,0,0,1,1,0,0,0,0,0,1,0,0,0,2,4,0,1,1,0,0,0,1,0,0,0,0,0,0,2,0,0,2,1,0,0,0,2,0,0,4,1,0,0,0,4,0,0,0,0,0,0,1,1,0,2,0,0,0,0,10,1,0,0,0,0,0,1,0,0,0,0,0,0,1,0,1,0,1,1,2,0,0,0,0,0,0,1,1,0,1,0,0,1,0,0,0,2,0,0,0,0,1,0,0,1,0,2,0,1,0,2,1,0,0,0,0,0,1,2,0,0,0,0,0,0,0,0,0,0,1,0,0,0,2,1,0,2,2,0,1,0,2,0,0,2,0,1,0,0,0,2,1,0,2,0,2,0,3,1,1,0,0,0,0,1,3,0,0,0,1,0,1,2,1,0,0,0,1,0,1,1,0,0,4,1,0,0,1,0,0,0,1,0,0,0,4,1,1,1,0,0,5,0,0,0,1,0,0,0,0,1,0,1,0,3,2,0,0,1,0,0,1,2,0,0,2,0,0,0,0,1,0,0,0,0,1,0,3,0,1,0,0,0,0,2,0,0,0,0,1,1,1,1,1,0,4,0,0,0,1,0,0,1,0,0,0,1,0,1,0,0,1,0,1,0,0,0,1,0,1,0,1,0,0,1,1,3,0,1,1,1,0,1,0,0,0,0,0,0,1,0,0,0,0,0,1,2,0,0,0,2,0,0,0,0,0,0,0,2,1,0,1,0,0,0,0,3,0,0,0,0,0,2,1,1,1,0,1,0,6,0,0,0,0,1,2,0,0,0,1,1,0,1,0,1,0,0,0,2,0,1,0,0,1,0,1,0,1,0,0,0,0,2,0,0,0,0,0,1,1,0,1,0,34,0,2,2,1,2,0,0,0,1,0,2,2,0,1,1,2,0,1,0,0,5,0,0,0,0,0,2,1,0,0,0,0,2,0,0,0,0,0,1,1,1,0,0,0,1,0,0,1,0,0,0,4,1,0,0,0,0,1,0,0,0,0,1,0,2,0,0,0,3,0,0,0,0,0,0,0,0,0,0,0,0,3,0,0,0,0,1,2,0,2,0,1,0,0,0,0,1,0,0,1,0,1,0,0,0,0,1,0,3,0,0,0,0,1,0,0,1,0,0,0,5,0,0,0,0,0,0,0,0,0,0,0,0,0,0,0,1,1,0,1,0,0,0,0,1,0,0,0,0,0,0,1,0,0,0,1,0,0,0,0,0,2,0,0,3,0,0,1,0,0,0,0,0,1,1,0,0,0,0,0,3,0,0,0,0,0,0,0,0,0,0,0,0,3,2,0,0,1,1,0,0,0,1,1,1,0,1,0,0,0,0,0,0,0,0,0,1,1,3,0,0,0,0,0,1,0,0,0,0,0,0,0,0,0,0,0,2,1,0,0,0,1,0,1,0,1,0,1,0,0,2,0,0,0,0,0,0,0,0,0,2,1,1,0,0,1,0,0,0,0,0,0,1,0,0,0,0,0,0,0,1,2,1,0,1,0,0,0,0,0,1,0,0,0,0,0,0,0,0,1,0,0,1,3,0,0,1,0,0,1,0,0,0,12,1,0,0,0,0,0,0,0,0,0,1,0,0,1,0,1,1,0,0,0,0,1,0,0,1,0,0,2,0,0,0,0,1,0,0,0,1,0,0,1,0,1,1,1,0,0,0,0,0,0,0,0,0,0,0,0,0,0,0,0,0,0,0,0,0,0,0,0,0,0,0,0,0,0,0,0,0,0,0,0,0,0,0,0,0,0,0,0,0,0,0,0,0,0,0,0,0,0,0,0,0,0,0,0,0,0,0,0,0,0,0,0,0,0,0,0,0,0,0,0,0,0,0,0,0,0,0,0,0,0,0
K56 Big Driver,king,2282,1010,892,990,821,309,269,605,872,682,410,181,467,1220,846,377,403,235,266,187,220,367,179,108,79,192,85,90,165,51,158,157,154,207,140,177,151,119,23,174,187,147,180,172,89,163,164,97,231,143,134,71,145,99,102,62,139,81,87,87,79,70,80,65,70,61,26,66,42,101,47,61,45,58,81,79,42,124,58,62,54,42,35,72,64,55,53,39,97,62,41,66,78,21,71,54,63,50,58,40,35,66,47,50,90,44,61,68,34,50,49,59,7,43,37,49,40,20,62,26,40,14,71,49,25,29,44,33,41,26,60,60,37,39,36,36,12,42,53,26,54,26,16,40,78,48,45,76,33,54,15,52,43,31,29,18,5,35,31,4,23,34,70,28,41,33,27,27,24,23,18,19,35,27,35,14,24,12,30,52,27,15,45,32,14,51,11,31,47,16,26,14,29,16,14,20,4,19,60,5,12,33,24,30,8,6,20,16,27,76,13,18,9,27,24,14,21,11,18,12,17,13,13,13,19,40,18,23,25,29,24,15,8,55,16,42,16,19,21,18,7,9,31,16,9,20,21,33,16,25,22,14,15,16,16,6,9,13,12,8,14,26,20,20,33,5,18,10,22,18,17,23,38,12,13,9,11,11,26,23,8,10,16,11,41,4,12,12,8,5,18,7,30,7,13,15,17,17,5,33,22,8,9,8,22,8,7,12,3,6,5,6,10,23,12,7,11,25,11,10,5,52,12,11,59,9,15,20,12,10,21,10,9,13,78,13,10,2,10,21,9,5,9,15,13,13,16,9,12,7,29,10,18,14,36,5,15,25,9,10,9,2,7,24,9,14,12,6,12,9,8,13,19,22,10,21,6,4,10,9,18,3,14,4,9,18,0,4,12,14,22,9,20,0,13,19,5,7,9,6,4,14,12,13,18,3,13,14,12,6,8,4,9,9,15,17,8,22,9,12,11,0,3,9,8,5,5,14,6,11,14,13,5,10,1,4,5,7,5,6,5,17,0,10,9,16,3,6,6,5,6,5,3,13,5,4,16,18,10,11,10,20,0,3,5,4,12,4,4,19,8,13,14,2,10,5,4,10,0,14,4,3,8,39,2,7,7,0,8,4,4,13,12,6,12,4,9,13,0,5,8,16,4,4,6,4,4,18,13,8,9,11,6,11,4,21,0,5,7,8,10,4,6,8,6,9,10,2,5,11,1,5,10,6,7,1,2,20,3,6,9,7,14,12,0,17,0,5,6,5,7,14,4,1,3,6,8,8,8,1,9,4,0,0,6,14,6,1,3,0,11,5,7,4,11,3,5,1,3,8,4,13,4,3,1,8,3,18,22,6,11,3,4,3,2,3,1,4,4,6,19,17,15,3,5,0,0,5,6,3,5,1,7,1,0,6,15,3,3,2,8,18,1,6,5,10,12,11,8,3,13,9,4,4,2,0,7,9,3,6,8,3,12,5,5,16,10,2,9,11,0,2,8,5,5,14,2,3,10,1,5,8,9,4,3,12,9,11,11,2,14,8,2,6,2,3,1,2,6,4,15,6,4,4,14,6,4,2,2,9,8,2,0,18,8,3,1,0,5,14,2,2,5,5,8,2,0,24,4,2,2,7,3,2,4,2,1,6,10,5,5,41,3,1,2,4,4,1,1,0,7,16,0,4,0,12,7,1,1,4,8,14,3,7,0,0,1,2,2,2,1,0,5,5,5,10,9,3,1,2,0,4,15,0,2,0,2,1,3,4,6,7,1,3,1,1,1,2,3,6,3,7,1,6,7,8,3,3,0,7,6,3,0,2,6,24,0,2,0,4,6,3,2,5,2,2,22,6,0,8,1,2,6,0,0,7,1,1,5,3,1,8,6,6,5,1,0,5,6,6,6,6,4,3,0,3,1,2,0,3,8,3,3,2,15,4,0,0,5,2,4,7,1,2,5,4,0,11,15,8,5,3,7,3,2,6,8,1,4,12,0,3,6,1,0,9,0,1,1,2,8,7,2,6,2,3,6,4,2,2,7,2,5,5,3,2,0,0,3,2,1,3,5,1,5,1,3,1,1,6,3,0,9,0,3,0,2,4,5,4,4,0,1,3,4,4,0,0,5,0,6,1,1,0,1,23,1,3,2,11,4,6,11,2,2,0,5,1,4,4,1,5,4,9,0,2,4,2,2,1,0,3,6,0,1,5,3,1,3,2,1,0,1,3,0,5,4,7,4,12,1,12,2,3,12,5,6,0,1,41,2,1,9,4,3,3,0,4,7,0,2,0,2,0,2,8,0,0,0,5,3,8,4,0,5,1,5,0,2,1,4,6,16,5,9,3,5,1,1,3,8,9,3,0,10,3,10,2,1,9,0,3,2,3,5,4,4,2,12,7,2,3,0,3,4,0,3,3,1,5,1,0,0,1,1,10,6,11,0,0,0,3,1,4,13,3,1,0,6,5,2,1,2,3,1,2,1,10,3,0,6,0,4,2,1,2,3,1,9,1,4,4,6,1,8,0,2,3,6,7,1,3,1,1,0,1,2,0,2,0,3,4,0,6,1,6,2,6,30,0,2,1,3,0,12,2,4,3,0,10,9,0,1,9,1,1,4,1,4,0,10,0,2,1,0,2,0,7,1,11,1,2,2,9,1,2,3,2,0,0,1,4,2,5,2,3,0,11,1,0,1,4,1,1,2,17,0,1,2,0,9,12,0,4,3,1,2,2,0,3,4,0,1,0,4,1,0,2,2,10,0,4,1,5,0,0,0,2,0,1,5,6,11,1,2,2,4,7,1,1,0,8,0,2,3,0,2,1,6,12,1,0,6,0,1,0,0,2,3,6,6,3,0,4,2,1,1,3,1,1,1,0,3,2,0,2,4,1,5,1,1,0,0,0,0,2,2,3,0,0,10,2,5,2,6,3,4,0,4,4,0,2,1,1,1,5,0,5,0,4,4,1,3,2,3,20,0,1,0,0,2,0,4,2,1,5,1,2,0,3,3,3,0,0,6,4,0,5,3,3,0,8,2,0,1,4,5,7,1,3,0,2,1,0,1,17,3,3,0,0,2,1,1,2,2,0,4,3,0,1,2,0,3,0,4,1,2,2,1,4,4,2,5,2,4,0,0,6,0,3,0,0,3,4,2,3,1,2,0,4,3,5,0,2,2,0,2,0,5,0,0,1,0,5,0,0,0,0,5,1,1,3,1,1,0,6,1,2,1,2,12,6,0,0,3,1,9,0,11,4,0,1,0,0,0,4,0,3,4,2,1,2,0,6,0,5,3,6,1,4,3,1,0,2,0,0,2,2,3,2,1,1,1,0,6,1,3,0,3,2,1,2,5,2,0,0,0,19,0,0,2,3,1,5,5,0,1,0,2,0,7,8,3,6,3,2,0,4,0,6,4,2,0,0,0,1,0,1,3,0,9,3,0,0,2,8,0,0,3,0,1,2,1,2,4,4,1,0,2,4,3,2,0,11,3,0,3,0,2,5,6,0,4,5,1,7,1,1,2,0,3,0,3,6,11,3,0,0,2,3,8,2,2,0,6,4,0,1,7,2,7,1,6,0,4,4,4,2,2,4,3,8,2,10,11,0,2,6,1,2,0,2,4,1,5,5,0,0,3,2,0,0,0,1,1,4,4,2,1,0,2,0,2,0,3,0,0,4,0,0,0,3,7,0,0,1,0,0,0,1,1,0,0,2,2,1,3,2,0,1,4,0,5,0,0,1,0,2,0,0,0,2,1,0,4,0,2,4,3,2,3,4,1,0,6,0,0,0,3,4,2,9,9,3,1,1,0,4,0,0,2,7,4,0,3,0,1,3,3,2,1,0,2,0,0,0,3,1,0,2,2,0,0,1,4,1,2,2,11,0,1,1,12,3,1,0,1,1,0,2,0,3,2,2,2,0,5,2,4,1,1,12,5,0,3,1,6,1,3,2,2,2,6,0,0,4,0,2,1,0,1,0,0,4,1,1,0,1,4,2,2,1,1,0,1,3,3,0,0,0,0,0,0,1,4,0,0,1,2,2,2,5,0,2,3,0,1,1,1,0,2,1,0,2,2,0,0,0,0,2,0,0,6,1,0,0,5,7,0,0,1,4,6,0,1,1,0,0,7,4,3,3,0,0,6,2,0,4,0,0,0,5,1,7,0,2,1,1,0,1,0,2,0,1,0,7,5,1,1,0,4,3,1,0,1,8,8,0,1,1,1,0,0,0,1,0,0,5,0,0,0,0,2,0,0,5,0,0,4,5,0,4,1,20,0,1,3,1,0,6,0,3,0,0,1,3,0,1,0,0,0,0,1,0,0,0,1,0,61,0,0,1,0,0,0,3,0,3,0,0,5,0,0,0,0,2,2,2,2,0,16,0,0,0,0,0,0,0,0,4,3,1,0,1,0,2,3,1,1,2,0,2,13,4,0,1,0,1,1,2,1,1,0,5,1,0,6,1,0,0,3,2,0,0,0,1,0,0,2,2,0,3,2,2,8,0,0,1,3,3,0,0,2,3,1,1,2,0,0,2,3,0,0,0,0,3,0,3,1,0,9,6,5,6,0,3,2,0,0,8,5,2,3,2,1,0,1,6,0,0,1,0,3,0,0,6,1,0,0,1,9,2,0,0,0,1,2,0,2,1,0,6,4,1,4,2,0,0,2,1,0,1,0,2,0,0,0,1,3,0,0,1,2,1,0,0,3,0,2,0,1,1,6,1,2,1,1,0,0,11,0,1,3,2,0,6,0,0,1,3,1,0,0,2,4,0,0,0,2,4,0,0,1,0,1,0,0,4,0,0,4,0,3,0,0,0,2,0,2,1,1,0,1,0,0,1,2,11,5,0,0,1,2,0,1,2,4,0,0,0,0,8,0,0,0,3,1,1,1,3,0,3,0,1,7,7,0,1,4,0,0,0,2,0,1,0,0,1,0,1,0,0,0,0,1,1,0,0,2,0,4,1,0,0,0,22,1,4,1,0,1,0,1,0,3,1,0,0,0,2,0,1,2,1,5,0,0,0,0,2,1,3,0,1,0,4,2,2,0,3,0,0,1,2,0,0,0,0,1,0,11,7,0,0,0,2,4,1,0,0,1,0,0,1,0,1,0,0,1,1,0,0,0,0,8,3,0,2,0,1,0,0,0,2,1,2,3,1,1,0,1,0,11,0,4,0,1,0,1,1,1,0,3,0,1,0,1,1,9,3,0,0,5,3,3,5,0,3,0,0,1,1,3,0,0,0,3,1,2,0,0,3,0,1,2,0,2,2,0,1,0,0,0,2,3,0,1,4,3,2,0,0,3,1,3,0,0,8,5,0,12,0,0,0,2,3,1,4,0,0,0,1,2,1,0,7,3,3,1,0,0,0,0,3,1,0,3,2,0,1,0,0,0,1,0,0,1,1,5,5,1,0,1,0,1,2,0,0,0,0,3,6,0,0,0,3,1,2,1,0,1,1,1,0,2,2,0,0,0,0,2,0,1,0,18,0,0,0,0,0,0,0,2,0,1,0,0,0,0,0,0,2,19,0,1,0,0,1,0,3,2,0,5,1,0,1,2,0,0,3,0,2,2,0,10,0,0,2,1,0,0,1,1,0,1,0,0,0,1,1,0,0,1,2,0,3,0,0,2,5,2,6,0,1,1,0,1,0,5,0,0,2,0,6,2,0,0,0,1,0,0,0,0,0,0,0,0,2,1,1,2,0,1,0,1,0,8,1,0,0,0,1,0,0,3,0,1,0,1,1,1,0,0,0,0,1,1,0,3,0,0,1,0,1,0,2,0,2,0,1,0,0,25,2,0,5,0,0,0,0,3,0,0,0,0,0,0,0,0,2,0,0,0,1,1,2,1,0,4,1,2,0,1,2,1,0,1,2,1,1,3,0,0,0,1,0,0,1,1,0,3,1,2,0,1,3,1,0,0,12,1,0,2,0,0,1,2,2,3,0,0,3,0,0,1,2,0,1,0,0,0,1,0,5,0,0,0,1,24,0,0,2,2,0,0,2,0,0,1,2,0,0,1,1,1,3,1,1,1,4,2,0,0,1,0,0,1,2,0,2,0,2,1,2,0,0,0,0,1,1,0,0,1,2,1,0,0,1,3,4,0,0,0,3,0,0,0,0,1,0,0,2,0,0,0,1,0,1,0,1,1,0,1,0,0,0,3,0,0,0,1,0,1,0,0,0,2,3,0,3,1,0,1,0,2,0,1,0,0,0,0,0,0,0,0,0,0,0,0,0,0,0,0,1,0,0,2,17,1,2,2,2,0,2,6,0,12,1,0,0,0,1,4,2,0,0,1,0,1,1,1,0,7,1,1,1,1,2,0,0,2,0,1,0,0,0,2,1,0,5,1,0,2,1,3,1,0,0,1,0,0,1,2,0,0,0,0,0,0,0,1,0,1,0,0,4,3,0,1,0,0,0,0,1,0,0,1,0,0,0,0,0,0,0,0,0,2,2,0,2,3,0,0,0,0,1,0,1,0,1,0,0,2,0,0,1,0,0,0,0,1,0,0,0,0,2,0,0,1,0,5,2,0,0,1,3,0,0,2,1,2,1,2,0,0,2,0,0,1,0,0,1,0,0,0,5,0,1,0,1,0,0,3,0,0,4,0,6,1,0,1,0,0,0,1,1,2,2,1,3,0,2,1,2,1,1,1,0,0,0,0,0,5,0,0,1,0,2,0,1,0,0,1,0,0,1,0,0,0,6,0,1,0,1,0,2,0,0,0,1,0,0,1,1,0,0,2,1,0,2,0,0,0,0,0,1,1,3,0,0,0,0,0,0,0,1,1,0,2,0,14,0,2,0,0,0,0,0,0,1,0,2,3,0,6,5,1,4,3,1,0,3,0,0,1,1,3,6,1,1,0,0,1,2,0,0,2,0,1,2,1,0,0,0,0,0,0,0,0,0,0,3,0,1,1,0,1,0,0,2,0,0,0,3,0,1,0,0,0,1,0,0,0,0,6,1,1,0,1,0,0,0,1,1,0,1,0,0,1,5,1,1,0,1,0,1,0,2,0,1,0,0,0,0,0,0,1,0,0,3,1,0,1,0,1,0,2,0,1,1,0,4,0,1,0,2,1,0,0,2,0,2,0,3,0,0,3,0,1,0,0,0,0,27,1,0,0,0,0,3,0,1,0,1,0,1,2,1,0,2,1,1,0,0,2,0,0,0,0,6,2,0,1,7,1,2,1,0,2,1,3,0,1,0,2,0,0,4,0,0,2,0,0,0,0,4,0,4,0,0,0,0,0,0,0,0,0,0,1,4,0,2,0,0,0,0,0,0,1,1,0,0,0,0,1,0,1,0,1,0,0,0,0,5,1,0,0,1,1,1,0,4,0,0,0,0,1,0,0,0,4,0,1,10,0,1,2,0,0,2,0,1,1,0,1,2,0,2,1,1,4,1,0,0,0,0,0,0,1,2,5,0,6,3,0,3,0,0,2,0,1,4,1,0,0,0,1,0,0,3,0,0,0,0,2,0,1,0,2,0,1,1,0,2,0,0,1,1,0,2,0,1,2,0,0,1,0,0,1,2,0,0,0,1,1,0,0,0,6,4,1,0,1,0,0,0,1,0,1,0,0,2,0,0,0,0,0,0,1,1,2,0,0,0,2,0,0,0,0,0,0,1,4,0,0,0,0,1,0,0,0,7,0,0,0,2,3,1,1,2,3,0,0,0,0,0,3,0,1,0,0,0,1,1,0,2,0,1,0,0,0,0,1,1,0,0,0,3,1,0,3,0,0,0,1,0,0,0,1,2,0,0,4,0,2,0,0,0,0,0,0,0,1,0,0,0,0,0,1,0,1,3,0,0,1,4,0,0,0,3,0,0,3,1,0,2,1,0,0,1,0,0,1,1,0,1,0,0,0,1,4,0,0,1,1,1,1,1,0,0,3,0,0,0,0,1,0,0,0,0,0,1,0,0,1,0,0,0,0,0,0,2,0,0,0,1,0,0,0,0,1,1,0,0,0,0,1,1,0,0,0,1,0,3,1,0,8,0,0,0,0,0,9,1,0,0,2,3,0,2,0,1,1,2,0,1,0,0,4,0,0,1,0,0,3,0,1,0,1,0,3,15,0,0,0,0,1,0,0,0,0,3,0,1,1,0,0,0,0,0,0,0,0,14,0,4,0,0,3,1,0,0,1,0,3,0,0,0,0,0,3,1,1,0,0,0,2,0,1,2,0,0,0,0,0,0,8,0,0,1,0,0,0,1,0,0,1,3,1,1,1,0,0,0,0,0,0,1,0,0,0,2,0,2,0,0,1,0,1,0,0,0,1,0,0,1,0,0,0,1,5,0,0,1,1,0,2,0,1,1,0,1,0,0,0,0,0,0,1,1,0,0,2,0,1,4,0,0,0,0,2,0,1,0,0,1,0,0,0,0,5,2,0,0,0,0,0,0,1,3,0,0,0,1,0,0,1,0,0,5,1,0,0,0,1,0,0,0,2,0,1,0,0,0,0,0,1,0,0,0,2,0,2,0,0,2,0,0,0,0,0,1,0,0,0,1,0,0,2,0,0,0,0,2,2,1,0,0,0,0,2,0,0,0,0,0,1,0,0,0,0,11,0,0,0,0,2,0,1,0,3,0,0,0,0,3,0,0,0,1,0,0,1,0,0,0,1,0,0,1,0,2,0,0,0,0,0,1,1,0,0,0,0,0,2,0,1,0,1,0,0,1,1,2,0,0,4,1,0,0,0,1,0,0,0,0,0,0,1,2,1,0,0,0,0,4,0,5,0,1,0,0,0,3,2,1,0,1,1,0,2,1,1,1,1,0,0,0,7,2,1,0,0,0,0,5,1,0,0,0,0,0,1,1,5,1,0,0,0,0,0,1,2,0,0,0,0,0,0,0,0,2,0,0,1,0,0,0,1,0,0,0,0,0,0,1,0,0,1,0,1,1,0,0,0,0,0,0,3,0,1,0,0,1,0,0,1,0,0,0,0,0,0,0,0,1,2,3,0,0,1,1,1,1,1,2,0,0,0,1,1,0,0,0,1,0,1,3,0,7,0,0,0,0,0,1,0,0,0,0,0,0,1,0,1,0,1,0,0,0,0,2,1,0,7,2,0,0,0,0,0,0,2,0,0,1,0,0,0,1,0,0,4,0,1,0,0,0,1,0,1,1,1,1,0,1,0,0,0,0,2,0,0,1,0,0,0,2,1,3,0,0,0,1,1,1,3,0,0,1,1,0,2,1,1,0,2,0,2,0,0,1,0,3,2,0,0,0,0,0,1,3,0,0,0,0,0,1,0,0,0,0,2,5,1,0,0,0,0,0,0,1,1,0,1,0,1,1,0,0,0,0,0,8,0,0,0,0,0,0,0,1,0,1,0,0,0,0,3,0,0,3,0,0,0,1,0,0,1,3,0,0,1,0,1,1,1,1,0,0,1,1,0,0,1,0,1,0,1,0,1,3,0,0,0,5,0,2,0,0,0,0,0,0,0,0,0,1,0,0,0,0,0,0,0,0,0,0,0,2,1,2,1,0,0,1,0,1,0,2,0,0,0,0,0,1,12,0,0,0,0,0,0,0,1,3,0,1,1,0,2,0,0,0,1,0,0,0,0,2,1,0,1,0,0,0,0,1,0,0,0,0,0,1,1,0,0,0,0,2,0,0,0,0,1,0,0,2,2,7,0,4,0,0,0,0,0,0,0,0,1,0,0,0,0,0,1,0,0,1,2,1,0,0,0,0,0,0,0,0,2,2,0,0,0,2,0,0,0,0,0,0,1,0,4,0,0,0,0,0,2,0,0,0,0,0,0,0,0,0,0,1,0,0,3,1,2,0,0,0,1,0,0,0,2,10,0,0,1,1,1,0,0,2,0,1,0,2,0,0,0,0,7,2,1,0,0,1,0,0,1,0,0,0,0,1,0,1,0,2,0,0,2,1,0,0,0,0,1,0,4,0,1,0,0,3,0,1,1,1,1,0,0,0,0,3,0,0,0,0,1,2,0,0,0,0,0,0,0,0,0,1,0,0,0,0,1,2,0,8,0,0,0,1,0,0,1,1,0,3,0,0,1,1,0,1,0,0,0,0,0,0,0,0,0,0,0,0,0,0,0,0,0,1,0,0,1,0,0,2,0,2,2,1,0,0,0,0,1,1,5,0,0,1,0,0,1,2,0,0,0,0,0,0,1,2,0,0,0,0,0,0,0,0,0,0,0,0,0,0,0,0,1,0,1,0,1,0,0,3,1,0,0,0,0,0,0,0,2,0,0,0,0,1,0,0,0,0,1,0,0,2,0,2,0,0,0,2,6,0,0,0,1,0,0,1,0,1,1,0,3,0,0,0,0,0,0,0,0,1,0,1,0,0,1,0,0,0,0,1,0,0,2,0,0,0,0,0,0,0,0,0,0,2,0,1,0,2,0,0,2,1,0,0,0,0,0,0,0,2,0,0,0,0,0,0,0,0,0,1,0,0,0,0,0,0,1,1,0,0,1,0,0,0,0,0,2,2,1,3,0,0,0,0,2,1,0,0,0,0,0,0,1,1,1,0,0,0,0,1,0,2,0,1,2,2,0,0,0,1,0,0,0,0,0,0,0,0,0,0,0,0,0,0,0,0,0,0,0,0,1,0,0,0,0,0,0,0,1,3,0,2,1,0,0,1,1,0,0,0,1,0,0,0,0,0,0,0,0,0,0,1,0,0,0,7,1,15,0,0,0,0,0,0,0,1,0,0,0,1,0,0,0,1,0,0,0,0,3,2,0,0,0,2,1,0,0,1,0,0,0,0,3,0,0,0,0,0,0,0,0,0,2,0,0,0,0,1,0,0,0,3,0,0,0,0,0,0,0,0,0,0,0,0,0,1,0,0,0,0,0,1,1,0,0,1,0,0,0,0,0,1,0,1,2,0,1,0,0,1,0,0,0,0,0,0,0,0,0,0,0,0,0,0,2,0,0,0,0,4,0,0,0,0,0,0,0,0,1,0,0,0,0,0,0,0,1,1,0,2,0,0,1,0,0,0,0,0,0,0,5,0,0,0,1,0,2,0,0,0,0,1,3,0,0,0,0,0,1,0,0,0,1,0,0,0,0,0,1,0,0,0,0,0,0,0,0,0,0,0,0,0,1,0,0,0,0,0,0,0,0,0,0,1,1,0,0,1,0,0,0,0,0,0,2,0,0,0,1,0,0,0,0,0,0,0,0,0,0,0,0,0,0,0,0,0,0,0,0,0,0,0,0,0,0,0,0,0,0,0,0,0,0,0,0,0,0,0,0,0,0,0,0,0,0,0,0,0,0,0
K57 Fair Extension,king,491,304,208,301,202,130,210,174,166,162,144,176,116,44,55,77,94,72,79,92,68,91,63,55,28,43,36,21,37,50,32,30,25,39,31,47,34,35,22,38,51,40,36,30,19,28,30,27,23,28,30,18,25,20,31,17,24,33,24,38,17,28,27,19,30,27,15,24,20,20,27,17,16,16,22,16,22,13,12,10,7,23,24,17,13,24,6,13,16,14,12,10,13,10,12,12,10,5,27,13,16,14,15,8,30,16,24,9,16,8,7,27,7,5,12,5,5,12,20,14,8,9,7,18,7,9,15,15,9,7,12,10,13,16,8,5,5,10,5,1,6,6,8,12,13,11,2,14,8,5,11,16,8,2,6,10,14,6,7,9,2,12,9,17,5,5,7,4,7,12,7,15,5,4,10,7,18,6,9,5,10,5,10,3,7,11,5,2,8,0,3,3,3,3,3,9,4,4,5,4,10,7,13,11,1,14,3,2,4,7,1,4,5,3,5,2,5,2,7,4,6,8,3,5,8,8,1,5,5,10,5,6,5,4,5,0,10,4,2,5,4,9,4,6,5,4,5,7,4,3,13,2,4,0,1,2,2,3,2,3,5,5,6,5,8,12,5,2,5,2,6,4,11,0,2,8,8,3,5,9,2,8,3,3,8,4,0,3,3,1,1,4,0,2,2,2,3,4,3,12,14,0,2,3,6,6,2,5,3,10,3,2,3,2,6,1,0,9,2,1,5,16,3,4,2,0,3,0,1,3,8,2,1,3,4,2,6,5,6,6,1,2,2,2,2,4,0,3,7,2,7,0,2,2,1,3,1,3,3,7,6,0,4,1,2,6,4,2,4,2,7,0,1,3,1,5,3,12,12,3,1,2,2,5,2,1,0,0,4,4,1,7,3,2,2,2,6,3,10,3,5,3,7,2,2,6,6,1,0,3,1,2,3,3,2,1,2,0,2,5,3,3,0,9,0,5,2,0,1,2,2,1,3,3,1,0,2,7,5,5,3,6,5,0,2,1,3,3,3,2,1,1,2,7,8,2,1,1,1,0,2,2,0,1,0,4,2,0,2,2,0,1,5,0,1,4,1,0,0,1,1,7,0,0,4,2,3,0,4,3,0,1,2,2,6,0,6,1,0,1,2,2,0,1,1,1,1,2,3,0,1,7,0,3,12,6,0,2,3,0,2,4,2,3,4,1,6,2,1,5,0,0,9,4,8,0,1,3,0,4,3,1,7,0,2,2,0,3,5,3,3,5,3,1,2,1,1,5,2,2,1,1,0,1,2,3,2,0,3,1,7,1,1,1,0,1,0,0,0,5,1,3,4,0,0,0,1,5,4,2,1,1,0,5,1,7,0,1,3,3,0,2,3,0,0,0,0,0,2,1,0,0,2,2,1,1,2,1,0,3,3,2,2,2,2,1,1,2,6,0,2,0,0,1,1,0,1,3,3,1,1,5,2,0,2,1,2,0,4,0,1,4,1,2,3,4,0,2,2,3,0,4,0,3,3,2,3,3,1,3,2,0,1,4,1,2,1,1,1,0,1,2,3,2,2,1,1,3,1,4,1,9,0,5,0,3,0,1,1,1,0,1,7,2,1,4,3,3,13,3,0,2,0,0,1,2,0,1,2,2,0,0,0,0,0,0,2,2,1,0,0,2,1,0,0,5,7,2,0,2,2,0,0,0,0,1,1,2,2,0,1,0,0,4,0,5,4,5,0,0,1,0,2,0,0,4,4,0,2,1,0,3,0,1,1,0,1,2,1,0,0,4,1,2,2,4,2,2,3,1,3,1,0,1,2,1,0,1,0,1,2,1,1,4,0,1,11,1,0,6,0,0,3,1,0,2,2,0,1,6,2,3,1,1,0,3,0,0,4,1,2,0,0,0,0,0,2,1,2,2,5,0,2,1,1,0,1,0,3,1,2,0,0,0,1,1,0,0,1,1,1,1,0,0,1,1,1,0,0,1,0,1,0,2,0,2,0,3,0,2,1,0,0,0,0,2,1,4,0,2,10,1,0,1,4,1,0,0,0,4,0,2,1,0,5,2,3,1,5,1,2,0,0,0,0,0,0,1,1,1,1,0,0,4,0,0,0,0,1,0,3,2,1,0,0,1,2,0,3,1,1,4,0,0,1,1,0,0,2,1,0,1,0,3,0,0,0,0,1,1,0,0,1,0,1,1,1,0,0,2,1,0,0,0,1,0,1,3,0,2,0,3,0,0,2,0,1,0,0,0,0,0,2,0,0,1,0,1,0,0,0,0,1,0,1,6,0,0,0,0,1,0,0,1,3,2,3,0,1,2,0,1,0,0,0,1,1,2,0,1,2,0,2,0,2,0,1,0,0,6,0,1,0,0,0,0,0,0,4,4,0,0,1,0,0,0,1,0,1,0,1,1,0,0,0,0,3,0,0,0,0,0,2,1,5,3,2,0,0,2,0,0,0,0,11,0,1,3,0,0,4,0,0,1,0,3,0,1,3,2,2,0,0,0,0,0,0,0,2,1,6,2,0,0,0,0,1,0,4,1,0,2,0,0,0,2,1,1,1,0,0,1,0,0,0,0,0,0,0,1,1,0,1,2,0,0,2,0,0,1,0,0,0,0,1,0,0,0,0,1,0,0,1,2,0,1,0,2,1,0,0,1,0,0,0,1,0,0,0,0,2,0,0,1,3,2,0,1,3,0,5,2,0,0,0,1,0,0,0,0,0,0,3,0,2,0,0,2,1,0,0,0,0,0,1,0,0,0,0,0,0,0,1,2,0,2,0,0,2,0,0,0,0,0,2,0,0,1,0,1,3,0,1,0,0,1,0,1,0,4,0,0,1,0,0,0,1,2,0,1,1,0,5,0,0,0,1,0,5,0,1,0,0,0,0,0,2,1,0,1,0,0,6,0,1,1,4,0,0,2,0,0,0,1,3,3,1,4,0,0,2,0,0,1,0,1,1,0,1,0,0,0,1,0,3,0,0,3,0,0,0,2,0,0,0,2,0,1,0,0,0,0,0,1,0,1,0,0,0,1,1,0,5,0,0,5,1,3,0,0,1,0,0,0,0,0,0,1,3,3,0,2,0,0,2,0,1,0,2,0,0,0,2,2,0,0,0,0,0,0,0,0,1,0,1,1,0,1,0,1,1,4,1,0,0,2,0,0,0,1,0,0,0,1,21,5,0,0,0,0,0,1,1,0,0,3,0,0,2,4,0,0,0,0,0,0,2,0,1,1,0,0,0,0,0,1,0,1,0,0,0,0,2,2,1,3,1,4,0,1,0,7,0,1,0,0,0,0,0,0,1,0,0,0,0,2,2,0,0,0,0,0,0,0,0,0,0,0,0,1,3,2,1,4,0,1,0,0,2,4,1,1,0,1,0,3,0,0,0,1,0,0,0,0,0,0,0,0,0,0,1,0,0,0,0,0,0,0,0,0,0,0,2,0,0,4,0,1,0,0,0,1,0,0,0,0,0,4,2,1,7,0,0,1,1,1,0,0,0,0,0,0,5,0,0,0,1,0,0,0,1,0,1,0,0,0,1,0,0,0,1,0,0,0,1,0,0,0,0,0,1,0,1,1,1,1,0,0,0,1,0,1,0,4,0,0,0,0,0,1,0,0,0,0,0,0,2,0,0,0,1,1,0,1,0,0,0,0,0,0,0,0,0,0,0,1,1,0,0,0,0,0,0,0,0,3,0,0,1,0,1,4,1,0,0,0,2,0,2,0,0,0,0,0,0,0,0,1,0,1,0,4,0,0,1,0,1,0,0,0,0,0,2,0,0,0,0,1,0,0,2,1,0,0,0,1,0,1,0,0,0,0,0,0,0,0,0,0,0,0,0,0,2,0,0,0,0,0,0,6,0,0,0,3,0,0,0,0,0,0,0,1,0,0,0,0,2,0,1,1,0,0,0,0,2,2,0,0,0,1,0,1,5,0,0,0,0,0,1,1,0,1,0,0,0,0,0,0,0,0,1,0,1,1,3,0,0,0,1,0,0,0,0,0,1,0,0,0,0,1,0,0,1,0,1,1,0,2,1,0,2,0,0,0,0,0,0,0,1,3,1,0,0,0,0,0,0,0,3,0,1,0,0,0,0,1,0,0,0,0,7,0,0,0,1,0,0,1,0,0,1,0,0,2,0,0,1,0,0,0,0,2,0,0,0,1,1,0,3,0,0,0,1,0,4,0,5,0,0,0,0,4,0,0,0,0,0,0,0,0,0,1,0,0,0,0,1,0,0,0,0,0,0,0,0,2,0,0,0,0,0,1,0,0,0,1,0,0,2,0,0,1,1,2,0,0,1,0,34,1,0,1,0,0,0,0,0,0,1,0,2,0,0,2,2,0,0,0,0,1,0,0,0,1,1,0,0,1,0,1,0,1,0,0,0,1,0,1,0,2,0,0,0,0,0,1,0,0,0,0,4,0,0,0,0,0,0,0,0,0,0,0,0,0,0,0,0,0,0,1,0,1,0,0,0,0,0,0,2,0,0,0,0,0,0,1,2,0,0,0,1,0,0,0,1,0,0,1,0,2,1,0,0,2,0,1,0,0,0,0,0,0,0,0,0,0,0,0,0,0,0,1,0,1,0,1,2,0,0,0,0,1,0,0,0,0,1,0,0,1,1,0,0,0,2,2,1,0,1,0,0,1,0,0,0,0,1,0,1,0,0,0,0,1,0,0,0,0,0,0,0,0,0,0,0,1,0,0,0,2,0,0,1,1,0,2,0,0,0,0,0,0,0,0,0,0,0,0,1,0,0,0,3,1,0,0,1,1,0,0,0,0,1,0,0,0,0,0,1,1,2,1,0,0,0,0,0,0,0,0,0,4,0,0,1,0,0,0,0,0,1,1,0,0,0,0,0,0,1,0,0,1,0,0,0,0,0,0,0,0,1,0,0,0,2,0,0,0,0,0,0,0,0,0,0,1,0,0,0,0,1,0,0,0,0,0,0,0,0,0,0,0,0,0,0,0,0,0,0,0,4,0,1,0,1,0,0,2,0,0,0,0,0,0,0,1,0,0,0,0,1,0,0,0,0,0,0,0,0,0,0,1,0,0,0,0,1,0,1,0,0,0,0,0,0,0,1,0,0,1,0,0,0,0,2,0,0,2,0,0,1,0,0,2,0,2,0,1,1,1,0,1,3,1,0,0,0,0,0,4,0,0,0,2,1,1,1,1,0,0,0,0,0,0,0,6,0,2,0,0,0,0,0,0,0,0,2,0,0,0,0,0,0,2,1,0,1,0,1,0,0,2,2,0,0,0,0,0,0,1,1,1,1,0,0,0,0,0,0,0,1,0,0,0,0,0,4,0,0,0,0,0,1,1,0,0,0,0,0,0,0,0,0,0,0,0,0,2,0,0,0,0,0,1,0,0,0,0,0,0,0,2,0,0,0,0,0,0,0,0,0,0,1,0,0,0,0,2,0,0,2,0,0,0,2,0,0,0,0,0,0,0,0,0,0,0,0,0,2,0,1,0,1,0,0,0,0,2,0,0,0,0,0,0,1,0,0,0,0,0,0,0,1,0,0,0,2,0,0,0,0,0,0,1,0,1,1,3,0,0,0,0,0,0,0,0,0,0,0,0,0,0,1,0,0,0,0,0,0,0,0,0,2,0,0,0,0,2,1,0,0,0,0,0,0,0,0,0,1,0,0,0,0,0,0,0,0,0,2,0,0,0,0,1,0,0,0,0,0,0,1,1,1,0,0,1,0,0,0,1,2,0,0,0,2,0,0,1,1,0,0,1,0,0,0,0,0,1,0,0,0,0,0,1,0,0,0,0,0,0,8,0,0,0,0,0,0,2,0,0,0,0,0,0,0,0,0,1,0,1,1,0,0,1,0,0,0,2,0,1,1,0,1,0,0,0,0,0,1,0,1,0,0,0,1,0,0,0,0,0,0,0,0,1,0,0,0,0,0,0,2,0,0,0,0,0,0,0,0,0,0,0,0,0,0,0,0,0,0,0,0,1,0,0,0,0,0,0,0,0,0,0,2,0,0,1,0,0,1,0,0,1,0,0,0,0,0,0,2,0,0,1,0,0,0,0,0,0,0,0,2,0,0,1,0,0,0,0,0,0,0,0,1,0,0,0,0,0,0,1,0,1,1,0,0,0,0,0,1,0,0,0,0,0,0,0,1,0,0,0,0,0,1,0,0,0,0,0,0,0,0,0,0,0,0,0,1,0,1,0,0,0,1,0,0,0,0,0,1,0,0,1,0,0,0,0,2,0,0,0,0,0,0,3,0,0,0,0,0,1,0,0,1,0,0,0,4,0,1,0,0,0,0,0,0,0,1,0,0,0,1,0,0,0,0,0,1,0,0,0,0,0,1,0,0,0,1,0,0,0,0,0,0,0,0,0,0,1,0,0,1,1,0,0,0,1,0,0,0,0,0,0,1,2,0,0,0,0,0,0,0,0,0,0,0,1,0,0,0,1,2,0,0,0,0,1,0,0,0,0,0,1,0,0,1,0,0,0,0,0,1,0,1,0,1,1,2,0,1,0,1,1,0,0,0,0,0,2,0,0,0,0,1,0,0,2,0,0,0,0,0,0,0,0,1,0,1,0,0,0,0,0,2,0,0,0,0,0,0,0,0,0,0,2,1,0,0,2,0,1,0,1,1,0,0,0,0,0,0,0,0,2,0,0,0,0,0,0,0,0,0,0,0,0,1,2,0,2,0,0,0,0,0,0,0,0,0,0,0,1,0,0,0,0,0,0,0,0,0,0,0,0,0,0,0,0,0,0,0,0,0,0,0,0,0,0,2,0,2,0,4,0,0,2,0,0,0,0,1,0,2,0,1,0,0,0,0,1,2,1,0,3,0,1,2,0,0,0,0,0,0,1,0,0,0,0,0,1,1,1,1,3,0,0,0,2,0,0,0,0,0,0,0,3,0,0,0,0,1,0,0,0,0,1,1,0,0,1,0,0,0,0,0,0,0,1,0,1,0,0,0,0,1,0,0,0,0,1,1,0,0,0,0,0,0,0,1,1,0,0,0,0,0,0,0,0,0,0,1,0,0,0,0,0,0,0,2,0,1,0,0,0,0,0,0,1,6,2,0,1,0,1,0,0,1,0,0,1,1,0,0,1,0,0,0,0,0,0,0,1,0,0,1,0,1,0,0,0,0,1,0,0,0,0,0,2,0,0,0,0,0,0,0,0,0,1,0,0,0,0,1,0,1,0,0,0,0,0,2,0,0,0,0,0,0,0,0,0,1,1,0,1,0,0,0,0,3,0,0,0,0,3,0,0,1,0,0,0,0,1,0,0,0,0,1,2,1,0,1,0,0,0,0,0,1,0,0,0,0,0,0,0,0,0,0,0,0,0,0,0,0,2,0,0,0,0,0,0,0,0,0,0,0,0,0,0,0,0,4,0,0,0,0,0,0,0,0,1,0,0,0,0,0,0,1,0,0,0,0,0,0,0,1,0,1,0,0,0,0,0,0,0,0,0,0,0,0,2,0,0,0,0,0,0,0,1,0,1,0,0,0,0,0,0,0,2,0,0,0,0,0,0,3,0,0,0,0,0,0,0,0,0,0,0,0,0,0,0,0,0,0,0,0,0,0,0,0,0,0,0,0,0,0,1,0,0,0,1,0,1,0,0,0,1,1,2,0,0,0,0,0,0,0,0,0,1,0,14,0,1,1,0,0,0,0,0,2,0,0,0,0,0,0,0,0,0,0,1,0,0,0,0,0,0,1,0,0,0,0,0,0,0,0,1,0,1,0,1,0,0,0,0,0,0,0,0,0,0,0,0,0,0,1,0,0,0,0,0,0,0,0,0,0,0,1,3,0,0,0,1,0,1,0,1,0,0,0,0,0,2,0,0,0,0,0,0,0,0,0,0,0,0,0,1,0,0,0,1,0,0,0,0,0,0,1,1,1,0,0,0,0,0,0,0,0,0,1,0,0,0,0,1,0,0,0,0,0,2,0,0,0,1,0,0,0,0,0,0,0,0,0,0,0,2,0,0,0,0,0,0,0,0,0,0,0,0,1,0,0,0,0,0,0,2,0,0,2,0,0,0,0,0,0,0,0,0,0,0,0,0,0,0,0,0,1,0,0,0,0,0,0,1,0,0,0,0,0,1,1,3,0,0,0,0,0,0,0,0,1,3,1,0,1,0,0,0,0,0,0,0,0,0,1,0,0,0,0,0,0,0,0,0,0,2,0,0,0,0,0,0,0,0,0,0,0,0,0,0,0,0,0,1,0,0,2,0,1,0,1,0,0,0,0,0,0,0,0,0,1,0,0,0,0,0,1,1,1,0,0,4,0,0,1,0,0,0,0,1,0,1,0,0,0,0,0,0,0,0,0,0,0,0,0,0,0,1,0,1,1,0,0,0,0,0,0,1,0,0,0,0,0,0,0,0,0,0,0,0,0,1,0,0,0,0,0,0,0,0,0,0,0,0,2,0,1,0,0,0,0,0,0,0,0,0,0,0,0,0,0,0,0,0,0,0,0,4,0,0,0,0,0,1,0,0,0,0,0,0,1,0,0,0,0,0,0,0,0,2,0,0,0,0,1,0,0,0,0,0,0,0,0,0,0,0,0,3,0,0,0,0,0,0,0,0,0,1,0,0,1,1,0,0,1,0,0,0,1,1,1,0,0,0,0,0,0,3,0,0,0,0,0,0,0,0,0,1,1,0,0,0,0,0,0,1,0,0,0,0,0,0,0,0,0,0,0,0,0,0,1,0,0,0,0,0,0,0,0,0,0,0,0,0,0,0,0,0,1,0,2,0,0,0,0,0,1,0,0,1,1,0,0,0,0,0,0,1,0,0,0,0,0,0,0,0,0,0,0,1,0,0,0,0,0,0,0,0,0,0,0,0,0,0,0,1,0,0,1,0,0,0,0,0,4,0,0,0,0,0,0,0,0,0,0,0,0,0,0,0,0,0,0,0,0,0,0,0,0,0,0,0,0,0,0,0,0,0,0,0,0,0,0,0,0,0,0,0,0,0,0,0,0,0,0,0,1,0,0,0,0,0,0,0,0,0,2,1,0,0,0,0,1,0,1,0,0,0,0,0,0,0,0,0,0,0,0,1,1,0,4,0,0,0,0,0,1,0,0,0,0,0,0,0,0,0,2,0,0,0,0,0,0,0,0,0,0,0,0,0,0,1,0,1,0,1,0,0,1,0,2,0,0,1,0,0,0,0,1,0,0,1,0,0,1,0,0,0,0,0,0,0,0,0,0,0,0,0,0,0,0,0,0,0,0,0,0,0,0,0,0,0,0,0,0,2,0,0,1,0,0,1,0,0,0,0,0,0,0,0,0,0,0,0,0,0,0,0,0,0,0,0,1,1,0,0,0,1,0,0,0,0,1,1,0,0,0,0,0,0,0,0,0,0,0,0,0,0,0,0,0,0,0,0,0,0,0,0,0,0,0,0,0,0,0,0,0,0,0,0,0,0,0,0,0,0,0,0,1,0,1,0,0,0,0,0,0,0,0,0,0,0,6,0,0,0,0,1,0,0,0,4,0,0,0,0,0,0,0,0,0,0,0,3,0,1,0,0,0,0,0,0,1,0,0,0,0,0,1,0,0,2,0,0,0,0,0,1,0,0,0,0,0,0,0,0,0,0,0,1,0,0,0,0,0,0,0,0,0,0,0,0,2,0,0,0,0,0,0,0,0,1,0,1,0,0,2,0,1,0,0,0,0,0,0,0,1,0,0,1,0,0,0,0,0,0,1,0,0,0,1,0,0,0,0,0,0,1,0,0,0,0,0,0,0,0,0,0,2,0,0,0,0,0,0,0,0,1,4,0,0,0,0,0,0,0,0,0,0,0,0,0,1,0,0,0,0,0,0,0,0,0,0,0,0,0,1,0,1,0,1,0,2,0,0,0,0,0,0,2,0,0,0,0,0,0,2,0,0,0,0,0,0,0,0,0,0,0,0,0,1,1,0,0,0,0,0,0,0,0,0,0,0,0,0,1,0,0,0,0,0,1,0,0,0,0,0,0,0,0,1,0,0,0,0,1,0,0,0,0,0,0,0,0,0,0,0,0,0,1,0,1,0,0,0,0,0,0,0,1,0,0,0,0,0,0,0,0,0,0,0,1,0,0,0,1,0,0,0,0,0,0,0,0,0,0,0,1,0,0,0,0,0,0,0,0,0,0,0,0,0,0,0,0,0,0,0,0,0,0,0,1,0,0,0,1,0,0,0,0,0,0,0,0,0,0,0,0,0,0,0,0,1,1,0,0,0,0,0,0,0,0,2,0,1,0,0,0,0,0,1,0,1,0,0,0,0,1,0,0,0,0,0,0,0,0,0,0,0,0,0,0,0,0,0,2,0,0,0,0,0,0,0,0,0,0,0,0,0,0,1,0,0,0,0,0,0,0,0,0,1,0,0,1,0,0,1,0,0,0,1,0,0,0,0,0,0,0,0,0,0,0,0,0,0,0,0,0,0,0,0,0,0,0,0,0,1,0,0,0,0,0,0,0,0,0,0,0,0,0,0,0,0,0,1,0,0,0,0,0,0,0,0,0,0,0,0,0,0,0,0,0,0,0,0,1,0,0,0,0,0,0,0,0,6,0,0,0,0,0,1,0,0,0,0,4,1,0,0,0,0,0,1,0,0,0,0,0,0,0,0,0,0,0,0,0,0,0,1,0,1,0,0,0,0,0,0,0,1,0,0,0,0,0,0,0,0,0,0,0,0,0,0,0,0,0,0,0,1,0,0,0,0,0,0,1,0,0,0,0,0,0,0,1,0,0,0,0,0,0,0,0,0,0,0,0,0,0,0,0,0,1,0,0,0,0,0,0,0,0,0,0,0,0,1,0,0,1,0,0,0,1,0,0,0,0,0,0,1,0,0,0,0,0,0,1,0,0,0,0,0,0,0,0,0,1,0,0,0,0,0,0,0,0,0,0,0,0,0,0,0,0,0,0,0,0,0,0,0,0,0,0,0,0,0,0,0,0,0,0,0,0,0,0,0,0,0,0,0,0,0,0,0,0,1,0,0,0,3,0,0,0,0,0,0,0,0,0,0,0,0,0,0,2,0,0,0,0,0,0,0,0,0,0,0,0,0,0,0,0,0,0,0,0,0,0,0,1,0,0,0,0,0,0,0,0,0,0,1,0,0,0,0,0,0,0,0,0,0,0,0,0,0,0,0,0,0,0,0,0,0,0,0,0,1,1,0,0,0,0,0,0,0,0,1,0,0,0,0,0,0,0,0,0,0,0,0,0,0,0,0,0,0,0,0,0,0,0,0,0,0,0
K58 A Good Marriage,king,1458,775,696,759,615,379,493,494,637,512,356,310,410,760,504,283,364,186,213,141,155,278,164,136,76,133,74,115,122,45,90,109,141,132,116,119,111,113,31,159,142,97,142,112,91,118,110,97,146,106,106,89,105,69,83,56,135,115,91,86,63,66,56,75,60,47,58,64,29,76,55,38,57,27,42,58,57,59,49,22,39,45,28,54,45,41,40,29,57,49,32,38,55,29,45,61,35,31,54,41,65,42,33,34,88,46,38,46,23,32,39,58,14,38,47,15,36,40,22,9,22,18,45,39,20,21,45,33,51,22,31,43,32,27,39,30,4,38,24,18,28,27,40,26,51,42,27,38,39,29,23,37,28,24,24,11,8,21,20,9,27,24,48,37,14,15,23,16,17,23,18,53,45,18,18,13,30,17,21,27,43,21,22,31,17,25,17,10,20,19,13,10,33,21,9,24,10,17,30,4,16,17,28,24,9,10,16,14,19,11,11,22,13,11,9,8,14,3,8,12,8,17,16,14,26,12,18,25,11,27,13,9,7,23,13,40,17,13,4,12,12,19,23,22,13,18,11,20,9,19,17,8,5,7,5,17,10,14,6,13,11,13,15,24,22,19,11,14,10,11,14,20,40,8,13,11,18,12,29,10,13,14,10,14,32,5,10,13,8,11,8,6,15,15,11,16,13,10,4,24,20,9,7,4,13,7,1,14,5,9,2,13,7,10,17,11,5,13,10,4,6,30,11,16,41,3,9,11,9,16,10,9,10,11,14,10,22,5,6,11,4,5,5,10,12,9,13,8,9,1,18,8,21,6,11,4,8,19,5,25,21,5,13,23,6,9,9,7,5,6,7,5,10,15,5,24,8,14,20,6,5,4,5,3,4,18,0,3,12,8,1,7,7,2,11,20,7,6,6,5,14,16,12,9,10,5,8,9,8,14,4,5,16,7,7,12,11,19,9,6,6,0,3,16,7,6,1,13,4,9,5,6,2,9,0,3,3,2,0,10,4,6,1,6,12,10,1,10,6,11,6,3,4,13,8,3,4,11,6,3,5,1,0,1,3,6,9,4,33,10,4,8,7,0,6,3,2,1,0,5,4,16,3,0,6,4,8,3,11,7,11,8,2,7,2,0,1,9,2,5,9,13,0,0,8,4,11,9,11,17,3,10,3,5,12,12,0,2,12,6,11,8,9,8,3,13,7,8,6,8,1,2,5,11,3,0,9,12,1,7,5,1,11,3,0,3,0,4,3,2,1,12,8,0,10,9,3,4,13,2,11,14,10,10,1,7,2,1,7,0,6,2,2,5,9,1,5,4,2,4,9,7,3,6,2,3,1,18,3,5,8,9,3,5,2,14,1,1,4,5,6,4,12,1,1,0,2,8,10,0,0,2,12,7,1,4,5,1,12,5,2,6,10,9,6,10,30,8,6,4,4,6,2,7,1,0,2,15,7,5,5,3,3,0,4,4,5,3,1,5,0,6,3,4,1,8,3,5,3,2,1,3,6,6,3,8,9,8,3,1,7,6,7,3,6,0,3,2,3,1,1,2,6,10,13,7,0,8,4,5,1,6,7,4,7,13,1,0,4,3,5,0,12,4,8,3,2,3,6,5,1,8,1,4,1,4,1,3,4,3,3,2,3,1,5,1,10,2,1,5,6,0,0,0,0,5,2,7,2,6,2,8,1,11,0,0,2,4,5,1,6,4,8,5,3,8,5,12,2,1,2,4,8,1,1,16,0,1,7,5,1,3,0,10,2,6,2,7,5,5,2,1,0,3,4,4,0,6,5,2,8,4,0,4,1,3,0,2,0,5,5,5,1,0,0,3,25,2,2,1,1,2,8,1,3,2,0,0,2,6,5,0,3,3,2,4,2,0,7,4,4,1,7,4,5,2,4,7,0,1,2,0,2,3,9,0,5,0,1,4,2,7,1,3,0,1,4,1,0,8,0,1,6,1,0,4,0,0,5,11,1,3,8,0,3,2,0,5,8,3,0,7,3,6,2,5,9,3,2,4,1,3,2,3,2,10,2,0,3,3,5,4,8,1,6,1,4,0,4,1,3,0,5,0,5,0,1,1,7,1,1,0,2,1,3,3,4,1,7,0,4,1,1,1,1,4,7,4,7,12,3,0,2,0,3,1,1,9,1,17,2,1,3,2,1,1,0,1,0,3,0,5,2,0,2,4,4,0,0,3,8,2,2,3,0,2,2,6,2,15,0,0,1,1,2,0,2,0,4,4,1,1,5,1,0,1,0,1,2,0,2,0,2,0,1,8,0,0,1,1,5,8,7,3,12,1,0,0,0,3,0,6,2,2,2,1,1,0,1,6,1,2,2,3,2,7,7,3,1,10,3,0,0,3,5,3,2,0,3,5,1,1,4,3,0,0,1,2,2,1,0,3,0,2,3,1,5,2,0,0,0,0,4,1,12,2,0,0,2,2,3,0,2,4,5,0,0,4,1,0,4,1,1,0,0,6,2,1,10,4,4,1,14,1,9,3,0,0,4,4,3,4,1,0,0,0,1,0,5,0,6,10,1,3,0,1,1,7,0,0,1,1,2,0,0,6,8,1,2,5,8,2,1,3,0,1,1,2,10,3,4,0,2,2,3,0,0,1,1,4,1,1,2,1,0,1,2,2,0,84,1,0,0,2,1,4,1,2,2,0,2,2,0,4,4,0,0,1,3,0,1,4,0,0,1,2,3,1,0,0,0,0,2,8,6,0,0,0,0,3,0,4,1,0,0,0,0,0,0,1,1,3,2,2,2,2,5,6,3,5,4,4,1,2,3,0,1,1,4,5,1,0,1,0,0,2,0,2,3,0,0,1,1,2,0,1,1,8,0,2,3,0,2,11,0,1,6,0,3,1,3,0,0,1,0,5,1,0,0,2,1,1,1,0,6,3,3,4,0,1,0,0,2,1,7,1,5,5,1,1,3,1,0,5,2,8,1,0,3,1,2,0,0,3,2,13,1,4,0,2,2,2,0,0,1,3,0,2,1,0,1,1,2,3,2,3,3,0,0,1,0,6,1,0,1,7,3,0,3,0,0,0,6,3,1,0,0,0,2,1,1,1,3,0,1,0,3,0,1,1,4,1,2,3,7,0,0,6,0,2,0,0,0,7,2,3,4,0,0,4,1,7,1,0,6,0,2,0,6,0,0,0,0,1,0,1,0,0,9,0,1,0,4,0,0,1,1,0,0,5,1,0,8,2,8,0,4,2,1,2,0,1,0,0,0,3,2,0,2,3,4,1,2,1,1,6,1,4,2,1,4,0,0,2,4,0,0,0,5,0,3,4,1,0,1,4,1,0,4,2,0,2,2,0,0,0,0,1,0,0,0,2,1,7,22,0,1,0,8,3,3,3,5,4,1,0,0,0,1,2,2,0,0,0,0,0,0,3,0,1,5,0,0,1,1,4,0,0,1,0,2,1,1,6,1,0,0,2,0,1,6,0,3,7,0,0,6,20,0,0,4,2,4,5,1,1,1,0,2,4,0,1,3,3,7,2,0,0,4,2,6,2,3,4,2,0,4,1,0,5,2,2,6,0,3,3,3,3,2,3,0,3,2,0,2,0,2,2,0,1,0,6,3,4,1,1,4,0,1,1,0,0,0,0,3,3,3,0,2,0,4,0,3,0,2,1,0,1,0,1,0,4,0,0,0,3,0,2,1,0,1,2,1,4,0,0,2,0,1,8,2,0,2,2,0,0,0,1,0,0,0,1,1,0,3,2,0,0,2,0,0,2,1,0,1,3,2,0,1,0,1,4,8,2,2,3,0,0,0,1,0,5,0,0,3,0,2,1,1,0,2,0,0,0,0,0,4,0,6,3,0,1,4,5,0,2,0,0,3,0,0,2,4,2,0,0,2,0,0,4,0,0,1,1,3,0,1,1,1,0,0,0,4,0,7,0,3,0,5,0,2,2,1,3,0,8,0,0,1,0,0,3,0,11,0,3,0,1,1,2,3,4,0,1,0,1,0,3,2,0,1,0,0,1,1,0,1,0,0,0,0,3,0,1,3,1,1,0,3,4,1,2,0,3,3,0,0,0,3,3,2,2,0,0,0,0,5,3,0,0,0,1,7,0,0,1,0,0,1,0,1,1,0,0,0,2,0,0,0,0,0,2,1,2,0,0,0,2,0,3,0,4,0,1,0,7,0,1,1,0,0,0,1,3,8,5,4,2,0,2,1,1,0,0,1,0,1,0,0,3,0,1,0,1,0,1,1,1,0,3,0,1,0,1,0,0,4,2,4,1,1,3,0,2,0,1,1,0,0,0,0,2,1,0,0,1,0,0,0,0,0,2,8,0,4,1,0,1,0,0,4,0,0,1,1,2,0,4,0,0,0,0,0,0,0,0,3,1,0,0,2,0,0,1,0,0,10,2,2,0,0,2,3,0,0,2,0,2,1,1,0,4,1,0,3,1,1,0,0,0,0,2,0,0,0,1,0,0,3,0,1,3,0,0,0,2,1,0,0,2,0,0,2,5,1,1,1,0,1,0,0,0,0,4,0,1,0,1,3,0,0,7,0,1,2,2,0,1,1,0,0,1,1,1,3,0,0,7,0,0,5,0,3,0,0,0,1,0,1,0,6,1,5,0,0,1,1,3,0,3,4,0,2,0,2,0,0,0,1,0,0,0,1,0,0,4,0,0,0,2,0,2,2,0,0,0,0,2,3,0,0,0,9,2,0,0,0,0,0,1,0,1,4,3,0,2,0,1,4,1,0,0,0,0,0,0,0,0,2,0,1,1,0,0,2,1,1,0,0,0,0,0,3,2,0,0,0,0,0,1,0,0,2,2,0,4,1,5,1,1,0,1,1,5,5,1,1,0,0,0,0,0,0,0,0,0,2,1,1,1,0,1,0,1,0,0,0,0,2,0,1,0,2,0,0,0,0,1,2,0,5,0,0,0,1,2,0,0,0,0,4,0,2,0,2,0,0,0,1,2,0,1,0,0,0,0,0,0,2,0,1,0,0,0,1,0,0,2,0,1,0,6,1,0,0,1,0,1,0,0,2,0,0,1,1,0,0,0,0,0,1,1,0,1,0,0,0,3,0,0,0,1,0,0,0,0,1,2,1,0,0,0,3,1,4,0,0,6,2,0,3,0,4,0,0,0,3,1,3,4,3,1,6,1,0,2,4,1,1,0,0,1,1,3,0,3,4,2,4,3,0,0,0,3,0,3,0,0,1,1,0,0,0,4,2,0,0,0,1,0,0,4,0,2,1,0,2,2,1,0,0,0,2,1,4,0,1,3,0,1,0,1,1,0,1,3,0,0,3,1,2,3,0,1,1,1,2,0,0,0,1,0,0,0,7,5,5,0,0,0,1,0,0,3,0,0,1,0,1,0,0,0,0,0,0,0,0,0,6,1,0,4,0,0,0,0,1,0,0,1,1,1,0,0,0,0,1,14,1,1,0,5,1,1,1,0,0,0,0,0,1,0,0,0,1,0,0,3,2,0,2,2,1,1,4,0,2,0,2,0,0,0,0,0,0,0,3,0,4,4,0,0,1,0,0,4,1,0,2,0,1,4,2,2,1,0,0,3,2,0,0,1,0,0,1,0,0,3,0,3,0,0,1,1,0,0,2,0,0,2,2,0,1,0,1,2,0,0,2,0,0,0,0,0,0,0,0,0,2,0,1,1,0,0,0,1,0,1,0,2,0,0,0,0,0,0,0,4,0,0,0,3,0,0,1,1,6,1,2,0,3,0,1,0,0,0,0,0,1,1,0,0,0,0,0,1,0,1,0,0,0,1,0,1,1,1,0,0,0,5,1,0,0,1,0,0,0,0,0,2,0,0,1,1,3,1,0,1,1,3,0,0,0,1,0,2,0,1,2,0,0,0,3,0,0,0,2,0,0,0,5,0,1,0,2,1,1,0,5,1,0,0,0,0,1,1,0,0,0,1,0,2,0,0,1,0,0,0,0,0,0,0,5,1,1,0,0,0,0,0,0,1,0,1,2,2,0,0,1,0,0,0,3,0,2,1,3,0,0,1,0,0,0,0,0,0,1,0,0,0,4,4,0,1,0,0,0,2,0,0,1,0,0,3,1,0,0,3,2,1,0,1,1,1,0,1,0,0,1,0,1,0,0,0,1,1,0,2,0,1,0,1,1,1,0,0,1,0,0,0,1,0,0,0,0,0,0,1,1,0,0,0,0,0,2,0,0,1,0,0,0,0,0,2,2,0,1,0,0,1,0,1,0,0,1,0,1,0,1,1,0,3,0,4,1,0,2,1,0,1,0,0,0,2,2,0,2,1,0,1,1,3,5,0,0,0,0,0,0,1,1,0,0,0,0,0,1,0,0,2,1,1,1,0,1,0,0,0,0,4,2,1,0,1,0,2,0,0,0,1,3,0,0,0,2,0,2,0,0,0,1,1,0,2,0,0,0,0,0,1,0,0,0,0,0,4,0,0,0,0,2,0,0,0,0,0,0,0,0,0,2,0,0,4,0,0,3,0,0,0,0,3,1,0,3,0,0,0,2,0,2,1,0,0,0,3,0,0,0,0,3,0,1,0,0,1,0,0,0,0,0,0,1,0,0,0,0,1,0,0,0,0,2,1,0,0,0,2,0,4,0,0,0,1,0,0,0,3,1,1,0,0,1,0,0,1,0,0,0,0,1,1,0,0,0,0,2,1,0,0,1,0,0,0,1,0,0,1,0,11,0,0,0,0,0,1,0,0,0,0,0,0,0,0,0,0,1,3,1,0,0,0,0,0,0,0,1,0,0,0,0,0,0,0,0,0,1,0,0,0,0,1,2,0,0,0,0,0,0,1,0,0,7,0,0,7,1,1,1,3,0,2,0,0,3,0,0,2,3,0,3,0,0,1,0,0,0,0,1,0,2,0,2,1,0,2,0,1,0,0,0,1,0,1,0,7,0,2,0,0,1,0,0,2,0,2,0,1,0,3,0,0,0,2,0,1,0,0,1,0,0,0,1,2,0,0,1,0,0,3,1,0,0,0,0,1,0,0,0,0,1,1,0,0,0,0,2,0,1,2,1,0,0,0,0,0,0,0,1,0,0,0,0,0,1,0,2,0,1,2,0,4,0,0,0,1,1,1,0,1,0,0,0,0,0,0,0,2,0,0,0,1,0,1,0,0,0,0,0,1,0,0,0,0,0,1,1,0,1,1,0,0,1,0,1,1,0,0,4,0,1,1,1,4,1,0,0,1,0,0,0,0,0,0,3,1,0,0,0,1,0,0,0,1,1,2,0,0,0,0,1,1,0,1,0,1,0,1,1,2,1,0,0,2,0,2,0,2,0,0,1,0,3,3,3,0,4,1,1,0,0,1,0,0,0,2,0,0,0,0,0,1,0,2,1,1,0,0,0,0,0,0,1,5,2,0,0,0,2,1,1,0,0,0,0,0,3,0,0,0,0,0,1,5,0,1,0,0,0,1,1,0,1,0,2,0,0,0,0,1,0,0,0,0,3,0,1,2,2,0,1,2,1,1,0,0,0,0,0,0,0,0,0,0,0,0,0,0,1,1,1,0,0,1,0,0,0,0,1,4,1,0,0,1,0,0,0,1,2,0,2,0,0,0,0,3,0,1,2,0,0,0,0,2,0,0,0,0,0,0,1,0,0,0,2,0,0,2,0,0,1,0,0,0,0,1,0,1,0,2,0,0,0,0,0,0,2,0,0,0,1,0,1,0,1,0,1,0,0,0,2,0,0,0,0,0,0,1,0,0,1,1,0,0,2,0,1,1,0,0,0,0,1,0,2,0,0,1,0,0,0,0,0,0,0,1,6,0,0,0,0,0,0,0,3,0,2,0,0,4,1,0,1,0,0,2,8,0,0,2,0,1,0,2,0,0,3,1,0,0,0,1,2,0,2,2,0,1,0,0,1,0,0,0,0,0,1,0,0,0,0,1,5,1,0,0,1,0,0,0,0,1,1,3,0,0,1,0,0,0,1,0,0,0,0,0,0,0,0,1,0,1,0,0,1,0,1,0,0,0,1,0,0,1,0,0,1,1,0,2,1,0,0,0,0,0,2,0,0,8,0,0,1,0,3,0,0,0,4,9,0,1,0,0,3,0,0,0,0,0,0,1,0,0,0,0,0,0,0,1,1,4,0,0,0,1,0,0,0,0,1,0,0,0,2,0,0,2,0,0,0,0,3,0,0,0,0,0,0,0,0,0,1,1,1,0,0,2,0,0,0,0,0,0,0,0,0,0,0,0,0,0,0,0,1,0,1,2,0,0,0,0,0,1,0,0,0,0,0,0,0,0,2,0,0,0,1,0,0,1,0,0,0,0,0,0,0,0,0,1,0,1,0,0,0,0,1,0,0,2,0,0,0,3,1,0,0,0,0,0,1,0,1,0,0,0,0,0,0,0,1,0,1,0,1,0,0,0,1,0,0,0,2,1,0,1,0,0,0,0,0,0,1,0,1,1,2,0,0,3,0,0,0,0,0,1,0,0,0,0,0,0,0,0,0,3,0,0,0,1,4,0,0,0,0,5,0,0,1,2,0,1,0,0,1,0,0,0,0,0,0,6,4,0,0,0,0,0,0,0,4,0,0,0,1,0,2,0,0,0,0,0,0,0,0,2,0,0,4,0,0,0,2,0,0,0,0,0,1,0,0,0,0,1,0,3,0,0,0,0,4,0,0,1,1,0,2,0,0,0,0,0,0,0,0,1,1,0,0,0,0,0,1,1,0,0,0,0,0,0,0,0,1,0,0,1,1,2,1,1,0,0,0,2,0,0,1,2,3,2,2,0,0,1,0,0,0,0,0,0,0,0,1,0,0,0,0,0,0,0,0,1,0,2,0,0,0,2,0,0,1,0,0,0,0,0,1,1,0,0,1,0,0,0,0,0,0,1,0,0,0,0,0,3,0,0,0,0,5,1,0,0,0,3,4,0,0,0,0,0,0,0,0,0,0,0,0,1,0,0,0,0,0,0,0,0,1,0,0,0,1,1,0,0,0,0,0,1,0,0,0,0,0,0,1,0,4,0,2,3,1,0,0,0,2,0,1,0,0,0,0,0,2,0,1,0,1,1,0,0,3,0,0,0,1,1,0,0,0,1,0,0,0,0,2,0,0,0,0,1,0,0,1,1,0,0,0,1,3,0,0,0,0,1,0,0,0,1,0,0,0,0,0,0,0,0,0,1,2,2,0,1,0,2,0,1,0,2,2,0,0,0,1,0,0,1,0,1,0,0,0,0,2,0,1,0,0,0,1,0,0,0,0,1,0,1,1,1,0,1,0,0,1,2,0,0,0,2,2,1,1,1,0,0,0,0,0,0,0,0,0,0,0,0,0,0,0,0,0,0,2,1,0,1,0,0,0,0,2,0,0,1,1,0,0,0,0,0,0,0,0,0,1,0,1,0,2,1,0,0,0,0,0,0,0,0,1,0,2,0,0,1,0,2,0,0,1,2,0,0,0,1,1,1,0,0,0,0,0,0,1,0,0,0,0,0,0,1,0,0,0,1,0,1,2,1,0,0,0,0,0,1,1,0,2,0,0,0,0,0,0,0,0,1,0,1,2,0,0,0,0,0,0,0,0,0,1,0,0,5,0,0,0,1,0,0,0,1,1,0,0,0,0,0,0,0,0,3,0,1,0,0,0,0,0,0,0,1,0,3,0,0,0,0,0,0,0,2,0,0,0,0,0,0,1,0,0,0,0,0,1,0,0,0,0,0,0,0,0,0,1,1,1,0,0,1,0,1,0,0,1,0,3,0,0,0,0,0,0,0,0,1,2,0,0,2,0,0,0,0,0,1,0,0,1,3,5,2,0,0,0,0,0,0,4,0,0,0,1,0,0,0,0,0,1,0,0,0,0,0,2,0,1,0,1,0,2,0,0,0,1,1,0,0,0,0,0,2,0,0,1,0,1,0,6,1,0,1,0,0,4,1,0,0,1,0,0,0,0,0,0,0,0,0,0,0,0,0,0,1,0,0,1,0,0,0,1,0,1,0,0,1,0,1,1,1,0,1,0,1,0,0,0,0,0,3,0,0,0,0,0,0,0,0,0,0,0,0,0,1,0,0,0,0,0,0,0,0,0,0,0,0,0,0,0,0,2,1,0,1,0,0,3,1,0,0,2,0,0,0,0,1,0,0,0,0,0,1,0,0,0,0,0,0,0,1,0,0,0,0,0,0,0,0,0,0,0,0,0,0,0,0,0,0,0,0,0,0,0,1,1,0,14,0,0,1,0,0,1,1,0,0,2,0,2,0,0,0,0,0,2,0,0,0,0,0,0,0,1,0,0,0,0,0,0,0,0,2,1,0,0,1,0,0,0,0,0,0,0,2,2,0,0,4,0,0,0,0,0,0,0,0,0,0,0,2,0,0,0,1,0,0,0,0,0,0,0,2,0,3,0,1,0,0,0,0,0,0,0,0,0,0,0,0,0,0,1,0,0,0,0,0,0,0,0,1,0,0,0,0,0,0,0,0,2,0,1,0,0,0,1,0,0,1,0,1,0,0,0,1,0,1,0,1,0,0,0,0,0,0,0,0,0,0,0,0,0,0,0,0,0,0,0,0,0,1,0,0,1,0,0,1,0,0,2,0,0,0,0,0,0,5,0,0,0,0,1,0,0,0,0,0,0,0,1,0,0,1,2,1,0,0,1,0,0,0,0,0,0,1,2,0,0,1,0,1,0,1,0,2,0,0,1,0,0,0,0,0,0,0,0,0,1,0,0,0,1,1,0,1,0,0,0,1,0,0,0,0,0,0,1,0,1,0,0,0,0,0,0,0,0,0,0,1,0,0,6,0,0,0,1,2,0,0,1,0,0,0,0,0,0,3,0,0,0,1,0,0,0,0,1,0,0,0,0,0,1,1,0,0,1,0,0,0,0,0,1,0,1,0,0,0,1,0,0,0,1,0,0,1,0,0,0,0,0,0,0,0,0,0,0,0,0,0,0,0,0,0,0,0,0,0,0,1,0,0,0,0,0,1,0,0,0,0,0,0,0,0,0,0,0,1,0,0,0,0,0,0,0,0,2,4,1,0,0,0,3,0,0,0,0,1,0,0,0,0,0,0,0,0,0,0,1,0,0,0,0,0,2,0,0,0,0,0,0,0,0,0,0,0,0,0,0,0,0,0,0,0,0,0,0,0,0,0,0,0,0,0,0,0,0,0,0,0,0,0,8,0,0,0,0,0,0,0,0,0,0,0,0,0,0,0,1,0,0,0,0,0,0,0,0,0,0,0,0,0,0,0,0,0,0,0,0,0,0,0,0,0,0,0
K59 11.22.63,king,14200,6905,6613,6847,5225,8868,2601,4235,5065,4038,3177,1831,3050,1682,1921,2701,1954,1734,1685,1278,1710,2310,1317,846,2614,999,1887,773,1093,822,1001,1084,1033,1190,926,1080,980,887,602,1171,1177,885,1038,888,777,944,789,676,900,893,940,532,685,619,626,566,721,711,720,728,579,590,637,481,497,628,300,507,460,475,490,464,419,357,521,441,449,574,379,293,366,457,431,498,432,428,470,424,423,360,328,395,412,214,380,380,377,289,429,334,331,483,507,338,405,290,471,310,340,339,352,280,177,292,351,207,244,231,245,227,207,242,391,292,173,292,312,240,233,260,332,343,339,304,282,272,158,297,270,178,168,189,138,303,489,335,233,336,240,305,256,214,300,223,198,192,120,190,220,76,190,150,355,236,173,131,147,134,179,158,554,173,240,215,160,74,185,190,191,320,139,163,223,136,182,147,108,150,218,115,178,127,248,188,145,164,70,120,148,79,138,142,203,187,104,231,170,114,160,200,75,129,105,93,115,65,164,125,125,99,104,182,120,148,152,91,94,182,136,143,100,93,112,144,105,47,155,150,88,108,97,127,134,82,95,109,175,160,108,96,173,51,78,130,111,140,87,103,93,138,128,188,95,125,193,124,103,80,138,116,88,122,166,106,128,75,94,97,146,98,110,73,111,151,244,341,84,100,102,102,110,76,104,82,96,132,147,112,54,185,158,49,106,68,132,122,77,98,69,64,91,205,63,119,63,109,79,125,103,66,65,237,86,69,21,111,107,101,125,89,154,112,105,90,77,80,118,31,89,91,172,67,65,34,98,44,168,118,112,80,141,54,116,88,97,76,131,135,62,125,136,49,89,51,73,61,97,48,54,87,66,69,96,79,74,119,27,114,112,111,64,93,106,97,53,85,0,72,107,85,21,72,82,52,69,142,75,61,98,82,185,76,86,125,65,47,65,117,51,95,71,51,78,139,56,46,61,111,44,38,77,16,60,85,37,58,46,55,77,72,105,74,43,54,44,28,59,44,27,82,89,51,38,83,74,43,24,54,61,87,41,49,33,117,77,111,58,114,62,50,106,36,2,51,33,75,55,22,43,76,45,56,67,58,58,59,22,25,0,75,41,142,59,91,22,52,59,23,89,44,64,35,58,80,74,20,65,60,21,42,59,50,16,41,45,34,39,77,61,56,58,49,35,53,68,66,0,56,93,51,67,41,83,100,50,51,72,45,58,35,75,33,57,63,54,1,56,85,9,68,53,40,95,77,51,49,0,11,60,51,25,58,70,37,47,55,72,53,23,58,49,69,42,52,69,78,36,15,94,20,68,35,47,50,39,40,43,23,43,56,37,51,45,38,28,53,38,67,19,33,73,69,37,55,43,65,8,34,45,39,56,33,104,14,17,0,109,28,51,38,26,20,74,54,29,40,37,33,41,39,33,58,28,87,51,79,52,73,29,34,87,37,28,39,31,3,74,39,51,45,45,38,45,29,35,108,44,58,17,44,0,34,35,54,27,48,17,41,40,65,26,38,51,56,38,35,46,47,31,19,51,35,19,32,46,33,21,35,37,37,32,43,34,25,33,50,3,43,17,44,68,31,19,79,41,59,15,2,41,39,60,14,39,38,61,28,25,92,46,31,10,65,13,27,40,63,38,37,41,37,24,37,38,2,13,41,50,31,11,41,34,40,22,15,0,79,39,21,28,77,53,52,9,28,19,4,60,22,33,37,19,31,22,22,13,53,50,29,19,23,37,23,51,23,27,129,34,24,28,32,27,27,43,36,2,26,21,25,69,35,17,10,8,55,22,39,37,53,23,40,28,33,14,33,23,28,13,55,14,17,37,49,32,32,19,17,153,36,11,78,13,12,60,32,26,43,37,5,31,76,44,20,15,23,46,40,14,37,68,56,35,5,23,29,5,43,36,45,0,57,89,46,20,13,46,20,27,0,40,22,30,28,5,33,29,29,27,16,21,33,28,8,45,26,69,48,24,0,38,42,25,45,45,13,1,37,33,33,19,25,22,25,17,35,20,26,25,23,16,25,36,17,13,43,31,19,6,15,19,31,29,14,23,20,52,29,28,21,48,16,25,1,23,0,31,3,17,29,53,23,20,144,28,20,33,12,53,0,45,16,50,15,17,34,10,66,40,24,61,37,30,28,38,18,32,16,28,20,20,27,19,37,34,11,7,43,44,21,21,40,0,31,26,2,28,47,49,18,44,31,41,4,16,26,8,28,35,31,18,18,3,68,24,13,47,56,32,1,22,41,14,9,28,23,21,19,2,10,29,0,27,2,31,0,20,48,1,0,19,31,19,27,27,8,42,18,26,2,18,22,6,31,43,7,8,7,9,18,28,28,20,50,7,16,25,48,15,10,27,39,23,31,18,17,18,15,40,7,55,64,14,28,15,21,29,0,23,5,19,18,13,43,0,20,22,33,54,23,0,0,1,20,38,31,113,17,18,0,17,25,28,14,17,23,19,20,15,59,8,5,18,0,34,23,4,48,25,8,42,11,44,19,13,27,77,18,35,15,17,19,25,26,9,14,0,0,8,34,24,14,31,72,50,25,18,29,17,39,26,4,27,15,11,5,9,31,28,20,12,72,27,33,12,19,6,12,19,17,26,6,24,9,10,26,23,11,20,21,13,40,9,10,7,33,0,20,14,22,5,8,1,27,9,17,13,26,4,3,16,0,14,17,17,16,56,29,0,23,18,0,47,19,0,12,6,34,12,17,21,29,75,0,19,13,39,7,3,72,34,30,1,5,15,11,33,0,1,15,8,9,69,47,38,3,28,23,15,82,13,22,10,21,1,35,17,0,12,9,9,36,20,13,35,2,13,24,1,11,20,22,14,13,11,9,2,11,49,23,12,14,34,0,21,32,0,19,10,4,26,29,21,17,19,8,0,10,24,12,0,34,19,18,11,14,26,32,65,27,9,18,0,21,12,10,7,33,11,17,11,23,16,28,19,16,14,37,20,0,19,6,12,1,10,16,6,47,25,27,21,22,19,21,13,0,10,19,7,16,7,4,11,14,7,21,11,12,38,11,10,30,21,20,22,1,15,57,6,33,9,105,13,1,21,19,26,7,16,19,19,2,10,12,17,2,30,10,12,9,17,23,9,22,5,16,35,0,0,21,0,35,2,0,20,28,11,53,8,17,46,15,22,30,9,8,13,13,10,1,8,2,0,3,0,7,3,18,4,0,45,28,11,15,16,11,0,22,6,16,19,43,26,15,4,16,15,4,26,9,22,23,25,15,0,0,7,19,6,16,25,13,12,4,5,17,5,46,38,25,14,11,20,23,1,16,25,0,19,26,10,0,11,24,9,0,30,58,20,0,18,20,10,20,9,14,1,45,9,29,15,7,19,14,10,18,41,12,8,17,11,18,23,22,10,10,9,2,0,2,3,16,7,1,62,0,0,5,0,8,13,6,14,19,11,17,20,29,6,0,91,2,8,28,18,15,9,15,6,25,7,13,61,10,19,13,10,5,9,15,11,13,23,12,24,19,16,11,11,9,10,13,22,15,37,14,13,4,3,2,10,17,36,5,8,13,14,36,6,10,16,19,14,22,14,0,9,18,18,4,15,9,16,12,13,24,26,12,29,16,4,16,0,23,24,275,15,21,9,1,14,11,1,1,0,9,7,14,16,11,19,15,20,14,15,21,26,7,8,10,0,34,4,17,19,0,6,16,5,17,4,1,11,1,7,22,10,10,10,8,27,13,10,19,30,16,0,3,6,9,10,3,7,15,14,2,26,15,6,17,9,11,4,17,11,5,42,11,23,0,16,13,25,19,21,17,6,15,3,4,6,14,23,29,23,16,10,0,7,12,19,10,24,0,9,13,0,5,23,6,26,6,8,5,12,7,5,13,8,8,18,7,13,12,29,23,6,15,2,11,0,18,10,5,9,12,29,6,24,34,51,7,13,24,32,2,15,23,22,11,16,3,14,5,22,25,0,15,6,56,15,5,12,6,6,16,7,20,2,6,5,6,11,23,7,8,10,20,26,10,12,0,7,6,7,9,17,11,1,5,27,6,3,34,8,15,7,9,4,8,9,13,11,14,1,14,13,2,6,12,31,20,4,12,26,3,13,7,10,7,12,5,16,23,16,9,4,30,16,3,22,15,24,13,0,0,10,19,0,6,0,21,1,25,3,16,7,13,8,5,0,7,3,16,3,14,6,40,14,21,15,0,9,16,16,17,18,41,35,15,23,5,7,11,19,5,23,7,5,4,12,8,1,19,2,16,15,18,11,39,9,25,0,6,8,14,2,4,9,23,11,10,8,19,0,8,6,2,24,12,23,16,0,12,10,6,0,15,16,0,16,10,0,8,11,0,20,13,5,13,6,14,17,7,0,16,7,5,7,2,21,12,0,14,0,8,13,0,4,10,0,17,15,8,0,13,1,13,12,6,26,3,7,34,18,9,3,7,0,11,2,14,10,10,16,9,13,8,10,2,8,9,16,3,0,0,10,8,8,16,8,11,10,11,10,11,25,10,5,8,24,6,3,4,15,6,4,9,27,3,9,3,8,13,10,16,2,12,15,10,4,46,5,7,10,8,31,21,24,3,7,5,10,6,9,6,8,0,6,8,9,0,7,8,18,10,15,8,10,3,14,7,34,27,3,42,4,14,3,1,13,11,6,15,9,9,17,29,35,26,6,7,19,11,5,6,11,2,5,14,22,11,6,0,23,9,0,1,18,14,6,0,31,3,15,21,9,9,0,4,1,37,7,12,18,22,4,16,0,6,7,14,7,3,12,6,19,10,0,10,4,6,10,3,71,8,9,9,8,4,0,1,20,0,11,11,0,0,2,5,27,13,10,12,4,2,0,11,9,26,9,5,2,15,11,9,17,13,1,3,0,2,4,18,1,0,11,0,24,0,29,11,0,19,1,9,11,10,19,6,8,7,5,1,7,3,7,1,0,18,4,1,7,2,0,3,3,9,26,7,8,1,7,11,5,27,8,4,7,10,31,18,23,7,7,18,28,2,0,0,4,27,6,9,5,5,15,1,4,13,5,13,16,12,1,6,2,19,9,7,9,3,4,3,2,18,18,5,6,70,11,0,11,31,11,5,10,1,7,6,5,12,4,6,4,7,20,3,7,6,11,3,5,5,11,8,7,5,7,23,13,6,14,3,1,15,1,6,6,6,14,7,44,6,24,7,12,1,11,19,19,6,6,15,20,19,2,7,8,12,15,13,10,3,4,13,2,14,1,12,9,1,5,9,18,7,6,4,12,3,4,7,5,19,0,79,22,2,7,13,5,2,4,17,21,11,5,7,4,13,6,4,11,8,7,6,10,2,2,4,15,16,10,4,2,14,0,9,9,14,0,2,5,2,13,15,12,18,13,25,4,1,6,0,21,9,23,0,24,22,9,11,0,4,1,12,2,0,1,2,4,4,16,4,6,6,5,8,5,2,2,18,6,15,6,0,2,16,5,44,13,3,8,12,11,7,24,1,3,6,0,2,6,4,15,26,8,0,1,24,18,1,3,12,8,4,4,5,9,7,5,5,0,6,4,19,9,0,9,5,10,2,3,4,6,19,16,12,7,12,7,10,5,11,30,5,4,17,5,7,3,0,0,23,12,20,7,15,0,2,7,11,0,8,16,5,0,15,18,0,11,8,8,17,19,6,14,6,11,3,5,1,2,3,0,13,4,5,1,1,9,15,4,10,0,2,0,3,8,4,7,11,4,40,10,6,5,3,3,31,4,6,2,2,18,9,6,4,4,5,7,29,7,0,1,2,8,9,9,4,5,12,2,2,0,6,6,12,11,4,1,5,9,1,16,4,6,18,4,3,0,4,5,0,0,6,1,0,8,1,0,6,4,6,5,4,10,4,8,9,0,8,31,9,6,4,2,14,1,5,2,36,8,16,12,1,5,6,5,9,10,38,9,5,5,1,4,10,19,9,9,33,4,4,6,1,10,9,4,2,6,2,0,19,0,21,1,2,2,10,2,2,1,17,0,8,1,10,5,8,258,0,0,14,7,6,7,5,19,1,20,6,7,3,7,2,5,20,11,4,8,5,3,1,4,1,4,4,22,1,6,2,15,4,9,8,10,17,0,5,5,1,1,0,8,6,1,0,3,13,1,10,5,1,9,6,2,2,14,1,19,3,4,3,10,4,5,15,3,17,13,4,27,7,13,7,0,26,6,1,0,21,6,0,4,13,4,3,4,4,6,6,0,0,134,8,10,0,5,24,4,10,0,0,3,8,2,0,4,0,13,6,3,10,0,10,4,3,13,29,9,17,4,2,1,24,1,2,13,5,2,9,0,10,10,8,20,0,17,9,8,1,3,7,21,5,8,4,8,9,5,7,7,4,7,3,0,0,3,2,0,17,4,8,7,5,19,7,4,0,6,1,18,5,5,6,18,4,0,3,5,5,9,4,13,2,7,4,10,9,1,0,1,3,7,1,2,3,8,5,3,13,0,7,4,5,9,19,5,2,1,7,7,7,4,3,0,6,0,4,0,9,10,1,4,3,8,19,19,0,4,1,0,15,12,4,13,7,3,15,5,1,3,4,64,0,5,11,2,5,6,10,5,1,4,0,0,7,0,0,13,3,6,6,10,7,1,12,7,5,2,4,0,0,30,3,0,3,3,16,28,5,0,6,21,6,0,17,7,10,7,2,0,6,14,8,2,19,4,3,3,2,3,5,16,2,4,21,2,14,9,0,5,3,3,0,16,5,0,5,7,9,0,0,16,2,9,6,13,7,2,12,0,0,3,1,4,6,2,1,2,6,2,0,2,11,4,4,9,13,0,2,11,0,0,8,0,1,8,0,13,8,18,5,10,2,3,1,0,6,4,2,3,2,5,7,4,6,8,13,5,10,1,2,0,3,17,6,5,5,28,7,44,10,17,4,5,8,12,2,2,4,9,4,6,1,10,13,3,4,4,4,5,0,0,2,7,7,3,3,36,8,6,0,5,6,5,5,7,5,12,4,1,3,0,16,15,5,2,3,13,0,1,0,0,4,7,1,1,6,1,11,6,3,1,14,4,2,3,10,4,0,0,3,0,4,0,0,8,3,3,13,2,1,6,5,7,1,14,18,3,7,1,1,1,2,2,12,12,4,0,12,5,9,4,2,5,1,2,3,2,4,2,7,1,0,8,8,0,5,2,10,0,11,6,2,4,6,6,0,3,7,1,3,0,3,3,9,5,4,4,1,6,0,9,21,9,10,3,0,11,2,12,9,8,26,5,4,3,2,11,3,8,0,11,2,2,7,8,3,6,10,1,14,1,2,11,3,3,0,6,4,18,18,5,3,5,14,2,3,3,5,0,0,6,2,10,16,10,1,5,5,7,0,4,22,6,4,10,4,7,1,0,22,5,0,1,2,5,8,8,3,6,16,4,10,1,0,7,1,2,2,1,0,4,3,24,2,0,3,28,2,2,4,1,2,0,8,5,4,9,0,1,0,17,6,1,8,3,1,5,1,9,8,8,7,1,2,13,2,0,12,0,8,1,4,23,2,2,28,3,0,7,6,3,4,8,9,0,5,4,3,1,6,1,1,0,2,4,0,6,2,2,4,3,2,5,1,0,0,1,10,3,9,0,7,2,0,2,5,2,2,8,10,10,2,8,12,6,3,1,1,11,6,2,4,8,3,9,1,3,1,16,2,4,0,12,3,2,3,5,1,3,7,0,11,9,6,7,20,6,8,0,8,5,5,1,0,33,3,1,2,0,1,5,4,1,1,11,2,1,7,21,0,10,7,8,0,4,7,0,0,5,10,3,12,6,32,8,10,9,8,9,2,5,1,2,0,2,1,20,3,0,1,8,5,1,1,2,0,5,1,19,1,4,0,20,7,3,4,0,12,146,3,12,5,1,5,3,1,0,8,6,2,1,11,6,2,12,1,3,2,3,4,5,1,9,4,7,6,0,1,7,0,0,4,17,3,2,0,2,1,4,3,5,5,1,1,6,2,3,2,2,18,4,2,2,7,5,9,1,1,6,1,1,5,3,11,4,2,7,2,0,1,3,10,5,1,32,0,9,2,9,0,7,2,12,0,8,4,9,5,5,4,0,4,2,3,7,4,7,12,8,4,16,2,3,1,6,1,7,35,4,5,3,3,1,9,5,0,3,0,8,0,2,42,4,7,4,2,1,12,0,14,13,3,1,7,0,1,7,9,14,1,0,0,4,8,5,2,6,1,29,5,10,1,0,0,5,1,4,7,0,9,2,11,2,7,12,6,16,4,0,3,3,1,3,10,7,9,2,5,2,9,4,4,3,5,3,11,1,8,5,5,7,10,7,2,0,0,11,3,13,0,1,1,4,3,10,6,2,4,11,11,9,2,4,4,4,3,11,9,6,5,0,2,0,3,7,3,10,0,5,6,2,1,7,37,3,4,8,3,3,0,1,2,9,13,3,4,0,2,6,4,2,1,7,0,1,3,7,11,1,1,5,12,1,4,8,2,0,1,6,3,13,1,6,0,1,4,9,3,1,6,1,1,2,2,6,0,1,0,3,6,3,11,4,4,2,0,0,5,3,3,11,0,2,11,2,1,6,0,0,4,1,1,10,0,0,0,0,0,3,2,22,5,6,20,3,1,6,6,1,5,1,0,2,6,9,3,1,5,2,6,4,9,2,4,6,0,2,5,1,3,10,1,1,1,2,14,12,2,4,2,4,7,1,12,1,5,3,6,4,3,1,0,6,1,6,5,3,1,1,4,1,14,0,3,8,7,108,6,3,4,5,2,0,1,1,0,5,3,4,10,2,1,5,3,6,13,0,5,6,0,10,3,4,1,8,10,0,4,2,5,16,1,6,2,0,0,14,7,4,0,2,6,0,4,0,1,0,2,3,6,1,7,0,2,4,7,0,2,1,2,3,1,3,3,1,2,0,0,0,1,4,3,4,1,2,3,4,0,7,2,11,3,0,10,4,1,1,11,107,0,2,2,2,6,0,2,3,5,9,2,0,4,1,3,4,10,7,4,5,2,0,0,4,3,3,6,4,0,3,9,0,3,7,10,0,5,4,5,5,1,1,0,6,6,10,7,3,8,6,5,2,2,10,3,1,4,14,3,2,0,3,1,5,1,4,3,3,0,1,8,5,3,0,7,7,0,8,2,2,2,6,7,1,0,3,6,4,6,3,2,11,4,5,4,3,1,1,2,2,2,5,3,3,2,1,0,0,3,1,1,3,1,1,0,4,3,2,13,3,3,0,14,2,3,7,4,1,7,3,2,10,2,0,6,6,2,4,0,0,1,1,11,1,6,2,3,17,1,8,22,2,0,0,5,4,3,6,7,0,3,0,45,5,0,2,3,1,2,1,1,4,8,1,0,2,41,0,0,1,4,0,8,0,5,2,0,5,3,14,9,0,10,4,5,1,5,0,2,3,7,2,0,1,1,2,0,3,4,0,0,5,2,20,5,1,5,0,0,17,2,0,7,3,0,4,0,1,0,2,4,3,1,2,0,8,6,2,0,4,4,4,2,6,0,4,6,0,3,2,1,4,8,0,0,2,11,5,1,12,3,1,0,3,9,9,2,0,57,3,2,4,1,3,5,2,1,0,2,0,3,1,5,2,9,32,4,0,3,7,0,3,7,0,3,29,1,1,7,1,0,4,3,0,2,0,1,7,1,2,1,6,7,8,0,0,6,2,13,9,4,0,1,1,1,0,3,1,9,4,2,1,4,4,2,0,2,2,5,26,1,0,30,0,230,2,0,0,2,2,4,1,0,20,3,0,4,2,7,4,6,6,0,0,6,5,1,10,1,3,7,3,3,4,2,2,3,4,2,4,0,1,1,2,5,5,2,3,4,2,3,2,4,2,1,8,5,17,0,3,1,0,2,5,7,1,0,2,0,6,1,1,1,5,0,1,6,1,0,4,0,0,3,2,5,3,1,6,2,15,2,5,5,3,5,10,4,7,4,3,0,8,5,0,6,7,1,2,2,9,4,3,3,2,10,5,0,3,3,0,0,1,0,2,1,0,0,0,0,2,0,10,0,4,2,10,0,2,16,4,0,1,4,2,13,2,5,3,0,1,2,7,3,1,10,2,5,1,4,7,1,4,5,1,6,3,2,0,4,5,3,0,7,0,3,3,0,2,1,5,1,4,4,3,1,3,4,4,1,15,2,1,2,0,4,5,19,6,4,4,2,6,4,1,1,4,6,0,3,0,0,2,6,9,11,1,0,8,0,3,0,2,0,1,1,7,1,5,0,1,0,61,2,10,1,4,5,2,8,7,15,1,1,2,4,0,0,2,6,2,1,8,1,4,2,2,1,0,0,10,5,2,5,2,1,6,8,12,1,4,0,7,3,3,0,8,7,3,2,1,30,1,0,0,6,1,0,0,5,1,10,18,11,0,4,1,8,0,0,2,5,5,1,5,5,0,0,3,1,8,0,6,3,1,1,1,4,2,7,0,2,5,7,0,9,1,6,1,4,10,1,0,0,1,8,6,0,0,7,0,1,3,1,6,2,4,0,3,0,2,1,2,2,5,0,2,0,4,5,6,4,1,3,2,6,13,3,3,2,1,1,1,0,4,1,0,7,3,2,1,2,5,5,0,3,4,0,1,0,0,3,2,2,1,3,0,9,1,3,0,9,1,1,2,0,3,1,2,3,5,2,0,0,11,1,7,2,10,8,2,3,5,1,1,8,2,2,3,2,7,4,0,0,2,4,1,0,4,3,3,3,0,0,1,2,10,1,0,5,1,0,1,0,4,5,0,2,2,4,1,0,5,3,2,1,2,3,1,2,0,4,4,4,1,1,0,3,5,3,2,3,4,5,4,1,0,0,4,3,6,2,7,8,1,5,7,3,3,0,0,7,0,7,4,2,1,4,4,0,0,1,2,4,3,9,1,0,2,0,2,12,1,9,1,3,1,0,0,3,2,3,1,5,2,0,1,8,1,3,2,0,0,1,1,0,2,2,3,4,2,2,0,0,9,17,0,0,5,5,1,1,1,1,1,0,1,2,5,1,0,19,0,2,2,1,3,4,2,3,2,2,1,3,3,0,24,0,0,3,0,7,5,2,0,0,2,1,0,1,2,2,6,0,5,3,8,2,6,0,0,3,0,9,0,3,0,0,0,0,12,2,4,0,7,1,0,13,1,4,0,19,3,3,0,2,1,13,1,1,3,1,0,3,1,0,0,2,0,0,0,0,0,0,4,0,0,0,2,0,0,16,4,1,0,0,2,0,0,3,0,0,0,1,0,0,0,0,0,0,0,0,2,0,0,1,0,0,1,4,0,0,0,1,0,0,0,0,0,0,0,0,0,0,0,0,3,0,74,0
K60 DTX The Wind Through the Keyhole,king,5423,2634,2125,2081,1895,1316,1766,1239,1473,1523,742,1353,899,436,532,666,837,645,624,516,573,823,683,580,334,408,346,417,290,261,382,357,313,386,350,420,366,319,267,411,385,285,355,291,122,331,237,318,320,369,291,294,192,236,159,227,293,174,236,145,178,123,167,217,206,166,202,152,128,195,90,77,122,177,66,182,146,142,110,120,122,149,280,102,129,183,173,138,157,117,146,143,183,97,106,96,146,106,136,157,141,179,45,137,160,140,189,131,72,70,149,156,84,149,102,62,101,132,141,30,109,147,101,171,26,86,151,83,102,87,155,109,64,97,111,89,67,137,98,62,51,56,69,47,100,99,61,128,79,33,52,88,123,65,95,73,63,70,60,70,37,67,53,107,66,180,82,45,65,58,58,42,102,81,9,68,44,72,82,80,44,32,48,51,49,33,29,58,122,31,45,46,137,40,63,82,65,43,51,24,48,70,57,106,24,1,50,73,31,135,88,30,52,41,49,38,53,59,61,50,38,44,57,42,20,69,33,26,28,28,38,37,70,66,74,14,37,50,43,85,13,42,44,23,25,50,21,70,25,67,49,106,39,20,60,39,15,33,40,59,72,7,27,45,50,17,38,62,49,69,20,19,38,30,52,30,67,19,64,58,16,13,45,44,57,25,11,31,28,41,34,34,0,96,36,25,33,18,17,34,23,25,5,23,96,56,2,8,17,56,67,23,16,42,55,55,14,38,48,20,46,49,22,125,11,12,9,13,28,31,28,37,23,16,17,11,66,9,23,34,16,31,24,19,7,41,21,2,44,31,32,19,23,26,73,2,16,19,30,32,18,36,46,36,12,22,44,12,21,18,26,39,19,9,20,55,24,16,42,17,23,38,19,38,8,0,0,33,42,19,3,11,31,5,30,44,41,31,22,8,3,42,31,14,28,12,20,11,15,42,34,18,48,54,42,54,25,35,16,3,25,0,5,24,17,17,15,12,11,9,24,14,13,9,0,44,16,24,0,15,37,8,40,14,14,6,12,23,24,24,29,20,7,27,14,16,28,4,25,24,46,4,0,5,6,14,32,41,10,18,31,40,11,31,23,37,31,12,0,16,10,34,26,54,9,16,34,35,10,7,44,10,56,20,33,25,19,18,2,42,17,20,7,14,22,4,18,28,27,1,32,27,14,28,16,35,0,13,27,8,33,15,23,5,10,16,32,27,24,13,4,19,20,18,31,1,8,19,8,4,37,14,21,10,17,44,0,32,1,3,8,17,4,4,32,7,20,7,15,0,21,6,6,0,27,14,10,40,3,3,46,12,10,18,3,3,11,3,19,10,27,29,31,5,17,42,18,14,3,4,20,11,13,2,21,12,3,22,14,17,19,133,34,18,14,0,2,16,11,7,7,1,33,14,2,17,12,11,4,12,13,2,20,15,17,5,17,30,16,20,5,9,9,20,9,0,12,23,18,28,9,10,10,13,0,19,10,6,0,20,0,68,17,20,24,23,27,1,27,0,4,14,21,12,0,15,16,9,4,9,7,9,12,4,7,27,4,17,9,5,5,8,12,11,10,7,21,11,20,8,12,5,8,14,8,5,6,0,31,6,32,1,28,35,12,17,1,20,6,17,11,46,17,20,8,13,10,24,6,12,3,0,16,4,10,38,1,2,9,17,8,18,10,17,0,3,8,3,37,17,19,6,3,13,0,1,4,10,4,2,5,56,37,5,0,43,2,3,15,3,33,19,17,5,7,1,16,32,40,14,18,7,1,5,0,8,17,12,4,9,6,5,5,16,18,6,13,6,12,15,12,14,0,17,15,7,0,13,37,14,3,11,20,10,4,19,99,5,11,2,22,6,17,2,12,11,0,0,23,2,9,5,4,20,14,1,3,9,5,10,7,1,21,6,0,23,5,3,0,7,15,13,7,14,27,9,4,0,13,0,32,32,0,4,9,6,8,0,4,21,2,5,11,11,11,26,1,6,9,19,10,9,15,3,0,3,1,15,2,7,17,6,7,11,3,12,10,7,15,10,1,6,5,2,2,12,28,71,27,6,11,0,4,5,18,2,7,9,29,5,13,0,17,0,13,8,13,16,30,15,7,1,4,17,2,9,0,0,16,10,5,6,9,0,2,19,8,10,3,9,12,4,1,5,7,5,8,4,7,1,14,13,13,1,0,12,18,8,4,19,0,16,12,4,4,30,2,8,1,12,4,1,18,6,4,13,1,11,14,0,0,13,10,1,0,48,12,0,12,6,3,7,6,17,2,20,0,2,5,0,10,0,6,0,8,17,0,0,0,2,6,3,1,3,0,6,11,0,0,6,1,2,0,0,7,0,26,2,0,11,3,31,14,0,10,2,11,27,4,25,3,5,25,8,7,24,14,11,0,7,7,5,36,0,1,0,12,5,4,6,1,12,0,0,17,9,4,1,0,0,0,0,9,3,4,11,0,0,3,9,0,4,2,0,9,9,0,9,4,2,1,0,8,7,2,4,3,5,9,8,2,18,0,6,11,19,12,3,6,16,6,3,3,4,0,1,1,0,6,10,11,11,65,5,6,4,19,16,0,15,8,0,12,1,25,16,16,18,4,18,16,5,5,13,4,8,23,10,1,1,2,0,6,6,5,5,1,6,0,5,2,4,2,14,0,2,0,5,1,0,51,6,12,38,2,12,2,26,7,0,5,30,18,7,2,7,0,2,6,0,18,10,0,5,7,8,4,9,0,6,0,0,1,3,22,0,1,2,16,5,0,11,15,21,1,0,0,7,4,3,7,1,8,5,19,1,2,24,8,7,11,19,17,13,15,0,0,13,4,2,14,4,10,68,1,0,0,5,5,3,2,0,2,0,0,43,14,1,0,3,6,0,0,7,0,3,3,5,11,6,39,0,0,1,0,2,16,8,0,0,0,9,7,6,2,7,4,1,5,1,0,6,2,5,5,10,0,21,0,0,5,3,12,3,2,15,1,5,4,2,6,0,3,11,3,7,9,11,11,6,5,11,0,0,16,4,1,3,1,2,0,5,3,3,0,8,2,2,3,2,13,16,0,0,11,0,1,6,4,0,15,4,3,6,15,3,9,10,5,0,0,4,5,0,19,2,2,0,4,6,3,6,6,0,0,0,0,2,0,0,1,0,2,19,6,6,0,5,6,4,2,9,2,2,0,0,2,1,3,0,1,0,0,6,0,16,0,0,4,0,3,10,2,5,0,2,0,3,3,14,11,6,1,8,7,2,0,1,1,5,6,1,0,0,0,14,4,4,10,2,5,1,0,15,0,15,0,8,6,0,6,10,0,10,6,0,1,1,12,0,1,11,1,0,0,12,9,0,0,3,3,1,1,6,0,1,26,1,4,1,5,2,3,5,0,4,2,0,3,11,3,3,0,4,13,3,0,0,8,5,20,0,0,0,0,9,0,6,3,0,2,0,1,3,12,6,13,0,0,0,35,15,11,2,17,4,7,9,1,12,0,6,1,0,6,1,2,3,4,3,13,4,3,7,3,11,2,0,11,3,7,19,12,3,12,1,3,73,7,12,7,9,6,1,7,1,20,2,0,2,5,11,5,0,1,7,6,2,21,2,1,7,4,9,6,10,2,7,0,7,0,17,2,0,6,1,22,0,1,5,0,0,0,1,1,6,1,3,14,1,9,5,1,0,7,7,0,0,1,8,1,6,11,0,3,7,0,7,2,2,3,0,2,0,6,2,2,2,0,3,3,1,3,6,0,0,2,7,5,0,0,10,9,3,2,5,0,9,0,9,0,11,6,0,0,0,4,0,9,27,0,11,7,4,2,9,0,5,0,6,2,4,12,4,9,0,0,11,9,6,0,0,14,1,0,3,3,0,8,2,7,1,7,0,1,2,15,8,0,0,0,5,0,2,3,6,0,0,0,12,1,4,8,0,3,0,1,11,8,9,6,15,4,0,4,6,0,4,11,3,2,8,3,9,0,0,4,3,17,1,0,3,11,2,0,11,0,6,5,9,5,0,8,15,4,6,2,5,3,0,2,0,0,2,3,0,0,1,0,4,3,1,1,2,22,2,6,0,3,2,9,7,0,14,1,1,2,2,6,3,6,0,2,1,3,2,2,1,5,0,5,5,11,5,4,16,4,0,1,0,14,3,0,0,2,1,0,1,3,0,0,13,8,5,0,5,0,2,0,1,0,3,0,3,1,0,6,0,5,0,18,13,12,1,4,0,12,6,1,1,2,4,2,1,1,0,0,3,0,9,0,6,2,5,13,8,6,0,6,0,0,2,5,8,1,6,4,0,1,1,2,4,0,1,11,0,11,1,0,0,0,7,3,2,0,2,6,1,1,0,0,3,4,0,9,1,2,3,1,5,4,0,0,0,4,5,2,0,11,0,0,1,0,0,0,0,2,6,0,2,0,2,0,4,0,4,0,1,0,1,1,6,0,2,0,2,0,0,2,7,0,0,5,2,8,0,4,6,0,12,3,4,0,0,1,1,12,3,1,12,0,2,3,4,6,0,0,0,1,0,1,0,3,2,1,0,0,0,0,1,1,0,3,2,0,2,0,5,1,0,1,5,3,6,0,6,14,0,3,0,8,15,4,0,2,0,3,10,0,0,0,12,4,9,9,7,15,3,4,6,3,3,1,0,5,10,2,9,10,11,0,2,0,1,2,12,5,9,2,3,4,1,2,6,3,2,2,0,10,4,0,0,0,1,0,0,2,4,1,0,1,0,0,6,6,6,0,1,0,5,1,2,0,22,0,9,0,0,7,3,0,0,4,1,7,8,0,0,1,3,2,0,0,3,3,0,0,4,0,0,10,0,3,1,0,0,0,3,0,5,8,2,13,0,0,2,2,7,5,2,1,0,15,4,4,9,0,5,0,0,0,10,0,0,6,0,12,2,6,4,0,19,0,0,6,1,3,1,0,0,1,0,0,0,6,0,0,9,4,4,48,0,0,0,28,2,33,0,4,2,0,1,1,0,4,6,1,5,0,2,0,5,0,0,9,8,0,0,2,6,0,1,0,9,3,0,0,4,0,1,5,0,0,0,3,6,3,0,12,0,1,0,3,9,1,1,0,1,2,0,5,0,10,8,1,8,7,3,0,1,5,3,0,4,0,3,5,3,4,0,3,0,5,0,1,5,4,23,7,0,0,0,0,8,0,3,2,2,4,0,9,2,9,2,2,0,0,1,0,1,7,3,2,6,0,0,0,2,4,4,5,2,1,3,2,9,2,0,3,0,11,2,2,6,3,1,0,2,2,3,0,0,0,0,0,10,2,8,5,9,0,4,0,10,0,0,0,1,4,11,0,0,5,3,0,0,0,5,0,0,5,3,0,11,4,2,0,7,0,0,1,0,0,2,0,4,2,0,26,0,0,0,0,0,0,0,5,2,5,2,0,4,0,0,18,0,1,0,0,3,0,0,0,5,4,1,0,0,1,4,8,6,13,0,0,8,1,4,7,2,2,0,0,0,2,1,1,0,0,2,3,0,2,5,0,0,9,1,2,0,2,2,9,3,2,3,0,6,5,0,0,5,0,0,1,0,2,4,4,0,3,8,1,4,0,2,14,0,1,1,4,8,8,1,0,6,0,0,0,0,0,2,13,1,1,5,0,4,0,3,0,2,2,9,0,1,9,0,14,2,2,0,1,3,6,3,7,3,2,12,1,2,3,9,8,1,0,0,1,0,1,3,0,0,0,4,1,2,0,1,0,0,2,1,0,1,0,1,2,1,1,2,2,0,7,1,0,0,2,0,2,0,0,0,0,1,2,1,0,5,0,0,0,2,0,4,7,4,0,1,0,3,0,0,1,1,0,0,0,0,0,0,0,3,0,0,3,5,0,2,0,3,7,0,1,1,1,1,0,2,17,1,0,10,5,2,1,1,2,1,1,0,6,2,0,10,12,2,1,0,2,4,4,11,8,0,1,0,2,0,0,0,3,0,0,2,2,2,7,1,3,3,0,0,2,1,1,0,2,0,3,2,0,0,2,4,2,5,0,0,0,5,5,0,1,0,1,3,3,0,0,8,1,3,1,6,4,3,1,1,0,0,2,10,1,0,3,4,0,0,3,1,4,3,0,0,0,3,9,1,2,0,0,3,6,0,0,0,3,0,2,3,1,3,0,6,0,0,0,0,1,0,4,0,0,2,0,0,0,0,1,5,1,0,0,2,12,0,0,0,0,0,3,3,0,0,0,0,0,0,0,0,0,2,2,0,13,2,2,3,0,0,0,1,3,0,1,0,0,2,1,2,0,2,0,0,0,4,1,2,2,1,0,11,2,0,0,2,1,0,11,0,13,3,0,0,1,0,0,0,2,1,0,0,1,1,4,2,0,2,1,0,0,0,0,0,4,2,0,7,0,3,2,1,2,1,1,0,5,0,5,0,33,3,2,1,0,2,2,3,1,1,0,0,1,0,6,0,0,0,1,1,1,1,0,1,0,1,2,1,0,0,2,0,4,8,2,0,2,1,2,3,0,5,0,1,0,1,1,1,1,0,2,4,0,3,0,0,1,3,0,6,0,0,0,0,0,1,0,0,1,0,0,0,0,7,1,1,0,1,3,1,0,0,0,0,0,0,1,2,9,0,0,2,0,0,0,0,0,0,0,1,9,2,0,0,0,1,2,0,2,5,0,1,0,3,0,3,5,4,0,1,2,0,3,0,5,0,0,0,3,1,0,3,0,4,0,4,1,0,0,0,2,0,2,0,1,11,0,0,0,3,23,1,8,5,2,1,0,0,0,0,1,0,0,3,2,3,0,1,1,0,0,2,2,1,3,0,0,0,2,0,0,2,0,0,4,0,0,7,5,1,1,1,0,0,0,8,4,1,1,0,0,8,0,0,1,1,2,5,0,1,0,0,5,2,1,0,0,7,0,0,1,3,2,4,1,1,0,8,3,3,5,1,0,0,3,4,1,1,0,0,0,2,4,0,1,2,1,2,0,0,0,4,0,1,0,0,0,0,0,0,0,0,8,1,0,0,0,676,0,0,3,5,5,0,0,0,1,3,1,13,2,2,1,1,0,0,0,0,0,2,0,0,0,0,2,1,1,1,0,2,1,5,0,0,2,3,1,0,0,5,0,4,0,0,0,0,0,0,0,6,3,1,0,0,0,0,5,0,3,1,0,1,4,0,0,5,1,0,0,0,2,0,4,2,17,3,0,1,0,1,0,0,3,2,2,0,2,2,1,0,5,0,0,2,3,0,2,7,3,2,1,0,2,3,0,4,4,0,0,0,2,1,2,6,3,0,0,2,2,3,0,0,4,4,0,0,2,0,5,0,0,2,0,1,0,0,0,2,0,0,0,0,1,0,4,6,0,0,4,0,17,15,0,0,0,0,1,2,0,0,0,0,0,5,0,4,0,1,6,2,1,3,7,0,1,0,2,0,2,3,1,3,5,0,0,0,0,2,6,4,0,0,0,0,5,2,0,1,2,0,0,4,0,1,0,0,4,2,1,3,3,3,2,0,1,0,0,5,0,4,0,2,5,0,1,0,1,0,0,0,2,0,1,0,0,0,0,0,0,1,3,0,0,11,7,0,0,0,1,1,0,0,0,0,0,0,1,1,3,0,3,6,0,1,0,1,3,1,0,0,1,0,2,0,2,7,0,0,0,11,4,1,1,1,0,2,0,1,0,2,0,0,0,1,0,2,1,1,6,1,1,0,2,2,9,0,0,4,0,0,3,0,1,0,0,1,0,0,0,0,3,0,0,0,2,0,0,0,0,0,0,0,0,0,4,2,1,0,1,3,0,0,0,0,2,1,0,1,0,0,1,0,20,0,2,1,1,0,0,0,1,1,5,1,5,0,3,0,0,0,2,0,1,0,2,0,2,1,0,5,0,6,3,1,0,0,0,4,3,1,0,1,11,1,13,0,1,5,1,1,3,0,5,0,0,2,0,3,0,0,0,0,0,3,1,0,0,0,4,1,1,1,0,0,0,0,0,0,2,7,5,1,0,0,1,1,0,4,1,0,0,0,0,0,2,0,0,0,0,1,1,7,7,1,0,0,4,0,0,0,0,2,0,0,1,4,2,11,0,1,3,8,3,2,4,0,0,1,0,1,0,1,0,3,0,0,2,0,4,0,0,3,0,0,0,0,4,0,2,0,0,3,3,1,0,1,1,0,0,0,0,0,0,9,0,0,5,4,0,2,0,0,1,2,0,2,0,0,2,0,4,0,1,0,2,28,3,2,1,2,0,1,2,2,2,1,0,1,0,0,0,0,0,6,0,0,3,2,3,2,0,0,0,0,0,6,0,0,1,5,5,0,5,0,0,0,1,22,0,0,1,0,4,2,0,2,0,2,4,10,2,0,2,4,4,0,5,0,0,0,0,0,0,0,6,0,0,2,0,0,4,0,3,8,1,1,0,6,3,0,2,0,5,1,0,2,0,1,1,2,2,1,0,0,3,0,8,1,3,0,2,1,0,1,0,0,0,4,4,1,2,0,1,16,0,0,1,2,0,3,0,0,0,0,1,1,0,0,4,2,1,0,0,0,6,0,0,1,0,0,0,0,7,2,1,0,0,6,6,2,0,1,2,0,0,1,1,0,2,4,0,0,0,0,0,0,2,0,0,1,4,0,0,0,1,0,0,0,2,2,0,0,1,0,0,0,0,0,1,0,0,0,0,0,1,0,0,0,2,0,2,0,0,0,1,3,0,0,5,1,0,1,2,0,0,4,1,0,2,2,2,5,5,7,1,1,0,0,0,0,1,1,0,0,0,0,0,0,1,0,0,1,1,2,0,2,0,2,0,0,1,1,1,0,3,0,13,0,2,1,3,0,0,0,0,2,1,0,1,0,0,3,0,1,1,4,0,0,0,3,0,0,0,0,1,0,1,1,0,0,2,0,0,4,0,0,0,0,1,2,0,1,3,0,0,0,0,0,1,0,0,5,1,1,0,6,0,3,0,1,0,1,3,0,0,1,1,0,0,0,0,2,0,0,0,0,1,0,0,2,0,0,0,2,0,2,2,0,3,3,0,0,0,0,0,2,0,0,1,0,0,0,4,3,2,1,0,2,0,0,0,0,8,2,5,0,0,0,1,0,0,0,0,0,1,3,1,0,1,0,5,0,0,4,1,0,3,0,0,0,3,1,0,0,1,1,0,6,0,0,5,0,2,1,0,3,0,0,1,0,8,3,1,9,1,0,0,1,4,0,0,3,0,0,1,1,0,7,0,0,0,0,0,0,3,0,0,0,0,0,0,2,0,0,3,0,2,0,0,0,0,2,8,0,5,0,0,0,1,11,0,2,0,0,3,0,0,2,1,1,1,5,0,0,0,9,1,0,1,0,1,0,3,0,4,1,0,0,0,1,0,3,0,3,0,1,0,0,0,2,0,2,1,1,2,0,0,0,1,2,0,0,0,0,0,0,0,5,0,0,0,2,7,2,2,0,0,0,2,0,0,3,0,0,0,0,0,0,0,0,0,0,2,0,0,2,1,3,0,0,6,0,0,1,2,0,0,7,5,8,0,5,0,0,0,0,0,0,6,0,0,0,0,1,0,0,0,0,0,0,0,0,1,1,5,0,0,0,8,6,1,0,1,0,0,0,0,0,1,0,0,2,0,2,0,0,1,2,1,1,0,0,3,0,0,1,1,3,0,0,1,1,4,0,0,3,10,0,0,1,0,1,0,1,0,0,1,0,1,0,0,0,4,0,0,1,0,1,1,4,2,0,4,0,0,0,0,1,0,2,0,0,0,0,1,0,3,4,1,0,0,0,0,0,1,2,9,1,0,5,0,0,1,1,3,0,0,0,1,0,0,0,2,0,0,0,0,2,1,7,2,0,0,0,3,0,5,0,0,0,2,4,2,4,0,0,0,5,3,20,0,0,0,0,0,2,1,1,2,0,0,0,0,1,0,0,0,0,0,1,0,0,2,13,0,0,0,0,5,0,2,1,2,1,1,2,1,0,0,0,0,0,0,0,0,0,7,0,0,1,0,0,1,0,0,0,0,0,1,0,1,0,0,2,4,0,0,3,1,0,0,1,0,2,0,3,0,1,0,2,0,0,0,0,4,0,3,0,1,0,2,1,0,4,2,0,0,0,4,1,0,1,0,1,1,0,2,1,6,4,2,1,0,0,1,0,0,1,0,1,2,0,0,1,3,4,0,1,1,0,0,0,0,0,1,1,0,2,0,4,0,3,8,3,4,85,0,0,0,0,1,1,0,0,0,0,0,0,1,0,0,3,1,0,3,0,0,3,0,0,2,0,3,0,0,0,5,0,0,1,2,0,0,7,1,1,0,0,2,0,1,0,0,0,0,0,1,2,0,1,0,0,0,0,0,0,3,1,0,5,3,0,1,0,0,0,2,1,0,1,2,0,2,1,1,5,0,1,0,0,1,0,0,1,0,3,1,0,1,0,0,1,0,0,0,3,2,0,0,0,1,1,0,56,0,0,0,0,13,0,0,1,2,2,2,0,0,1,0,2,1,0,2,0,2,2,5,5,0,5,10,0,3,0,0,1,1,0,0,0,0,0,0,0,1,0,0,0,0,0,0,1,10,0,0,0,0,0,0,0,0,0,1,3,0,0,1,0,0,0,0,1,1,1,1,1,6,2,0,2,1,0,1,0,0,1,0,0,2,0,0,1,1,0,2,1,1,0,0,0,1,1,0,0,0,0,0,3,0,0,0,0,2,0,0,0,1,0,2,0,0,0,0,2,0,4,0,3,1,0,0,0,1,1,0,0,0,0,1,0,1,9,0,0,0,1,0,2,0,1,4,5,0,0,0,1,0,0,0,1,0,4,0,0,0,0,3,0,0,0,1,0,2,4,0,1,0,0,0,4,1,0,0,1,0,0,1,0,2,0,0,0,0,6,0,0,0,0,4,0,1,0,2,0,1,0,0,0,0,0,0,0,0,23,2,0,3,3,0,0,0,0,0,0,3,0,0,1,1,0,0,2,1,0,0,0,0,1,1,0,1,0,2,1,3,1,0,1,0,0,0,0,1,12,0,0,7,5,0,0,0,0,0,0,0,0,4,0,0,0,1,1,4,0,0,0,0,0,4,1,5,0,0,0,8,10,1,0,0,5,0,0,0,0,0,0,1,0,0,0,4,0,2,0,0,0,0,0,0,0,2,0,0,0,0,0,0,0,0,0,0,0,2,0,0,3,0,0,0,0,0,0,0,0,0,0,0,0,0,0,0,0,0,0,0,0,0,0,0,0,0,0,0,0,0,0,0,0,0,0,0,0,0,0,0,1,1,1,0,0,0,0,0,0,0,0,0,0,0,0,0,0,0,0,2,0,0,0
K61 Joyland,king,4149,2092,1788,1946,1471,2597,826,1129,1400,1177,1092,544,897,690,683,679,480,514,517,477,556,733,396,277,651,299,614,210,336,261,252,349,289,282,235,376,285,325,250,350,309,261,273,228,225,306,205,228,184,239,269,170,195,158,156,155,172,252,240,231,222,198,145,130,230,201,78,142,137,204,188,147,139,164,197,115,118,215,131,89,130,174,59,136,148,131,103,128,133,94,73,136,150,69,143,108,96,78,134,94,116,163,142,72,118,108,114,97,122,92,108,106,101,98,139,46,43,64,99,53,71,76,83,82,39,104,89,86,52,87,97,75,111,88,109,72,55,62,53,43,78,67,31,101,149,97,65,67,74,106,120,72,67,64,52,69,33,49,75,17,61,39,96,83,31,49,50,64,45,55,111,48,78,79,65,37,55,53,76,108,72,56,66,46,51,21,30,32,31,30,35,33,59,40,35,70,30,57,34,35,56,36,70,61,46,58,63,25,44,84,28,48,14,39,31,32,46,16,41,44,25,56,51,16,62,16,28,30,33,78,19,29,21,34,41,33,48,41,35,41,52,53,28,23,55,48,60,47,35,23,43,19,27,36,30,46,26,34,30,33,45,53,29,42,70,40,26,33,50,22,45,39,48,46,69,28,42,38,42,24,16,19,32,59,74,12,18,26,32,22,21,24,29,46,30,20,23,36,41,44,39,34,67,15,25,41,17,106,14,13,26,45,28,39,27,51,27,35,30,27,30,76,13,47,15,14,33,23,20,21,59,32,38,24,8,25,28,16,37,28,26,19,14,13,20,11,31,59,38,26,53,10,41,24,30,7,7,32,19,51,36,11,30,14,27,35,16,14,26,14,21,17,34,9,17,42,12,4,32,26,12,19,18,33,13,18,0,13,40,42,50,26,34,38,28,36,26,21,25,15,26,13,26,8,28,25,21,54,17,39,32,9,14,19,16,5,11,32,19,15,20,1,22,21,15,31,14,12,20,34,42,25,20,16,3,11,14,12,1,24,23,16,12,18,16,11,5,20,20,25,17,9,15,37,26,36,27,12,14,32,29,3,0,1,4,31,33,8,4,16,15,6,26,12,16,15,10,4,0,24,11,26,18,13,9,14,25,21,43,21,11,23,39,12,9,7,19,15,2,11,12,23,3,13,13,8,11,22,11,13,7,12,10,9,25,19,0,11,21,10,13,17,25,25,12,13,64,19,23,25,4,12,10,26,13,0,15,33,2,27,12,18,35,7,31,22,0,4,13,29,13,12,25,11,19,15,20,26,7,5,6,20,9,72,21,23,14,4,8,2,18,18,14,12,11,16,6,1,8,53,9,8,15,10,9,14,5,20,4,4,22,12,5,14,14,15,4,12,3,15,9,40,36,7,9,0,1,7,10,6,3,4,15,32,7,19,12,13,16,59,9,10,9,13,10,28,12,29,9,15,12,9,0,9,9,0,25,8,9,10,13,15,4,9,18,58,10,6,4,19,0,11,12,17,8,2,4,6,11,5,6,16,17,16,11,5,9,14,12,4,8,11,3,5,11,21,10,7,13,12,21,33,3,6,23,18,1,8,11,8,10,3,11,27,6,16,3,3,10,7,17,1,9,14,28,17,7,21,15,7,2,33,1,7,10,65,11,14,7,8,10,8,15,2,4,14,8,21,2,24,12,4,17,4,0,17,11,9,23,8,18,21,4,13,1,0,10,10,14,3,4,2,7,7,4,23,15,2,9,19,21,6,23,22,17,54,11,9,4,13,14,9,10,12,7,4,2,4,33,5,6,5,4,6,4,9,2,20,12,7,9,13,0,24,9,5,1,6,2,11,16,8,6,5,9,2,48,10,4,9,8,2,16,0,11,7,4,0,3,80,10,9,10,7,14,7,6,6,12,9,10,14,4,5,2,16,17,8,0,19,12,12,3,4,18,2,9,0,9,5,12,10,62,13,4,11,5,5,9,6,6,5,11,3,4,13,7,0,18,10,19,12,9,2,0,1,1,10,4,6,8,10,5,11,2,12,11,13,13,11,5,3,6,9,10,4,4,55,3,6,10,100,2,8,13,15,6,7,4,3,6,0,14,0,9,10,18,6,26,10,10,0,10,8,19,5,3,1,21,16,11,11,8,0,3,13,6,12,5,13,7,12,17,3,7,1,8,8,9,5,17,8,11,6,4,1,2,5,7,3,0,5,4,3,18,15,5,17,3,16,6,1,6,8,1,6,7,12,2,0,6,31,13,3,6,13,12,0,9,1,5,4,8,15,12,3,0,9,8,0,7,0,11,2,1,20,0,1,2,9,5,4,11,0,6,4,12,0,1,13,0,6,10,2,0,2,10,1,12,11,2,7,4,2,16,1,2,5,1,10,3,3,0,5,9,4,10,3,9,19,4,10,3,7,3,0,9,4,8,9,18,8,0,2,5,2,10,5,0,0,0,2,3,10,18,2,2,0,8,12,0,2,19,5,3,5,0,10,13,2,4,0,9,4,2,10,8,3,14,4,1,4,9,10,5,10,7,3,6,5,8,3,4,4,0,1,2,2,11,6,11,28,2,9,9,13,6,17,0,0,2,51,7,1,1,7,7,90,6,26,4,5,6,6,0,1,9,6,5,2,4,0,7,2,9,3,5,8,2,8,0,3,0,15,0,3,2,10,2,0,0,5,8,3,6,13,6,15,9,0,8,5,3,4,12,26,0,2,9,0,5,7,0,6,2,6,4,6,2,5,11,0,5,4,8,0,3,22,5,6,0,1,10,2,4,0,0,1,2,5,3,8,15,1,8,5,8,7,3,7,3,8,1,11,1,0,2,1,3,8,4,9,10,32,4,40,0,6,1,8,1,1,7,8,0,1,12,0,0,5,9,0,0,10,0,1,3,2,9,6,0,0,4,2,0,3,8,1,0,25,7,9,13,2,1,9,13,14,9,18,0,6,4,7,5,9,3,6,0,2,3,2,5,7,5,5,2,1,5,4,0,0,1,1,0,9,10,6,10,12,10,6,7,0,4,7,8,0,3,3,0,5,0,10,0,4,6,4,1,5,5,7,19,0,5,14,0,0,2,13,5,1,7,9,3,0,3,9,5,1,1,9,1,0,5,2,4,5,1,4,0,1,8,4,3,0,0,7,0,11,0,0,3,3,4,9,3,8,11,2,4,10,4,2,1,2,1,0,1,0,2,0,0,0,0,4,1,0,5,2,6,4,10,3,0,2,4,12,4,16,4,3,1,4,6,0,2,1,1,7,14,3,0,0,3,4,3,3,0,2,4,0,1,8,0,7,2,5,2,2,2,7,0,13,5,0,1,3,5,1,3,2,6,0,3,20,12,0,4,7,3,5,0,3,0,11,10,16,7,2,5,20,5,11,2,4,2,9,1,10,7,7,12,2,5,2,0,0,0,4,1,3,0,0,0,0,0,2,2,3,6,6,0,3,2,3,7,0,1,1,1,7,6,3,7,7,4,9,3,4,4,2,1,4,1,0,1,1,4,6,13,8,6,3,5,4,14,0,3,0,3,7,7,2,2,6,1,2,4,3,6,3,2,7,15,3,6,4,3,3,4,5,6,0,4,7,5,17,5,8,9,1,8,1,6,5,3,2,0,3,0,3,9,8,2,7,5,0,2,11,0,0,0,4,2,0,7,4,2,3,15,14,4,11,4,5,0,6,0,3,3,6,9,0,3,3,3,1,1,0,2,1,1,0,0,0,0,5,2,2,2,1,12,5,0,0,0,1,5,0,1,6,1,13,7,4,1,2,1,2,2,5,3,0,4,0,2,0,8,11,9,10,4,5,0,1,1,3,2,4,21,9,10,3,12,1,5,0,6,4,2,0,16,4,0,0,1,0,1,5,2,0,5,1,0,0,6,5,5,3,0,2,3,7,12,3,1,1,0,6,4,3,1,7,2,0,6,3,6,2,1,21,12,0,6,6,3,2,6,2,2,0,10,7,0,7,0,6,9,1,4,1,2,0,1,9,5,2,3,10,9,8,1,5,0,8,3,1,4,0,1,1,0,6,9,3,0,0,0,1,2,11,4,9,0,1,1,4,2,0,1,4,3,5,4,2,6,3,8,9,0,9,4,3,6,3,7,3,1,11,0,6,1,1,1,6,6,0,5,1,12,3,0,0,1,2,0,3,0,4,0,2,2,9,0,5,5,4,0,1,0,4,0,0,0,5,6,7,10,0,3,2,5,5,0,3,14,8,2,1,3,2,11,1,7,2,2,1,3,0,2,2,2,12,1,6,10,0,2,0,0,3,4,0,0,0,5,3,2,7,3,4,0,3,1,0,12,0,2,0,0,9,3,0,0,1,4,0,115,2,0,1,3,0,10,0,1,6,1,4,8,1,0,3,1,0,3,1,6,2,2,0,0,1,0,0,6,1,0,6,4,2,0,1,0,2,7,2,4,4,5,3,21,0,2,0,2,4,0,8,4,2,0,5,7,28,1,8,2,4,1,4,0,0,2,3,4,3,2,1,0,4,4,4,2,6,3,2,3,2,0,1,1,6,0,2,6,0,7,0,1,0,3,2,1,0,1,5,0,21,2,0,3,3,0,3,12,0,3,2,4,0,3,5,2,0,1,1,1,0,3,1,2,5,6,5,2,0,3,0,5,4,5,0,2,1,1,0,8,2,3,10,2,1,2,9,13,9,4,0,8,5,0,5,8,3,1,3,6,4,0,1,3,7,0,0,4,6,4,0,12,0,6,6,4,4,0,0,0,5,6,3,2,7,1,16,0,1,3,1,1,0,7,4,0,4,0,0,1,1,0,3,11,0,4,4,1,5,0,0,6,0,1,2,0,0,0,2,0,1,1,5,2,1,0,1,4,1,2,4,1,4,1,0,22,3,1,1,0,3,1,11,0,0,1,0,7,3,6,1,0,3,0,6,3,2,1,7,1,0,4,0,2,0,15,0,0,1,1,1,9,43,0,0,3,2,0,2,3,0,3,2,1,0,1,3,1,3,5,2,0,2,4,0,4,0,0,0,3,8,1,4,4,3,5,1,1,0,3,2,2,7,1,0,2,8,3,5,5,2,3,1,0,3,1,2,2,0,2,0,2,11,5,0,2,2,3,1,2,2,12,1,1,5,4,1,0,2,2,0,0,2,1,5,4,0,3,1,5,1,0,0,0,1,0,1,0,6,8,5,5,0,138,3,1,0,2,1,1,0,3,5,0,4,3,1,1,3,6,5,5,6,2,6,1,0,0,4,0,1,3,5,1,1,0,2,0,1,0,0,2,4,0,8,7,0,1,8,3,0,0,2,4,0,2,6,3,5,3,3,3,5,4,0,0,0,1,2,2,0,42,2,1,7,3,0,5,3,0,0,0,0,3,12,3,3,2,0,1,0,3,0,0,17,2,0,2,1,1,1,0,2,1,4,0,0,1,1,3,1,0,5,1,5,6,28,6,2,1,2,1,3,1,0,3,9,2,3,3,1,0,9,9,0,8,0,0,0,0,0,3,1,3,2,5,0,4,2,14,0,1,0,6,4,3,1,1,9,5,1,0,6,0,80,0,0,2,2,2,0,0,2,1,8,0,3,1,0,3,2,1,3,2,1,4,2,1,10,0,0,0,39,3,5,3,5,0,1,0,4,1,2,7,1,0,0,3,0,2,1,2,0,3,0,0,1,3,2,1,0,0,0,0,12,1,0,0,0,1,0,0,0,0,1,0,1,3,7,4,7,3,6,2,1,2,2,12,1,0,1,1,1,5,0,2,4,0,0,0,1,2,0,0,7,3,3,8,4,0,5,1,0,0,1,0,2,5,3,0,0,2,0,1,1,2,2,0,0,1,3,1,0,0,2,0,0,0,2,0,1,0,0,1,2,3,0,1,2,0,3,1,0,3,2,0,1,0,0,1,2,9,2,1,0,1,0,0,1,2,2,1,2,4,5,3,3,2,1,3,4,0,0,2,0,0,3,1,1,0,3,0,1,0,7,0,0,7,0,9,0,1,2,0,1,1,2,3,1,1,0,0,3,0,5,2,5,0,1,10,2,0,4,1,2,2,8,7,6,1,0,0,1,6,0,5,0,1,48,2,0,2,0,2,0,0,1,0,2,4,0,0,0,1,1,0,0,2,3,3,0,0,0,5,3,3,1,0,1,0,0,0,1,0,2,1,2,0,0,4,4,9,0,6,0,10,1,1,2,0,12,0,0,3,5,5,0,4,0,3,4,0,2,203,4,2,0,3,1,1,1,0,0,0,3,1,1,0,0,2,1,1,2,0,2,0,1,3,0,3,1,2,1,0,16,0,0,6,4,2,0,5,0,10,2,5,0,5,2,0,0,9,7,11,0,4,1,2,3,5,1,1,0,0,0,0,0,0,2,0,2,0,1,4,0,3,0,0,0,0,0,3,6,5,4,7,3,1,4,0,1,0,0,0,0,3,2,3,0,1,0,0,0,5,2,0,6,5,1,0,0,2,0,0,0,3,3,2,2,1,4,0,2,1,5,0,1,0,5,2,2,1,1,2,1,1,1,1,0,3,2,1,10,0,1,2,6,1,0,7,0,1,1,0,0,1,1,0,6,0,4,1,1,1,0,1,3,0,0,5,6,1,0,1,0,3,0,1,0,0,1,0,0,2,0,0,2,2,2,2,2,0,2,11,3,0,2,2,0,1,3,0,1,5,0,1,3,0,1,0,0,0,0,3,0,0,0,0,2,1,0,3,0,0,1,7,1,0,2,2,1,0,2,1,0,4,4,5,2,0,1,0,0,5,1,1,1,1,3,2,2,0,0,0,1,2,1,3,0,0,1,2,0,0,6,0,0,4,0,2,0,6,4,1,0,0,0,0,0,0,1,0,2,0,3,0,2,2,3,2,3,0,2,0,0,6,2,0,2,5,2,4,1,1,3,0,4,10,1,1,10,5,2,0,0,0,3,1,4,1,0,0,2,0,0,1,6,1,0,4,7,0,0,0,1,0,0,8,1,1,3,1,0,0,3,3,2,0,0,1,0,0,0,0,2,6,0,0,2,1,5,1,0,1,3,4,2,0,8,1,0,0,2,0,0,0,0,1,0,3,4,3,3,0,1,1,0,7,0,0,1,0,1,0,0,0,1,4,0,0,2,10,1,0,3,0,0,1,9,3,0,0,2,7,1,0,0,0,2,0,3,0,0,6,0,0,1,2,0,0,1,0,0,0,0,0,3,0,1,2,0,2,0,2,4,0,7,0,0,5,0,2,1,0,0,1,0,0,1,5,2,5,0,1,2,1,3,1,3,0,2,1,3,3,1,0,1,0,0,2,1,4,2,1,1,0,0,0,1,0,0,2,0,1,0,5,2,6,0,0,0,1,0,2,4,2,4,4,3,2,0,0,4,0,0,0,0,3,2,0,5,1,3,0,2,1,1,1,0,0,0,1,3,3,0,1,2,0,1,8,0,0,0,4,1,0,1,1,0,8,0,0,0,3,1,0,2,0,2,0,0,0,3,1,1,4,1,4,1,0,2,0,2,0,12,3,0,1,9,0,0,1,2,0,0,4,0,1,3,2,0,0,0,0,0,0,0,2,0,0,0,1,1,1,0,0,1,0,0,2,1,1,4,1,2,0,0,1,0,18,0,1,0,2,2,0,0,0,0,1,0,3,3,6,0,0,0,0,0,9,2,0,0,2,2,2,4,1,1,0,2,2,1,0,2,5,0,1,4,0,2,0,1,2,0,1,3,4,1,0,28,1,0,1,0,1,2,1,0,0,3,0,0,2,0,1,0,0,1,2,0,2,1,3,0,0,5,3,0,0,2,1,0,4,1,0,0,2,1,4,2,0,0,0,0,0,0,0,0,9,3,3,0,2,0,6,4,1,2,0,1,15,1,1,5,0,1,1,1,0,0,0,0,0,3,1,0,4,0,0,1,1,1,4,1,2,2,3,0,0,0,5,0,0,1,3,0,0,0,0,3,2,27,1,4,1,0,2,0,1,0,0,3,3,0,0,0,0,0,0,0,4,0,0,3,1,1,0,0,5,1,0,0,4,1,0,1,5,0,4,0,1,0,1,6,1,5,3,0,3,1,0,0,1,1,0,2,0,0,0,3,3,1,0,0,3,0,7,0,0,1,1,6,0,0,0,0,7,0,2,0,1,0,0,2,2,0,0,2,2,0,0,0,11,0,0,3,0,1,12,1,1,0,0,1,2,0,0,0,1,1,4,1,13,0,0,0,2,0,1,6,0,4,0,2,0,0,6,2,4,2,0,0,3,2,0,17,3,3,1,8,0,2,1,2,0,3,3,1,0,5,5,2,0,7,1,0,0,0,3,0,2,0,0,0,1,1,2,0,0,6,7,2,2,0,0,1,0,0,3,2,2,1,0,0,0,1,2,0,2,1,2,0,3,0,2,5,2,0,0,2,0,0,0,25,4,8,1,3,1,3,5,1,2,0,3,0,0,1,0,1,1,0,2,2,0,0,2,0,0,3,1,0,2,2,2,0,0,4,0,0,0,2,0,0,1,0,12,3,0,0,1,5,1,3,0,1,2,0,0,0,1,0,0,0,1,1,1,0,5,1,0,0,1,1,1,0,0,0,0,0,2,1,1,2,0,1,1,0,1,2,1,4,1,0,0,2,0,3,0,1,2,1,0,0,0,7,3,1,0,0,0,2,2,0,2,0,2,0,0,0,0,1,0,1,0,0,1,4,1,0,0,3,0,1,2,0,1,0,0,2,0,2,0,0,0,1,2,4,0,1,1,1,3,0,0,0,1,0,1,2,0,1,2,0,0,0,1,3,0,0,0,0,0,0,2,0,9,8,0,0,1,2,5,1,0,1,0,2,3,0,1,0,0,0,0,1,1,1,0,0,0,0,1,3,1,0,0,0,2,0,0,1,2,1,0,0,0,1,0,0,0,0,3,1,1,0,2,3,1,0,4,1,5,1,2,0,3,1,2,6,0,1,0,0,0,0,1,0,1,0,2,0,0,2,4,1,0,5,3,1,0,0,2,0,1,1,1,1,2,0,5,1,0,1,0,0,0,0,3,1,1,0,0,0,1,1,0,0,0,2,1,1,0,0,0,2,4,0,0,4,0,0,0,0,1,0,2,0,1,0,2,3,0,7,1,1,0,0,0,1,3,0,1,1,0,1,1,2,2,0,0,0,4,0,2,1,1,0,2,0,1,5,3,0,0,1,1,1,0,0,2,1,0,0,0,0,2,0,0,4,0,2,1,4,0,0,0,1,0,1,0,1,6,0,1,1,1,0,4,0,0,0,0,7,0,3,0,7,0,0,1,25,1,1,0,1,0,3,0,1,1,0,0,4,2,0,1,1,8,0,1,1,6,0,0,1,0,1,0,0,0,0,0,1,0,2,2,1,0,0,8,3,0,1,0,3,1,0,0,5,1,2,0,1,0,1,0,0,1,6,0,0,1,1,0,0,1,1,0,0,5,1,0,1,0,0,1,0,1,0,0,0,6,0,1,1,0,0,0,0,0,6,0,3,0,0,0,5,0,0,0,2,1,1,1,0,0,1,0,0,0,0,2,0,1,0,2,0,3,2,0,0,0,0,1,2,1,1,1,1,0,6,0,3,1,4,0,0,0,0,4,0,0,1,0,1,0,19,1,6,1,2,1,0,0,1,0,1,0,0,0,0,2,2,1,1,0,0,1,2,1,1,0,0,0,0,1,0,0,3,0,3,2,1,2,0,1,3,0,2,0,0,0,0,0,0,1,0,0,2,1,0,3,1,7,2,0,3,1,0,4,2,1,0,0,5,1,1,0,1,0,3,1,0,2,1,0,5,2,1,0,0,0,0,0,1,0,2,0,6,0,1,3,1,1,1,3,1,1,0,0,0,1,0,2,0,0,0,2,0,3,2,0,1,1,0,0,3,0,0,0,0,1,0,1,0,1,0,0,0,4,0,0,1,1,0,9,4,3,4,0,0,4,1,0,1,0,0,1,0,0,2,1,1,0,0,2,0,2,0,0,1,0,0,0,0,0,0,0,0,0,0,1,0,3,0,0,0,1,0,0,0,0,2,0,1,0,2,0,3,0,1,0,2,0,1,0,1,0,0,0,2,0,6,3,1,1,0,0,0,4,0,0,0,0,1,2,0,0,0,0,0,3,3,0,0,0,1,0,0,0,1,0,0,0,2,0,2,0,0,1,0,0,0,0,0,0,2,0,2,0,0,0,2,1,2,0,0,0,0,0,0,0,0,0,1,0,1,0,1,1,0,1,2,1,0,1,0,0,3,1,7,0,2,1,2,0,0,0,1,0,0,0,1,7,0,2,1,0,0,1,0,1,1,0,0,4,1,8,0,1,0,0,3,0,0,1,3,2,2,0,2,0,0,0,0,0,0,3,1,0,1,3,0,0,1,0,2,0,1,0,0,0,0,3,0,0,1,0,0,4,17,0,2,0,0,0,1,0,4,0,2,1,1,0,0,0,3,0,4,0,0,1,0,0,3,1,0,0,3,0,0,1,0,0,1,0,0,0,0,1,3,2,2,0,1,1,1,3,2,0,2,0,2,0,0,0,1,0,3,0,0,2,0,0,3,2,3,0,1,0,1,0,0,0,0,0,0,0,2,0,0,0,1,0,0,1,1,1,1,1,0,0,0,0,0,0,2,0,1,1,2,1,1,3,0,2,0,3,0,2,1,2,0,6,1,3,0,16,2,0,0,1,0,0,1,1,0,0,1,1,1,0,0,0,0,0,4,0,1,1,0,0,0,0,8,0,2,0,3,3,0,1,2,2,0,1,0,0,0,0,0,0,0,1,0,0,1,1,1,0,1,0,0,4,0,0,0,0,0,0,2,1,1,0,1,0,0,0,7,0,3,0,1,1,2,1,0,0,0,0,0,0,3,0,5,1,0,0,0,0,1,0,0,1,0,4,0,0,0,0,1,1,3,1,1,1,0,4,0,5,0,0,0,1,0,1,1,0,2,0,1,0,0,1,2,0,0,0,2,0,0,0,1,0,0,1,0,1,1,0,0,0,2,0,2,0,2,0,0,2,0,0,1,0,0,0,0,0,0,0,1,1,1,1,0,0,0,0,0,0,0,1,0,0,0,6,0,4,1,0,2,0,0,0,0,0,0,1,0,1,0,0,0,1,0,0,0,1,0,0,0,1,0,0,0,0,0,0,0,0,1,0,0,1,0,1,1,0,0,0,0,0,0,0,0,0,0,0,0,0,0,1,0,1,0,8,0,0,0,0,0,1,0,0,0,0,0,0,0,0,0,0,0,0,0,0,0,0,0,0,0,0,0,0,0,0,0,0,0,0,0,0,0,0,0,0,0,0,0
K62 Doctor Sleep,king,7979,4050,3659,3772,2979,1591,2532,2342,3183,2424,1990,1520,1741,2116,2296,1384,1699,1048,970,892,1084,1543,709,711,366,680,474,898,609,446,591,641,688,672,664,648,621,615,368,757,721,545,751,555,422,645,489,401,508,521,538,470,501,328,341,283,482,448,449,447,347,385,343,416,402,354,231,275,342,336,343,257,274,272,314,238,228,356,248,197,205,253,142,303,249,263,226,258,280,198,135,306,308,155,281,198,201,157,279,199,230,390,266,174,316,170,259,226,181,205,218,215,98,255,202,137,189,120,160,175,162,164,191,292,165,150,193,146,204,156,182,206,210,151,240,168,59,168,168,105,74,123,145,192,320,182,116,207,167,181,135,141,179,108,142,84,68,110,115,74,126,133,240,168,88,62,105,76,127,165,46,147,156,143,48,98,71,84,144,192,127,107,157,107,115,78,70,73,88,60,63,83,145,80,83,121,90,64,140,47,106,83,129,165,66,75,106,52,87,119,70,56,47,83,76,35,117,48,78,89,79,99,83,64,107,55,58,107,142,133,82,66,70,114,89,63,82,108,35,87,79,56,96,62,82,81,94,120,74,92,114,54,45,57,44,85,38,71,62,84,79,101,68,71,103,31,61,37,67,84,82,76,85,82,82,51,45,101,134,61,60,48,59,78,147,64,39,85,42,48,63,41,54,52,62,67,62,64,142,84,91,62,103,50,93,83,35,180,28,29,44,14,31,75,28,81,45,97,52,86,77,124,45,98,75,53,79,39,51,91,63,56,41,52,49,48,62,37,38,59,34,48,41,15,33,59,85,38,50,52,102,34,66,52,62,39,39,76,41,53,58,39,62,26,32,58,61,37,74,40,42,31,60,50,37,99,42,33,106,42,28,51,40,38,30,22,0,37,67,45,16,39,20,41,69,50,52,44,49,55,57,47,84,32,36,35,37,62,34,33,44,45,45,60,48,30,35,55,30,20,62,90,12,35,23,27,37,29,38,43,56,55,18,29,5,18,25,30,17,57,48,37,56,45,41,28,27,37,45,54,54,15,25,52,40,31,57,38,34,39,75,16,1,6,22,34,59,40,12,46,21,38,35,13,25,38,24,20,0,30,29,63,23,30,52,31,26,413,50,23,103,20,21,29,24,32,42,27,10,43,21,35,19,22,48,18,35,28,38,52,17,40,30,30,54,188,0,29,25,40,22,39,47,20,36,47,62,34,27,31,297,44,33,40,37,7,41,59,11,31,34,20,48,21,43,33,0,6,30,58,23,47,22,3,26,52,34,22,23,19,14,15,31,58,38,29,23,12,24,8,22,37,46,56,42,33,12,2,28,26,30,53,20,22,16,26,16,40,8,22,37,25,31,22,26,36,11,38,28,24,44,39,63,22,28,2,0,27,22,16,25,22,51,34,8,19,28,14,16,22,24,36,13,16,34,54,17,35,25,22,11,21,15,19,15,0,36,23,34,28,17,18,20,24,20,43,35,24,50,48,0,20,18,36,18,28,19,13,23,16,23,32,35,25,22,42,45,39,26,21,52,32,9,19,14,47,21,15,16,13,15,30,14,15,39,29,1,17,19,21,31,12,12,40,13,25,16,2,54,40,24,8,19,26,24,29,58,44,9,16,3,52,20,19,13,101,24,19,15,19,16,74,14,2,19,29,21,50,19,24,31,22,7,62,1,40,19,9,25,27,35,44,14,37,0,2,23,31,20,12,13,13,18,39,9,36,21,2,27,8,29,7,43,21,15,62,14,10,17,13,16,10,16,12,2,14,8,15,27,9,17,9,4,18,21,28,8,29,17,24,23,11,9,33,11,18,1,16,255,12,15,8,5,20,17,12,86,27,26,10,12,7,17,28,28,20,7,9,29,37,17,8,16,23,25,18,8,13,20,17,28,2,11,15,0,18,43,13,0,12,17,19,15,11,31,12,14,0,18,33,42,32,8,13,8,25,6,8,7,37,7,6,24,12,24,29,7,0,14,30,26,31,13,7,19,10,18,26,4,15,15,9,10,12,5,30,23,33,16,11,21,18,2,16,16,29,13,4,8,45,28,9,18,16,18,16,13,23,19,8,16,0,30,0,9,8,5,9,62,20,19,2,12,16,7,19,9,3,40,12,32,15,14,25,8,13,16,19,13,33,14,37,14,9,10,13,14,9,14,19,12,20,18,6,8,30,3,28,8,26,3,16,28,3,8,28,34,38,6,20,17,2,28,7,7,16,14,39,17,19,0,32,9,3,17,18,16,1,28,16,14,10,13,15,19,10,0,15,16,0,1,1,27,0,9,21,0,0,2,38,22,18,4,20,49,11,30,0,15,18,7,18,32,0,7,6,19,4,18,23,11,14,11,10,13,3,8,14,12,21,29,12,24,8,30,11,29,10,15,29,12,11,12,8,1,0,17,11,6,29,13,14,0,1,10,4,18,9,0,0,1,0,13,12,12,13,4,0,5,14,7,7,10,2,5,2,4,21,7,1,21,0,13,23,5,12,12,4,33,8,12,7,16,16,6,9,21,6,21,10,6,8,5,19,0,17,4,3,15,3,12,34,12,10,16,16,21,28,5,2,10,46,7,0,3,12,7,21,7,105,20,7,7,14,1,4,14,36,13,6,18,1,12,11,9,3,9,20,6,25,12,3,11,24,1,14,48,21,4,7,1,13,31,10,6,8,10,1,14,0,10,10,7,2,13,57,1,3,13,0,24,18,0,6,5,15,8,13,3,23,13,0,6,12,11,2,4,2,25,17,1,6,6,5,7,0,0,3,17,6,21,22,2,7,17,8,17,19,10,16,8,11,2,22,9,0,4,7,7,7,4,2,3,0,6,4,1,7,9,13,5,4,10,13,2,9,13,12,17,11,29,0,4,10,1,6,12,1,21,22,17,9,5,7,2,3,12,11,0,40,16,23,17,35,13,18,20,6,6,26,0,10,5,13,9,13,9,36,0,9,4,5,20,8,8,17,5,1,14,2,5,1,4,14,17,24,14,14,7,16,8,10,0,0,11,13,8,17,8,11,0,12,3,5,14,10,19,11,28,12,15,20,6,0,6,32,3,5,7,26,16,5,4,7,15,1,11,16,3,2,2,14,10,0,13,7,6,9,15,12,4,14,10,8,11,0,0,9,0,10,2,0,8,18,2,14,0,4,24,13,3,21,6,5,4,7,9,0,17,3,0,0,0,5,1,28,2,0,11,4,15,16,14,9,208,7,4,5,7,11,10,5,2,15,5,6,5,0,18,24,11,17,0,0,8,14,8,4,17,12,9,5,4,11,43,21,14,4,5,10,11,4,31,18,7,0,12,9,11,5,4,18,10,0,9,26,14,0,5,5,18,4,2,7,0,5,6,16,7,7,13,7,5,14,13,8,8,14,4,21,23,10,13,5,7,4,0,22,1,5,16,0,3,0,0,4,0,6,37,1,6,4,1,18,21,11,4,16,10,10,2,16,16,14,11,11,4,19,6,21,10,6,10,17,5,1,6,2,11,13,7,5,8,20,13,6,13,115,9,6,19,9,9,7,18,6,7,0,11,6,23,8,6,1,10,20,4,2,8,15,12,12,13,0,11,14,20,3,16,7,6,4,17,12,11,7,16,12,1,11,0,20,13,3,12,5,9,0,12,6,1003,0,0,12,4,14,8,5,3,3,13,11,5,0,18,11,2,7,0,5,3,10,29,0,3,9,16,4,1,1,4,1,6,7,4,8,5,5,1,9,12,1,21,5,1,0,86,8,12,0,3,5,8,3,7,9,3,14,2,7,2,22,11,1,28,3,7,0,18,3,6,7,34,10,1,16,1,7,1,11,11,8,11,2,8,0,6,6,5,5,1,0,6,3,0,6,14,2,25,2,3,1,14,2,15,0,8,10,8,2,5,4,9,4,9,5,10,3,0,14,7,19,7,6,9,0,15,20,6,12,7,31,15,0,8,9,8,6,21,17,2,6,9,8,0,2,4,6,13,8,10,2,1,8,1,19,0,6,9,17,16,5,6,9,8,12,0,8,4,0,7,2,3,4,29,3,2,2,12,7,12,7,3,6,6,1,2,3,2,8,16,17,1,9,5,3,3,7,20,9,0,4,6,5,8,3,22,3,5,1,9,8,5,7,6,12,2,0,8,9,13,11,0,0,5,2,0,0,0,0,8,19,8,7,1,11,5,0,0,9,2,14,0,3,2,16,11,6,6,2,6,9,6,3,3,17,22,10,7,5,4,6,5,12,69,3,2,5,6,8,22,1,3,10,7,4,2,10,8,10,1,5,4,9,0,4,5,8,13,12,4,5,1,2,3,3,7,2,5,4,0,4,3,5,0,3,4,1,2,5,0,3,4,0,13,3,7,17,8,8,4,41,0,4,9,3,20,1,16,2,5,1,0,2,0,0,3,3,0,3,2,14,0,8,0,7,7,3,8,2,2,10,10,9,0,2,0,10,0,11,15,5,12,1,8,1,2,8,1,6,1,6,1,0,2,9,3,9,6,14,0,6,3,12,3,13,7,3,3,4,1,5,6,8,2,7,14,1,11,3,2,0,2,3,5,7,1,4,0,11,4,4,15,9,7,4,23,2,5,1,9,2,4,2,4,0,4,13,0,0,7,6,2,9,3,13,6,2,6,12,15,6,1,0,1,1,6,2,13,4,1,15,12,7,3,5,7,24,6,4,4,2,4,6,4,3,3,5,12,1,0,1,6,11,0,0,22,9,20,1,16,3,13,13,16,6,0,0,0,15,7,3,26,13,0,12,0,1,8,7,0,1,8,3,3,3,0,1,5,4,6,2,3,2,9,2,3,2,0,0,9,0,6,5,0,0,0,7,1,8,4,8,10,14,0,9,13,7,5,6,2,3,5,0,10,6,2,2,0,1,1,12,0,0,7,0,1,5,18,4,0,10,1,4,1,13,10,4,4,4,6,1,2,0,2,0,0,7,0,3,11,0,0,1,1,6,10,4,0,0,1,5,4,2,0,3,1,6,7,9,0,10,1,0,4,1,0,0,5,8,2,4,7,2,3,1,4,4,0,7,10,5,2,2,3,14,5,2,8,5,3,2,2,13,6,5,3,1,2,0,5,2,6,1,0,6,9,10,5,5,3,3,1,9,4,3,6,8,2,7,0,3,4,8,7,4,5,8,10,0,1,0,4,3,0,9,2,2,2,11,4,5,8,6,1,0,5,1,4,13,6,7,8,8,2,2,0,11,18,6,8,1,5,12,7,6,13,5,9,0,3,4,4,6,2,4,3,1,3,3,5,14,1,4,3,2,2,6,11,4,0,9,7,5,16,0,5,5,13,4,7,5,8,0,2,0,6,1,11,1,12,11,2,6,1,4,8,42,1,0,1,1,6,16,7,18,6,5,7,1,3,0,2,3,5,0,6,7,0,2,0,1,0,5,7,0,3,15,0,3,6,6,2,1,2,5,1,1,3,4,6,6,6,0,2,4,5,37,3,11,5,53,6,2,5,1,19,2,0,1,8,0,5,9,14,0,0,4,13,0,1,5,15,4,5,0,6,4,9,1,0,10,10,23,4,0,7,5,5,0,0,6,2,7,0,5,2,1,5,6,7,4,6,8,2,2,52,17,1,0,0,2,2,3,4,4,0,1,5,10,0,1,23,1,0,7,1,0,2,6,5,0,2,0,6,0,4,3,2,2,0,1,1,1,7,3,0,0,2,0,3,3,0,0,0,7,2,5,5,3,4,2,9,2,5,1,2,0,1,3,4,11,6,0,4,2,1,2,4,8,6,0,1,2,5,4,4,1,4,3,4,0,0,0,2,2,4,9,0,0,5,6,0,6,3,5,1,0,2,6,3,0,0,4,0,0,3,2,0,4,3,2,3,7,8,6,0,4,0,5,1,2,2,4,2,2,0,3,2,4,12,3,1,1,1,2,1,8,1,3,4,6,14,3,9,4,2,0,4,6,1,0,7,2,8,1,2,3,3,3,2,4,0,1,2,1,0,4,4,0,2,4,5,9,0,2,3,9,1,0,0,10,4,3,5,1,6,12,15,5,4,3,7,10,2,11,12,1,2,4,6,3,5,0,0,0,7,4,0,1,2,3,3,4,0,6,0,4,60,1,4,0,1,5,2,0,2,7,19,5,1,2,5,8,2,2,1,1,4,1,2,14,2,3,3,10,0,0,8,10,8,3,2,1,1,7,4,6,2,10,4,0,5,2,2,0,4,5,2,11,0,1,3,5,1,0,5,3,2,3,0,0,2,3,0,0,2,0,1,6,2,1,0,6,0,1,2,1,1,5,2,2,0,22,4,0,10,3,3,1,0,2,13,1,12,1,10,1,5,0,10,2,3,0,3,8,6,3,0,1,4,8,4,1,0,0,7,6,2,4,0,1,5,2,3,2,0,0,5,2,3,2,10,3,2,93,0,2,3,3,0,1,5,0,3,0,10,3,1,0,0,0,1,4,1,10,9,1,0,0,0,0,1,2,7,9,7,2,8,1,1,2,2,5,0,3,0,0,0,21,2,7,3,3,4,2,0,0,2,0,1,23,4,0,2,4,6,5,11,0,7,2,1,0,4,11,2,1,7,4,5,3,1,0,1,9,0,0,1,0,2,0,4,0,1,5,3,3,6,3,0,2,9,2,0,2,4,3,4,2,2,1,12,3,1,5,2,10,6,5,0,2,1,1,8,5,4,0,1,0,2,3,6,0,2,1,2,4,0,0,0,0,1,0,7,2,0,11,4,2,0,7,8,2,5,5,5,2,0,1,2,0,3,1,9,1,4,2,1,0,2,0,0,2,1,2,3,2,0,1,3,0,0,2,0,5,6,0,5,9,9,1,0,2,0,2,0,7,1,2,3,2,3,7,2,3,2,1,6,5,0,8,0,0,6,3,5,4,17,2,4,7,5,5,1,6,1,1,3,6,6,9,2,0,0,14,0,7,4,5,1,3,0,2,5,6,3,1,8,3,1,0,2,1,5,1,2,3,9,9,2,1,0,2,2,4,0,0,4,0,1,0,2,4,11,2,0,0,3,15,2,1,2,7,1,4,1,3,1,4,1,2,0,2,0,0,2,2,5,1,3,3,0,5,4,0,10,4,2,0,0,6,0,0,2,1,2,6,0,3,22,6,3,0,3,1,3,3,2,10,2,1,8,0,3,4,0,4,0,3,0,2,2,4,1,3,2,4,4,4,9,0,0,2,3,8,2,2,4,2,1,0,4,4,4,12,0,0,4,2,7,1,1,5,9,0,0,3,5,0,22,0,5,0,2,6,3,0,1,5,0,5,1,2,5,6,3,0,4,2,7,13,12,5,4,5,0,0,8,7,1,0,0,2,5,6,7,1,3,0,4,0,11,24,9,2,0,1,2,3,0,6,0,0,0,5,6,6,0,2,1,11,8,10,2,0,0,0,1,5,2,1,2,2,10,9,0,1,2,11,2,2,17,3,1,7,1,0,1,1,2,7,6,4,0,6,8,0,11,0,3,6,6,2,0,6,2,0,1,7,0,1,0,3,1,0,4,16,7,0,3,5,6,1,2,1,0,2,4,1,0,4,6,0,1,31,3,0,8,3,1,1,0,5,0,1,0,0,1,1,5,3,3,4,2,0,3,2,0,1,4,1,2,2,1,1,0,0,9,0,1,4,7,3,6,0,0,6,0,2,5,1,4,0,5,3,0,8,2,1,4,5,1,0,2,1,3,13,7,12,0,3,4,0,5,1,8,0,0,0,1,0,3,2,5,16,6,2,0,2,0,0,0,0,2,0,6,1,1,0,2,0,1,9,4,12,1,4,10,1,0,1,0,0,0,1,8,3,6,2,0,0,3,1,3,3,0,0,5,0,4,0,4,0,2,3,2,0,2,4,0,0,1,5,1,2,3,1,0,1,1,3,0,9,2,2,8,1,10,4,1,1,9,1,2,0,3,4,0,2,4,0,0,2,0,1,2,0,1,0,1,2,1,0,7,2,6,0,5,2,5,9,2,3,0,0,2,11,1,3,5,3,1,1,1,2,0,0,13,4,0,0,2,5,3,0,6,0,2,1,0,0,10,2,3,6,2,2,8,3,2,0,5,8,2,6,0,1,1,0,3,4,0,5,1,0,8,1,8,0,12,9,5,1,0,3,8,0,1,0,4,2,1,1,2,3,2,5,8,6,0,1,5,1,1,9,0,0,7,2,0,29,3,0,6,0,5,1,1,0,6,0,13,0,16,0,8,2,0,0,0,1,1,2,1,5,6,0,4,0,0,1,4,1,3,4,6,2,2,6,1,7,1,0,3,6,8,5,1,2,3,21,2,6,2,0,0,0,4,6,0,0,2,0,0,5,5,2,0,1,5,6,4,0,4,8,2,0,2,3,3,2,0,0,0,1,1,0,4,0,0,0,2,0,1,6,2,1,1,0,2,0,3,0,5,4,2,2,0,2,10,0,1,1,3,0,1,0,9,19,1,0,1,2,0,1,1,0,0,1,12,2,5,6,2,1,0,2,1,10,0,1,1,1,0,0,0,3,0,0,4,5,3,2,0,3,0,0,0,0,1,3,0,0,2,6,1,0,3,1,1,1,0,1,6,0,0,2,0,0,7,3,3,4,1,2,0,1,0,4,4,1,5,0,3,1,5,3,2,3,3,2,0,0,0,1,2,0,2,0,4,1,7,1,0,0,0,3,4,3,0,2,1,2,2,3,5,2,0,3,2,0,0,1,11,0,5,0,2,0,2,3,3,3,3,4,3,2,2,11,1,2,1,2,0,5,4,0,0,0,5,2,3,0,2,0,0,5,0,0,0,1,5,2,6,2,3,5,1,1,4,5,8,3,0,1,0,3,3,5,0,0,2,0,0,0,1,0,0,1,0,2,0,7,1,3,1,3,0,1,1,1,0,0,1,3,0,2,0,2,3,0,2,4,6,1,4,2,0,0,5,0,19,4,0,2,3,0,1,5,0,1,4,6,0,0,1,2,4,2,9,0,0,5,1,0,1,4,4,0,1,2,1,0,0,19,3,8,3,0,7,1,1,4,1,4,0,0,4,1,4,0,0,0,6,1,3,1,0,6,3,3,2,1,8,4,2,0,0,1,1,0,1,0,3,0,4,2,2,0,4,7,5,1,0,4,3,0,1,2,2,1,4,2,0,0,3,0,1,3,1,2,1,4,1,1,2,3,1,0,0,4,4,6,10,1,0,8,0,1,5,5,0,2,1,0,3,1,2,9,1,3,0,7,3,3,6,2,1,2,0,4,15,1,2,2,3,6,1,0,0,0,1,12,3,5,5,2,0,0,4,2,5,1,0,0,3,1,4,1,6,0,6,37,4,0,0,1,1,2,0,1,0,3,1,0,5,9,0,0,2,0,0,5,0,1,1,3,1,1,7,6,4,2,1,4,4,1,1,2,0,3,3,0,0,2,1,0,2,6,0,1,1,2,12,5,5,0,1,0,2,1,0,0,1,0,3,0,1,0,2,0,0,1,6,0,2,6,7,0,0,1,2,2,0,0,7,2,1,0,7,1,3,2,2,0,0,5,1,2,7,0,2,0,0,4,0,4,2,4,0,1,1,0,3,0,6,0,0,0,0,2,0,2,0,4,2,0,0,0,2,0,6,3,0,0,2,1,0,5,0,1,3,2,84,5,0,1,4,1,0,1,2,4,5,0,0,3,21,6,0,3,0,1,5,1,0,2,2,6,0,3,0,1,5,1,1,0,0,5,0,1,0,0,5,0,4,0,3,2,1,2,0,0,4,7,1,2,0,0,3,6,2,0,3,2,5,1,7,1,1,2,7,0,3,2,1,1,1,1,7,3,0,1,0,3,2,0,0,7,0,4,2,2,3,1,8,4,4,0,0,1,0,0,0,0,0,0,0,0,5,0,3,0,3,1,2,8,2,0,1,0,0,1,0,1,5,1,3,2,7,2,8,2,10,3,0,5,4,1,2,0,4,3,2,0,6,2,4,0,4,1,2,3,0,3,2,0,1,0,0,1,0,0,0,2,3,0,0,0,1,0,6,0,2,5,4,1,0,6,2,2,0,5,2,6,2,3,4,2,0,1,1,2,1,2,1,1,0,2,2,5,5,2,3,5,1,4,0,2,4,0,0,7,0,0,3,4,0,0,1,1,5,1,2,0,3,0,0,3,0,2,0,0,0,0,2,0,1,1,2,0,3,3,0,1,0,3,0,1,0,5,0,3,6,3,3,0,3,3,0,0,0,0,0,0,1,0,4,0,7,0,18,1,3,2,0,0,1,5,0,0,1,1,2,1,0,0,2,0,3,1,12,2,3,5,0,0,0,1,3,2,2,5,2,0,3,3,49,2,2,3,3,0,1,3,1,8,2,1,3,2,1,2,2,7,0,0,0,3,0,2,3,5,2,3,0,3,0,1,2,0,10,0,0,0,0,1,2,1,3,0,1,2,0,6,0,2,1,1,4,0,2,3,0,0,0,3,1,1,0,0,0,4,2,1,2,3,0,0,0,1,4,2,3,1,2,1,0,2,1,0,7,2,5,0,0,3,1,2,4,3,3,2,2,2,0,1,0,0,0,1,2,1,0,5,1,11,1,1,1,0,2,0,3,5,1,0,2,1,0,1,0,2,0,1,1,0,2,0,0,0,6,1,0,0,3,0,3,0,3,2,1,2,3,2,5,1,2,1,4,2,2,1,1,2,2,1,3,3,1,0,3,0,0,1,2,0,6,1,8,0,0,0,0,4,0,0,0,1,1,0,0,1,0,1,0,0,1,7,2,0,0,3,1,0,0,3,0,4,0,0,0,1,5,2,0,2,0,1,1,1,0,11,1,0,0,0,1,0,5,1,7,2,3,0,0,2,1,16,1,5,0,0,4,2,0,1,1,0,1,0,1,3,2,5,0,0,0,2,4,6,1,1,1,1,2,0,0,0,1,0,2,2,2,1,4,2,0,0,0,0,0,1,1,0,1,0,0,1,0,0,0,0,5,0,0,0,0,4,4,1,1,0,0,2,0,3,0,1,0,0,4,0,1,0,0,3,5,3,0,0,1,1,0,0,0,0,0,0,0,1,14,2,1,1,1,1,0,0,1,2,6,0,5,0,8,2,2,0,0,5,0,2,0,0,0,0,2,0,1,1,3,0,3,0,0,0,0,1,0,2,3,1,0,0,0,1,1,0,1,1,0,1,0,0,4,2,0,0,0,0,0,0,1,0,0,0,1,0,0,0,0,0,1,0,45,0,0,0,1,0,0,1,0,0,1,0,0,0,0,0,1,0,0,0,0,0,7,0,0,0,0,1,0,0,0,0,0,0,0,0,0,0,0,0,0,0,0,0
K63 Mr Mercedes,king,6937,3578,3222,3245,2437,1349,2838,1837,895,1744,1533,1677,1420,1292,1436,1244,418,990,781,198,934,1112,608,773,356,594,369,488,566,1378,424,562,525,688,547,568,189,456,195,608,630,420,381,457,413,466,373,391,309,368,388,341,202,277,319,226,260,314,384,411,311,292,289,282,337,271,191,252,518,235,284,225,257,199,241,228,249,129,180,188,166,512,131,248,187,32,159,363,231,182,146,240,240,101,200,164,148,153,215,160,171,195,221,150,101,137,224,181,171,136,131,201,59,142,169,88,114,100,67,167,35,299,52,150,89,55,116,153,43,112,49,47,207,50,124,123,33,108,113,85,73,115,42,140,284,80,120,151,147,148,85,110,35,109,97,422,454,84,131,126,81,16,52,177,72,60,84,66,70,116,49,65,169,105,173,58,78,49,124,155,90,42,100,26,78,96,69,34,105,57,42,87,96,76,65,94,23,81,88,48,137,11,72,94,69,195,73,43,27,118,167,87,28,79,32,44,94,30,85,7,51,84,67,58,170,39,71,90,87,110,50,57,5,61,58,25,73,71,26,56,64,52,71,50,46,57,75,64,64,56,79,19,38,10,39,83,52,48,49,49,52,102,77,65,135,34,56,58,81,42,41,70,67,54,33,58,56,59,99,43,30,44,48,50,115,76,38,51,93,28,20,666,79,52,46,71,23,78,201,54,68,37,89,35,14,188,37,50,6,77,39,22,49,63,31,9,37,44,47,42,46,152,18,65,37,36,69,31,24,8,37,49,35,21,25,44,61,6,46,32,33,47,35,31,58,29,40,129,44,47,75,7,95,36,46,20,72,15,26,42,44,2,142,26,22,4,49,27,83,34,37,15,47,46,47,40,22,20,57,242,19,35,14,6,38,63,0,35,87,126,32,45,21,85,50,62,31,19,52,28,45,28,22,44,24,30,37,71,34,32,12,22,17,7,31,21,23,40,28,17,51,4,12,34,16,51,36,30,43,39,39,48,25,26,3,25,8,23,11,42,54,39,25,37,37,68,11,26,54,33,9,16,16,71,84,66,40,16,8,29,50,24,5,134,30,70,36,16,14,46,27,21,52,3,22,17,3,17,0,35,12,67,28,44,16,17,32,4,34,25,32,15,27,29,20,1,31,8,3,28,32,30,13,12,27,25,15,3,29,47,18,22,14,7,35,46,0,29,6,23,38,16,39,36,11,10,23,138,29,23,10,27,31,27,3,0,26,28,7,20,6,13,51,20,37,19,0,4,39,51,9,32,34,27,24,40,35,32,22,14,46,31,31,171,31,50,20,1,40,10,13,29,32,35,17,29,19,65,23,45,29,33,21,7,3,20,10,39,13,8,27,31,1,24,24,29,11,3,8,31,8,5,67,8,15,0,3,15,0,164,8,0,45,24,6,24,32,43,13,26,17,46,11,26,19,42,36,9,14,4,13,5,12,14,4,0,42,10,8,24,21,10,12,8,45,70,19,11,8,26,0,8,28,33,7,19,14,14,24,10,24,11,9,34,11,20,37,19,19,7,26,20,0,14,13,33,76,10,24,16,37,42,29,15,17,13,1,9,7,23,20,20,8,36,14,36,9,1,17,9,102,6,17,15,31,16,35,18,31,5,3,4,3,12,15,52,19,17,19,11,17,45,3,4,4,30,15,11,6,10,13,20,11,5,0,41,22,13,8,24,32,42,2,18,4,0,8,22,19,6,53,2,20,18,12,34,35,8,24,17,1,3,24,15,35,33,76,5,5,18,11,20,7,23,1,14,14,4,55,6,6,19,4,26,0,18,14,21,89,44,14,6,2,5,4,7,1,5,22,8,18,14,2,30,13,9,69,17,11,15,6,9,16,1,16,134,8,1,18,15,15,13,34,19,21,13,13,80,15,28,26,7,1,14,7,15,13,25,0,8,34,5,10,7,16,0,22,0,8,24,8,16,5,6,19,22,2,38,14,21,10,4,20,11,10,26,10,1,17,10,19,26,22,6,6,8,26,3,7,21,7,17,42,26,6,10,14,15,13,16,6,7,83,5,12,7,5,0,6,5,13,16,18,4,15,27,10,5,15,12,12,0,9,0,23,5,5,11,36,67,23,15,9,2,13,7,12,1,18,14,41,3,16,2,16,38,13,9,25,37,17,44,27,9,3,7,53,5,15,27,31,15,10,13,1,10,4,10,37,2,0,13,22,4,19,20,10,3,3,3,16,14,5,17,6,9,9,13,16,108,0,3,36,12,24,8,17,1,14,19,5,21,16,5,11,7,0,9,23,0,5,0,26,3,3,21,0,1,11,6,14,5,17,0,13,15,27,2,8,19,59,4,55,68,1,12,8,5,13,13,21,79,5,6,13,7,8,29,9,26,9,11,40,7,1,10,2,0,17,38,4,7,17,5,10,0,23,3,5,16,9,4,0,4,3,2,24,11,0,0,0,2,9,9,28,14,10,0,7,9,6,11,19,16,11,2,1,24,10,6,51,0,13,4,16,9,24,5,28,11,14,12,7,16,7,4,18,0,20,10,14,15,0,2,0,0,2,28,18,2,8,29,85,12,10,11,23,41,8,6,1,68,11,2,0,3,3,17,104,20,20,2,11,13,4,12,2,4,10,4,3,0,8,14,16,3,3,5,1,11,10,1,5,19,0,1,47,20,1,1,1,10,10,15,12,22,0,0,21,0,17,8,6,4,12,21,0,10,5,0,21,6,0,8,5,6,6,82,4,7,16,0,11,5,11,2,0,6,12,11,1,4,15,2,9,0,0,8,2,6,8,9,5,0,7,19,42,9,3,9,15,17,0,2,10,0,4,7,6,5,1,4,4,2,7,6,0,11,12,13,6,6,6,11,2,6,4,9,0,10,13,0,15,15,0,10,6,3,17,13,4,11,85,3,2,5,7,3,0,15,10,29,5,3,17,19,14,15,8,8,0,7,2,285,15,16,17,10,0,1,4,9,1,7,13,15,6,2,8,5,4,0,0,3,4,18,10,6,8,2,17,4,4,1,4,4,3,0,6,7,0,24,4,18,17,6,11,2,36,9,6,10,20,1,1,59,7,20,4,10,0,2,9,9,7,3,11,10,9,12,4,8,5,2,3,3,3,10,0,13,14,1,10,12,17,0,0,20,0,53,0,0,17,17,1,12,5,5,7,24,10,20,4,33,11,1,12,0,6,1,0,1,0,8,0,2,1,0,7,18,11,14,1,19,0,2,0,4,2,7,6,19,5,35,7,3,17,0,18,10,2,6,0,0,4,9,6,2,1,7,8,15,0,20,0,13,9,19,3,5,22,5,0,12,9,0,6,26,9,5,5,10,6,0,8,28,16,0,8,97,4,11,1,10,0,1,2,23,8,15,19,14,3,11,21,7,6,8,5,1,20,16,5,2,4,1,0,0,2,8,11,4,2,0,0,4,0,3,17,1,7,6,4,18,6,7,2,0,4,4,1,16,7,7,9,11,3,7,6,12,22,4,2,6,6,0,4,7,18,12,21,3,15,13,8,3,5,1,14,8,13,5,9,5,2,19,3,0,8,11,14,1,2,6,11,5,6,0,4,24,11,2,7,0,2,15,10,35,9,11,1,6,8,10,6,3,3,7,55,1,6,6,11,3,8,1,5,0,6,29,0,8,0,11,4,5,7,3,5,2,2,8,12,0,9,2,0,9,0,7,3,9,5,0,59,3,4,8,5,0,8,9,2,19,2,1,0,8,3,1,5,2,16,3,2,2,1,2,8,2,8,6,2,3,10,4,2,19,4,3,1,11,6,3,16,1,8,0,8,2,26,10,19,2,1,0,1,9,3,11,9,22,16,2,3,0,33,3,11,3,8,0,3,6,1,2,12,3,6,6,6,0,0,3,3,4,3,7,13,7,1,13,10,15,7,3,6,16,0,0,10,2,3,7,2,0,6,0,6,3,1,9,21,0,8,4,17,5,16,5,13,2,6,21,0,3,3,5,1,0,9,3,4,15,2,12,1,0,6,8,4,10,1,0,2,5,3,3,15,0,7,2,0,2,10,16,3,2,7,9,3,14,3,10,5,1,5,2,1,4,5,2,0,6,5,4,2,58,16,16,4,2,4,1,5,7,7,7,8,1,7,13,3,4,2,13,1,0,6,3,5,8,0,0,7,4,0,6,0,0,1,5,3,6,0,10,3,3,0,0,3,9,0,12,3,23,3,6,8,11,4,4,3,8,2,0,16,8,14,5,4,8,2,37,2,0,5,3,3,2,0,6,2,11,1,6,7,9,11,6,0,1,5,26,4,4,2,7,8,13,3,2,0,6,1,6,15,3,3,3,0,6,17,2,0,5,20,2,1,2,0,2,1,1,10,0,0,5,2,4,8,1,0,10,1,2,7,9,4,4,8,2,0,3,4,0,7,17,0,12,7,3,0,6,0,4,9,31,7,1,3,8,14,4,1,6,0,8,0,7,10,17,3,17,2,2,2,6,5,3,2,10,5,0,0,1,3,12,4,5,5,9,6,11,2,4,0,4,4,3,5,13,3,0,7,7,50,4,6,3,2,0,4,1,5,5,8,3,1,24,2,7,14,3,5,3,6,0,2,0,3,2,5,12,2,0,3,7,1,0,7,1,2,5,1,20,2,3,4,2,15,5,0,0,1,6,5,39,4,4,5,12,8,3,2,8,6,0,5,4,10,6,1,2,1,1,3,3,10,1,0,2,2,10,0,0,13,10,7,0,23,5,13,17,4,4,0,2,1,5,13,4,10,3,0,3,0,0,3,5,3,1,5,78,3,4,0,1,16,3,7,3,6,4,4,0,97,6,0,6,9,0,6,3,0,0,1,2,1,3,8,3,4,11,0,4,4,11,2,78,0,5,6,0,4,2,9,1,0,9,0,4,0,0,9,0,5,4,10,4,0,7,0,6,2,11,6,1,2,2,4,2,2,0,39,0,0,4,0,4,6,0,0,0,1,1,1,3,5,2,1,3,10,3,1,1,0,6,7,6,0,5,4,2,7,15,0,0,3,11,0,0,14,1,2,1,21,3,3,13,4,3,4,2,2,21,1,8,4,5,7,0,8,6,0,1,4,0,2,0,31,1,4,25,3,3,2,12,6,3,2,2,14,4,6,0,35,2,1,3,0,4,0,1,17,1,3,11,31,0,4,0,17,2,3,7,1,3,5,0,9,5,14,5,0,2,8,7,14,5,7,9,10,7,4,1,3,8,10,4,1,12,2,4,1,3,0,19,1,2,12,2,5,0,4,3,4,1,1,0,1,2,0,13,14,2,3,0,4,6,0,6,10,6,11,0,2,4,1,5,13,5,0,3,4,2,7,2,1,1,4,1,0,4,1,1,13,3,2,2,2,1,6,7,6,6,14,1,2,0,1,1,12,9,1,0,3,1,4,7,62,3,5,5,1,0,1,4,8,5,6,7,3,1,1,2,3,4,2,1,5,3,2,0,1,5,4,9,5,3,9,4,10,5,13,0,0,0,0,13,5,4,7,2,0,0,1,6,1,0,0,8,2,0,4,2,1,5,6,3,0,6,2,1,9,0,2,3,0,5,2,4,4,9,0,3,1,2,7,2,1,0,2,1,1,5,0,1,6,1,0,11,2,2,4,9,0,0,3,5,6,3,8,6,0,1,3,0,2,3,1,0,0,1,0,2,3,5,6,2,0,0,1,2,2,3,0,0,2,0,15,8,0,0,0,3,3,4,2,35,0,0,10,2,2,0,10,11,0,4,2,5,14,3,11,7,7,1,6,72,4,0,4,3,2,3,3,5,7,3,0,4,0,1,3,4,6,2,0,1,2,1,1,0,3,4,2,0,5,0,5,0,0,3,0,0,0,2,1,4,2,5,3,3,5,1,2,9,6,3,3,4,3,1,0,0,0,5,3,2,1,2,1,2,14,1,0,5,0,2,2,1,4,7,6,5,5,5,4,8,2,4,6,1,6,0,2,2,0,3,0,4,0,3,2,1,0,1,2,0,5,2,0,6,54,0,4,8,3,0,0,3,6,4,10,7,5,4,5,1,4,1,1,4,3,0,2,4,1,3,3,3,1,0,2,0,3,1,3,1,5,7,2,0,0,9,0,3,1,1,27,0,1,3,3,0,0,3,7,3,2,1,5,2,4,0,2,3,25,0,0,22,0,7,1,6,0,9,4,4,10,1,2,3,1,1,3,2,0,5,0,0,2,10,2,0,7,2,4,7,4,0,11,9,8,0,1,1,0,0,0,0,1,6,2,1,3,4,13,4,0,7,0,2,0,5,5,3,3,6,2,0,0,17,8,1,13,4,1,3,3,0,3,5,1,2,17,1,2,1,3,4,13,0,53,1,3,0,1,9,2,5,0,1,0,0,1,2,24,19,0,2,8,6,2,1,4,3,2,0,4,4,5,2,3,2,0,0,1,4,4,0,3,2,8,1,4,6,3,0,0,1,0,2,3,4,6,0,4,0,0,1,1,5,2,2,2,1,0,7,2,4,11,0,0,4,0,3,1,1,3,1,0,2,1,0,1,0,9,5,1,4,0,6,5,3,3,0,3,2,9,1,1,0,1,44,3,3,0,5,7,0,1,1,0,4,0,0,3,0,0,1,4,3,1,22,6,20,1,1,0,1,5,3,0,2,1,40,21,0,2,0,5,7,0,3,2,5,0,4,0,7,3,4,1,9,2,3,2,0,3,11,3,2,1,0,2,9,0,0,2,0,0,0,8,4,0,7,6,19,47,2,2,1,19,2,4,0,1,3,1,0,1,1,0,5,1,0,1,1,0,0,0,4,0,1,3,8,0,1,1,0,0,3,3,2,8,0,2,15,7,8,2,2,1,1,0,4,2,0,2,4,3,6,0,12,2,6,1,2,0,3,0,2,5,2,3,2,9,4,0,8,7,2,1,3,2,0,3,12,2,2,0,3,0,7,4,3,15,7,0,11,0,1,4,8,4,1,4,4,3,0,0,1,1,2,13,0,8,2,0,6,0,1,3,3,0,1,3,2,0,0,3,5,3,1,0,3,1,1,3,1,36,1,0,42,3,3,5,0,2,3,0,0,0,4,0,0,1,9,2,2,2,0,0,1,8,6,8,1,0,1,0,2,0,1,5,0,0,6,3,2,0,0,4,0,6,2,1,4,2,0,4,0,1,0,0,3,0,3,0,8,2,2,0,3,0,2,0,5,0,3,0,0,2,4,1,3,5,0,1,0,5,6,6,23,2,0,3,9,1,8,7,6,3,0,0,3,0,6,4,1,5,1,1,2,2,2,2,0,22,6,4,2,4,3,1,0,1,180,2,4,1,3,0,3,2,1,1,4,1,0,0,1,3,7,7,0,1,1,5,1,6,10,0,4,6,1,3,3,0,12,0,0,4,1,7,0,1,2,8,10,5,9,8,17,0,2,0,2,3,5,1,0,5,0,1,0,6,1,1,4,1,0,1,4,4,4,1,1,2,0,3,5,0,1,4,1,3,2,1,0,2,0,1,4,4,2,0,1,0,19,0,0,1,3,2,16,3,0,5,6,1,4,6,3,0,1,7,2,3,1,2,0,0,3,5,0,0,5,1,4,1,2,1,1,2,0,0,1,3,5,5,2,0,0,1,5,3,24,2,1,0,0,0,3,1,1,9,1,7,3,1,2,5,1,0,0,0,2,2,1,2,2,8,2,3,3,2,0,2,7,5,0,3,4,0,2,4,4,3,6,1,2,2,0,3,0,0,5,0,0,1,0,0,2,2,1,0,2,2,0,2,0,57,0,1,2,2,0,2,3,1,1,0,3,0,5,0,4,1,3,2,1,0,0,2,1,2,0,0,2,1,1,1,0,1,0,0,0,15,1,4,0,3,0,11,2,0,1,0,2,6,6,0,0,1,1,0,7,2,3,1,0,5,0,6,0,1,13,0,0,3,3,2,4,2,1,0,6,0,0,0,0,0,1,3,0,0,0,4,5,34,4,2,0,4,2,1,3,1,2,1,0,0,1,1,2,2,0,0,0,2,5,0,2,1,0,3,2,0,3,2,12,2,2,0,0,2,1,5,0,2,0,4,0,2,2,1,2,0,1,2,0,1,3,0,1,21,3,1,3,1,2,4,0,3,3,5,1,1,6,0,0,1,10,11,0,0,0,1,1,0,8,3,10,2,6,1,1,0,0,5,0,1,11,0,0,2,0,2,0,31,0,3,0,0,1,2,2,0,3,3,0,2,3,0,0,1,1,0,5,0,0,0,2,8,0,3,1,0,1,1,2,0,11,11,3,2,0,1,2,0,2,1,2,0,4,1,3,1,3,1,2,2,0,0,0,1,0,4,0,1,0,2,2,6,3,0,2,5,6,0,1,4,3,0,0,0,16,2,3,0,0,0,1,2,1,3,4,1,1,0,1,1,9,0,3,2,0,1,0,0,2,2,0,4,1,0,2,2,2,1,1,4,0,1,0,6,5,0,0,0,5,2,1,2,0,0,4,1,0,1,2,1,1,5,2,1,0,0,3,0,0,0,4,7,2,0,0,3,1,2,0,1,9,3,0,2,1,1,0,0,0,1,5,0,0,6,0,0,2,4,1,4,1,0,2,2,0,6,0,6,1,2,0,0,1,1,0,0,1,4,0,3,2,0,0,8,1,0,0,0,0,0,5,5,2,2,1,1,7,5,0,0,0,5,2,0,2,31,2,0,1,0,1,0,2,4,0,2,5,6,1,1,3,7,0,1,3,40,0,3,4,0,5,4,1,7,1,1,4,1,0,0,1,4,0,0,6,5,1,3,1,2,2,1,1,38,4,0,0,5,5,1,0,8,3,3,2,2,4,3,3,0,6,0,4,0,2,0,0,2,4,0,8,0,0,0,0,0,1,0,0,1,1,0,2,2,0,1,1,1,0,1,2,2,2,0,1,0,1,1,7,3,6,0,7,0,0,3,0,23,6,0,0,0,1,1,0,2,4,0,2,0,1,6,6,6,0,3,3,0,22,0,2,0,3,3,3,1,4,3,0,1,6,1,25,0,0,0,0,10,3,1,2,0,0,6,0,0,0,4,0,0,1,17,1,0,2,0,1,0,1,20,2,0,20,2,4,0,0,1,0,3,0,4,0,1,0,2,4,17,1,0,7,3,0,1,0,0,2,3,1,1,0,1,0,0,2,1,2,0,5,3,0,0,1,2,0,1,4,5,2,2,2,0,4,0,23,1,0,3,2,0,0,3,3,2,1,6,2,0,8,0,3,5,1,5,2,0,2,20,0,2,2,0,2,0,0,1,9,1,9,4,2,0,0,2,0,5,31,1,0,1,0,0,7,1,0,8,0,2,23,0,0,6,3,1,2,1,1,0,4,0,0,1,0,0,0,1,0,0,2,0,1,0,1,6,1,8,1,0,4,2,2,0,5,3,2,8,1,2,1,0,0,0,0,2,3,0,0,3,1,17,3,0,0,0,0,0,2,1,6,0,0,0,0,0,0,0,2,2,0,1,0,1,0,0,0,2,1,0,0,7,0,0,7,1,4,1,1,2,2,1,0,0,6,1,2,0,1,2,0,13,4,2,1,2,3,0,4,0,0,2,0,0,0,1,0,1,1,2,4,1,7,1,0,0,4,2,1,15,1,1,0,1,1,0,4,2,0,2,0,1,0,0,0,2,0,0,0,3,10,2,0,0,2,0,2,1,4,3,0,2,2,0,4,2,5,1,1,1,3,4,2,0,4,0,1,0,3,0,0,2,0,0,0,2,1,0,5,0,2,11,0,0,0,0,0,1,1,5,0,0,2,0,1,3,0,4,4,5,0,5,1,1,1,2,0,0,2,7,1,18,1,2,0,1,1,1,1,1,2,0,4,6,0,3,0,18,1,1,0,2,1,0,2,2,0,0,0,1,1,1,0,4,5,0,2,2,5,1,40,1,1,5,0,0,0,3,3,5,2,2,3,2,6,2,0,3,0,0,0,1,1,2,1,2,0,17,5,2,2,0,5,1,2,0,2,0,1,1,0,1,1,0,0,0,0,3,3,1,2,4,1,1,0,2,1,2,1,0,2,0,6,2,1,1,1,0,1,1,0,0,8,0,1,1,4,12,2,0,6,4,2,9,7,1,4,1,2,2,2,0,2,0,2,6,6,0,0,7,4,0,0,0,2,12,1,0,0,1,0,0,0,0,2,2,2,3,0,0,4,0,0,3,0,1,39,0,1,1,0,1,7,3,0,1,5,2,0,0,0,0,21,2,0,3,0,3,1,0,8,3,0,1,7,0,0,0,0,2,0,0,1,0,0,1,2,0,2,4,0,2,0,0,0,1,0,3,2,2,2,1,2,2,2,20,0,1,0,4,7,7,0,1,1,0,0,4,5,1,4,2,3,0,0,2,6,1,3,0,2,0,3,1,0,0,5,0,1,7,1,0,1,0,0,5,0,0,0,2,1,6,1,0,0,2,0,4,2,0,3,0,2,1,2,0,2,1,0,0,0,3,3,1,2,0,5,0,0,0,5,0,11,2,1,0,2,2,0,1,4,9,0,0,6,1,0,1,0,0,2,0,0,2,0,1,1,0,0,4,2,1,0,5,10,2,4,0,2,0,3,3,0,2,0,1,1,0,2,1,0,1,12,0,0,2,1,1,1,2,0,1,0,0,1,0,0,2,0,1,0,5,1,1,4,6,2,2,2,0,1,5,2,3,2,8,1,1,1,3,0,0,0,1,0,4,2,3,4,0,0,0,7,0,0,0,2,0,0,6,3,3,0,0,1,1,2,1,0,0,0,0,0,3,4,0,1,0,1,30,3,5,2,0,0,0,0,0,0,2,13,2,0,0,0,1,0,0,4,0,0,2,7,0,1,0,1,1,0,0,3,3,2,1,0,2,0,0,0,1,2,1,3,3,0,5,0,1,4,2,0,1,1,0,3,0,0,6,26,0,3,1,0,2,4,2,17,6,1,1,1,0,0,1,0,0,2,0,0,0,0,1,3,0,0,0,6,0,0,0,1,5,0,2,8,4,1,0,0,2,6,0,2,0,2,0,4,1,0,1,2,4,0,0,0,1,1,2,8,0,6,3,0,3,1,0,1,1,1,0,0,0,0,9,0,0,0,0,2,1,1,0,0,0,0,0,0,0,0,0,0,7,0,0,0,1,0,0,0,1,2,0,1,1,1,0,0,0,0,0,3,2,0,2,0,1,0,0,0,0,0,7,0,0,0,1,0,0,0,2,0,2,0,0,0,2,0,0,0,0,0,0,0,0,0,0,0,0,0,0,0,0,0,0,0,0,0,0,7,0,0,0,0,0,0,0,0,0,0,0,0,0,0,0,0,0,0
K64 Revival,king,5844,3285,2791,2854,2335,3768,1563,1858,2136,1700,1372,912,1385,658,802,1063,932,809,734,686,790,1100,689,394,1201,446,902,375,436,410,424,491,407,461,369,468,514,428,369,524,488,401,469,407,256,527,303,345,303,357,369,225,289,250,288,289,278,269,276,314,275,241,225,280,283,308,135,198,236,270,184,201,182,193,183,216,183,284,165,125,161,218,81,183,160,221,163,166,176,157,119,186,204,96,177,156,131,125,186,146,163,174,138,175,173,146,183,162,176,169,150,163,124,134,189,112,123,105,124,98,113,161,155,161,101,141,146,128,90,103,131,156,137,106,154,119,175,116,105,89,60,82,70,128,233,119,78,124,95,80,144,89,142,93,80,81,62,80,104,44,70,58,138,107,59,57,81,63,70,71,127,141,142,96,55,60,83,65,114,115,66,74,106,56,76,69,49,60,95,69,62,51,104,71,66,105,41,63,52,40,72,60,93,101,43,58,58,55,59,105,108,53,15,51,39,49,82,36,83,54,51,85,63,47,77,43,41,65,82,70,26,48,50,102,44,27,63,52,46,69,37,66,44,35,58,64,46,92,41,78,96,47,59,41,35,56,30,44,45,53,54,69,43,65,96,39,40,55,57,50,47,45,55,35,103,56,73,57,81,62,39,51,62,82,99,6,23,56,52,31,37,38,13,40,36,66,39,28,31,54,47,39,50,50,72,71,25,72,28,52,35,83,24,48,50,61,31,42,51,31,45,64,41,42,18,26,90,31,41,41,63,70,38,46,72,29,57,26,36,83,23,36,27,15,29,32,52,34,39,26,65,35,35,19,62,40,32,64,25,50,45,37,35,21,21,28,35,21,27,21,33,17,40,36,46,62,38,46,58,31,25,29,27,48,22,6,0,27,53,48,15,21,27,33,57,58,35,43,36,22,50,33,30,35,32,21,27,55,32,28,22,19,23,19,24,38,31,38,26,19,26,6,34,42,24,26,24,40,35,35,39,27,38,21,8,24,23,15,10,33,20,24,32,29,29,19,7,20,37,50,27,13,27,63,23,49,25,23,29,28,51,57,0,20,11,31,31,19,13,14,30,19,27,19,16,21,7,12,0,33,22,39,29,6,19,24,29,12,26,27,21,14,33,25,15,16,18,26,5,28,20,12,12,23,33,11,11,36,18,10,28,34,15,30,24,49,0,18,40,25,25,26,21,15,12,28,55,17,25,24,6,25,30,20,17,41,32,37,5,48,31,25,40,27,19,22,0,6,28,26,18,22,34,9,23,35,18,29,16,13,6,15,18,23,28,27,16,7,17,3,34,16,26,25,16,13,20,22,26,30,17,27,28,12,6,32,18,27,15,20,19,19,9,21,13,15,9,16,19,19,29,32,34,16,10,0,0,23,20,7,12,10,54,23,51,17,15,2,16,18,17,21,16,20,13,35,45,33,15,7,19,20,7,31,9,0,28,19,23,21,19,36,21,9,28,26,16,63,11,30,0,18,27,26,23,9,7,5,13,13,10,11,18,9,17,14,19,23,4,10,27,14,9,13,12,16,7,12,20,6,26,21,14,11,22,23,3,18,20,15,18,14,4,18,11,19,7,2,14,27,27,5,12,18,29,11,8,24,17,17,6,25,9,13,9,18,20,34,17,17,6,12,3,3,3,18,18,23,13,28,13,13,16,2,0,15,16,11,15,11,25,19,15,17,2,1,12,20,19,6,13,7,19,33,3,26,8,11,10,2,21,8,25,50,3,32,16,5,6,13,17,8,15,15,1,8,14,14,28,13,14,6,2,27,6,12,15,17,14,5,20,15,17,23,12,15,0,20,10,11,14,12,10,21,40,7,122,20,8,6,20,6,14,6,16,13,4,1,24,42,11,14,23,15,12,10,5,12,34,18,24,12,7,16,3,16,17,3,0,31,3,15,6,5,21,8,10,0,14,12,12,34,2,10,9,37,20,12,7,15,3,6,17,13,19,20,8,0,28,17,25,20,12,5,0,5,0,18,13,7,10,7,15,16,4,6,8,13,9,19,19,6,16,8,11,10,13,3,6,21,9,13,6,8,28,8,11,7,17,6,13,0,9,1,22,1,13,14,46,6,40,12,16,10,21,16,2,2,25,16,6,13,8,3,6,8,13,7,12,15,10,16,11,5,1,23,5,32,12,12,13,17,15,10,2,7,13,13,8,8,0,17,17,5,6,24,21,3,5,16,9,8,6,11,9,19,51,12,12,16,2,27,7,2,16,5,8,0,10,14,11,5,7,23,13,25,0,13,9,0,9,0,14,0,6,14,0,0,25,17,12,6,4,10,10,9,20,2,5,14,9,6,8,1,4,7,6,4,11,9,16,9,13,2,14,9,7,17,6,14,12,12,10,12,3,3,17,32,6,20,8,14,7,4,3,0,11,4,4,14,8,33,0,8,7,4,16,7,1,0,0,5,12,11,12,11,7,0,9,14,1,3,15,4,4,1,6,26,10,2,5,0,13,6,6,7,28,5,18,6,3,13,4,10,7,7,11,13,13,7,6,4,5,8,0,0,3,25,11,9,4,30,6,8,13,7,8,33,5,1,8,78,11,3,6,18,15,15,6,2,35,5,2,12,3,5,16,8,8,5,6,0,10,12,12,4,3,15,9,16,6,7,2,12,2,3,4,13,0,3,0,7,1,10,10,15,0,1,5,0,7,21,2,10,15,14,0,14,2,0,20,12,11,9,2,6,5,3,2,5,8,0,12,10,55,15,4,6,7,4,0,1,7,6,7,0,0,1,8,5,12,4,3,3,24,4,5,8,1,8,5,6,7,7,10,0,4,11,5,4,7,12,10,0,4,1,0,15,2,2,0,3,4,4,28,6,27,19,1,15,12,0,7,10,6,2,7,5,4,5,3,2,0,2,0,13,12,4,1,81,8,7,11,10,5,14,14,8,3,12,0,6,3,4,2,20,6,6,3,4,5,9,10,8,4,10,2,1,5,5,2,0,4,11,4,9,12,14,13,14,14,5,15,1,1,10,7,6,6,1,0,6,2,7,7,7,14,2,2,6,5,19,10,0,13,36,3,17,4,9,4,2,9,5,6,2,8,12,11,3,6,8,13,7,15,2,2,6,7,6,1,13,4,15,9,0,0,11,0,2,14,0,13,10,10,6,3,3,20,19,10,15,4,31,7,6,7,0,8,1,79,1,0,10,0,9,5,0,9,7,7,16,10,11,0,8,5,4,4,17,3,5,0,8,12,2,6,5,3,14,6,9,0,0,1,15,2,15,5,10,2,4,3,8,81,15,8,17,6,10,6,0,0,10,26,0,6,8,8,2,2,11,5,0,17,21,5,0,5,7,4,13,3,6,0,0,19,5,8,7,9,9,21,7,21,10,3,11,11,10,8,8,2,8,6,7,0,0,2,10,3,2,0,44,0,1,0,2,4,9,2,20,1,11,6,18,7,0,3,1,2,7,5,8,6,4,3,10,1,11,4,2,9,4,6,16,4,6,9,10,25,10,7,10,13,4,6,40,7,2,9,11,7,10,4,11,3,1,1,1,11,2,6,9,10,10,3,7,8,7,7,9,16,0,5,13,8,0,7,9,3,4,9,4,10,14,6,3,1,9,1,11,11,15,7,6,3,0,14,14,10,0,0,12,3,6,3,7,7,5,11,5,8,2,8,4,0,3,0,7,4,4,15,0,3,2,5,6,5,3,5,0,3,1,23,1,5,2,4,4,5,6,19,7,0,0,3,0,12,0,3,4,2,2,19,7,2,4,4,4,1,14,10,0,9,4,6,0,12,4,12,7,4,7,5,11,0,12,14,6,19,57,2,6,8,0,7,4,8,2,14,0,6,9,0,3,15,0,3,9,12,3,5,2,43,9,11,3,13,4,1,17,8,6,7,4,9,3,0,8,2,3,3,3,7,0,9,8,10,6,0,9,17,0,5,17,6,3,9,7,2,3,15,8,0,4,6,14,8,1,2,3,7,5,3,5,0,9,7,8,7,1,2,4,7,2,12,3,8,0,1,1,0,3,9,4,6,5,4,3,5,20,4,4,2,4,1,8,5,4,13,9,0,6,3,1,1,5,6,11,4,1,4,4,5,2,5,1,6,2,12,5,1,1,1,6,3,0,6,5,9,7,0,0,3,9,2,2,0,0,9,15,4,6,1,9,8,5,1,0,2,8,0,11,7,10,4,7,8,0,6,4,6,17,7,6,12,4,4,1,10,3,4,1,10,5,2,3,4,4,7,7,2,12,7,7,4,0,6,22,0,18,7,3,2,0,4,12,5,6,2,7,0,4,0,2,9,2,0,5,0,2,4,3,0,9,2,1,1,5,0,5,1,1,4,4,5,8,4,2,4,0,0,1,4,6,19,1,12,3,0,0,0,2,2,0,2,3,0,2,3,7,0,4,0,4,10,8,4,2,3,9,5,5,0,0,0,1,0,7,4,3,6,6,7,3,2,4,3,6,2,6,0,0,2,1,0,2,4,4,0,13,6,6,6,3,0,0,4,4,0,7,3,2,0,3,4,0,8,2,3,1,3,4,7,3,0,3,3,4,3,2,1,2,2,9,10,0,5,3,1,5,3,2,3,0,9,5,1,0,4,1,3,4,4,8,10,0,5,5,7,22,0,0,0,8,0,5,0,3,2,4,4,1,9,5,12,14,4,5,7,4,5,3,4,2,9,7,12,5,0,2,6,5,0,0,3,5,22,1,21,0,4,14,8,7,1,0,5,9,4,5,3,9,0,17,0,1,8,7,5,0,3,2,2,3,0,0,6,4,2,5,2,3,6,2,0,2,0,0,6,0,8,5,0,0,0,2,3,4,8,4,3,11,0,3,2,10,7,6,8,2,4,1,0,2,1,1,0,6,0,6,1,0,8,0,11,1,18,4,0,2,0,15,2,6,9,15,3,12,0,0,0,0,0,0,0,8,4,1,13,0,0,0,8,2,4,4,7,0,0,4,5,2,2,7,5,2,5,5,0,3,13,13,6,5,0,1,4,5,3,1,4,0,6,0,2,10,2,8,5,0,6,7,1,8,2,2,6,7,22,2,0,18,0,0,1,0,12,0,6,13,10,0,2,9,2,2,3,1,2,3,0,4,4,1,2,5,7,0,1,0,4,3,7,4,7,6,3,53,3,0,3,2,2,0,1,2,2,2,5,2,4,3,2,1,3,4,6,1,3,3,4,4,2,1,16,8,9,10,5,1,0,5,2,4,2,3,0,0,4,6,10,1,3,4,9,0,5,2,3,5,0,10,13,2,1,5,1,1,3,4,2,9,7,5,1,6,3,2,5,4,2,0,3,0,5,4,6,8,14,3,1,8,0,3,4,6,1,2,2,0,7,7,3,2,6,0,0,0,10,3,1,1,2,0,10,8,4,6,0,3,0,2,1,2,2,1,1,6,5,7,0,7,1,2,9,2,10,2,4,3,2,0,3,13,2,15,3,3,5,4,4,1,7,0,10,1,0,1,3,1,2,5,8,0,1,7,2,0,4,3,5,1,4,6,0,3,7,0,0,4,4,0,4,0,9,6,2,2,2,4,2,7,0,3,6,0,7,3,6,3,4,2,0,5,0,6,3,0,0,9,1,5,3,5,0,1,1,5,2,3,7,3,0,2,6,0,5,3,6,0,2,2,10,1,5,2,1,2,1,1,3,1,0,2,0,0,11,0,0,6,0,0,0,4,4,2,4,6,0,2,2,1,0,0,2,6,0,5,4,1,7,2,0,0,2,3,1,6,4,0,1,1,10,2,9,1,0,3,2,0,0,1,5,3,7,4,1,1,1,3,0,2,2,0,4,1,0,26,2,0,0,1,1,0,0,1,0,6,0,0,5,3,8,5,1,2,0,5,8,3,3,0,0,3,2,14,8,4,2,1,5,1,5,1,7,10,3,0,8,5,17,0,6,1,2,5,5,4,1,2,6,0,1,1,0,2,5,3,7,3,0,1,2,2,1,3,5,1,0,4,0,7,0,0,2,9,31,0,0,9,3,0,5,5,1,3,4,2,0,4,6,7,1,7,8,3,4,5,2,0,1,0,2,1,5,4,1,2,3,1,6,2,0,8,0,5,7,2,1,0,3,3,1,0,1,1,6,4,2,6,5,3,1,0,0,2,3,4,1,4,8,3,3,5,0,2,4,10,4,0,34,3,1,7,7,6,2,7,7,0,4,0,10,0,1,2,2,1,7,1,11,7,1,0,3,14,3,1,0,0,2,12,11,1,1,1,8,1,1,3,0,4,0,2,3,1,0,6,5,0,0,15,2,0,6,0,11,0,0,2,6,3,1,1,8,10,2,0,1,1,1,0,11,4,2,4,2,3,5,2,0,1,0,0,8,5,0,3,3,1,6,2,3,2,1,0,3,0,5,2,4,4,6,1,0,3,1,3,2,0,3,2,5,2,6,3,1,0,4,0,78,3,1,4,4,1,1,2,7,0,0,3,2,1,6,3,1,7,0,2,0,4,0,2,0,10,4,2,4,0,3,4,3,4,1,0,5,2,0,5,2,1,4,3,0,0,5,0,4,6,0,1,1,4,2,6,6,9,6,3,1,1,0,5,0,0,3,1,0,8,1,1,0,8,3,19,3,0,0,2,3,1,0,2,3,7,18,7,0,1,3,4,0,4,2,5,2,2,0,1,3,5,1,4,1,0,2,0,0,0,4,1,1,2,1,4,0,67,3,0,2,1,11,5,0,9,4,1,0,2,5,2,8,3,1,0,0,0,0,0,2,1,1,2,2,2,1,2,2,0,1,3,3,4,3,4,0,0,8,0,0,1,2,0,6,0,6,2,3,5,4,1,0,5,0,5,1,3,2,7,3,0,0,3,3,4,14,7,3,2,0,0,9,2,1,1,7,8,0,12,5,8,0,8,1,2,3,6,4,26,1,0,6,1,4,1,4,4,4,0,0,4,1,2,4,0,1,1,2,0,1,4,5,3,2,5,5,3,2,4,0,6,1,0,0,1,1,0,1,0,0,0,4,1,0,2,0,12,3,0,0,6,1,1,0,3,2,3,0,2,0,1,0,1,3,1,1,1,2,0,0,1,2,0,3,4,3,3,0,1,0,0,9,0,0,4,0,4,5,4,2,2,1,1,2,0,2,2,0,3,10,0,2,2,0,2,19,1,0,4,3,4,1,1,3,2,0,1,4,5,0,2,6,6,2,1,3,0,0,40,9,5,0,10,4,0,6,2,3,1,3,4,2,0,6,0,1,4,7,0,1,0,3,4,3,0,2,0,5,7,3,0,5,9,1,0,1,2,10,18,1,3,4,4,1,1,3,3,0,0,1,1,2,3,8,1,3,0,3,0,5,15,3,2,0,0,3,3,0,6,0,0,2,0,5,4,0,10,1,16,5,2,1,0,0,2,0,2,0,1,6,1,8,0,0,3,18,3,0,1,1,2,0,2,4,10,9,5,8,0,4,7,0,4,0,10,1,0,3,5,2,1,13,0,3,0,0,3,0,34,1,5,5,2,4,2,4,0,3,4,1,4,1,10,0,17,11,0,0,2,1,1,0,3,10,0,0,0,1,4,0,1,0,0,1,0,4,3,2,3,3,7,0,0,3,3,0,2,3,0,1,0,1,2,3,1,6,0,5,3,7,2,2,3,1,3,2,7,1,5,0,11,8,6,0,4,0,0,3,7,0,1,0,5,3,13,2,5,1,5,3,1,2,1,11,2,1,0,1,0,7,1,0,4,3,0,2,2,4,0,2,1,3,0,3,1,2,3,1,0,0,1,4,7,1,2,2,4,0,3,1,0,6,0,4,2,3,0,0,0,8,1,3,0,3,0,3,2,6,0,3,0,4,5,2,1,3,10,0,0,1,4,0,2,3,1,0,5,0,0,0,1,2,1,5,1,6,3,1,1,5,4,1,1,7,7,0,3,3,0,0,0,0,2,0,0,1,0,5,6,3,5,1,0,6,0,0,1,0,4,3,1,0,4,5,2,2,0,6,1,2,2,0,3,0,0,2,5,0,2,1,1,2,1,12,0,3,0,2,0,1,3,3,2,2,4,9,3,2,0,1,4,0,2,2,0,0,1,0,2,2,0,3,0,5,0,1,13,2,0,1,1,0,5,0,0,3,0,5,0,0,17,2,0,4,0,12,11,0,1,3,0,0,16,0,3,1,4,1,2,2,5,2,0,0,0,1,0,2,1,4,0,0,0,2,0,0,4,0,4,0,3,7,1,2,4,3,0,0,0,0,0,0,5,2,1,7,4,1,1,1,2,1,4,8,0,0,4,5,3,0,9,2,1,0,0,5,2,2,3,4,0,3,4,5,1,0,0,4,1,3,2,2,3,0,2,22,8,1,0,0,17,0,3,3,3,4,0,1,0,1,15,1,4,7,1,0,0,3,0,0,1,1,1,3,3,5,8,9,3,2,1,3,0,1,1,1,4,2,0,1,2,2,1,1,1,0,4,0,1,4,2,2,0,0,7,2,5,0,0,0,1,0,0,1,4,0,0,0,2,2,18,1,11,0,0,0,6,3,1,2,0,2,2,1,0,4,3,1,3,1,0,2,0,0,1,1,0,4,1,6,2,2,5,0,0,1,1,1,8,2,0,1,6,1,0,0,0,2,2,1,4,0,4,4,0,2,2,3,1,3,0,0,0,1,0,0,8,2,0,1,1,1,0,1,6,1,0,3,1,0,0,0,2,0,1,2,0,0,0,4,5,0,0,6,2,3,1,0,1,1,2,0,3,4,0,1,1,2,6,1,2,3,0,1,3,0,3,0,0,11,2,1,2,5,6,1,1,0,3,1,1,2,0,0,1,2,3,1,0,8,0,0,2,0,0,0,0,0,0,0,3,6,0,1,0,3,1,0,0,3,0,1,1,0,1,1,0,0,0,2,4,3,0,18,0,1,0,6,0,21,3,0,1,6,0,0,11,3,3,1,1,2,1,2,5,6,2,3,2,0,0,2,0,1,1,1,1,11,0,3,0,0,3,1,1,1,0,2,0,1,4,0,1,0,0,0,1,1,0,0,0,3,1,5,2,0,3,1,1,0,1,2,0,2,0,1,2,0,0,0,0,2,2,5,2,3,0,3,1,0,0,1,13,0,0,1,1,1,3,2,2,1,0,3,0,3,5,0,2,0,1,2,0,2,1,5,1,0,4,3,2,2,3,1,2,0,2,3,0,3,0,0,0,1,2,2,1,1,4,1,8,1,0,2,1,3,7,1,0,1,2,1,1,3,0,0,0,0,2,5,4,5,1,0,1,1,1,1,21,3,1,3,0,1,0,3,0,5,0,4,17,2,0,0,3,1,15,0,0,1,1,0,0,0,2,0,0,1,1,0,5,0,0,1,0,2,3,5,6,0,6,1,8,0,1,3,0,1,5,1,0,0,0,0,0,0,7,0,1,2,2,2,1,1,1,0,0,7,1,0,6,2,0,1,0,1,0,0,0,2,1,1,0,0,3,0,0,0,2,0,2,1,0,1,1,0,3,3,0,3,2,2,0,0,10,2,0,2,0,1,1,1,0,2,1,1,9,0,6,1,1,1,0,3,5,0,0,0,1,0,2,1,8,2,1,0,0,2,0,8,2,0,0,3,3,2,6,1,0,0,1,1,1,0,0,4,0,1,2,1,2,0,0,0,5,1,3,1,2,0,1,0,0,1,6,0,4,2,1,0,6,5,1,0,0,1,2,1,4,3,0,2,1,1,0,1,2,5,1,0,1,6,4,0,0,0,1,2,1,2,0,1,2,1,1,2,0,1,4,0,0,2,5,2,3,6,0,1,0,0,1,0,0,1,0,1,5,2,0,3,3,0,1,2,2,4,0,1,6,1,0,0,25,1,0,0,1,10,0,0,1,1,0,0,1,0,5,1,0,0,3,4,1,1,2,1,0,5,0,4,1,3,1,0,1,2,3,0,0,4,2,5,1,4,0,3,0,7,4,6,2,0,2,1,1,2,4,0,2,0,0,19,3,0,0,0,0,2,0,2,1,0,6,2,0,2,58,2,0,0,4,14,4,12,5,2,0,0,1,2,0,1,7,1,3,0,1,3,2,1,1,3,2,1,0,0,7,4,2,1,7,0,0,1,1,1,1,1,0,1,4,0,1,1,1,1,0,0,2,0,11,0,0,4,3,1,2,3,2,1,0,1,1,1,5,0,3,0,0,1,3,3,6,0,0,1,4,1,0,0,2,0,0,0,5,6,0,2,0,2,1,8,7,1,0,1,5,0,2,1,0,3,0,0,0,0,0,0,7,4,1,0,0,0,0,0,21,2,0,4,2,2,0,1,3,0,0,6,0,1,1,0,3,1,2,5,0,5,5,0,0,3,1,2,1,17,1,0,0,3,3,0,0,0,2,0,0,0,0,2,0,1,0,0,2,3,1,1,0,2,3,0,0,0,2,0,19,1,0,1,4,0,2,0,1,4,3,0,2,1,2,1,1,0,0,0,2,0,0,0,0,2,0,2,1,4,2,0,1,6,0,3,0,3,1,2,3,1,3,0,1,0,0,1,0,3,1,0,0,1,3,1,2,2,0,1,1,0,1,1,2,4,3,2,0,0,0,0,3,4,0,0,1,1,2,0,1,0,2,1,0,0,0,5,2,0,0,3,1,2,4,2,0,1,0,1,1,5,1,0,1,1,0,2,1,0,0,1,0,2,0,1,2,1,0,1,1,2,0,0,0,0,4,0,0,0,2,0,0,0,0,0,0,0,1,0,4,0,0,3,1,0,0,3,3,0,0,0,2,6,1,2,1,1,0,1,2,0,1,0,2,1,0,0,0,3,6,0,3,2,2,2,2,1,1,1,0,0,2,0,1,0,1,1,0,0,0,2,0,0,3,1,3,1,0,0,2,1,3,2,0,0,1,3,2,0,0,1,3,7,0,1,2,3,0,2,1,2,1,2,0,1,1,1,2,1,2,0,0,0,1,1,0,0,0,0,7,0,0,2,2,2,0,3,2,1,2,0,1,15,0,0,1,1,1,4,4,0,1,0,1,0,0,0,0,0,0,0,1,2,1,1,0,0,3,0,0,1,0,2,0,0,5,7,0,5,0,1,5,7,10,0,0,0,0,9,0,0,2,1,0,0,0,0,3,1,0,0,0,1,0,0,0,2,4,0,0,1,1,0,1,1,0,0,1,1,0,0,0,0,0,0,0,0,0,0,0,0,0,2,0,0,0,4,0,0,1,0,0,0,0,0,0,0,0,0,0,0,0,0,0,0,0,0,0,1,0,0,0,0,1,0,0,0,0,0,0,0,0,0,0,0,0,0,0,0,0
K65 Finders Keepers,king,6364,3216,3054,2876,2301,1184,2769,1788,1268,1541,1385,1772,1414,654,683,1025,658,807,787,297,789,1073,634,567,275,593,304,421,531,962,435,467,480,653,530,548,280,450,135,578,582,369,422,425,371,400,307,337,336,344,416,343,248,268,306,240,294,270,324,316,262,270,252,304,300,266,113,199,379,211,271,197,216,149,219,232,175,171,218,154,122,354,123,247,171,92,215,273,229,187,107,213,208,116,218,183,143,101,220,140,166,204,186,148,153,141,205,157,144,149,158,215,30,118,191,127,104,111,86,73,51,224,115,144,100,79,115,118,87,115,67,111,194,58,113,160,29,102,98,92,104,98,79,142,235,85,96,177,103,163,89,74,44,75,122,288,306,65,95,150,82,43,116,116,91,51,67,62,70,86,46,122,134,129,72,77,84,56,109,137,81,64,101,66,76,91,56,31,86,46,90,77,91,67,36,96,37,70,26,52,93,33,78,114,57,200,72,54,56,102,72,69,24,55,42,50,68,41,81,21,43,84,62,42,119,31,71,55,81,95,38,56,9,45,35,14,49,55,32,53,59,42,58,51,63,55,77,83,41,30,84,19,59,16,34,76,60,58,52,39,68,69,43,45,131,37,49,62,74,49,37,62,48,41,32,50,53,53,65,56,37,24,40,47,108,117,43,31,48,34,27,334,58,58,50,74,43,55,96,71,69,34,91,21,35,143,186,39,10,44,48,11,26,62,37,21,38,124,47,24,40,131,33,104,18,46,52,46,73,16,31,56,42,23,13,47,47,7,35,27,28,36,36,58,44,14,40,51,41,34,111,8,69,33,38,42,25,31,23,65,65,10,104,11,28,16,44,31,53,22,31,19,40,36,61,35,15,17,45,173,24,15,63,8,25,68,0,18,77,39,12,32,63,41,50,63,28,20,53,20,75,51,38,36,30,23,35,63,34,35,19,26,18,16,33,24,36,34,19,11,44,4,18,31,21,27,30,19,34,41,22,27,15,15,17,21,20,33,7,27,32,19,18,34,29,44,13,31,31,42,6,23,17,62,72,27,24,90,11,21,57,37,1,78,11,47,24,12,4,31,20,21,20,8,19,21,10,35,0,34,23,47,21,55,3,31,37,1,34,25,16,10,13,21,28,7,18,11,5,27,22,26,68,14,24,13,16,19,26,18,17,25,25,13,56,49,0,32,8,21,25,14,25,14,22,12,30,90,29,32,58,21,24,21,8,0,20,32,14,23,14,7,47,30,30,29,0,13,43,104,20,29,32,15,10,37,36,40,23,7,42,42,20,29,24,27,8,14,13,11,32,18,11,40,12,13,16,51,14,34,29,31,18,19,4,16,11,23,14,12,22,20,10,23,25,20,9,7,19,18,41,7,52,8,9,0,0,10,11,112,14,5,35,27,0,25,22,3,24,18,19,23,8,23,22,38,19,16,12,12,11,8,10,22,12,2,58,10,13,23,24,8,22,14,14,43,25,18,2,26,0,11,27,18,7,19,5,9,18,37,18,16,11,20,8,22,103,15,31,7,23,20,10,22,17,9,40,5,30,12,13,26,18,19,26,14,7,12,11,32,18,10,8,33,13,21,14,0,12,14,55,14,11,23,21,19,10,39,23,9,3,18,9,10,29,70,10,16,15,20,27,22,7,0,4,12,16,40,7,7,16,19,7,4,0,30,12,4,19,28,14,29,19,15,30,0,1,11,33,11,7,24,11,16,4,27,29,3,14,4,9,5,18,20,16,61,56,6,14,19,10,8,7,21,3,12,2,10,23,9,7,17,5,25,8,25,14,41,60,26,10,3,4,8,5,62,3,17,10,11,9,6,14,7,9,12,91,30,4,8,5,4,16,0,22,82,7,1,15,22,19,24,3,15,19,15,7,30,34,26,40,3,4,24,5,11,17,22,0,13,62,10,8,6,10,5,7,0,10,17,14,22,1,9,19,16,4,17,25,20,9,3,23,14,22,17,31,1,8,19,17,20,20,8,0,15,2,15,3,13,5,11,29,13,4,15,12,12,18,1,17,13,23,8,10,10,7,0,8,14,9,13,9,3,19,17,8,9,12,10,11,0,11,0,7,2,71,9,43,53,15,2,10,2,8,6,6,0,25,11,42,2,15,2,18,8,13,7,12,14,11,28,18,17,2,4,10,12,10,18,27,11,8,10,2,18,2,7,41,1,0,7,12,1,13,9,3,4,4,4,12,0,10,10,11,8,5,18,14,50,10,13,12,8,13,12,8,0,7,13,5,3,18,3,10,13,3,5,17,0,8,1,16,0,9,18,0,0,3,14,6,17,18,6,10,3,17,0,3,12,20,16,17,10,5,7,8,6,4,23,14,19,13,5,9,6,7,9,18,16,12,9,40,10,4,17,22,18,59,22,3,13,24,4,6,0,19,8,7,7,14,8,0,5,10,5,13,5,0,0,0,2,11,14,18,14,4,0,12,13,2,1,14,7,35,7,6,23,6,8,8,0,9,5,5,22,18,3,53,16,14,6,8,21,24,7,23,2,13,10,12,7,2,8,0,1,0,4,14,5,4,25,53,7,5,20,11,27,2,60,3,83,15,0,3,3,3,10,78,5,7,6,6,10,3,7,106,8,21,8,3,2,4,13,9,0,1,7,4,17,2,3,2,13,0,16,14,11,2,1,0,10,13,3,8,13,1,0,14,0,11,9,2,3,17,16,0,11,3,0,24,5,0,8,2,7,0,24,1,10,15,0,9,8,3,2,1,6,7,13,2,10,17,1,39,0,0,8,6,3,25,6,15,2,7,5,23,24,3,11,12,28,3,10,7,0,5,2,16,11,12,1,10,0,10,4,1,12,8,11,10,1,6,13,6,31,6,5,2,13,16,0,20,17,0,6,12,5,18,11,2,0,8,3,0,2,13,1,0,52,9,15,3,6,5,10,17,31,7,4,0,11,14,165,10,7,10,11,0,6,9,3,1,9,7,4,8,3,10,2,1,0,1,5,2,12,20,13,4,21,7,12,5,2,20,3,3,3,3,2,2,20,0,3,5,11,10,5,2,12,5,12,23,0,3,25,15,4,2,55,10,0,9,10,4,4,5,11,3,9,5,8,1,0,20,4,10,10,1,15,11,4,11,3,20,2,0,18,0,22,2,0,8,15,1,5,5,4,14,10,8,14,4,8,5,16,5,0,2,12,0,2,0,2,0,9,1,0,13,3,13,10,6,4,0,5,2,2,11,5,11,30,1,28,5,1,10,26,9,18,1,3,0,0,5,8,3,3,3,3,2,4,2,10,19,8,43,9,9,7,9,13,0,9,14,0,5,2,1,0,8,4,6,0,14,36,7,9,4,59,2,14,8,6,0,1,0,22,6,3,12,5,7,4,25,5,6,12,0,3,16,12,3,6,7,4,0,5,2,4,6,1,1,0,0,3,0,4,7,2,11,2,9,8,8,5,2,0,7,3,6,9,8,3,13,6,3,8,8,9,3,2,4,13,8,1,8,5,12,16,10,0,7,4,3,6,17,0,19,2,20,3,12,2,2,2,2,0,5,15,17,3,10,2,12,8,2,3,12,21,6,8,8,0,3,2,7,3,7,7,21,10,3,2,11,7,1,6,2,3,10,8,10,3,6,10,4,0,9,7,0,8,0,10,3,7,9,4,6,4,3,3,5,13,9,4,0,5,0,11,5,8,8,0,34,7,0,4,3,1,3,2,3,15,1,4,5,5,5,2,7,1,7,2,0,1,1,1,2,2,1,2,2,0,1,7,3,17,4,11,3,9,4,0,12,5,3,0,9,4,14,14,12,2,3,9,0,9,1,10,14,4,5,4,4,1,38,3,7,2,5,0,5,4,1,5,12,0,4,5,4,1,6,4,0,3,2,4,2,8,1,3,16,7,4,2,9,10,0,1,4,5,6,9,1,0,16,0,6,3,0,13,20,0,17,6,23,6,5,4,3,2,5,5,0,2,7,6,6,2,3,2,8,7,1,3,0,2,2,4,1,4,4,4,5,5,23,1,8,0,6,0,0,5,12,5,0,0,2,6,1,13,1,11,19,1,2,6,3,6,2,29,0,9,3,0,4,27,13,9,0,1,13,1,1,2,8,5,3,2,1,8,9,5,1,12,0,0,2,4,9,4,0,0,6,5,0,10,0,0,0,0,1,10,3,9,8,2,0,1,1,8,2,0,0,13,3,5,40,4,2,9,2,7,9,29,13,6,9,1,3,4,0,1,8,2,2,4,1,4,1,6,0,8,2,9,1,8,6,4,0,2,10,8,3,4,13,17,4,12,2,10,0,6,3,5,10,4,13,6,0,9,19,3,0,4,8,0,90,5,0,4,4,0,15,6,2,5,2,2,15,0,0,17,5,3,3,3,0,8,12,9,0,5,2,0,4,9,0,4,5,3,0,2,0,3,8,2,5,4,0,6,8,6,1,0,0,7,1,2,1,7,2,6,2,0,17,11,4,5,4,3,1,0,4,0,0,8,8,5,4,7,13,8,11,4,1,4,0,3,7,6,0,13,1,14,4,0,9,1,3,0,11,2,2,2,5,5,3,9,8,6,5,5,4,2,12,0,3,2,1,2,10,2,5,0,1,2,2,0,5,1,3,7,12,17,3,0,12,9,8,4,0,0,1,5,0,8,4,12,3,10,3,6,4,5,9,1,3,2,8,3,1,5,9,3,5,3,8,3,0,1,1,8,0,0,11,4,10,0,11,2,6,7,2,4,0,1,0,16,4,0,2,1,4,4,0,2,3,2,2,1,9,68,1,2,0,2,4,3,3,6,8,1,4,0,51,5,0,1,10,0,8,4,0,0,0,2,3,6,4,3,10,1,0,2,3,10,4,33,7,1,5,4,1,1,2,2,0,4,1,12,1,0,8,0,6,0,9,5,0,5,0,6,7,18,10,1,1,2,1,1,5,0,10,0,0,4,0,0,1,58,0,1,6,0,104,5,3,0,4,5,11,0,6,2,2,14,7,4,0,7,2,0,2,4,0,0,1,3,4,2,4,3,7,0,4,3,3,12,5,5,1,0,1,10,3,3,8,3,9,1,1,3,13,3,4,18,0,0,7,0,4,16,3,5,7,25,1,4,0,7,9,9,5,3,14,9,5,0,0,0,1,2,7,0,4,10,15,4,2,0,3,1,1,1,2,2,5,7,6,5,22,10,3,1,10,8,2,3,8,10,15,7,4,2,3,7,6,3,3,2,5,3,0,7,1,14,2,0,6,8,2,2,3,6,5,1,4,2,2,5,0,6,3,0,13,3,2,3,0,8,7,3,1,2,6,1,1,3,6,0,0,0,1,3,5,4,2,1,10,1,1,4,19,4,5,4,6,7,2,1,6,5,6,6,12,12,0,0,1,0,2,3,18,0,2,3,1,5,0,3,2,8,0,0,2,1,0,15,7,11,2,4,1,3,2,6,3,6,7,1,3,0,1,1,10,7,8,6,6,12,17,1,7,1,0,2,0,2,1,1,5,14,1,0,5,6,1,1,5,7,7,1,2,1,2,1,3,2,0,2,0,1,5,0,1,2,6,1,1,0,2,6,0,3,4,0,7,3,1,4,2,2,21,3,103,4,7,1,0,8,0,6,6,2,1,3,2,8,0,3,7,3,0,8,2,0,1,3,3,0,6,1,3,2,3,8,15,2,0,0,2,3,1,4,0,0,4,0,6,1,0,0,0,2,0,6,0,11,0,0,2,5,2,6,4,13,4,6,1,0,22,1,10,4,0,2,7,5,9,0,5,3,4,5,1,7,0,7,5,2,0,2,2,5,1,7,0,3,5,1,1,0,8,2,2,0,1,0,0,0,0,1,0,0,7,1,1,3,0,1,1,2,2,3,3,1,1,8,1,1,2,1,2,1,0,7,2,5,5,5,1,0,12,30,4,10,3,2,7,0,5,2,5,1,3,0,6,9,1,4,7,1,2,0,2,3,1,2,1,3,0,1,1,1,0,0,6,19,2,9,5,3,23,1,6,4,25,0,0,6,4,2,4,5,2,12,5,3,3,1,0,12,3,1,2,3,4,4,0,1,0,0,5,2,6,0,1,0,5,0,2,3,0,6,0,2,7,0,18,0,1,3,2,0,1,1,3,8,1,1,7,6,4,0,0,1,6,0,2,3,4,3,5,1,0,3,6,1,5,2,3,2,1,5,1,2,0,0,0,0,1,6,4,0,8,4,4,6,0,1,0,12,8,0,2,3,1,5,0,0,1,4,1,4,1,0,3,5,0,2,0,2,2,8,6,3,0,6,2,5,0,4,10,0,17,1,3,2,0,0,1,6,2,2,4,3,1,1,23,3,2,0,34,4,4,2,1,2,4,5,1,2,0,0,6,1,2,3,1,6,3,2,2,1,0,0,2,1,5,2,7,1,0,1,1,4,3,1,2,3,0,1,4,3,8,7,0,0,1,3,0,4,0,5,1,0,0,0,0,0,3,2,4,8,5,0,3,0,3,1,2,2,0,3,0,2,4,5,3,0,0,2,2,3,1,0,4,1,0,12,1,5,4,2,1,3,5,0,8,4,1,0,0,11,2,0,3,3,1,4,0,0,0,2,0,0,1,0,0,0,5,1,4,3,5,3,7,1,0,8,9,0,0,0,5,6,3,2,2,2,10,5,3,3,3,6,1,0,0,1,7,0,8,10,2,4,0,0,1,5,9,1,32,2,0,5,4,0,6,0,1,0,13,0,16,1,7,3,3,4,4,0,5,3,4,0,0,13,0,0,5,3,1,1,0,2,0,6,1,0,1,2,4,2,4,4,0,1,0,0,0,2,4,0,6,0,10,7,10,10,0,4,0,0,0,4,3,1,1,0,2,4,0,6,1,1,3,1,0,9,0,1,2,3,4,2,9,2,12,1,7,3,2,6,0,2,5,8,1,1,8,0,0,8,2,4,11,6,0,0,0,1,1,8,1,3,4,1,0,0,1,8,5,5,7,0,6,4,2,3,0,2,8,5,1,3,1,0,0,0,3,3,5,0,0,1,0,14,1,1,21,1,0,22,1,10,1,0,1,3,0,0,0,1,0,1,1,4,1,3,2,0,0,0,1,4,6,4,0,3,0,0,1,1,11,6,0,5,1,2,0,2,1,0,4,4,3,10,0,0,4,0,2,4,0,4,1,6,0,1,4,2,2,4,0,1,6,1,3,0,0,1,2,0,1,7,0,1,1,1,5,3,4,1,3,0,6,14,2,2,0,42,3,1,2,4,1,5,3,0,2,1,5,4,5,0,5,0,21,0,7,1,2,4,2,0,1,498,2,1,5,0,1,2,2,1,1,2,2,0,1,2,7,4,7,4,4,0,0,0,14,11,2,0,0,2,2,6,0,3,0,0,0,1,3,3,3,0,2,8,6,12,1,0,0,1,0,7,2,1,4,4,7,1,0,0,3,1,5,2,0,2,1,0,1,0,0,0,3,0,6,4,0,7,2,0,5,0,3,8,3,1,7,2,4,3,0,1,0,9,1,0,0,1,1,10,6,0,5,5,4,4,6,0,0,6,9,1,0,0,11,0,0,1,0,0,3,0,6,3,2,1,1,2,0,0,1,2,0,2,1,2,0,0,0,5,4,4,6,3,1,1,0,1,2,0,0,0,3,0,2,1,2,3,1,3,0,0,1,0,2,0,7,5,6,1,1,4,2,5,0,1,0,5,2,4,2,4,8,2,1,3,1,1,8,1,0,2,0,0,3,1,0,1,0,4,1,1,4,0,3,0,30,0,0,2,2,0,3,0,0,0,1,6,2,4,0,12,0,6,18,7,0,0,1,3,4,0,0,0,0,4,1,0,0,0,1,1,9,0,5,0,5,1,9,5,1,1,0,1,3,3,0,0,1,1,1,4,1,2,1,1,1,0,8,0,1,0,1,1,3,2,12,1,0,4,0,5,4,0,0,1,1,1,0,0,2,0,3,3,7,5,0,3,5,0,1,1,4,10,1,1,0,0,1,4,1,0,2,5,1,1,5,1,1,0,1,2,0,0,5,12,1,4,3,0,2,3,0,0,0,2,2,2,3,1,2,2,2,3,2,4,2,10,0,1,3,1,1,3,0,5,8,0,6,1,3,4,3,2,2,0,5,1,2,2,1,0,2,1,2,10,5,1,3,5,1,3,0,5,3,0,3,1,0,1,2,2,2,0,11,1,1,2,0,3,0,2,6,0,1,0,1,0,0,2,1,0,4,2,1,0,1,2,6,2,4,0,2,0,1,1,0,0,1,4,1,3,2,0,1,0,0,1,1,3,3,4,1,3,1,5,9,0,3,0,2,1,7,0,3,0,1,1,6,3,0,0,0,4,0,0,2,3,0,0,0,6,0,3,0,0,0,3,2,2,3,2,5,1,0,0,0,5,0,4,3,0,5,0,0,1,5,5,1,3,5,1,7,1,1,0,1,0,0,3,9,5,0,0,0,8,1,2,6,0,0,1,0,0,2,0,1,3,2,1,2,2,10,0,0,1,0,0,1,2,0,0,5,2,2,0,0,4,7,0,1,6,4,5,0,0,1,8,2,0,0,1,5,1,0,4,4,0,0,2,0,0,1,0,11,3,1,2,0,0,0,1,0,10,2,0,0,4,3,1,3,4,3,1,0,0,0,3,1,1,4,1,1,3,2,1,0,0,0,1,2,2,13,5,3,1,0,3,0,7,0,0,3,0,3,1,7,2,5,0,3,3,28,7,0,1,0,2,3,2,0,6,0,1,0,5,0,1,1,0,0,0,2,1,2,3,3,2,4,1,47,2,0,0,1,1,1,0,8,2,3,0,20,2,0,2,2,1,0,6,0,3,0,0,3,2,0,5,0,0,0,1,0,0,0,3,0,1,2,2,13,0,1,1,3,0,3,0,2,1,0,0,0,2,0,4,0,0,0,4,0,0,1,0,3,6,0,0,3,0,2,1,2,0,2,2,0,1,3,1,2,0,7,3,0,15,0,0,0,4,4,0,0,1,0,0,0,7,0,25,2,0,2,1,3,1,1,3,0,2,0,1,0,0,3,0,4,0,10,2,7,1,0,1,1,0,6,2,0,10,1,1,1,0,1,0,6,1,1,3,1,0,15,5,16,1,0,2,1,0,1,5,0,0,2,2,1,0,2,0,1,4,2,0,3,3,4,0,2,0,3,1,8,9,2,13,0,0,0,1,0,9,1,0,7,0,13,0,0,2,0,4,0,6,1,5,0,1,0,2,0,4,2,1,5,1,2,0,1,0,1,0,7,1,0,6,5,3,2,0,2,0,3,1,0,1,0,2,0,5,0,2,2,0,5,25,5,0,2,0,2,0,4,0,8,0,1,0,7,3,0,0,1,0,0,5,0,1,0,1,1,0,1,2,0,3,1,1,3,2,4,1,0,0,0,0,0,0,0,6,3,0,0,1,1,1,5,3,0,0,0,0,0,2,0,2,10,0,0,0,2,0,0,1,6,4,1,0,0,0,4,0,0,4,0,3,3,0,1,1,0,2,3,2,2,3,0,0,0,1,2,0,0,2,3,0,5,13,1,2,0,3,0,3,5,0,1,1,5,0,0,0,0,1,0,2,11,6,1,2,0,0,1,0,8,2,0,1,7,0,1,1,0,0,1,0,4,4,0,2,2,0,0,0,2,10,3,0,0,2,0,1,1,7,0,0,1,2,3,3,0,3,3,4,1,2,1,1,0,1,2,1,6,6,0,0,0,0,0,0,1,0,1,3,1,0,2,0,0,0,0,1,2,1,1,2,0,0,2,1,5,2,0,0,3,0,1,2,4,0,2,1,1,0,4,0,16,1,1,0,0,2,1,2,0,5,1,2,3,0,1,0,16,2,1,0,1,1,3,2,1,0,1,0,2,0,2,1,3,6,1,1,1,0,1,2,0,2,1,0,0,1,4,1,5,0,2,4,2,6,1,0,0,0,1,0,1,1,1,1,8,1,3,3,2,1,1,3,0,0,0,2,0,1,0,0,1,3,0,0,2,0,1,1,2,0,18,0,5,0,4,100,4,1,0,3,0,3,0,11,8,10,0,3,0,0,1,2,2,2,2,0,3,1,4,5,1,1,2,7,0,2,3,3,0,0,0,0,0,1,0,0,2,0,3,0,3,0,2,0,1,0,0,2,0,1,0,2,2,0,2,6,3,1,3,0,0,0,1,12,1,22,4,6,13,3,1,5,1,0,3,0,0,0,1,0,0,12,3,4,2,0,2,2,2,4,0,3,0,1,2,0,1,4,0,1,0,1,0,0,1,2,0,5,8,0,2,0,0,1,0,0,1,0,2,1,0,0,0,0,5,0,9,0,2,2,0,0,0,0,1,1,3,5,1,4,0,1,0,0,2,8,0,3,1,1,0,6,0,0,0,1,1,0,2,2,0,2,0,1,2,0,0,202,5,0,0,1,0,1,0,1,3,2,2,4,0,1,1,3,0,1,1,2,0,0,0,4,1,1,0,4,0,0,1,1,0,12,0,2,1,0,1,7,3,6,3,0,1,3,1,2,5,5,0,1,3,1,3,1,2,0,0,0,2,5,3,0,0,1,2,6,0,1,3,5,0,1,0,0,1,3,0,0,0,0,0,7,0,0,1,0,0,0,0,0,0,0,2,1,0,1,3,1,0,1,3,1,2,1,2,2,4,1,1,1,0,9,2,1,3,0,0,3,3,0,0,3,4,0,1,2,2,2,0,0,2,3,6,0,0,2,0,0,0,1,0,37,0,4,2,2,0,0,1,2,0,0,5,2,1,4,0,0,23,1,6,2,1,2,5,0,0,1,2,7,1,1,0,0,4,3,0,1,0,0,1,11,2,1,0,0,0,3,0,0,2,1,1,0,0,0,0,1,0,2,2,3,0,0,9,1,0,5,0,0,0,0,1,1,0,0,3,9,2,2,3,0,2,2,2,9,0,0,0,0,1,2,1,0,0,0,0,0,0,1,2,4,0,0,0,4,0,1,1,0,1,1,0,4,2,0,0,0,1,2,1,4,0,1,0,1,2,0,0,0,0,0,0,0,0,3,0,1,0,9,2,5,2,0,0,0,5,1,2,1,0,0,11,1,0,0,0,3,1,0,0,1,0,0,1,0,0,0,3,0,4,0,0,0,0,1,0,1,0,1,0,0,0,0,2,0,2,0,0,0,1,1,0,0,0,0,0,0,0,1,2,0,0,0,0,0,0,0,0,0,0,0,12,2,0,0,0,0,0,0,0,0,1,0,0,0,0,0,0,0,0,0,0,0,0,2,0,3,0,2,0,0,0,0,0,0,0,1,0,0,0,0,1,0,0,0
K66 End of Watch,king,5851,3084,2928,2764,2144,1197,2140,1688,1071,1720,1332,1301,1323,1189,1291,1024,430,802,678,165,879,1087,579,598,196,519,338,385,491,1190,428,532,493,597,535,501,239,425,156,582,479,423,397,366,318,429,288,308,280,305,347,295,217,286,323,272,268,307,370,361,267,245,255,323,224,249,122,194,402,199,242,194,218,186,189,198,187,126,189,157,135,465,111,244,179,44,149,319,189,166,93,198,203,89,190,165,123,114,183,138,150,162,167,130,86,151,212,131,131,158,114,153,56,139,163,89,110,86,57,90,30,272,63,141,154,69,131,157,38,123,56,82,194,58,121,126,21,91,141,95,74,85,40,106,276,73,112,120,97,127,81,85,33,77,89,320,371,51,71,125,42,26,58,123,60,47,71,70,59,104,32,67,145,101,64,44,64,51,123,141,85,37,117,76,69,56,61,37,83,59,57,67,70,63,48,69,17,64,45,54,134,21,92,115,66,58,55,33,37,83,61,52,24,69,38,40,57,33,70,16,57,89,69,37,132,34,62,74,70,100,42,43,5,80,33,21,32,50,30,61,51,37,66,31,51,63,70,78,68,56,58,20,55,3,29,64,49,60,44,39,54,63,46,57,94,22,46,41,56,60,32,65,56,52,36,55,59,51,76,49,43,35,32,66,84,47,31,44,47,16,7,618,68,34,65,68,43,61,217,48,78,30,84,23,20,175,28,41,8,58,46,9,29,56,28,13,30,51,37,30,40,118,17,130,47,52,45,31,25,18,28,68,33,17,25,54,46,10,42,38,30,34,35,53,46,46,53,53,32,42,88,5,61,35,32,17,42,20,28,35,41,1,120,19,31,5,48,21,58,29,25,30,45,22,47,30,18,22,59,201,18,25,43,5,15,57,0,40,77,69,9,26,17,81,59,42,17,29,31,22,60,48,27,48,13,28,26,44,26,29,21,15,34,7,25,26,25,49,19,19,46,2,14,29,25,24,28,14,29,29,33,33,45,18,2,22,10,25,117,35,34,32,20,32,27,50,9,28,39,30,9,10,20,75,67,29,20,17,11,35,32,12,11,87,24,47,27,20,10,29,17,21,32,7,22,14,8,27,0,24,20,30,18,33,6,20,25,4,23,30,31,25,29,30,21,6,39,10,1,35,16,38,39,10,24,20,7,12,31,18,10,22,23,7,21,26,1,32,2,32,34,23,23,33,18,13,40,85,32,29,5,11,30,26,7,0,21,45,4,21,13,14,67,16,28,22,0,2,29,51,16,41,18,2,25,28,17,35,18,18,23,13,24,37,20,38,12,11,8,10,11,27,19,24,8,22,27,20,26,32,32,30,21,8,8,35,10,31,5,5,17,36,4,13,34,20,5,1,7,25,27,14,49,21,7,0,1,25,4,143,9,2,42,22,0,33,10,28,10,37,15,26,5,15,23,35,12,8,10,6,7,7,6,24,2,0,16,17,5,17,32,13,13,4,12,41,10,27,30,23,0,11,20,17,4,13,10,11,25,5,13,17,12,24,56,14,16,26,27,10,73,15,6,14,11,14,52,13,17,10,31,32,25,11,36,13,1,17,16,28,26,4,6,45,23,22,3,5,13,25,68,9,12,16,20,14,22,22,40,14,7,3,0,12,5,35,15,9,14,15,18,21,8,20,11,18,27,16,16,10,13,10,3,2,0,27,14,7,13,25,27,31,5,23,1,0,11,23,21,5,2,2,10,15,13,22,34,7,15,14,3,1,25,23,16,34,81,14,4,14,9,35,6,5,1,10,13,3,15,8,8,10,3,25,2,16,5,21,70,15,19,5,0,4,6,10,0,11,5,3,9,8,3,13,14,9,67,21,8,3,3,5,16,3,18,93,4,0,14,8,19,5,29,31,13,75,5,48,27,30,27,2,8,20,9,23,6,24,0,12,19,4,8,6,11,6,13,0,6,12,18,20,0,7,7,18,2,117,5,20,4,7,21,10,3,19,5,0,15,28,11,35,19,9,0,9,2,10,8,11,5,14,34,17,4,17,14,15,8,7,15,8,22,11,12,16,4,0,1,8,4,7,16,3,8,10,17,8,22,11,9,0,7,1,17,1,8,11,52,48,20,3,4,6,8,16,4,4,15,2,19,0,12,0,12,17,8,5,11,14,13,44,11,5,6,5,6,5,11,19,32,24,10,5,2,11,4,7,44,2,0,11,7,0,8,15,14,4,3,11,7,2,5,15,5,10,7,24,5,100,0,4,16,8,6,7,6,0,26,8,3,4,13,5,12,2,1,14,13,0,12,1,14,0,4,19,0,1,0,8,7,9,21,63,44,4,18,0,2,16,12,6,19,27,0,7,11,1,9,14,17,21,4,5,17,43,7,7,10,19,6,9,31,5,0,9,8,8,20,30,7,8,4,3,2,0,12,8,7,8,11,20,0,14,6,5,14,2,0,0,0,3,6,13,21,6,11,0,7,11,10,1,9,4,10,9,2,8,6,0,26,0,8,2,5,12,57,3,28,2,13,3,4,10,6,3,14,4,22,9,11,13,1,6,0,0,3,11,14,5,2,26,86,11,7,29,11,19,4,2,2,22,11,1,6,2,3,11,84,8,8,2,8,11,3,114,5,6,4,1,10,0,6,17,3,5,7,6,4,13,2,2,6,17,0,15,2,9,0,2,0,3,23,8,7,6,19,1,7,0,7,7,4,3,11,17,0,4,5,0,12,3,0,3,2,63,6,15,2,11,6,0,9,6,9,4,0,7,8,6,0,1,24,2,7,0,0,1,1,4,22,8,10,2,5,10,39,62,5,9,32,18,0,3,10,0,9,7,9,7,2,2,3,3,1,4,0,27,8,11,8,6,12,11,5,2,1,5,9,9,20,0,12,15,0,2,9,0,10,5,1,0,20,5,6,4,5,10,1,10,6,4,7,2,10,10,14,6,5,9,0,11,9,198,3,12,2,2,0,2,7,7,4,6,3,10,9,5,9,0,1,0,1,3,12,9,6,1,16,4,11,4,7,0,7,1,7,2,7,5,0,21,3,10,5,6,4,3,2,9,7,13,4,0,2,34,0,11,7,11,2,1,15,6,2,0,6,4,12,1,7,6,0,0,10,2,6,6,1,13,11,4,9,2,6,1,0,8,0,22,1,0,11,7,4,3,11,2,3,9,4,10,3,12,8,4,6,0,0,4,0,1,0,4,10,4,1,0,20,8,14,14,15,6,1,1,1,7,4,2,3,7,4,28,10,1,18,3,9,23,1,12,0,0,5,2,5,3,7,10,3,5,7,15,0,4,9,13,7,6,7,15,1,5,10,0,4,12,8,7,11,6,7,0,1,22,4,0,5,66,5,9,4,2,0,3,21,20,3,2,14,11,3,7,33,5,5,8,2,1,13,12,5,2,2,1,0,0,0,4,9,0,6,0,0,3,0,1,32,1,8,3,5,64,1,5,4,0,2,4,3,15,6,4,9,4,2,10,4,14,7,2,1,7,4,0,3,4,9,7,8,2,6,10,1,2,4,0,12,1,12,11,9,3,10,3,3,1,6,4,13,2,3,8,5,4,7,2,5,16,6,3,18,0,1,3,4,6,6,1,10,5,14,2,9,8,1,4,3,0,0,9,6,0,10,5,7,0,12,16,0,2,0,4,3,3,9,5,8,1,6,8,2,1,14,1,0,6,1,6,2,8,4,0,35,3,4,2,3,0,4,6,0,7,3,0,2,0,4,2,3,2,17,4,0,0,0,3,3,4,7,2,3,1,8,6,3,8,1,2,0,15,0,1,6,5,2,0,9,5,10,7,29,7,2,0,1,1,2,10,6,7,8,2,2,1,9,3,13,6,1,0,2,7,6,4,11,1,15,3,0,1,1,3,0,3,13,11,3,7,4,3,4,13,1,2,10,5,0,2,12,3,3,3,5,4,12,4,7,3,3,10,28,0,1,11,19,3,5,2,7,0,6,10,0,10,2,4,4,0,10,6,3,5,2,4,2,1,0,4,10,12,1,0,6,4,8,5,9,0,4,1,2,6,22,12,3,1,4,6,4,2,4,5,4,3,1,19,3,6,9,6,0,9,5,0,2,42,4,17,0,2,1,1,1,3,11,5,2,0,6,8,10,5,2,7,1,0,2,4,12,7,0,0,6,3,0,2,0,0,1,2,5,12,0,5,8,0,0,1,4,4,0,24,1,14,2,4,6,4,9,4,2,3,6,51,23,8,4,5,2,3,11,5,3,2,0,5,1,2,0,5,0,5,1,4,0,5,20,1,0,2,5,7,0,5,3,3,3,6,2,3,0,2,1,4,7,5,7,12,0,3,10,9,0,5,9,1,20,8,0,11,2,0,3,2,0,4,3,0,8,1,0,5,3,2,3,6,2,1,14,1,0,5,8,3,3,10,0,6,1,2,0,1,1,2,4,10,5,1,0,15,11,1,1,3,0,6,2,6,5,10,3,8,2,2,1,18,1,7,6,7,4,0,2,4,0,11,4,5,2,8,5,10,14,3,2,1,16,14,5,12,5,6,6,4,3,0,5,3,1,1,1,0,15,5,1,1,5,8,4,1,2,8,7,2,3,0,1,0,4,0,6,5,2,0,5,4,0,0,4,1,8,4,0,10,3,2,4,1,5,3,0,0,0,7,5,29,2,2,3,5,9,3,10,5,8,1,13,4,9,7,1,2,4,3,0,0,13,6,0,0,9,3,0,4,14,3,9,2,19,9,7,10,2,3,1,0,3,2,2,1,4,4,0,4,0,6,7,2,2,1,3,61,0,4,0,0,15,2,3,3,1,3,1,1,75,3,0,2,2,0,3,1,0,0,1,7,3,6,3,7,10,9,0,13,5,14,0,48,1,4,7,1,5,4,7,2,0,2,0,7,0,0,3,0,9,1,10,4,0,7,0,3,6,10,7,3,0,10,4,6,11,0,15,0,0,0,0,5,6,1,0,0,3,0,0,4,4,0,1,9,4,2,4,3,5,5,2,3,0,3,1,1,8,7,0,0,2,2,3,2,3,0,4,0,17,4,1,6,6,1,4,0,0,15,4,6,2,2,6,2,4,14,3,0,9,19,0,0,13,3,2,26,3,3,5,3,1,2,4,4,9,3,6,2,25,4,4,1,1,2,3,1,8,0,2,8,15,5,0,0,5,0,0,5,1,0,6,0,2,3,14,4,1,1,2,5,3,6,2,9,2,9,1,1,1,4,7,4,1,3,3,2,0,5,3,7,2,1,3,2,7,1,2,9,8,4,0,5,2,1,0,3,2,2,3,0,2,2,0,3,4,5,1,0,0,3,2,2,2,6,1,0,1,1,9,4,0,2,2,3,1,2,0,7,11,3,0,11,0,3,3,3,1,3,3,1,3,0,5,0,7,8,3,0,3,3,2,8,1,1,0,2,2,0,0,5,4,5,2,15,4,1,7,9,3,0,4,1,1,4,3,0,0,4,5,3,3,3,4,2,3,1,10,1,0,0,0,5,2,1,6,1,2,0,0,3,4,0,7,1,5,0,2,0,0,1,3,1,0,3,2,1,4,0,1,1,3,4,2,2,3,5,1,3,2,0,3,2,1,0,2,1,1,10,0,0,3,0,0,5,2,0,4,3,1,2,4,0,6,4,5,3,0,5,1,0,0,4,4,0,4,5,1,0,4,3,0,2,0,7,1,10,8,3,0,0,4,1,8,2,0,0,0,9,1,1,15,15,1,1,0,0,1,1,4,1,0,2,0,1,13,2,9,2,1,3,4,8,4,0,13,6,1,1,2,2,2,0,7,4,0,2,4,4,7,3,0,3,5,1,1,0,3,18,1,3,1,1,2,0,0,1,0,0,1,1,1,6,1,1,1,3,4,2,0,4,4,4,1,3,2,1,0,6,0,14,1,5,5,1,0,4,3,3,2,11,2,8,4,0,10,0,4,4,3,6,6,1,0,1,2,1,3,0,3,2,3,4,1,2,0,0,3,0,0,2,3,0,3,0,0,3,34,1,3,1,74,0,1,2,1,2,2,8,3,4,6,1,4,6,0,1,2,4,3,5,8,2,4,1,3,0,2,0,4,2,1,1,3,2,2,1,0,3,0,0,2,1,31,0,1,0,0,0,2,2,6,2,0,0,27,2,1,0,1,4,2,1,3,23,1,3,2,6,0,3,9,1,8,0,3,0,0,0,5,2,0,0,0,0,2,0,5,0,7,4,0,3,0,0,1,8,7,5,27,2,0,2,0,0,0,15,1,6,1,0,2,3,3,5,0,7,0,1,7,0,2,3,0,2,0,4,2,0,8,2,1,1,6,2,8,5,2,1,10,3,7,1,2,5,2,0,30,3,3,6,0,3,4,3,0,0,0,0,1,0,12,12,1,1,5,4,0,2,1,0,1,2,3,0,5,3,1,1,0,2,1,3,11,0,10,0,7,1,6,6,2,0,4,0,0,1,0,6,13,0,2,0,0,0,3,14,7,3,2,3,0,2,2,2,3,1,0,0,0,2,3,1,2,0,0,1,1,1,2,0,3,0,1,10,0,4,5,6,1,0,3,0,3,0,0,0,0,11,1,9,1,1,3,4,3,0,0,4,0,0,4,0,0,2,5,7,0,14,6,9,6,2,0,0,5,1,0,2,3,94,2,2,0,0,6,9,0,2,1,3,0,3,0,1,4,1,0,2,1,1,0,0,1,2,7,0,1,0,0,2,1,0,3,1,4,0,7,5,0,2,2,10,6,2,4,0,16,2,3,0,0,1,0,0,3,1,0,2,1,3,0,2,0,0,1,2,2,4,1,4,0,1,5,0,0,1,1,0,2,0,2,2,5,5,3,1,6,0,0,3,1,1,2,2,4,2,2,7,2,1,4,13,0,4,0,4,10,4,4,4,4,1,19,4,3,1,2,6,2,0,1,5,1,4,2,1,0,3,0,12,5,5,1,8,0,1,5,5,4,0,5,4,2,0,3,2,1,1,6,1,2,8,1,14,0,0,7,7,0,0,2,0,3,0,3,2,2,2,1,2,1,8,0,2,38,2,1,23,6,1,1,0,1,4,0,1,0,12,0,1,1,6,2,1,0,5,0,1,2,3,0,6,0,6,0,3,0,1,2,0,0,3,5,4,0,5,0,0,0,1,1,4,1,0,14,12,1,7,0,3,0,6,0,4,4,5,2,4,2,2,4,3,18,0,0,2,1,4,0,3,4,0,0,0,6,4,10,3,0,0,7,3,3,9,3,5,5,0,0,3,0,4,6,0,1,0,2,6,1,1,0,2,28,3,3,1,2,23,6,1,3,157,1,0,8,3,0,3,0,0,0,3,1,0,1,1,2,1,11,0,4,0,4,0,20,8,2,1,0,4,2,4,0,5,0,0,0,3,2,1,0,0,3,9,7,6,1,0,1,0,1,2,0,1,7,2,7,3,0,0,1,4,1,4,0,3,1,3,1,9,4,2,4,0,6,5,0,5,2,1,1,2,4,0,4,0,0,3,2,0,1,8,0,19,0,3,0,2,2,5,1,0,0,5,0,1,3,0,0,5,3,2,1,1,1,1,1,0,7,1,2,1,4,1,1,1,0,2,1,0,4,1,0,2,2,1,2,0,1,0,3,14,4,2,0,2,0,0,0,4,1,1,1,2,1,0,3,2,0,2,0,2,4,2,1,0,0,8,0,3,0,0,1,3,2,2,2,4,3,22,0,4,1,4,0,3,0,1,2,2,8,2,1,0,6,1,2,3,0,1,2,2,3,0,0,2,39,1,1,1,16,0,4,2,1,0,1,1,2,2,0,4,1,2,1,1,2,0,8,3,4,0,0,0,2,3,2,0,4,0,0,0,31,0,3,0,1,1,2,0,0,3,1,2,5,1,0,1,2,0,0,4,2,1,2,2,4,1,4,0,2,1,2,2,3,2,1,1,0,2,0,3,2,0,0,1,0,3,1,0,0,0,5,2,12,3,3,1,5,0,1,2,0,9,0,1,0,0,2,7,4,0,2,1,1,0,0,2,0,0,0,1,0,0,2,4,1,2,1,0,1,2,1,0,1,0,6,1,1,6,2,2,4,0,3,2,2,0,8,0,4,0,2,3,3,18,4,0,0,4,0,0,0,7,1,0,2,15,0,1,1,0,1,17,0,15,2,5,2,7,4,1,0,4,1,0,0,3,0,1,0,1,1,0,18,0,3,2,3,1,0,0,0,1,1,0,0,6,1,1,0,0,0,7,0,0,0,1,4,3,1,1,0,0,2,2,0,3,3,0,3,3,1,2,0,1,3,5,1,0,0,4,3,8,0,2,1,0,3,0,19,1,3,0,4,1,1,1,7,0,1,0,0,3,1,13,5,5,4,0,2,9,1,1,0,0,0,4,2,2,6,0,1,2,0,0,1,5,0,1,0,0,0,0,0,0,3,0,1,0,3,2,5,0,1,0,0,0,0,3,2,3,0,0,0,2,1,0,1,0,0,1,2,1,2,1,1,0,0,0,0,0,0,1,4,1,1,1,2,6,0,0,1,5,3,1,0,2,3,0,0,4,12,2,0,0,2,6,1,0,1,7,0,0,1,0,11,2,0,3,0,0,1,0,4,0,1,0,2,0,0,0,1,2,1,0,0,1,3,0,0,2,1,1,0,0,1,0,1,0,2,3,1,3,8,1,1,0,1,0,2,2,18,0,5,3,0,1,0,3,0,0,2,4,0,0,2,4,2,0,2,0,20,1,0,1,0,1,0,2,3,29,1,2,2,1,0,4,3,0,1,2,2,2,1,3,1,3,1,3,105,4,2,1,21,12,0,0,6,9,1,1,0,2,3,2,1,6,0,14,3,3,0,0,2,0,0,0,0,0,1,0,0,2,0,3,0,0,1,1,5,1,0,1,0,0,2,0,1,0,0,0,0,0,1,5,3,11,4,2,0,0,2,0,2,5,0,0,2,1,0,1,0,3,6,1,0,0,3,3,1,0,0,1,0,31,0,0,1,2,1,4,7,3,0,0,5,5,0,23,1,0,1,0,1,4,0,0,0,1,0,2,1,1,0,0,0,3,2,5,1,2,2,1,0,1,8,1,0,12,0,0,1,0,0,0,1,0,1,3,2,0,1,3,27,3,0,1,0,0,1,1,3,0,2,0,0,0,0,0,1,2,0,0,0,12,0,0,2,0,3,0,3,1,4,0,2,0,0,1,0,16,0,0,3,0,6,0,1,2,0,0,0,4,0,9,0,3,2,1,3,6,0,0,6,0,2,5,0,1,0,0,14,6,3,3,7,1,1,0,5,0,3,11,0,0,2,3,0,1,2,0,8,0,1,19,1,0,4,1,2,0,0,2,0,0,2,0,0,2,0,0,1,1,0,3,0,6,2,2,2,0,12,1,0,8,1,0,4,3,0,0,0,2,4,2,0,4,0,0,3,3,0,1,3,8,1,0,1,2,0,0,1,8,0,1,4,0,0,0,1,0,0,4,2,1,1,0,2,4,1,0,3,2,2,0,5,0,0,4,1,3,0,2,0,1,1,0,0,3,0,2,0,3,4,0,10,6,1,2,0,1,0,1,2,0,3,1,0,0,0,2,0,1,0,4,1,1,1,0,0,0,0,0,19,1,33,1,1,0,0,4,0,0,0,0,3,2,0,0,5,2,1,0,1,6,0,0,0,1,0,0,0,3,2,0,0,1,7,0,2,3,2,2,1,6,3,0,0,1,0,2,3,5,0,22,1,0,0,0,1,3,2,0,0,1,2,0,0,2,1,1,0,0,0,0,0,1,1,0,0,0,2,3,1,0,2,1,5,3,3,0,4,1,1,3,15,1,4,0,0,0,0,3,0,0,0,11,4,0,0,0,6,1,0,0,0,1,0,1,1,11,1,0,1,1,2,1,0,2,0,1,0,8,0,11,1,1,5,2,1,2,3,0,2,0,3,1,1,5,0,0,1,0,0,1,4,0,0,2,0,1,9,1,0,3,6,0,1,0,0,1,0,2,0,0,0,5,0,0,0,0,1,0,0,1,6,0,10,0,0,2,2,0,1,0,0,0,1,4,2,0,0,1,1,7,1,3,0,0,1,3,9,1,0,4,3,3,1,3,0,1,1,0,0,1,0,0,0,0,0,1,0,2,0,2,0,0,2,2,9,0,1,1,0,0,0,0,0,18,1,2,1,1,3,0,0,4,1,8,0,33,0,3,0,5,4,8,1,0,1,2,0,0,0,1,0,8,1,1,1,0,2,0,0,2,1,0,0,2,3,0,2,3,2,1,0,2,0,0,1,3,0,2,1,0,3,0,0,0,0,0,0,3,0,0,2,2,1,1,10,2,3,1,1,1,0,0,0,2,5,1,3,1,0,3,1,2,0,2,2,5,2,1,4,12,0,2,7,3,0,1,0,0,1,0,0,2,0,0,1,1,0,0,16,0,0,1,0,3,1,0,0,1,0,4,2,5,0,2,9,2,1,2,0,0,2,1,3,4,0,5,0,0,3,7,1,14,0,1,0,0,0,0,0,0,5,0,1,4,3,0,1,0,3,2,3,1,0,1,1,2,1,0,2,0,1,0,2,0,0,4,0,0,1,0,0,0,1,0,0,0,0,4,0,0,4,11,0,0,1,4,0,0,0,0,1,0,3,4,0,1,2,0,0,0,1,0,2,1,1,3,0,5,0,2,0,2,1,2,8,0,4,1,1,0,0,2,1,0,1,0,2,1,0,0,0,3,2,0,0,0,0,0,0,3,0,0,0,1,1,2,1,0,1,2,1,0,1,0,0,1,0,0,17,3,17,1,0,0,0,0,0,2,3,3,3,0,1,0,5,1,4,1,0,1,0,10,0,0,5,2,2,4,0,2,1,1,2,1,3,0,1,0,1,1,0,3,0,0,4,2,1,5,0,0,0,0,0,3,0,0,1,8,0,3,1,0,5,0,4,13,1,1,3,0,0,2,0,0,3,3,0,3,0,0,3,1,1,0,0,5,1,2,0,0,4,0,0,23,3,1,0,2,3,3,2,0,0,1,0,3,1,1,0,0,0,0,0,0,1,4,0,0,0,8,0,4,3,2,0,0,3,0,1,2,0,0,11,0,0,0,0,1,1,3,0,1,0,0,0,1,1,0,6,0,1,0,0,1,0,0,0,0,0,0,0,1,0,2,0,0,0,0,0,0,1,0,0,6,0,0,0,0,0,0,0,1,0,0,1,0,0,0,1,0,0,0,0,0,0,0,0,0,0,0,0,0,0,0,0,0,0,0,0,0,0,0,0,0,0,0,0,12,0,21,0,0,0,0,0,0,0,0,0,0,0,1,0,0,0,0
K67 The Outsider,king,8694,4198,3976,3599,3079,1927,2948,2444,2911,2384,2023,1865,1949,1277,1238,1531,1525,1070,994,1200,1174,1488,770,920,359,737,515,732,716,621,610,637,736,713,750,753,608,630,453,771,744,553,795,588,445,566,440,422,550,411,563,485,426,310,366,322,611,435,472,493,403,398,395,340,370,354,250,270,316,390,331,336,264,246,326,252,290,327,239,313,198,310,268,348,243,246,235,270,284,164,156,305,264,130,297,206,215,174,253,231,168,227,289,145,266,221,247,159,214,228,191,130,104,179,198,121,164,141,174,136,205,221,253,167,166,159,168,143,124,214,237,188,240,175,168,141,83,172,156,127,87,158,104,178,279,170,129,222,175,217,106,120,155,133,129,167,79,109,124,96,74,82,197,155,114,94,79,96,105,133,63,78,213,146,83,95,65,78,143,230,98,82,210,125,105,159,108,58,156,69,105,75,109,117,55,115,64,71,84,53,100,81,132,118,78,149,101,72,90,99,75,82,47,80,70,49,108,38,58,92,64,115,112,55,144,84,115,82,118,106,60,68,79,60,84,39,74,58,35,72,75,59,59,59,42,57,83,102,75,75,104,22,45,32,64,71,48,79,54,38,88,135,59,62,145,26,87,94,83,75,48,82,81,84,76,94,61,75,85,90,34,70,74,67,129,45,57,76,74,26,59,51,64,27,67,81,49,64,41,94,93,52,108,46,77,89,13,27,19,73,61,23,54,75,36,58,40,55,74,68,32,133,43,91,38,35,57,44,55,58,84,144,61,63,48,65,71,32,54,64,40,41,70,32,51,34,84,85,50,34,119,34,87,53,61,67,108,87,35,41,33,43,55,23,38,47,50,27,68,50,38,49,46,50,57,42,21,92,47,63,18,54,33,64,31,109,0,39,75,44,15,51,58,26,48,84,44,57,62,50,39,92,50,47,58,30,41,74,43,30,36,25,18,66,14,29,44,49,32,25,60,7,19,35,27,50,35,33,58,45,61,45,33,27,17,28,42,18,14,51,32,29,52,49,35,36,10,49,46,40,36,34,21,78,47,43,40,47,27,36,70,20,0,199,45,44,54,50,51,31,15,18,31,23,30,38,18,31,0,30,28,47,51,34,42,38,44,11,56,30,64,20,20,18,24,27,34,33,3,52,21,67,22,27,52,24,21,27,41,47,15,62,30,25,27,35,0,27,25,50,38,34,54,36,30,39,50,38,36,43,14,20,54,30,36,7,39,41,6,34,33,21,53,23,75,25,0,1,34,56,25,65,28,16,57,15,58,51,14,3,45,34,29,86,28,33,22,8,14,8,55,31,31,31,19,32,24,7,28,16,30,44,20,16,134,31,23,38,15,14,38,30,26,18,24,24,6,35,18,26,17,27,51,5,15,0,2,21,35,25,21,15,23,44,4,29,22,8,23,16,46,27,21,26,26,57,27,29,27,15,41,19,16,42,10,5,26,31,26,15,22,5,19,24,37,60,23,29,15,15,0,31,28,34,11,20,16,12,26,18,18,20,23,26,17,25,22,20,24,10,36,32,17,17,11,31,15,13,18,26,28,18,39,17,44,26,9,12,22,13,29,18,13,28,22,29,8,4,20,33,26,15,12,31,55,17,11,52,62,8,4,43,3,13,8,68,17,26,22,20,21,47,13,0,5,25,73,18,10,22,26,21,5,17,0,24,24,18,10,39,27,36,24,20,3,0,51,27,29,17,6,12,7,24,14,17,40,9,25,5,28,4,25,22,20,52,28,9,22,14,36,20,15,18,3,16,26,19,119,22,7,10,3,40,21,24,18,23,24,23,20,7,0,14,2,10,1,15,9,10,28,5,6,16,7,15,94,29,28,18,23,11,20,33,22,31,7,0,18,18,21,10,8,15,28,35,7,10,19,16,31,125,2,18,45,10,8,43,2,16,30,13,8,3,20,8,22,0,19,21,24,31,0,4,8,6,8,27,3,24,8,11,30,13,19,19,2,0,15,21,18,26,17,12,4,10,3,17,7,23,15,17,14,20,6,17,25,16,15,17,14,5,0,29,14,20,11,1,14,52,3,30,11,19,24,11,6,18,20,11,18,0,25,0,16,5,95,11,46,35,20,4,27,13,18,31,10,0,40,0,16,18,9,3,14,29,15,12,15,44,20,28,12,13,9,3,29,3,9,22,17,18,10,9,4,17,13,8,24,10,0,13,21,3,35,43,16,22,10,18,12,1,18,10,7,8,13,18,21,19,2,31,18,68,24,28,12,0,18,8,10,5,18,8,20,10,1,5,11,0,18,0,7,28,11,22,0,0,6,15,3,5,49,0,26,13,13,0,18,18,32,21,65,222,12,7,15,8,8,14,16,19,3,16,17,11,14,15,10,18,15,10,32,8,27,17,37,16,11,28,12,7,12,6,4,0,25,10,7,2,9,10,0,18,6,2,22,25,1,0,0,0,10,13,17,9,14,0,11,7,19,6,9,4,6,2,1,24,13,13,15,0,19,11,9,12,6,13,19,6,8,22,12,9,9,5,11,7,16,19,10,12,1,11,0,1,5,40,19,22,10,47,125,11,10,21,21,33,9,22,7,31,8,1,1,17,17,9,15,6,16,17,6,34,4,10,19,27,18,6,14,0,3,17,6,8,43,13,4,7,5,11,4,18,0,30,8,11,1,0,21,18,20,5,13,19,17,2,22,0,15,7,6,3,12,23,1,7,5,0,27,24,0,5,11,5,4,12,0,8,15,0,4,7,26,1,0,4,11,15,0,6,12,13,11,0,0,3,12,5,21,10,17,2,16,20,13,50,6,6,6,19,0,15,24,0,6,10,10,26,4,7,8,2,3,16,0,8,12,6,13,9,5,11,4,28,25,2,6,8,7,0,6,19,0,14,6,1,7,12,1,1,33,10,0,11,12,6,0,20,7,10,16,13,18,14,23,28,19,21,0,9,7,9,6,9,3,12,0,4,8,23,15,10,7,12,14,2,12,0,3,0,5,9,4,23,21,8,13,8,7,9,29,1,11,11,4,7,4,13,1,6,6,10,2,8,14,8,33,9,10,14,6,0,8,42,2,9,4,13,27,3,15,6,9,5,6,21,11,30,7,2,12,0,35,7,12,7,13,16,25,20,13,72,6,0,0,24,0,35,2,0,8,22,10,20,3,5,16,13,8,16,6,4,3,6,8,0,3,1,0,0,0,18,2,21,0,0,22,9,16,10,4,13,0,5,10,23,14,9,6,11,5,12,6,0,8,6,11,8,8,8,0,0,4,8,10,19,10,18,9,14,5,6,1,24,4,13,6,6,8,10,8,10,10,0,6,33,11,2,7,8,10,0,16,36,18,0,9,10,4,14,7,4,0,17,1,31,12,6,12,2,7,11,12,10,8,13,3,21,13,24,15,9,7,1,0,20,2,9,12,3,2,0,0,5,0,7,1,1,21,6,1,8,21,13,3,0,1,10,10,10,10,12,12,13,5,17,6,10,7,2,5,26,4,3,6,2,3,5,13,6,9,16,5,4,8,0,9,13,7,33,12,9,6,17,7,2,9,11,16,6,2,6,6,2,3,2,5,22,19,13,14,0,10,5,7,19,11,7,8,13,16,6,8,4,11,13,0,12,5,11,36,12,8,13,3,1,19,8,0,16,0,8,5,14,11,12,12,4,9,19,12,5,13,3,0,5,0,9,23,19,19,0,2,6,9,9,0,1,3,3,68,8,11,6,14,5,4,4,12,2,6,12,0,0,2,3,3,0,1,8,19,5,1,5,11,11,3,24,7,11,11,1,21,3,5,0,13,17,35,23,5,2,2,11,1,10,2,10,25,5,8,1,5,0,5,8,6,9,15,0,6,7,0,2,16,0,16,8,8,0,6,3,1,3,10,12,5,13,11,6,12,20,8,5,7,6,0,17,16,3,4,14,31,1,8,7,6,2,10,88,16,0,5,0,8,13,9,5,15,3,14,14,0,9,3,6,6,7,4,4,2,7,0,7,1,4,2,8,4,18,8,2,7,9,0,5,8,0,11,1,0,8,10,8,4,4,22,2,3,20,13,3,23,8,5,3,2,7,7,17,0,10,16,3,2,4,10,16,3,6,7,1,3,3,8,7,8,0,9,3,12,2,3,4,7,0,5,8,10,7,0,0,20,1,0,6,6,0,0,18,11,6,0,11,10,2,0,0,1,8,0,8,5,14,11,5,8,0,3,0,2,14,4,2,21,14,6,2,6,1,11,0,17,0,1,3,2,5,0,5,1,18,1,5,6,21,17,8,0,3,7,11,1,5,10,7,8,17,6,5,0,0,4,18,13,0,1,6,0,2,8,1,0,9,16,1,16,9,0,6,3,0,4,2,4,8,7,7,6,3,0,7,3,4,0,17,8,4,43,2,0,3,6,0,5,6,0,0,5,1,0,0,2,7,11,22,4,2,2,8,13,3,0,0,0,4,5,6,3,12,8,11,6,3,5,10,5,7,6,4,0,0,2,11,2,11,7,7,2,8,3,10,14,9,2,2,2,8,8,10,9,22,1,5,7,0,10,3,4,0,4,4,7,5,5,7,7,6,7,12,1,8,0,6,10,0,5,4,20,42,10,4,4,0,5,3,2,0,2,2,2,9,2,25,4,0,6,1,20,7,3,0,1,3,6,6,10,7,2,11,7,3,4,16,6,6,23,2,7,18,4,6,9,3,1,6,6,2,0,1,9,10,0,0,14,2,9,0,40,4,16,18,7,7,0,0,3,9,0,10,10,18,3,24,0,2,9,3,2,0,8,2,1,6,0,1,11,6,6,8,4,7,4,13,0,6,0,1014,6,0,8,2,0,0,2,9,1,5,4,4,6,13,0,0,7,15,4,7,1,5,4,0,5,3,6,1,0,8,4,13,0,0,12,0,12,0,16,5,0,7,0,6,5,15,13,0,7,9,5,1,3,1,8,148,0,2,0,0,6,0,0,5,3,5,1,6,4,0,11,10,11,0,7,2,1,13,9,6,0,2,1,1,7,3,0,0,0,8,2,2,3,4,3,0,1,4,0,3,3,4,2,1,2,9,3,3,12,11,7,2,3,15,2,5,2,1,1,0,7,0,7,7,3,14,12,21,10,3,5,5,17,1,5,4,0,6,0,2,1,5,3,3,6,2,4,5,4,0,1,2,3,10,6,7,2,4,1,4,10,2,1,10,3,3,21,5,1,2,5,9,4,15,4,5,4,9,14,7,5,26,6,2,0,13,2,10,6,1,0,7,2,1,2,11,0,7,8,8,5,16,0,38,8,7,4,5,8,6,0,7,8,4,11,1,1,9,5,1,4,4,3,5,5,27,4,1,1,0,9,2,2,7,0,6,9,2,0,7,2,0,8,3,8,8,7,4,6,3,3,0,6,7,3,0,7,2,6,7,0,1,2,2,0,0,0,6,5,8,2,13,2,2,7,2,2,4,7,10,24,8,3,0,4,9,17,26,8,0,1,18,2,5,10,3,0,2,0,4,5,2,8,5,6,0,2,3,6,0,1,3,11,2,5,3,0,1,13,1,0,2,21,67,5,0,4,5,8,8,2,4,19,7,0,3,4,0,7,7,6,8,5,8,5,8,1,0,4,0,0,12,2,1,7,14,0,5,1,3,3,3,19,3,0,6,9,0,1,7,7,0,3,3,6,1,6,2,10,8,0,2,0,9,1,3,0,0,5,0,0,4,0,0,0,3,11,7,4,7,7,2,1,7,2,3,1,0,3,2,5,3,4,5,8,1,1,4,3,13,2,0,4,8,5,10,1,5,4,8,4,5,0,13,3,5,3,8,0,5,3,5,0,5,7,2,0,4,6,1,1,0,0,2,0,0,2,5,0,10,0,3,3,1,3,1,1,1,4,7,20,1,6,4,0,8,1,4,2,4,6,9,6,2,5,2,3,5,3,0,3,1,5,1,8,4,4,0,3,9,7,3,8,1,0,2,2,3,1,2,0,5,0,6,2,0,0,6,3,3,4,1,14,13,1,0,7,14,0,0,0,8,10,1,8,3,1,1,12,1,2,2,4,1,3,9,6,4,8,6,3,0,3,0,4,2,4,0,2,2,6,7,0,3,0,10,0,1,5,2,3,0,5,8,4,0,2,4,2,9,2,0,16,3,2,3,5,3,2,1,3,4,10,15,1,6,0,6,3,6,10,1,0,11,10,5,9,5,0,45,1,0,1,7,0,0,3,8,33,4,10,0,0,8,4,0,3,4,2,2,0,0,0,7,0,3,2,5,10,3,1,7,0,4,0,2,0,1,4,6,4,4,0,2,4,0,13,4,5,1,0,25,8,3,1,4,0,3,2,3,9,3,19,0,3,0,2,2,4,6,4,4,2,1,0,0,12,2,10,7,0,0,5,3,4,6,0,1,3,10,7,2,2,1,4,2,1,2,4,3,17,0,10,3,3,3,2,5,2,0,0,0,0,4,1,4,3,3,5,10,0,0,2,6,0,2,3,5,2,6,5,4,3,2,0,8,0,10,6,4,7,2,8,3,1,4,0,0,1,1,1,13,0,1,1,1,2,1,3,0,3,3,3,0,1,2,5,1,0,3,13,5,3,1,0,6,0,0,5,1,0,3,45,4,3,3,12,2,2,7,0,0,6,1,5,2,1,4,7,1,1,0,10,2,0,2,1,6,3,2,0,7,13,3,3,2,5,0,0,0,3,2,12,24,2,0,5,3,2,454,3,0,3,0,6,9,1,3,8,5,3,2,3,2,19,3,9,1,0,1,2,0,7,0,2,2,1,5,0,5,0,0,5,8,6,3,9,6,0,1,5,0,0,3,5,3,6,0,4,0,14,4,1,21,2,3,0,4,2,5,5,3,2,4,1,4,1,2,1,5,1,7,0,2,7,6,2,4,14,0,7,1,5,4,3,6,5,6,2,0,2,3,3,1,0,1,1,2,11,0,0,1,0,4,5,4,1,2,1,2,15,0,9,33,3,3,4,1,3,12,2,3,1,0,8,7,1,2,0,0,1,0,8,5,1,2,0,8,0,12,1,5,0,2,3,1,3,2,2,2,3,2,0,1,0,3,3,0,4,3,2,6,3,0,0,0,1,2,2,0,0,3,0,4,0,2,1,8,0,4,8,3,3,3,1,0,4,2,3,2,2,5,3,1,4,2,2,0,1,4,0,1,8,1,1,1,2,1,1,2,3,3,0,0,0,1,3,0,4,4,3,0,16,1,7,2,0,0,7,5,4,2,22,8,7,0,0,2,3,0,8,0,0,3,2,7,2,1,3,6,4,4,3,12,7,4,0,0,4,8,5,9,8,3,7,4,0,0,2,5,0,0,1,1,5,2,5,6,1,1,1,0,14,10,1,3,0,10,3,4,0,5,0,0,0,2,2,1,0,2,2,8,4,10,4,0,0,1,0,6,2,4,11,13,7,1,0,1,2,9,4,1,0,3,1,1,3,0,1,1,0,2,5,10,0,4,8,0,2,2,2,2,3,2,5,2,5,18,1,6,0,3,1,7,2,1,1,6,11,0,4,11,5,3,6,1,1,4,5,4,2,0,5,1,0,4,1,1,1,3,3,0,0,0,1,2,0,0,0,3,4,2,0,3,1,0,2,3,5,2,4,0,27,0,2,0,4,1,4,0,3,3,2,3,5,0,0,0,0,2,20,2,4,0,6,5,1,1,0,4,3,3,3,11,1,0,2,22,1,8,1,0,6,2,1,0,19,3,0,0,1,0,7,2,1,3,2,3,1,1,0,1,6,1,2,0,1,2,1,0,5,3,2,3,3,1,2,4,2,3,15,2,4,0,0,0,4,0,9,1,0,3,10,1,2,2,6,0,4,0,12,0,3,0,3,4,13,2,1,0,0,4,2,1,2,13,2,1,0,14,1,1,2,4,6,2,8,0,17,6,0,1,1,6,6,1,1,2,0,5,7,0,0,1,0,4,0,0,1,0,7,1,11,2,3,0,9,3,6,10,0,4,0,2,0,0,3,1,0,1,4,3,0,2,0,0,0,1,1,1,0,5,2,19,1,0,4,0,3,3,3,0,2,1,12,0,0,4,4,5,4,2,1,2,3,3,3,1,8,10,1,4,1,6,6,0,2,0,2,1,3,2,5,1,3,4,2,0,0,0,6,6,1,0,3,2,0,3,2,5,0,16,32,0,4,1,0,1,3,3,4,0,1,0,3,5,0,2,4,0,3,0,1,0,0,0,1,1,1,11,0,2,0,3,2,4,5,0,7,1,0,3,2,0,0,5,4,2,2,5,1,7,2,0,3,2,4,4,49,4,2,5,2,3,4,6,0,0,3,0,4,0,3,1,1,0,1,4,11,0,17,1,4,3,1,10,2,0,2,3,4,3,0,0,0,2,2,12,1,2,3,4,2,0,4,4,0,3,3,4,2,0,0,1,5,0,0,1,1,4,3,0,13,1,0,0,0,0,8,5,2,1,1,3,1,0,3,1,1,6,4,0,4,0,3,1,11,2,4,12,0,0,1,1,0,0,3,1,0,0,7,1,1,0,2,7,4,0,0,1,3,4,0,0,2,9,3,0,1,4,11,2,2,0,2,0,0,1,1,0,8,0,8,5,0,0,0,1,0,1,4,7,9,0,0,1,3,0,46,2,2,4,0,0,1,2,1,0,4,2,0,0,5,0,0,1,3,0,9,1,0,5,1,2,1,6,0,7,1,3,2,2,1,1,8,2,3,0,1,1,0,6,0,1,7,2,5,1,90,3,0,3,1,0,0,1,2,0,1,2,3,3,1,0,2,1,8,3,3,2,0,4,1,6,0,0,6,3,1,0,3,1,1,1,1,43,0,2,5,0,3,0,2,3,0,3,2,1,0,0,0,0,0,3,2,0,3,4,1,2,0,2,8,0,0,1,0,1,0,0,0,2,1,5,2,6,8,2,1,0,2,0,10,4,3,4,2,3,5,0,42,0,0,7,1,0,13,5,2,0,3,1,0,5,0,0,0,1,0,1,1,0,0,0,0,8,1,3,2,0,3,2,0,3,1,2,0,1,0,3,1,0,0,0,4,2,5,2,1,1,1,3,1,0,12,7,3,2,1,1,0,0,0,0,0,0,2,1,3,0,33,4,4,2,0,0,3,0,5,2,0,1,5,1,0,1,1,3,3,1,2,0,1,0,0,1,3,1,2,0,3,5,4,2,0,2,0,0,0,0,5,0,14,1,0,0,0,6,0,7,0,3,0,4,0,8,3,1,0,29,3,0,7,3,0,0,4,0,0,0,6,1,4,8,6,7,3,3,1,0,3,7,2,3,1,19,0,3,4,1,1,0,3,14,3,0,1,0,11,0,0,0,4,0,1,0,0,4,0,0,0,1,0,9,0,3,1,0,2,11,7,4,0,3,2,2,6,1,1,2,0,3,3,0,13,0,0,0,1,8,0,0,7,0,20,0,1,5,0,0,10,1,3,0,0,0,1,0,1,0,0,1,15,1,2,0,0,1,2,0,1,0,2,0,1,0,3,2,2,0,1,1,1,2,0,0,0,1,4,5,1,4,2,0,5,0,2,5,0,9,0,0,5,0,3,2,3,0,0,0,12,1,0,0,0,3,1,0,0,6,1,0,16,6,1,2,20,4,1,5,3,0,1,1,5,0,0,0,0,3,0,0,4,4,3,0,0,2,0,1,2,0,0,0,8,5,0,1,1,11,4,3,0,0,2,0,0,3,0,3,1,1,0,0,2,5,3,0,0,1,2,7,1,1,15,2,0,1,3,0,0,0,3,0,0,2,0,0,7,9,1,3,0,0,0,1,1,2,0,1,2,6,3,2,0,1,1,0,1,4,1,3,2,3,1,5,2,7,0,0,1,1,1,0,2,0,2,11,0,0,2,0,0,5,4,0,1,0,1,5,1,8,2,2,2,0,4,4,2,0,4,5,8,2,2,6,4,2,2,2,0,0,2,1,1,0,1,1,1,1,8,7,1,0,0,1,2,0,1,2,0,1,1,0,1,0,0,0,0,0,2,2,2,1,2,1,9,2,3,1,1,15,0,2,1,0,6,2,6,3,2,1,1,0,2,1,0,2,2,5,1,1,8,1,1,2,4,5,0,2,5,3,0,4,0,0,3,3,1,1,0,0,1,1,1,0,3,0,0,2,0,1,2,0,0,1,1,5,0,7,2,1,4,0,0,4,0,1,0,1,0,10,1,24,16,6,1,0,1,0,0,0,0,5,0,0,0,1,6,0,1,1,0,2,5,3,2,0,1,3,2,2,2,1,3,1,3,0,1,0,1,2,4,3,0,0,1,2,1,0,5,0,2,1,0,1,2,0,8,0,1,3,3,3,0,0,2,3,2,2,7,1,2,0,1,3,0,0,1,10,2,1,1,2,0,4,0,2,0,1,0,3,2,0,2,1,0,0,2,0,2,0,2,2,2,3,0,2,0,1,5,4,3,2,0,17,0,3,1,3,0,2,0,2,1,2,3,0,0,4,0,1,3,1,4,1,0,1,2,3,11,1,1,1,5,0,0,14,3,5,3,0,4,2,2,1,0,0,2,1,1,0,1,1,3,12,2,6,1,4,0,2,2,2,0,1,0,0,1,4,0,3,1,1,5,1,0,0,1,0,0,1,3,1,3,0,1,2,0,2,3,2,0,1,5,0,2,0,5,0,2,2,2,0,1,2,1,0,4,0,0,3,3,0,0,1,2,0,3,1,4,1,0,0,0,6,0,0,1,2,0,0,4,2,4,1,0,2,0,3,2,0,7,4,1,0,0,0,0,1,0,1,0,3,5,0,1,2,0,0,2,0,5,1,2,0,0,0,1,2,0,0,0,0,2,3,2,1,0,2,3,3,0,0,3,2,3,0,2,0,3,3,0,2,1,4,0,0,51,2,4,4,1,1,0,2,0,1,0,5,2,5,1,0,0,0,3,1,1,2,3,0,4,0,5,2,0,0,0,0,0,2,0,0,2,0,0,0,0,2,2,0,2,0,2,0,0,3,2,0,0,0,2,5,8,0,0,2,2,4,9,1,3,0,0,0,1,0,1,1,2,1,5,2,0,2,4,0,0,1,0,1,1,0,9,0,5,0,4,0,0,1,0,2,0,4,0,0,1,1,0,0,0,0,3,1,0,0,0,0,0,0,1,0,0,0,1,2,0,0,0,0,0,1,4,0,0,0,0,0,0,0,0,0,1,0,1,0,0,0,0,0,0,0,0,0,0,0,0,0,0,0,0,0,0,0,0,0,0,0,0,0,0,0,0,0,0,0,0,1,0,0,0,0,0,0,0,0,0,0,0,0,0,0,0,0,0,0,0,0
K68 Elevation,king,1365,706,689,642,453,336,578,353,415,390,345,309,278,246,196,283,226,189,155,188,195,255,151,135,78,141,77,89,101,72,78,135,88,149,110,113,106,82,57,133,122,96,75,80,74,93,90,75,95,86,84,105,61,57,51,49,68,52,58,84,99,61,42,82,74,46,50,47,41,65,40,62,61,45,49,64,41,64,24,28,45,81,24,39,41,42,35,47,45,29,34,40,46,20,53,24,40,26,57,34,30,48,47,41,81,34,40,33,35,24,44,21,16,16,43,20,22,30,27,23,26,43,54,28,20,17,25,26,21,24,29,34,30,24,19,35,12,22,24,25,10,25,22,27,39,38,21,52,26,31,33,17,25,14,16,4,14,16,17,17,25,19,26,30,19,12,11,8,25,24,13,16,32,16,4,14,11,9,31,31,13,17,32,8,23,16,9,10,28,13,25,19,24,13,12,20,1,11,14,7,16,18,17,16,15,9,14,7,13,39,4,15,12,7,7,14,20,9,9,9,13,21,18,8,8,14,11,5,28,21,9,6,17,3,14,6,7,9,5,15,13,16,5,13,8,13,15,13,11,1,18,9,24,12,18,11,6,24,8,9,20,11,13,22,18,7,9,13,15,13,20,11,13,12,16,11,15,15,21,10,5,14,6,2,21,21,6,5,13,15,10,7,4,5,6,7,11,12,19,14,12,9,14,10,19,15,2,5,6,7,7,5,6,13,5,14,4,15,8,7,2,15,11,7,6,13,9,6,7,8,11,16,12,8,16,9,15,2,12,8,12,7,8,3,7,15,6,8,6,14,23,10,5,20,2,0,5,13,9,13,10,10,7,15,7,11,6,7,7,6,3,2,9,11,11,8,1,15,9,7,3,10,5,7,1,0,0,11,17,11,5,7,3,2,6,17,10,2,8,9,8,2,17,13,11,7,5,14,3,8,16,6,13,26,6,10,4,9,4,7,12,0,3,12,3,11,3,5,7,8,10,4,9,7,0,3,2,2,6,4,4,7,8,10,6,9,1,12,2,5,5,4,15,14,9,3,10,4,16,26,21,1,292,4,0,8,6,5,3,0,0,5,3,1,9,2,1,4,0,9,2,20,5,1,4,6,14,5,14,5,0,2,12,3,5,3,6,9,0,8,8,0,3,7,5,2,2,3,2,5,4,3,5,1,7,12,0,8,14,1,2,1,10,6,4,2,14,5,5,9,0,7,6,15,2,2,7,7,1,2,3,2,14,4,27,13,0,2,6,5,4,2,3,1,7,8,8,8,3,0,12,11,11,0,3,11,6,1,1,4,1,9,8,4,5,3,8,0,3,9,11,5,11,10,0,7,0,7,2,0,8,10,3,3,1,4,5,11,5,6,6,7,13,5,10,0,0,5,4,2,1,1,5,7,5,7,1,3,4,7,10,11,1,9,10,4,4,13,1,2,2,1,3,1,2,0,1,3,7,2,7,4,4,2,5,9,5,2,63,6,0,1,4,1,6,3,0,2,12,3,8,0,4,1,3,2,1,10,4,4,1,3,5,3,6,11,3,2,4,0,2,8,5,4,7,10,0,5,3,4,7,15,2,3,3,5,1,0,2,0,3,0,1,6,2,3,1,8,3,5,4,10,0,4,3,3,5,6,1,2,5,0,0,0,1,2,0,1,4,7,2,2,12,2,0,4,8,1,2,11,9,6,5,6,0,0,3,5,7,3,6,10,3,6,0,3,9,4,5,1,2,3,10,3,3,12,2,3,0,3,3,2,2,1,0,4,1,1,0,3,2,3,2,17,1,1,0,2,2,4,0,2,0,5,3,1,0,5,0,0,5,2,0,2,2,3,16,2,4,2,3,1,3,0,3,5,1,0,0,6,3,0,3,2,3,2,3,4,1,8,6,0,0,7,0,7,1,5,0,2,7,4,1,4,1,3,4,0,7,0,2,10,0,0,1,3,2,5,1,3,3,1,3,2,2,6,0,0,2,0,6,7,2,1,0,0,0,2,1,4,3,0,0,2,1,6,3,6,2,8,2,1,0,4,1,3,1,0,2,0,7,7,4,0,3,3,7,0,1,0,2,0,2,0,1,16,1,4,11,1,2,0,1,1,10,1,2,0,10,0,3,2,1,5,2,0,4,3,6,5,3,2,1,2,3,2,2,2,2,2,2,4,1,1,0,2,8,1,4,1,0,2,6,0,0,3,3,0,4,0,4,0,4,2,2,1,5,6,0,11,1,5,6,1,0,1,0,0,2,8,0,1,4,0,2,4,1,14,1,0,3,0,1,0,2,11,0,0,0,2,0,2,0,7,13,2,3,0,0,2,0,1,3,0,0,1,2,3,0,0,2,1,0,3,6,7,1,1,1,3,1,1,2,3,3,0,10,1,6,5,5,5,0,0,2,0,1,2,2,2,1,9,0,0,1,0,1,4,0,0,0,0,10,1,1,0,0,0,1,1,5,0,3,0,0,2,0,3,0,1,0,0,2,2,0,4,1,1,5,1,0,6,0,2,2,1,4,0,1,1,42,2,1,3,0,1,1,4,2,1,3,4,21,4,0,2,3,4,0,0,3,2,1,1,0,1,3,1,0,1,0,1,0,1,0,2,2,3,1,0,1,0,1,0,3,2,0,2,1,0,3,0,2,4,0,3,0,2,0,70,1,3,0,1,1,5,0,0,5,0,1,3,8,3,5,0,0,1,0,0,1,3,0,5,2,3,0,1,0,5,1,0,5,1,23,0,0,0,0,0,0,0,3,1,1,0,0,0,4,6,11,4,1,1,5,1,0,1,1,3,1,1,0,4,1,0,0,3,2,5,5,2,4,0,1,0,0,0,2,2,2,1,3,4,0,0,1,0,4,2,6,0,2,3,0,0,0,0,2,1,0,0,0,1,0,2,2,1,0,0,1,0,3,2,8,1,5,6,1,3,0,0,2,1,1,1,1,0,0,0,3,1,1,0,1,1,3,3,2,0,0,0,0,3,0,5,8,1,1,0,3,0,2,0,0,0,0,1,2,0,1,1,0,4,3,1,9,3,0,3,2,1,2,0,1,2,0,14,0,0,1,0,3,0,2,0,1,2,2,0,0,1,1,0,5,0,1,1,1,9,0,4,1,3,2,0,0,3,0,0,0,0,4,2,1,0,1,4,4,6,0,1,3,0,8,1,1,0,3,1,0,0,0,0,0,3,0,0,1,2,3,3,3,2,0,1,0,0,5,0,5,0,0,2,1,0,1,0,0,1,3,0,0,0,0,1,1,1,2,2,3,2,6,0,1,0,1,3,3,8,2,1,3,1,3,0,0,9,1,1,0,0,4,1,2,2,7,0,1,0,9,1,0,0,0,0,1,2,3,0,0,3,15,0,1,2,0,1,0,3,2,0,4,3,2,0,0,0,1,7,3,0,0,0,0,0,0,1,5,0,2,0,0,0,0,6,1,0,0,1,0,3,4,0,2,1,12,5,1,2,0,0,5,1,1,0,0,3,7,0,5,1,3,3,2,0,4,0,2,0,0,5,1,0,14,1,0,0,1,0,3,1,0,0,2,0,0,0,0,2,5,2,3,0,0,2,2,0,4,1,2,5,2,2,1,2,1,0,3,3,0,1,2,0,1,0,1,0,4,0,0,0,0,0,0,2,2,2,1,1,1,0,18,0,3,0,0,0,0,7,1,0,0,0,2,4,0,1,0,1,0,1,0,1,1,0,0,1,0,1,2,2,0,3,0,0,0,1,1,2,0,0,0,0,0,0,0,1,2,0,0,1,0,0,18,1,1,0,17,0,0,1,2,0,1,2,0,1,0,1,4,3,2,18,0,0,0,1,1,0,2,0,2,0,0,0,2,0,0,1,1,0,1,1,0,0,2,1,2,0,1,1,5,4,1,1,0,0,0,3,1,1,0,0,2,1,2,1,3,0,0,0,3,0,1,1,3,3,0,0,2,0,1,5,0,0,0,1,5,1,0,1,1,0,1,2,0,2,2,5,2,2,0,0,2,6,0,2,4,0,1,0,0,4,5,0,5,1,0,0,1,0,1,5,0,0,2,1,2,2,0,0,0,0,1,1,3,1,6,9,0,1,0,2,1,0,1,2,1,0,3,0,2,0,2,0,2,0,3,2,3,2,0,0,3,2,0,0,0,0,0,0,0,3,0,0,1,0,0,0,1,2,0,2,0,3,4,2,0,0,5,1,1,2,1,0,5,0,0,0,0,1,1,0,2,0,1,1,2,1,0,2,0,1,0,4,2,3,0,8,0,1,0,0,0,3,1,2,1,2,0,1,0,4,2,2,1,1,0,1,0,1,0,1,1,13,1,0,0,2,0,3,0,0,3,0,2,0,0,0,0,0,0,1,0,2,0,0,3,0,13,0,0,0,0,0,0,0,0,0,0,2,0,0,0,1,0,2,1,2,1,2,3,0,0,2,1,3,0,5,0,1,1,8,6,1,1,0,1,5,2,2,0,0,4,0,0,0,0,0,0,5,1,2,0,0,0,0,2,0,0,0,2,0,5,1,4,0,2,0,0,0,1,0,0,2,0,4,0,0,0,0,0,5,0,1,1,0,1,2,1,0,1,0,0,0,0,0,2,0,0,0,0,0,0,3,2,0,1,2,3,0,0,0,0,0,1,4,0,0,0,2,0,0,2,2,0,5,2,0,0,3,0,3,1,1,1,3,3,3,0,0,10,1,0,1,4,0,0,0,2,0,0,1,2,1,0,0,0,8,0,3,1,2,0,0,0,0,2,0,3,0,3,1,0,0,0,0,0,1,0,1,3,0,0,1,1,1,0,0,0,0,0,1,0,0,1,1,0,1,0,3,0,3,0,0,4,0,0,1,5,1,3,1,0,2,0,1,0,0,0,3,0,0,1,0,2,3,1,5,0,1,0,2,6,0,4,1,1,0,1,0,5,0,2,0,0,0,0,0,0,0,0,0,0,3,0,3,0,0,1,0,1,0,0,1,0,1,1,4,0,2,1,0,2,0,0,0,1,3,2,0,2,1,1,0,1,0,0,19,1,0,1,0,0,1,2,3,1,0,0,0,1,4,1,5,1,0,2,0,2,3,2,0,0,0,1,0,0,0,0,2,0,0,1,1,2,0,2,1,1,1,0,1,0,2,1,4,1,0,0,0,0,1,0,2,1,1,1,0,1,0,0,0,0,0,2,1,0,0,1,1,0,1,2,0,0,3,0,2,0,1,3,1,0,1,0,0,0,0,0,1,2,0,0,2,2,0,0,0,0,2,0,0,3,0,0,2,0,0,0,0,0,0,0,0,0,2,0,2,1,1,5,0,0,0,1,1,5,1,0,1,0,0,0,0,0,0,0,0,2,0,4,1,1,1,2,0,0,0,0,0,0,4,0,0,3,1,0,2,0,0,0,1,0,0,0,0,0,7,0,0,0,0,0,1,0,0,0,0,0,0,1,0,0,1,2,0,0,1,0,0,2,1,0,0,0,0,0,1,0,1,1,1,0,0,0,0,2,0,0,2,8,1,0,3,1,1,0,0,0,2,0,0,0,0,0,1,3,2,1,1,0,0,0,4,0,0,2,0,2,0,2,5,0,0,0,1,1,0,0,0,0,0,1,10,0,0,1,2,0,0,0,2,0,1,0,0,0,0,0,0,0,0,1,1,0,0,0,0,0,0,0,0,1,0,0,0,1,0,0,1,0,0,0,1,0,2,4,0,0,0,0,3,2,1,0,0,0,1,0,0,4,2,0,0,0,0,0,2,2,0,1,1,0,0,3,1,0,0,0,0,0,1,0,1,2,2,0,0,2,0,1,0,1,0,0,0,0,29,0,80,0,2,0,0,0,1,0,1,1,0,0,0,1,1,0,2,0,3,4,0,0,0,0,2,0,0,0,3,0,2,2,0,0,4,2,2,0,0,1,0,1,2,0,2,3,0,0,6,0,0,0,0,2,0,0,1,0,1,0,0,0,0,0,0,0,1,0,0,1,0,1,0,0,0,2,3,0,0,0,0,0,0,0,0,2,0,0,1,4,1,0,0,0,0,0,2,3,0,0,0,2,0,0,0,1,0,0,0,0,0,1,0,0,0,0,0,1,0,0,0,3,0,0,0,0,12,0,0,0,0,0,0,1,0,0,0,8,0,0,2,2,2,0,0,0,9,3,2,1,0,0,0,0,0,2,6,0,0,1,0,1,1,0,0,0,3,0,0,0,0,21,0,0,0,0,1,1,0,0,0,1,0,0,0,0,0,0,1,0,4,0,0,0,1,0,0,1,2,0,0,0,3,0,0,0,0,0,1,0,1,0,0,1,0,1,0,0,0,1,0,2,0,1,0,1,0,0,0,3,0,0,0,0,0,2,0,0,0,0,1,1,0,0,0,1,0,0,1,1,1,1,2,2,1,0,0,0,1,3,1,2,0,0,0,0,0,0,0,0,1,7,0,0,1,2,0,0,0,0,1,0,0,1,1,0,0,0,0,2,1,0,0,0,2,0,4,0,1,1,1,0,0,0,0,0,0,1,0,0,5,0,1,2,3,0,0,1,0,2,1,1,0,0,1,0,0,1,2,3,0,0,0,1,1,0,0,0,0,0,0,0,1,0,0,0,1,0,0,0,0,0,1,0,1,0,1,0,0,0,0,4,0,0,1,1,0,0,0,0,0,1,1,0,0,0,0,2,0,3,4,0,1,0,0,0,2,0,0,0,0,0,0,0,1,0,0,0,0,0,0,1,0,0,0,0,0,0,0,0,0,1,0,1,0,0,2,0,2,0,0,0,0,0,7,0,1,0,0,0,0,0,0,0,1,0,0,0,0,1,0,0,0,0,0,0,2,0,0,2,0,0,0,0,4,3,1,0,0,0,2,0,0,0,1,0,0,1,0,0,0,3,1,0,3,0,0,0,0,0,1,0,0,0,0,1,0,0,0,0,0,0,1,0,0,0,1,0,1,1,0,0,4,0,0,0,0,0,0,1,9,0,0,1,1,0,0,0,0,0,0,0,1,0,0,0,0,1,0,0,0,1,2,0,2,0,1,0,0,0,2,0,0,0,0,0,0,1,0,2,1,0,0,0,0,0,0,0,0,0,0,0,1,0,0,1,3,0,0,1,4,0,1,0,1,2,0,0,1,0,0,3,0,0,1,0,0,0,0,0,2,0,0,1,0,7,0,5,0,1,0,0,0,2,2,0,0,0,0,0,0,0,0,0,2,0,0,0,0,1,0,1,0,1,0,0,1,0,0,1,0,7,0,0,0,0,0,1,0,1,1,0,0,1,1,0,0,1,0,0,1,2,0,0,2,0,1,1,0,1,0,0,0,1,0,1,2,2,0,2,0,0,1,1,2,0,0,0,0,0,2,0,0,0,0,1,0,1,1,1,0,1,0,0,0,0,0,0,0,0,2,0,0,4,0,0,0,1,3,0,0,0,0,0,0,0,0,0,0,0,0,0,0,0,0,1,0,0,0,0,1,1,0,0,2,0,0,0,0,0,0,0,1,2,0,1,0,0,0,0,1,1,1,0,0,0,0,0,0,0,0,2,0,0,0,1,0,0,0,1,2,1,0,0,0,0,0,2,0,1,0,0,0,1,0,0,1,2,0,0,0,1,1,0,0,1,0,0,0,0,0,2,0,1,0,0,2,0,0,0,0,0,0,0,0,0,0,0,1,0,1,0,0,1,0,1,3,1,0,0,1,0,0,0,0,3,2,0,0,0,0,0,0,1,0,0,0,0,0,0,0,0,0,1,0,1,0,1,0,0,0,1,0,0,0,0,1,2,1,0,0,0,0,1,0,1,6,0,0,0,0,0,0,0,0,1,0,0,0,0,0,0,0,3,1,0,0,0,1,0,0,0,0,0,1,0,0,0,3,0,0,0,1,1,0,1,0,1,0,0,0,3,1,3,0,1,1,0,0,0,0,0,0,0,0,0,0,0,0,2,0,6,0,0,1,1,0,0,0,0,0,0,0,0,0,2,0,1,0,0,0,1,0,1,1,0,0,0,0,0,4,0,0,1,1,1,0,0,0,1,0,0,0,0,2,0,1,1,1,0,0,1,3,1,0,0,1,0,0,0,2,1,0,0,0,1,0,0,0,0,0,0,0,1,0,0,0,0,0,0,0,0,0,0,0,1,2,0,0,0,3,0,0,0,0,0,0,0,0,0,0,0,0,0,0,1,0,0,0,0,0,0,1,0,1,0,0,0,1,0,1,0,0,0,1,0,0,0,0,0,0,1,0,0,1,0,0,0,2,0,0,0,2,1,0,1,1,0,2,0,0,0,0,1,0,0,0,0,2,2,0,0,0,0,1,0,0,0,2,5,0,0,0,1,0,4,0,6,0,1,2,0,0,0,0,1,0,0,0,0,0,1,0,0,0,0,1,0,0,0,0,0,0,0,0,0,0,0,0,0,0,0,0,0,0,0,1,2,0,0,2,0,1,0,0,2,0,0,0,0,1,1,1,0,0,0,0,1,1,0,0,2,0,0,0,4,0,0,0,0,1,0,1,0,1,4,0,0,0,1,0,0,0,0,0,0,0,0,0,0,0,0,0,2,1,0,1,0,0,1,0,2,0,0,0,0,1,0,0,0,0,0,0,0,0,0,0,0,1,0,1,0,0,0,6,0,0,0,0,0,0,1,0,0,0,0,0,0,1,0,0,2,0,0,1,0,1,0,0,0,0,0,0,0,0,0,0,0,0,2,0,0,0,0,1,0,0,1,0,0,0,1,0,0,0,0,0,0,0,2,1,0,0,0,2,1,2,0,0,0,0,1,0,1,0,5,0,0,0,2,0,1,1,0,0,0,2,1,0,0,0,0,2,0,0,0,0,0,0,0,0,0,1,0,0,0,0,0,0,0,0,1,0,0,0,0,0,0,0,0,0,0,0,0,0,4,0,0,0,1,0,1,1,1,0,0,0,0,1,0,0,0,0,0,0,0,3,0,0,2,0,0,1,1,0,0,0,1,26,1,0,0,0,0,0,0,1,1,0,0,0,0,0,0,0,0,0,0,0,0,0,1,0,1,1,0,0,0,0,0,0,0,1,0,0,0,1,0,0,0,0,1,0,0,0,0,0,1,0,1,0,1,0,0,2,0,0,0,0,0,0,0,0,0,0,0,0,1,1,0,1,0,3,3,0,1,0,0,0,0,0,2,0,0,0,0,0,0,0,0,0,0,2,0,0,0,2,1,0,1,0,0,0,0,1,0,1,0,0,0,0,0,0,0,1,1,0,0,0,0,0,0,0,0,1,1,1,0,0,1,8,0,0,0,4,0,0,0,0,0,0,2,2,0,0,0,2,1,0,0,0,0,0,0,0,0,0,0,0,0,0,0,0,0,1,0,0,0,0,2,1,0,1,1,0,0,0,0,0,1,0,0,0,0,2,0,0,0,1,0,0,0,2,0,0,1,0,0,0,1,1,0,0,0,0,0,0,0,0,0,0,0,0,1,0,0,0,0,0,0,0,2,0,0,0,0,0,1,0,0,0,0,0,0,0,0,0,0,0,1,0,1,0,1,2,0,0,0,1,0,0,0,0,0,0,1,0,0,0,0,1,1,1,0,0,0,0,0,0,0,0,1,1,0,1,0,0,0,2,0,0,0,0,0,0,0,0,2,0,0,0,0,1,0,0,0,0,0,0,0,0,0,0,0,3,0,0,0,1,0,0,0,0,0,0,0,1,1,1,0,0,0,0,1,0,0,0,0,0,0,0,0,0,0,2,0,0,0,0,0,1,0,0,0,1,0,1,0,0,0,0,0,0,1,1,0,0,0,1,0,0,0,0,0,0,1,0,0,0,0,1,0,0,0,0,0,0,2,0,1,1,0,0,0,0,0,0,0,1,0,0,0,1,0,0,1,0,0,0,1,0,0,0,1,0,3,1,0,0,0,0,0,1,0,0,0,3,0,0,0,0,1,1,0,0,1,1,0,1,0,0,0,0,0,0,0,0,0,1,0,0,0,0,0,0,0,0,0,0,0,2,1,0,0,0,1,0,0,0,0,0,0,0,0,0,1,1,0,1,0,1,0,0,0,0,0,0,0,0,0,0,0,1,0,0,1,0,0,0,0,1,0,1,0,0,0,2,0,0,0,0,0,0,0,0,0,0,0,2,0,3,1,0,0,0,0,0,1,0,0,0,0,0,0,0,1,0,0,0,0,0,0,1,1,2,0,0,1,0,0,0,1,1,0,1,0,0,0,0,0,7,0,0,1,0,0,4,1,1,0,2,0,0,0,0,0,0,0,0,0,0,5,1,0,0,0,0,2,0,4,0,0,0,0,0,1,0,0,0,2,1,1,4,0,0,0,0,0,0,0,0,0,0,0,0,0,0,0,0,0,0,0,0,0,0,0,1,0,0,0,0,2,0,0,0,0,0,0,0,1,0,0,0,1,0,0,0,0,0,1,0,4,0,0,0,0,0,2,0,0,0,0,0,1,0,0,0,0,0,0,0,0,0,0,0,0,0,2,0,0,0,0,0,0,0,0,0,0,0,1,0,0,0,0,1,1,0,1,0,0,0,2,0,0,0,0,1,0,0,0,0,0,0,0,0,1,0,1,0,0,0,0,0,1,0,0,0,0,10,0,0,0,0,0,0,0,0,0,0,0,0,0,0,2,0,1,0,0,0,0,0,0,0,0,0,0,0,0,0,0,0,0,0,0,0,0,1,0,0,1,0,0,0,0,1,0,0,0,0,0,0,0,0,0,0,0,0,0,1,0,0,0,1,0,0,0,0,1,1,0,0,0,0,0,0,0,0,0,1,0,0,0,0,0,0,0,0,0,0,0,1,0,0,0,0,3,0,0,0,0,3,0,1,1,0,0,0,0,0,0,0,0,1,0,3,0,0,0,0,0,1,0,0,0,1,0,0,0,0,1,0,0,0,0,0,0,0,0,0,0,0,0,0,0,0,2,1,0,0,0,0,0,0,0,0,0,0,0,1,0,0,0,0,2,0,0,0,0,0,0,0,0,1,0,0,0,0,0,1,0,0,1,1,0,0,0,1,0,0,0,0,0,0,0,0,0,0,0,0,0,0,0,1,0,0,0,0,0,0,0,0,0,0,0,1,2,0,0,0,1,0,0,0,0,0,0,0,0,0,0,0,0,0,0,0,0,0,0,0,0,0,0,0,0,0,0,0,0,0,0,0,0,0,0,0,0,0,0,0,0,0,0,0,3,0,2,0,0,0,0,0,0,0,0,0,0,0,0,0,0,0,0,0,0,0,0,0,0,0,0,0,0,0,0,0,0,0,0,0,0,0,0,0,0,0,0,0,0,0
K69 The Institute,king,8652,4659,4131,4092,3111,1660,3093,2399,3114,2531,1981,1931,1879,1330,1170,1546,1361,1066,1042,1222,1125,1572,825,996,313,820,498,1224,711,573,591,790,827,928,725,721,872,593,406,846,807,655,775,607,488,524,621,426,601,510,701,612,447,320,411,299,479,479,538,521,443,471,406,482,442,352,320,350,406,343,431,321,316,262,374,313,299,402,301,379,261,320,172,342,261,352,269,303,262,189,185,353,315,143,285,176,219,230,289,191,167,295,253,173,439,224,290,193,263,216,195,122,125,241,193,210,179,137,189,159,220,214,221,197,222,156,157,163,158,172,176,262,238,184,191,179,91,134,122,156,36,136,117,204,313,209,174,336,195,286,100,107,137,153,125,161,66,140,150,122,131,107,193,128,130,93,82,72,79,131,49,78,225,136,48,102,60,118,123,223,82,92,175,65,103,80,77,92,131,45,192,86,116,103,67,131,22,98,87,51,113,105,105,135,74,120,108,73,83,159,27,84,69,93,73,69,89,54,65,79,71,118,104,56,130,50,73,75,129,118,64,104,67,89,55,36,73,97,40,72,69,45,62,56,61,96,104,144,72,89,114,54,57,57,60,105,62,82,82,69,80,78,53,270,145,18,60,61,81,86,79,65,71,50,141,48,53,94,128,70,60,34,71,34,119,36,46,66,61,54,62,58,134,28,74,93,70,103,61,85,107,66,138,42,135,89,33,81,17,50,50,21,48,76,41,60,42,107,47,78,30,124,55,200,23,28,57,65,51,76,77,89,39,68,38,65,71,109,36,53,58,43,43,63,66,24,82,80,37,75,155,39,104,55,71,10,30,64,68,46,36,58,45,24,48,57,66,28,120,28,38,50,64,19,44,87,20,10,102,63,56,42,40,70,32,44,0,61,72,44,13,59,52,49,50,79,54,49,46,47,44,49,63,22,39,35,51,84,64,22,59,29,24,82,27,43,37,43,31,34,65,0,15,21,46,37,33,35,49,76,71,49,57,41,7,10,27,42,123,39,35,41,55,53,35,26,20,57,58,54,45,26,18,88,38,57,66,14,37,62,68,14,0,12,20,62,32,81,6,29,35,38,43,17,20,27,20,47,0,35,20,85,59,46,26,19,38,22,46,25,56,26,39,23,31,24,47,41,14,35,33,30,39,27,43,20,27,44,37,15,11,24,57,27,36,51,0,34,50,35,28,15,55,54,39,36,55,23,32,37,68,23,46,34,25,0,46,51,12,21,28,11,49,19,41,29,0,11,31,63,32,45,26,35,32,65,48,50,18,7,30,39,26,332,33,50,27,37,7,5,35,70,36,50,24,39,15,11,17,28,28,52,35,26,4,46,14,55,40,25,37,25,24,17,39,20,5,14,17,33,47,13,54,13,20,0,44,39,37,19,20,14,46,23,8,30,36,12,19,9,19,45,7,27,17,52,48,50,18,11,13,28,17,51,20,0,18,45,23,30,27,9,24,23,50,53,34,38,25,71,0,19,40,44,11,16,19,22,39,12,47,24,18,32,10,26,31,26,40,14,43,29,30,25,18,32,16,15,35,26,95,28,23,22,70,31,23,21,12,17,35,21,25,44,7,19,10,2,29,33,22,20,27,42,23,20,1,45,39,21,8,45,42,12,11,195,46,38,30,27,25,26,42,0,8,31,45,56,15,18,21,29,0,3,4,50,15,8,20,38,41,20,17,39,17,0,59,22,39,18,41,15,9,27,23,32,30,7,30,17,38,13,30,30,55,259,26,13,13,27,17,8,17,21,1,9,12,16,36,27,10,5,5,30,38,45,12,30,19,26,21,15,15,26,14,12,2,20,7,10,12,15,10,24,39,19,93,37,15,6,29,16,13,12,9,37,3,3,10,15,34,3,10,23,15,21,12,14,19,25,38,19,39,33,24,19,20,17,0,12,10,30,17,13,27,16,17,0,12,20,37,29,6,5,13,11,7,49,4,26,10,18,27,14,20,21,4,0,31,20,30,22,21,17,123,8,2,17,7,17,9,12,18,24,16,22,26,18,13,13,21,13,2,15,9,17,11,0,8,32,22,24,10,18,18,20,14,21,15,49,25,0,25,1,13,5,12,15,61,27,24,3,13,11,13,12,10,0,28,7,36,24,9,2,8,14,27,9,4,36,21,30,31,8,6,11,14,19,26,12,16,20,66,2,4,19,9,20,16,2,0,20,22,1,22,8,11,80,5,36,22,32,41,19,9,16,8,29,38,61,1,35,17,6,14,16,24,0,28,21,13,6,22,21,14,12,0,12,9,0,8,1,22,0,6,25,0,0,29,20,10,12,7,1,25,19,15,0,16,26,30,10,10,0,6,13,9,11,8,18,10,26,5,8,18,8,13,3,12,21,15,14,22,10,36,14,47,11,18,31,17,12,3,5,12,0,28,11,3,7,10,20,0,3,15,15,13,2,0,0,0,5,18,10,38,6,6,0,10,14,0,23,34,15,10,9,0,20,28,1,16,0,24,15,6,14,18,6,26,11,4,21,1,12,7,12,16,6,21,14,10,22,7,5,0,0,5,0,24,6,6,50,27,10,6,10,17,28,12,0,16,26,8,5,4,11,7,18,6,8,5,15,7,26,12,4,21,11,10,4,20,9,10,17,10,15,9,22,19,12,10,8,7,29,0,9,17,22,3,1,83,12,18,4,8,20,2,21,19,0,8,13,8,4,23,15,1,7,9,0,26,18,0,11,8,25,7,7,2,10,24,0,13,6,13,7,0,15,31,42,0,0,16,12,12,0,0,9,11,4,28,6,21,4,35,7,17,17,6,19,15,23,2,20,10,0,7,10,10,13,10,5,16,0,8,32,0,10,17,15,11,7,6,14,13,6,25,6,26,13,11,0,4,14,1,11,18,4,11,12,0,3,28,9,0,7,17,10,0,17,34,25,20,17,20,21,22,10,11,9,0,8,12,17,47,17,0,7,0,5,7,11,12,12,10,17,3,5,12,4,6,1,3,6,5,33,13,13,14,9,5,12,30,0,11,3,12,8,4,16,41,6,4,5,1,16,6,4,2,11,15,11,12,0,0,28,6,7,62,22,2,8,12,9,17,2,6,14,12,10,4,5,11,1,38,12,31,11,15,15,1,19,13,15,5,0,0,5,0,22,3,0,15,27,7,15,4,10,22,8,4,20,8,1,4,16,43,0,3,14,1,0,0,18,0,3,6,0,28,6,21,14,0,12,0,8,7,25,7,8,16,9,1,14,3,3,4,5,19,19,22,12,0,0,5,20,5,7,9,15,5,4,14,9,0,22,10,19,5,15,11,17,29,5,7,0,12,11,14,13,9,8,0,0,5,35,33,0,7,4,11,11,6,10,0,1,5,49,9,7,9,8,8,23,3,9,5,13,6,23,10,13,9,4,2,4,0,2,3,15,11,2,0,0,0,2,0,8,8,6,11,7,1,0,3,10,10,0,9,7,3,10,14,12,16,11,7,10,3,6,7,7,9,8,7,3,9,1,4,5,27,2,5,10,22,3,13,0,7,3,19,14,27,22,4,28,1,6,26,11,21,7,13,4,11,12,20,6,9,31,10,7,12,0,13,8,9,1,6,17,3,15,16,3,17,3,9,8,7,12,3,27,17,201,8,8,21,0,31,19,9,11,0,3,9,15,13,4,7,7,9,7,7,4,19,2,0,5,0,19,3,14,21,0,3,7,3,2,1,3,8,5,3,0,1,57,4,14,6,4,15,2,7,11,0,1,4,3,18,1,7,5,4,5,7,7,5,11,5,5,8,17,10,2,14,2,8,0,14,16,24,10,30,7,2,8,1,4,3,15,18,14,14,7,3,0,1,5,14,12,4,0,6,2,0,9,18,10,20,4,10,0,11,4,2,23,10,17,4,7,44,5,11,13,7,7,5,9,0,11,18,4,1,18,5,1,10,0,13,2,6,21,24,0,3,8,2,10,12,14,4,3,7,17,0,15,4,10,9,5,5,0,9,27,1,3,0,11,6,4,3,5,3,6,6,5,0,7,7,0,7,0,0,11,10,45,0,2,9,9,5,6,6,9,4,7,2,2,5,10,9,1,1,4,1,1,7,8,18,19,3,0,4,4,0,11,5,8,7,0,12,8,8,2,12,11,3,0,15,6,22,7,0,0,5,0,0,7,0,0,0,9,9,12,1,12,9,2,0,6,2,6,0,37,2,18,6,6,8,1,8,1,9,4,0,5,21,1,4,3,2,5,19,1,7,4,5,6,8,8,0,17,45,9,0,11,2,7,9,3,0,7,2,8,1,3,12,4,15,1,2,4,0,1,6,21,8,7,3,6,0,8,3,3,0,4,7,5,9,2,0,6,6,0,6,4,6,15,3,1,5,59,1,4,4,16,11,2,42,4,4,14,0,2,16,0,3,5,0,11,2,5,0,2,0,3,6,1,4,3,4,11,5,2,1,3,0,4,0,14,20,7,1,7,8,0,1,12,6,3,5,5,2,0,14,6,0,13,5,15,1,11,6,8,19,6,6,5,3,34,6,7,5,8,5,4,6,0,16,5,2,1,3,1,1,14,3,3,1,0,6,12,4,6,6,12,7,1,1,3,1,4,14,2,6,0,5,13,4,0,5,0,3,0,3,11,1,5,2,13,13,4,43,0,1,2,7,1,20,5,3,11,10,2,42,15,11,9,0,5,7,13,3,8,11,1,0,7,22,2,0,4,14,9,0,3,11,5,3,2,29,3,12,15,6,3,0,0,2,3,1,11,7,8,2,12,0,0,10,2,5,1,2,7,2,2,0,2,5,3,1,8,5,0,1,0,1,3,0,0,4,0,8,3,0,0,2,2,2,5,11,3,10,7,0,5,6,15,5,4,0,12,5,2,6,2,7,3,0,1,2,19,3,0,6,0,6,6,19,5,0,2,0,3,10,18,20,0,1,17,4,0,3,1,5,0,0,3,1,2,6,0,0,4,2,2,2,9,3,1,0,9,2,5,7,3,18,9,7,9,0,11,2,1,3,31,0,0,2,9,2,2,3,3,5,3,10,3,4,5,5,2,4,1,3,16,5,3,8,2,5,0,0,21,5,4,2,1,5,0,4,1,11,6,8,10,5,5,6,1,1,8,3,0,4,4,5,7,4,0,0,3,4,2,10,4,4,6,9,0,0,10,2,4,0,4,2,1,5,2,14,4,7,6,10,0,7,2,9,8,5,9,1,11,1,1,5,5,14,5,7,1,2,2,5,11,5,5,4,1,4,9,10,11,6,3,0,2,6,8,5,9,0,5,0,1,6,6,4,3,0,11,0,6,22,3,4,9,5,1,11,1,5,7,5,1,3,3,5,8,5,4,4,2,0,2,1,5,3,0,1,4,3,5,5,2,12,0,3,0,2,1,2,0,0,0,6,5,3,5,0,6,1,3,8,0,0,0,0,6,1,3,1,6,44,2,7,1,6,6,10,7,2,0,0,11,0,5,13,1,5,5,3,1,15,1,1,0,0,1,2,3,10,2,9,0,1,3,2,0,2,3,23,4,3,1,1,2,9,1,0,4,0,24,4,0,10,1,12,0,2,2,5,2,2,7,4,0,9,3,4,7,12,6,0,5,12,5,9,0,0,4,3,4,5,8,0,4,3,12,9,5,9,9,0,16,4,0,1,6,4,19,0,3,2,2,10,1,0,1,0,3,2,6,4,6,0,0,5,2,0,7,0,5,0,4,2,3,15,5,4,7,10,5,6,0,2,0,2,1,3,7,1,4,7,4,0,1,3,8,2,0,11,2,0,14,11,2,5,14,3,0,0,0,1,1,8,7,0,5,9,2,3,2,4,3,2,3,4,10,1,0,0,10,0,0,4,2,0,3,2,4,5,5,10,2,0,0,0,2,5,6,1,3,1,22,1,5,2,7,6,7,7,6,1,1,6,8,5,6,14,8,5,23,6,4,8,3,2,8,0,5,4,0,2,2,4,2,8,3,2,6,0,1,5,2,1,3,6,0,6,5,0,6,0,2,1,2,0,0,0,5,1,3,3,14,0,2,11,5,6,0,0,8,4,9,12,3,3,7,3,1,5,30,3,4,8,0,1,0,3,5,3,5,0,24,0,4,5,3,0,0,5,9,6,0,4,7,2,3,1,7,7,5,1,3,1,0,4,0,3,5,3,0,0,6,2,0,5,12,5,0,2,5,1,3,7,2,0,9,2,0,1,14,6,0,9,6,1,8,2,0,2,8,1,0,13,2,2,9,0,0,1,8,2,2,1,0,3,4,5,2,0,6,2,0,9,4,2,8,3,1,0,11,4,0,41,2,0,1,0,4,3,4,5,1,0,0,0,1,12,3,24,1,5,0,4,6,0,10,5,3,3,0,0,0,11,2,4,6,2,2,11,2,24,4,1,0,5,6,6,1,7,5,0,7,1,1,9,2,4,4,5,1,1,1,3,4,2,0,2,2,2,1,2,14,3,2,0,0,0,1,3,27,6,5,5,2,1,13,3,9,4,3,0,6,0,10,1,1,4,1,2,7,1,6,23,0,10,0,5,14,2,6,2,5,4,0,2,3,2,2,0,0,0,6,0,2,0,11,3,6,3,341,0,2,0,0,5,1,0,1,2,8,2,5,6,12,7,2,0,0,7,1,0,3,6,14,1,6,1,4,1,9,0,8,4,6,4,8,0,2,11,2,1,5,5,4,0,1,4,3,7,2,0,0,1,5,3,0,11,0,0,0,4,6,0,23,5,3,0,2,8,0,8,2,5,6,0,8,0,0,3,0,0,2,10,5,4,1,3,0,1,1,4,2,3,5,0,0,1,0,0,1,1,2,12,0,9,2,14,5,2,0,0,0,0,2,1,4,7,3,8,6,1,4,0,3,5,5,2,10,0,0,3,4,5,2,5,3,0,7,5,12,2,15,10,9,2,4,7,2,2,2,4,4,3,4,9,8,0,3,0,0,3,5,0,2,3,8,3,0,4,6,2,5,6,5,9,18,0,24,1,0,7,3,4,0,0,530,1,0,4,3,4,1,5,2,0,11,1,0,2,5,4,4,1,3,3,4,1,2,0,0,0,0,4,0,1,4,6,0,1,6,1,0,10,3,3,3,3,3,0,1,1,0,2,1,0,1,4,4,1,1,1,0,8,3,4,3,4,1,5,1,1,1,0,2,10,6,0,6,8,3,5,7,2,3,1,5,1,0,0,0,1,3,1,2,5,4,7,3,3,6,7,8,1,0,7,14,1,11,1,1,4,1,1,6,4,3,11,0,2,0,5,10,0,1,1,8,4,14,7,1,7,1,7,0,2,9,7,10,1,8,0,4,0,1,2,2,0,0,1,2,6,0,8,3,3,0,3,0,18,13,1,8,1,14,1,2,0,4,0,0,0,1,8,1,3,0,8,2,3,1,1,0,1,1,0,0,0,3,10,3,9,12,0,1,0,1,2,0,1,2,5,5,4,0,3,1,1,1,7,3,0,12,2,2,2,1,2,3,5,3,1,19,2,0,1,5,0,2,0,2,1,1,7,3,8,0,2,7,1,2,4,11,10,3,2,1,0,2,2,2,0,7,6,1,0,1,3,1,1,10,1,5,15,0,1,4,9,6,3,6,1,0,1,0,2,0,2,0,3,1,2,1,1,3,3,0,7,6,7,1,6,4,0,5,12,5,2,3,0,11,4,6,3,5,0,1,6,6,0,2,5,2,3,1,15,8,1,1,1,5,6,0,2,3,1,13,2,0,1,2,3,5,3,3,1,1,2,0,2,0,1,0,0,6,0,0,1,0,4,5,2,3,4,2,1,2,1,2,2,2,0,0,11,0,2,4,0,0,1,0,0,10,1,0,2,1,13,0,1,0,3,1,1,2,1,2,0,6,6,2,1,12,0,1,0,7,0,4,2,4,2,8,4,3,7,1,2,1,0,5,7,1,4,4,0,4,1,0,0,3,3,5,1,0,1,0,2,1,6,1,3,1,12,1,0,2,2,11,1,1,0,4,3,4,0,4,5,1,0,1,1,2,0,0,11,4,0,2,2,4,0,3,3,0,0,0,3,0,2,0,3,0,3,8,2,11,0,2,5,2,3,1,9,1,11,1,3,6,4,0,8,1,3,2,3,6,7,3,7,1,2,1,0,0,1,0,5,6,0,3,1,1,2,4,4,5,0,0,0,2,3,3,0,2,7,9,1,0,0,7,1,2,3,2,1,5,2,1,3,3,1,2,3,1,4,1,1,6,0,1,2,1,8,3,10,2,0,1,2,0,0,2,7,0,12,1,1,1,2,2,2,2,0,7,2,5,5,28,0,4,35,1,2,0,5,2,3,1,0,0,0,1,11,1,21,0,14,3,1,2,1,17,1,0,1,1,1,2,0,2,0,3,8,1,1,1,0,2,2,1,7,12,0,6,3,4,6,0,6,0,9,9,0,2,0,1,7,1,0,2,0,0,0,0,10,5,4,138,1,6,1,1,1,1,0,3,7,0,4,2,4,5,0,2,6,3,1,3,4,1,0,1,6,4,4,0,6,6,2,13,0,4,2,0,0,4,1,6,0,0,1,20,0,0,3,7,0,0,5,0,3,0,0,4,0,0,9,1,3,2,1,0,0,0,4,0,3,0,4,0,0,0,2,1,0,1,5,3,0,4,0,1,8,0,0,3,2,2,2,0,0,1,3,6,0,3,0,4,2,4,1,9,2,6,2,0,1,2,9,0,7,5,2,0,1,10,0,3,0,3,25,2,7,9,9,0,4,1,0,2,0,0,2,0,1,3,2,2,5,5,4,4,4,5,0,0,0,1,4,3,2,3,9,6,4,2,0,2,2,2,2,1,0,1,0,3,0,0,3,3,0,1,0,6,0,0,1,0,0,4,0,1,1,2,0,7,0,0,2,0,0,0,1,2,0,0,3,0,4,2,2,3,8,8,0,0,3,0,1,8,2,0,2,2,3,0,2,1,5,2,2,1,8,4,2,1,12,3,0,4,2,1,6,7,2,7,4,4,0,0,0,8,2,6,1,0,1,2,2,11,2,2,0,1,2,0,4,0,0,0,3,2,13,2,0,9,2,3,6,0,7,2,7,1,0,3,2,0,1,0,0,1,5,4,1,0,2,5,5,2,1,6,0,1,3,0,9,0,5,1,3,1,3,1,7,4,1,0,1,0,2,0,3,0,2,0,1,4,3,1,1,3,0,19,0,2,1,1,8,1,0,0,3,0,1,8,3,5,0,6,2,4,1,2,6,5,1,3,0,2,0,3,2,1,3,0,1,0,0,7,9,4,3,4,2,0,5,2,5,1,5,5,2,0,2,2,8,0,5,29,9,0,3,4,5,0,0,1,9,2,4,0,11,2,0,0,1,0,0,3,0,3,0,0,0,1,5,2,2,4,2,1,1,3,4,0,0,1,0,0,0,2,0,1,1,2,0,0,4,4,2,1,7,2,0,0,1,1,0,3,5,0,0,0,2,0,1,0,11,0,3,1,2,3,4,0,1,1,2,2,6,1,3,1,1,3,0,1,2,2,1,0,0,1,0,0,1,1,3,0,0,1,3,0,0,5,1,2,0,1,1,1,3,0,0,0,0,0,0,4,1,5,0,2,1,2,2,0,24,0,0,1,4,0,1,3,0,0,1,1,1,1,0,3,6,2,0,0,2,1,2,0,2,0,0,10,0,7,0,0,23,7,0,1,1,12,0,0,5,0,8,0,0,1,1,6,1,4,1,0,3,0,0,0,0,5,8,3,1,1,0,1,1,2,0,0,1,5,2,0,0,4,0,1,2,0,0,3,3,0,10,3,3,3,5,1,7,0,1,51,1,0,0,3,0,1,2,1,1,2,3,10,7,6,3,0,4,1,3,0,0,6,0,1,1,0,1,3,0,1,2,0,1,6,1,0,0,0,1,4,2,1,2,0,0,5,7,4,4,1,2,17,0,4,2,2,3,0,2,4,1,3,2,3,1,3,9,6,1,3,2,1,1,2,4,7,1,2,1,0,0,1,1,0,0,0,1,0,4,1,9,4,5,0,1,15,2,0,0,2,8,4,33,8,4,0,0,1,1,3,10,0,1,5,0,0,1,3,3,3,1,5,4,0,0,2,4,1,0,6,0,2,2,0,1,1,2,1,1,2,1,3,9,1,1,0,0,0,3,0,0,0,6,2,1,4,2,1,3,0,1,14,3,2,1,0,0,4,0,2,5,2,0,0,2,0,5,0,0,0,0,0,4,2,0,0,6,1,5,6,3,0,0,0,3,5,1,4,0,1,6,1,0,0,0,0,0,2,1,3,3,1,0,0,1,1,3,0,0,2,1,0,2,1,1,1,0,0,4,4,3,2,3,13,1,1,0,1,4,1,1,2,0,0,1,5,0,5,4,0,0,4,0,9,0,0,0,2,3,0,0,3,0,6,0,4,2,0,1,2,0,1,0,6,3,0,5,5,1,0,1,1,0,5,47,4,0,0,0,1,2,0,2,4,0,2,0,1,3,6,1,1,1,2,2,0,6,2,4,2,0,0,1,6,5,5,4,1,3,0,2,3,1,3,3,6,2,0,3,3,1,0,0,1,0,1,1,1,2,0,1,1,1,0,1,1,0,1,2,0,0,1,1,0,1,1,0,0,0,2,0,0,68,1,1,4,4,2,1,2,4,0,3,4,5,2,1,2,4,0,1,1,1,0,6,2,2,3,2,0,11,3,7,1,2,2,1,1,0,0,1,0,1,2,0,5,0,0,0,1,2,0,0,1,0,6,4,0,4,2,2,0,3,3,1,2,0,4,0,1,1,3,3,2,0,0,0,0,0,3,3,0,0,0,1,2,0,0,8,2,1,1,0,3,0,23,1,9,0,0,1,1,0,2,0,0,0,1,1,1,0,4,1,0,0,1,2,5,0,0,1,0,2,1,0,2,1,1,1,2,1,0,4,0,1,2,8,2,0,0,1,1,1,5,1,1,0,4,0,1,3,3,0,0,0,3,1,0,0,3,6,0,0,2,0,1,0,7,1,1,1,0,0,2,1,2,0,0,1,0,5,0,2,0,5,1,2,0,2,1,1,4,2,2,0,0,4,1,5,1,0,0,3,0,3,0,0,1,2,3,0,9,0,0,1,0,0,0,1,0,3,11,0,2,1,0,0,2,0,2,0,0,0,5,0,0,0,2,0,3,0,3,0,0,0,0,0,0,0,0,1,0,0,0,5,0,0,0,3,0,1,0,1,0,1,1,0,0,0,1,0,0,0,0,0,0,0,0,1,0,1,0,0,4,1,0,0,0,0,0,0,0,0,0,0,0,0,0,0,0,0,0,0,0,0,0
K70 Mr. Harrigan's Phone,king,1238,794,672,685,567,1207,461,376,548,491,370,264,378,64,58,234,253,175,167,236,166,287,135,163,314,131,262,74,125,101,90,119,112,117,95,139,98,112,78,132,146,127,105,105,129,142,108,92,107,88,81,44,90,57,66,53,75,75,80,122,47,82,51,48,77,45,26,35,45,79,43,54,77,39,72,59,35,80,58,22,45,50,33,61,49,23,27,49,70,37,27,44,51,14,46,55,29,30,66,46,42,39,48,41,59,58,50,22,47,40,24,41,36,14,36,9,28,25,38,38,41,39,59,22,22,53,23,34,35,41,24,35,26,33,31,27,33,15,27,17,25,29,37,39,81,40,23,28,28,34,34,25,23,23,20,19,10,28,36,7,49,13,52,32,16,12,13,16,33,19,66,33,34,21,7,15,8,15,21,47,37,32,27,22,10,25,13,18,16,13,11,16,17,23,8,14,27,15,2,13,11,18,49,31,22,180,14,9,26,40,11,5,5,9,4,9,21,1,19,11,6,27,10,5,34,2,14,9,17,33,4,11,3,18,13,2,14,8,6,27,13,9,13,13,22,14,16,7,19,27,18,8,10,5,2,23,10,14,14,16,16,19,4,12,23,12,12,9,20,9,11,16,20,14,22,11,13,7,22,17,6,9,11,25,23,8,9,9,8,4,4,6,86,10,7,22,8,13,3,18,21,6,23,5,7,10,19,3,4,13,4,20,6,7,6,15,6,4,8,6,8,25,14,19,0,1,12,2,34,12,19,17,7,4,8,14,19,3,12,15,6,11,9,0,10,3,5,19,8,8,23,3,13,7,8,4,7,15,10,22,8,6,9,0,4,4,8,3,3,7,6,4,9,6,15,13,10,0,17,10,12,5,11,6,6,3,0,7,7,2,0,16,7,13,6,13,3,10,11,6,32,6,4,7,6,6,8,20,2,6,5,6,8,10,2,6,4,6,9,0,5,0,4,24,5,14,5,6,1,16,4,6,7,9,2,2,4,7,4,12,7,6,2,6,1,8,3,17,8,7,10,1,5,15,7,7,4,7,1,3,9,0,0,1,6,14,5,2,3,3,1,2,9,0,0,8,7,1,0,2,5,8,4,0,3,4,7,5,15,11,4,3,2,8,6,8,4,5,2,8,2,5,3,2,6,4,1,9,7,6,1,2,3,1,5,11,0,5,12,12,7,17,8,3,5,10,7,5,7,5,3,6,6,3,6,0,7,4,2,5,7,1,18,4,5,2,0,0,7,3,0,6,15,2,5,16,3,8,5,1,8,6,4,19,3,5,3,3,1,0,4,3,3,2,12,2,8,1,1,5,5,10,5,3,0,3,2,8,0,14,10,9,5,7,6,2,4,2,2,12,1,2,13,3,1,0,0,1,6,2,2,1,15,7,14,9,7,2,2,4,4,4,10,5,4,15,10,6,3,3,2,6,0,6,2,0,8,2,5,2,4,4,2,1,5,9,11,7,5,4,0,0,7,17,2,4,0,0,5,2,4,7,3,1,2,5,5,4,4,5,2,6,4,2,2,7,1,1,6,0,0,9,2,2,7,12,10,1,2,4,11,7,3,20,2,5,4,0,3,1,3,2,5,5,16,5,0,1,10,2,1,4,3,4,3,21,1,2,2,4,3,0,3,0,0,2,4,3,0,6,3,7,2,2,0,5,3,1,2,1,5,2,10,7,2,0,2,7,11,6,0,3,1,11,10,7,4,4,4,0,3,0,4,0,1,27,4,1,5,3,8,8,0,6,0,3,2,3,5,0,0,1,0,3,5,3,2,14,1,2,7,1,0,1,1,7,0,6,15,1,5,3,0,6,3,2,28,0,2,3,1,0,2,0,2,4,1,0,4,9,5,1,0,7,4,2,3,3,4,0,8,0,2,2,0,0,1,3,0,9,0,2,0,1,2,0,1,0,3,2,0,4,1,4,3,5,1,8,3,1,0,2,3,1,0,2,3,0,6,8,5,4,8,0,0,4,2,5,4,1,3,1,4,4,3,2,1,1,2,0,0,3,2,2,3,6,1,0,5,1,1,1,2,3,12,2,6,1,0,3,3,0,1,0,3,0,0,4,7,2,7,1,1,3,3,4,0,0,13,0,3,2,0,3,2,4,2,2,6,3,4,2,5,0,0,0,7,1,5,1,8,4,8,1,1,1,2,3,8,0,0,4,13,0,12,7,3,0,1,1,2,0,7,5,0,1,2,9,1,2,2,5,2,1,3,5,3,0,2,3,1,1,8,0,3,0,1,2,4,0,1,0,1,0,0,2,0,0,11,8,0,0,1,4,4,3,5,0,0,8,0,4,2,1,0,0,1,1,7,7,1,2,3,5,0,8,1,2,2,4,4,8,7,0,7,7,9,6,13,12,3,3,4,0,2,0,2,0,1,1,2,0,0,0,1,0,4,0,0,0,0,0,3,1,13,4,2,0,2,6,0,0,3,1,2,1,12,9,3,0,19,0,7,5,0,5,0,1,8,0,0,3,1,5,4,0,3,3,2,1,2,3,2,0,0,1,1,1,3,2,2,11,0,1,1,0,3,4,0,3,0,6,3,0,2,3,5,3,2,2,0,2,0,2,0,1,0,1,4,0,0,0,1,3,0,1,2,5,1,2,0,1,0,1,0,2,0,3,0,0,0,1,2,0,0,6,0,1,0,0,1,0,5,0,13,2,0,2,2,0,6,3,0,3,1,0,0,0,0,3,1,0,4,3,8,0,3,4,3,4,0,0,1,3,11,0,0,1,1,0,2,2,4,1,0,2,2,0,0,2,1,3,1,2,3,0,0,0,3,4,7,3,0,0,1,0,0,3,3,1,2,2,2,3,0,0,0,3,0,0,1,0,0,0,0,0,1,0,1,4,0,1,1,1,0,7,1,1,0,111,0,1,1,1,1,5,7,1,0,1,0,1,0,0,1,1,1,3,0,2,2,2,0,0,2,6,6,2,4,0,3,0,0,2,0,2,1,1,2,4,2,1,0,0,4,4,3,0,0,2,0,1,0,0,6,0,2,0,1,2,3,1,12,0,0,4,3,5,0,3,4,0,2,2,0,0,0,7,1,1,5,7,4,0,9,0,0,0,0,1,3,2,0,1,4,0,0,3,0,1,0,0,3,4,2,3,1,0,4,2,1,5,1,3,9,0,2,0,0,1,0,0,0,0,0,2,2,0,1,0,2,3,3,3,0,1,1,1,0,2,2,1,0,1,1,0,1,1,1,4,0,1,0,0,1,1,1,1,3,0,1,0,0,6,0,2,2,7,1,3,2,1,0,2,1,0,2,2,0,1,3,0,0,0,6,4,1,0,1,2,1,5,1,0,0,0,0,6,1,0,0,1,5,0,0,2,2,1,0,5,1,2,3,1,0,2,0,0,0,1,1,0,2,0,0,0,0,0,5,1,3,0,1,1,1,3,0,0,0,1,1,1,1,1,1,1,1,3,0,4,2,0,2,1,0,1,0,1,2,5,2,0,2,3,1,1,2,0,2,1,2,1,0,2,0,1,0,0,1,1,2,1,4,1,2,3,0,0,4,2,2,3,1,0,0,0,0,0,2,4,0,0,2,0,3,1,3,1,1,5,0,5,1,2,3,4,0,0,5,0,0,1,0,0,0,0,3,2,0,1,1,1,1,4,2,1,0,1,0,0,1,3,0,0,1,0,0,6,0,0,2,0,0,0,0,0,1,1,0,0,0,0,0,2,0,0,0,0,2,0,3,0,0,0,3,2,2,1,1,1,0,1,2,0,1,0,0,0,1,0,3,4,0,1,0,0,0,0,0,0,1,2,1,0,0,1,1,1,2,1,1,0,0,1,0,0,3,0,1,1,0,2,1,0,3,0,1,0,7,0,0,0,3,0,4,1,0,0,0,0,1,1,0,1,2,0,3,0,1,1,2,0,4,0,3,3,5,2,4,0,0,0,1,0,0,0,0,4,2,0,2,0,3,8,0,2,0,0,1,2,3,4,0,3,2,0,4,0,7,0,0,0,0,1,0,5,0,0,1,0,4,1,2,2,1,1,1,0,0,3,0,4,0,4,1,2,1,2,3,3,0,0,0,0,1,0,0,0,2,0,2,0,1,0,0,0,0,0,0,1,8,0,0,0,0,1,0,0,0,1,0,1,0,1,0,2,0,0,0,0,0,0,0,1,0,6,1,2,4,1,1,2,1,4,1,2,2,1,0,0,3,0,0,1,8,0,0,0,0,2,1,0,0,0,0,1,0,1,0,1,0,2,2,2,0,0,2,3,3,4,2,0,0,1,4,0,1,0,2,4,0,1,0,0,0,1,0,0,0,0,0,2,2,0,0,0,0,0,0,1,1,0,0,0,0,0,1,1,0,1,27,0,0,0,2,0,0,0,0,0,1,0,0,3,1,1,2,12,7,0,0,2,0,0,0,0,0,0,0,0,1,1,9,1,1,1,0,1,0,0,1,1,0,0,1,1,0,1,1,0,1,4,1,3,0,1,4,0,0,3,0,0,1,0,0,2,2,0,3,0,1,0,0,1,1,2,1,4,0,0,0,0,0,1,0,0,2,0,1,1,2,3,0,0,1,0,0,0,0,0,1,1,0,0,0,1,1,0,2,0,2,0,0,0,0,0,0,0,1,2,1,1,1,0,1,0,0,1,6,0,1,2,0,0,0,3,0,2,4,1,0,0,0,3,0,0,3,0,3,0,4,0,0,1,0,0,0,0,4,0,0,1,0,3,0,3,0,0,2,0,0,0,0,0,1,2,0,0,0,1,0,1,1,0,3,0,2,0,0,0,1,0,1,0,0,0,0,0,10,1,1,3,2,0,0,1,2,1,0,4,1,1,0,0,2,1,0,0,0,2,1,3,2,0,2,0,2,0,4,4,0,4,0,2,1,2,4,0,0,2,0,0,3,1,0,0,0,0,0,0,1,0,0,0,0,1,0,0,0,0,0,1,2,0,1,0,2,0,3,2,0,0,0,2,0,0,0,0,0,0,0,0,2,0,1,0,2,1,0,0,1,0,0,0,0,2,0,4,2,1,0,0,0,5,0,1,2,0,1,0,0,1,0,0,0,0,1,2,0,0,0,0,0,0,2,0,0,1,0,0,0,1,0,0,2,1,0,3,0,3,1,0,0,1,0,0,0,1,1,1,1,0,1,1,0,0,5,2,0,1,0,1,2,1,2,0,4,0,0,1,2,0,0,3,0,0,1,1,1,0,0,1,0,0,3,0,4,0,0,1,0,0,1,1,0,0,2,0,0,1,0,2,2,2,0,0,1,0,0,0,2,3,0,0,0,0,0,1,2,1,2,1,0,0,1,1,1,1,0,2,1,1,2,0,0,0,1,0,1,0,0,1,0,4,2,0,0,0,0,0,0,0,1,0,2,0,0,1,0,1,4,4,0,0,0,0,0,0,2,0,0,0,1,0,1,3,0,0,0,0,1,3,1,0,1,0,0,0,0,1,1,2,1,9,0,0,0,3,1,1,0,1,1,0,0,2,0,2,0,0,0,0,0,0,1,0,0,3,1,0,2,1,0,0,0,0,0,0,0,1,0,0,0,0,2,0,0,1,0,0,0,1,1,2,1,0,0,0,1,4,0,0,0,0,0,1,1,0,1,2,0,0,1,0,0,0,0,1,1,0,0,1,0,0,1,0,0,0,3,0,0,0,0,0,0,1,2,0,1,1,1,0,0,2,1,0,0,2,0,2,0,1,1,0,0,1,0,0,0,0,1,0,1,1,0,2,0,0,0,3,0,0,0,0,5,0,0,2,0,1,0,0,0,0,0,0,0,1,0,6,1,0,0,0,0,0,0,0,0,2,0,0,0,5,1,2,0,1,0,2,3,0,0,0,0,0,0,0,0,1,1,3,4,0,2,3,1,3,3,1,2,0,0,0,2,1,9,0,0,4,1,0,0,0,0,0,0,0,0,1,0,0,0,0,0,0,0,1,0,1,0,1,0,1,0,0,0,4,1,0,0,2,1,0,0,0,0,0,1,0,1,0,0,0,2,4,2,0,0,4,0,0,0,0,0,0,0,0,1,0,2,1,1,0,2,0,0,0,2,0,0,0,1,0,0,0,0,0,2,5,0,0,0,1,0,0,0,0,0,1,0,0,0,1,2,1,0,2,0,0,1,0,0,1,0,2,1,3,0,1,0,0,0,1,0,0,2,0,0,1,1,0,1,1,1,0,0,1,0,1,0,0,0,1,1,1,1,0,8,0,0,2,0,0,0,1,0,2,0,1,1,0,0,2,7,0,6,0,0,0,0,0,0,0,1,0,0,2,1,0,0,2,1,0,1,0,0,0,0,0,1,0,0,0,0,0,5,1,0,0,0,1,0,0,0,2,0,1,0,0,1,2,0,3,1,0,0,2,0,0,2,0,1,1,0,0,1,0,0,0,2,0,0,2,3,0,0,0,0,6,0,0,0,2,0,1,1,2,0,1,0,0,0,1,0,1,0,0,0,0,2,1,0,0,0,0,4,0,3,0,0,2,2,0,1,0,0,0,1,0,0,2,0,0,0,1,0,2,1,0,0,2,0,0,0,1,0,0,0,0,0,0,3,2,1,0,0,0,0,0,0,1,3,0,0,0,1,5,1,1,0,0,2,3,0,0,1,0,1,0,0,2,4,1,0,8,2,1,2,0,0,0,0,0,0,0,0,0,0,0,0,0,0,0,1,0,0,0,1,0,0,0,0,0,0,1,1,0,0,1,0,0,2,0,1,0,3,0,0,2,0,0,0,0,0,0,0,1,0,0,1,0,0,1,0,0,3,0,0,1,2,0,0,0,0,0,0,0,0,0,6,1,1,1,0,0,0,0,0,1,0,1,0,0,0,2,1,0,1,0,0,1,1,1,1,2,0,0,2,0,0,0,0,0,0,1,0,0,2,1,0,0,0,0,0,1,0,0,1,0,0,0,1,0,0,0,2,0,1,2,0,1,0,2,0,0,0,0,0,0,0,0,0,1,0,0,0,0,0,2,0,0,0,0,2,0,0,3,0,0,0,0,0,0,0,2,0,0,1,1,0,0,0,1,0,0,0,1,0,0,0,0,0,0,0,0,0,1,0,1,0,0,0,1,1,0,2,2,0,1,0,1,0,0,0,0,0,0,2,0,0,1,0,1,1,0,0,0,0,1,0,0,0,1,1,0,0,0,0,0,2,0,0,2,0,8,2,0,1,0,0,0,0,0,0,0,3,0,0,1,2,0,0,0,0,0,0,0,0,0,0,0,0,0,0,2,0,0,0,12,1,2,0,1,0,1,0,1,0,9,0,0,0,0,1,4,1,0,0,0,1,0,1,0,0,0,0,2,1,0,0,1,0,0,0,2,4,0,0,1,0,1,0,4,1,0,1,1,0,0,0,0,1,0,3,0,0,0,1,0,0,0,0,1,0,0,0,0,0,0,0,0,1,0,0,1,0,0,0,1,2,0,1,0,3,0,0,0,0,0,0,1,0,1,0,0,0,0,3,0,0,4,2,1,0,0,0,1,0,0,0,6,0,0,0,0,1,0,0,1,1,0,0,0,0,0,0,0,0,0,1,0,0,0,0,0,0,0,0,0,1,0,0,0,0,0,0,0,0,0,2,0,2,0,0,0,0,3,0,0,0,0,1,0,0,1,0,0,0,0,0,0,0,1,2,1,0,1,0,1,0,2,1,2,0,0,1,1,0,3,0,0,0,0,0,0,0,2,0,0,2,0,1,0,0,0,1,0,0,1,0,0,0,0,0,2,2,0,0,0,0,0,0,0,0,0,0,0,0,0,0,3,2,6,0,1,0,0,0,0,0,0,2,0,1,2,1,0,0,0,0,0,4,0,0,1,3,0,0,1,0,0,0,1,0,1,2,1,0,1,0,0,0,1,0,0,1,0,0,0,1,0,0,0,0,0,0,0,0,0,1,0,6,0,0,0,0,0,0,1,0,1,0,0,0,0,0,0,0,1,0,0,0,0,2,0,0,0,1,0,0,0,1,0,1,0,3,0,0,0,0,0,0,0,0,0,0,1,0,0,0,0,0,2,0,1,1,0,7,0,0,0,1,0,1,0,0,1,2,0,0,0,0,0,1,0,0,0,0,0,0,1,0,15,0,0,0,0,1,0,0,0,1,0,0,1,0,0,0,0,0,0,0,0,0,0,0,0,1,0,0,0,3,1,0,4,0,0,0,0,0,0,0,0,1,0,0,0,0,0,0,0,0,0,0,1,2,0,1,1,0,0,1,0,0,0,3,2,0,1,0,0,1,5,1,0,0,0,0,0,1,0,0,0,1,0,0,0,0,0,0,0,0,0,0,0,0,0,3,0,0,0,0,1,0,0,0,0,0,0,0,0,0,0,0,0,0,0,3,1,0,0,0,0,0,0,0,1,1,0,0,0,0,0,2,0,0,0,0,1,0,0,0,2,1,0,0,0,0,0,0,0,2,0,0,0,0,1,0,0,0,0,0,0,0,0,0,2,0,0,3,0,0,0,0,0,0,0,0,0,0,0,0,0,0,0,0,0,2,1,0,0,0,0,1,0,0,0,0,0,0,0,4,1,0,0,1,0,0,2,0,0,0,0,0,0,0,0,0,0,0,0,0,1,0,0,1,2,2,0,0,0,0,0,0,0,0,0,0,0,0,0,0,0,0,2,0,0,0,1,1,1,0,0,0,0,2,0,0,1,1,0,0,0,0,0,0,0,7,0,0,0,0,0,0,0,0,0,0,0,0,8,0,1,0,0,0,0,0,1,0,0,0,2,0,1,2,0,1,2,0,0,0,0,0,0,0,0,0,1,0,0,0,0,0,0,0,0,0,0,0,0,2,0,0,0,1,0,0,0,0,0,0,0,0,0,0,0,0,0,0,0,0,0,0,0,0,0,0,0,0,0,2,0,1,0,2,0,1,0,0,0,0,1,0,0,0,0,0,1,3,0,0,0,0,0,0,0,0,0,1,0,0,0,0,0,0,0,1,0,5,0,0,0,0,0,0,4,0,1,0,0,0,0,0,0,1,0,0,0,0,0,0,0,0,0,0,0,0,0,0,0,0,0,2,0,0,0,3,0,0,0,0,0,0,1,0,0,1,0,0,0,0,0,0,0,0,0,0,0,0,0,0,0,0,0,0,0,7,0,0,0,0,0,0,0,0,1,0,0,0,0,0,0,0,0,1,0,1,0,0,0,0,0,1,3,0,0,1,2,0,0,0,0,1,2,0,0,0,0,9,3,1,4,0,0,0,1,0,0,0,0,0,0,0,0,0,0,0,0,0,0,0,0,1,0,0,0,0,0,0,0,0,3,0,0,1,0,0,0,0,0,0,0,0,0,0,0,1,1,0,1,0,0,0,2,0,1,0,0,0,0,0,0,0,0,0,0,1,0,0,0,0,0,1,0,0,0,0,0,1,0,0,0,0,0,1,0,0,0,0,0,0,0,0,1,0,0,0,0,0,0,0,0,1,0,0,0,0,0,0,0,0,0,0,0,1,0,0,0,0,1,10,0,0,0,1,0,0,2,0,0,1,0,1,1,1,0,1,0,2,1,0,0,0,1,0,0,0,0,0,0,6,0,0,2,7,0,0,1,0,0,0,0,0,2,0,0,0,0,0,0,0,1,1,1,0,1,0,0,0,1,0,0,0,0,0,2,1,3,0,0,0,1,0,0,0,0,0,0,0,0,0,0,0,0,0,0,0,1,0,0,0,1,2,1,0,0,0,0,0,1,0,0,0,0,0,0,1,0,0,3,0,0,0,0,0,0,2,1,0,0,0,0,0,0,1,0,2,0,0,0,2,0,1,1,0,0,0,0,0,0,0,0,0,0,1,0,1,0,0,0,0,0,0,0,0,0,0,0,0,0,0,2,0,0,0,10,0,1,0,0,0,0,0,0,0,1,0,0,1,0,0,0,0,0,1,0,0,0,7,1,0,0,0,0,0,4,0,1,0,0,0,0,0,0,0,0,0,0,1,0,0,0,0,0,1,0,3,0,0,0,0,1,0,0,0,0,0,0,0,0,1,0,0,0,0,0,0,0,1,0,1,0,6,0,0,3,0,1,0,6,0,0,0,0,0,0,0,0,0,0,0,1,0,0,1,1,0,0,0,2,1,0,0,0,0,0,0,0,0,0,0,0,0,1,0,2,0,0,0,0,0,0,0,1,0,0,0,1,1,0,0,0,0,0,0,0,1,0,3,0,0,0,1,1,0,0,0,0,0,2,0,0,0,1,0,0,0,0,0,0,1,0,0,0,0,0,1,11,1,0,0,1,0,0,0,0,0,0,1,1,3,0,1,0,0,3,0,0,0,0,0,0,0,0,0,0,19,1,0,0,0,0,0,0,0,1,0,0,0,0,1,0,0,0,0,0,1,0,0,0,0,0,0,0,0,0,0,0,1,0,0,0,0,0,0,1,2,1,0,0,0,0,0,0,0,0,0,0,0,0,0,2,3,0,0,0,0,0,0,0,1,0,13,0,0,0,1,0,0,1,0,1,0,0,0,0,0,0,0,0,0,3,1,0,4,4,0,1,0,0,0,0,1,0,0,0,1,1,0,1,2,0,0,0,0,0,0,0,0,0,2,0,0,0,0,0,0,0,1,0,1,0,4,0,0,1,1,0,0,0,0,0,1,3,0,0,0,0,2,0,0,0,0,0,0,0,3,0,0,0,0,2,0,0,0,0,0,0,0,0,0,0,0,0,0,0,0,0,0,0,0,0,0,0,1,1,0,0,0,0,1,0,0,1,0,0,0,2,0,0,0,0,0,0,0,0,0,0,0,1,4,1,1,0,0,1,0,0,1,1,0,0,3,0,0,0,0,0,0,1,0,2,1,0,0,0,0,1,1,0,0,0,0,1,0,2,0,0,1,0,0,1,0,0,0,0,0,0,0,0,0,0,0,0,0,0,0,0,0,0,0,0,0,2,0,1,0,2,0,0,0,0,0,0,0,1,1,0,0,0,0,0,0,0,0,0,0,0,2,0,0,0,0,0,0,1,0,0,0,0,4,0,3,1,0,0,0,1,0,0,1,0,1,0,0,0,2,0,0,0,0,0,0,1,0,0,0,0,0,0,0,0,0,0,0,0,0,0,0,1,0,0,0,1,0,0,0,0,0,1,0,0,0,0,0,0,0,0,0,0,0,0,0,0,0,0,0,0,0,0,0,0,0,0,4,0,0,0,0,0,0,1,0,0,0,0,0,0,0,0,0,0,0,0,0,0,0,0,0,0,0,0,0,0,0,0,0,0,0,0,0,0,0,0,0,0,0,0
K71 The Life of Chuck,king,1005,501,445,445,390,147,419,281,316,249,154,282,195,136,138,183,109,133,114,96,123,165,81,95,31,71,26,100,75,108,45,94,67,74,66,56,79,68,33,76,59,72,94,55,55,82,47,38,51,62,68,42,45,40,54,42,36,35,40,61,49,28,35,50,34,40,25,30,33,39,29,22,28,27,29,41,20,26,22,8,23,39,25,38,33,18,30,23,26,23,16,39,31,12,41,23,12,23,40,32,30,54,30,21,21,29,21,13,16,17,12,24,6,17,21,15,13,16,21,26,18,34,27,8,13,16,24,11,17,11,16,12,25,17,24,20,5,13,13,6,14,18,16,11,35,29,12,22,12,34,40,16,15,15,7,33,20,10,10,15,6,12,19,16,6,10,7,14,5,18,2,22,29,4,9,12,14,6,17,15,10,16,18,3,6,17,6,15,11,13,13,16,16,12,13,17,4,6,8,7,6,16,8,19,7,15,14,11,5,14,6,3,1,3,3,10,15,4,8,8,6,15,6,10,7,5,7,10,9,20,7,11,3,4,9,4,6,5,5,8,4,9,10,10,16,8,13,18,9,8,16,3,13,9,11,9,6,6,16,20,21,9,5,18,17,11,8,6,12,9,3,6,6,9,6,11,15,3,13,2,12,5,8,11,13,20,2,11,8,3,2,38,6,14,5,8,4,14,15,7,10,5,6,6,6,12,3,13,2,2,4,5,5,12,5,3,8,12,5,7,15,12,3,16,3,11,13,4,5,7,4,5,4,9,2,8,19,1,4,18,7,12,1,1,3,0,4,10,10,2,21,3,13,3,8,0,2,7,2,12,15,4,7,1,4,2,6,8,7,6,10,1,9,9,9,4,6,14,16,15,3,5,5,3,6,0,0,2,3,5,2,4,5,8,5,3,3,3,12,1,20,0,6,5,4,11,3,12,14,7,2,2,1,1,1,3,9,8,6,1,9,0,21,2,7,1,1,3,2,7,7,9,2,6,1,2,2,2,0,3,10,6,0,2,3,2,1,6,2,8,4,2,3,5,5,9,3,5,0,5,5,6,0,6,3,2,3,5,4,0,0,5,2,1,0,1,0,5,0,9,3,5,2,0,0,1,5,1,4,8,3,4,0,6,4,1,8,3,1,7,2,2,6,2,5,3,2,2,2,0,6,5,5,2,4,5,0,7,6,2,0,8,6,6,2,2,1,8,3,3,0,4,7,2,0,0,3,8,1,5,2,1,9,5,3,4,0,0,9,4,7,0,3,1,2,8,2,3,1,1,0,4,3,8,1,8,1,0,3,0,8,1,6,7,5,3,4,15,3,4,4,1,2,1,0,0,1,3,1,1,4,2,2,11,1,3,4,1,8,8,1,0,8,2,6,0,0,2,2,13,2,0,7,6,0,1,0,1,1,8,1,5,6,4,4,5,2,3,0,1,1,1,2,4,2,0,11,5,1,0,2,2,8,0,6,6,0,2,4,2,0,0,5,5,7,3,3,1,5,5,0,6,3,4,6,3,1,1,2,0,4,2,5,0,1,2,2,4,5,0,1,8,1,1,6,5,0,1,2,0,2,4,2,3,0,5,0,0,4,3,6,1,0,5,6,3,3,3,4,3,1,3,0,2,4,9,3,3,1,2,2,1,1,0,0,2,2,10,1,5,2,2,6,0,0,1,3,2,1,3,3,1,1,1,0,0,3,3,5,0,2,1,1,5,3,3,1,2,1,0,2,1,3,2,0,10,5,0,3,0,2,1,1,5,1,2,1,0,9,2,0,3,1,7,5,1,2,3,2,1,2,2,1,2,1,7,0,2,1,3,2,1,2,0,2,4,17,4,3,4,0,2,10,3,6,4,4,0,3,6,2,2,0,0,5,3,0,4,3,2,5,4,0,4,0,7,1,1,0,1,0,1,0,1,0,0,2,0,0,1,2,0,1,0,1,5,0,5,1,3,2,0,4,1,1,4,1,0,3,0,2,12,7,5,0,5,0,2,1,5,0,2,4,5,1,2,3,2,0,2,1,1,1,0,0,3,0,0,5,2,0,4,1,0,5,2,2,1,1,1,0,0,3,1,3,2,2,3,4,6,2,0,2,0,4,0,0,0,2,0,6,1,0,0,0,1,0,0,6,4,3,2,5,1,0,3,0,1,2,0,6,2,0,3,0,2,0,0,3,0,0,7,4,3,8,1,1,3,2,0,0,0,3,0,1,1,3,6,3,1,0,2,2,0,1,1,2,0,1,4,1,3,3,2,1,1,0,2,1,0,1,1,1,0,0,12,0,0,0,1,0,2,2,0,0,1,3,1,2,1,0,0,2,1,1,0,0,0,2,0,1,1,1,1,3,5,1,4,0,0,4,7,2,1,2,0,4,1,3,12,2,5,4,0,1,0,2,1,0,0,2,1,0,0,1,2,0,4,0,0,0,0,0,2,0,4,2,0,2,2,0,0,1,4,7,1,2,3,1,0,1,0,2,0,0,5,4,0,0,2,3,2,0,1,0,0,3,4,2,1,2,1,1,0,0,0,1,5,1,1,1,8,0,3,2,1,0,4,1,0,0,5,1,0,0,1,2,0,6,19,1,2,2,2,0,1,1,1,1,0,0,1,0,2,1,0,1,2,1,0,4,1,0,1,0,2,5,2,0,0,0,2,0,0,2,5,0,0,1,0,2,1,0,1,17,0,0,6,0,0,1,8,0,1,0,7,0,0,0,3,0,0,1,3,3,0,1,1,0,0,0,1,0,1,3,0,0,1,0,0,11,1,0,0,0,2,4,1,1,2,3,1,1,2,0,0,0,2,0,4,0,4,3,0,1,0,0,1,1,0,0,0,2,3,0,1,2,2,0,3,1,0,5,1,0,0,0,0,0,3,0,2,1,0,0,3,5,1,0,3,0,1,0,0,1,1,2,1,4,2,0,0,0,12,3,4,1,2,0,0,1,0,3,1,1,0,3,0,0,1,0,0,0,0,0,3,1,4,2,1,1,1,0,0,0,3,2,2,1,0,1,0,1,3,0,0,2,0,3,0,0,2,6,0,1,8,3,3,0,1,0,0,2,0,3,1,1,2,2,0,3,0,1,0,5,3,0,1,0,4,1,2,0,0,1,0,0,0,0,1,0,0,1,2,0,1,1,0,4,5,1,4,0,0,7,6,2,0,0,1,1,0,0,1,0,4,0,0,1,1,3,2,1,1,0,0,1,0,1,2,3,0,0,0,2,0,0,0,0,1,2,0,0,0,0,0,0,1,1,0,0,0,0,0,1,2,2,3,0,1,2,1,0,0,0,0,0,4,1,0,0,1,0,0,2,6,1,0,2,5,5,0,1,0,0,0,0,0,1,2,2,5,0,2,6,2,0,0,0,1,1,1,2,0,1,1,0,0,0,0,0,0,0,0,0,1,0,2,1,0,0,0,2,1,0,1,1,0,3,0,0,1,2,1,3,0,1,2,1,1,0,0,0,0,0,1,2,0,1,2,0,1,2,1,2,0,3,0,0,0,0,1,1,1,17,2,0,0,3,0,0,0,0,0,0,3,0,0,1,2,1,1,1,0,3,2,3,1,4,0,0,0,5,1,1,1,1,0,0,0,0,1,3,0,0,4,0,0,0,3,0,0,0,0,0,1,1,0,0,2,0,0,0,0,1,1,0,1,0,1,2,2,1,0,2,0,0,2,0,0,1,0,0,4,0,3,4,0,2,0,2,0,1,1,2,0,0,0,0,0,2,0,0,0,3,0,0,3,0,0,2,0,3,0,2,1,2,0,0,0,0,1,0,0,1,1,0,1,0,0,0,12,5,0,0,1,0,0,1,1,2,0,2,1,0,0,2,0,0,1,4,1,2,1,0,1,1,0,3,1,0,0,1,1,0,1,0,0,0,0,1,3,1,2,0,0,2,0,0,0,1,0,4,0,0,5,0,0,0,3,0,5,1,0,0,2,0,34,2,0,0,1,1,0,0,0,0,1,0,2,0,0,1,0,0,2,2,1,1,0,0,0,0,1,4,0,0,0,0,0,1,4,1,0,1,1,1,0,0,1,1,0,35,0,2,1,0,4,1,5,0,0,0,0,1,0,0,1,0,1,0,2,1,0,0,0,0,0,1,0,2,0,0,0,0,1,0,0,0,0,0,0,0,1,1,0,0,0,0,0,7,2,0,0,0,1,1,0,0,0,0,0,1,1,0,2,2,0,1,0,0,0,3,8,2,0,0,0,1,2,0,0,0,0,0,2,0,5,1,2,0,1,1,5,0,0,1,2,0,1,5,1,0,0,0,1,0,0,0,1,0,0,1,0,0,0,0,0,3,0,0,2,0,0,1,0,0,0,0,0,1,0,0,1,1,2,0,0,2,0,0,0,0,3,0,0,1,2,0,5,2,0,0,0,0,0,0,4,2,2,0,0,4,0,0,0,0,5,0,1,0,0,0,1,1,1,0,0,0,0,0,1,0,0,1,0,0,1,0,1,0,2,1,0,0,0,0,0,0,1,0,0,0,0,0,1,0,0,1,1,0,0,2,1,0,1,0,1,0,1,0,0,0,0,0,2,0,0,0,0,0,0,0,0,0,0,0,0,0,0,0,1,0,0,0,2,2,0,1,1,3,0,0,0,1,1,0,0,0,1,0,0,0,0,0,1,1,0,0,0,0,2,0,4,1,0,0,3,2,2,0,0,1,1,0,0,1,0,3,0,1,0,0,1,0,1,0,0,0,0,0,1,1,3,0,0,0,0,0,2,0,0,0,5,1,1,0,1,1,2,0,0,1,0,0,0,5,3,0,0,0,0,1,1,0,0,0,1,2,1,0,1,0,0,0,0,1,1,2,6,0,0,0,1,5,0,0,1,0,1,0,3,1,0,4,0,1,1,1,0,0,2,0,0,0,0,0,2,2,0,0,0,0,1,0,0,0,0,0,1,11,0,4,0,0,0,0,0,0,0,0,0,1,1,0,0,0,0,1,0,0,0,1,0,1,0,0,0,0,0,0,0,2,0,0,0,1,0,0,0,0,0,0,1,0,1,0,0,0,0,0,0,0,0,2,0,0,0,0,0,2,2,5,1,3,0,0,0,0,0,0,0,0,0,1,0,1,0,0,0,0,0,1,0,0,1,0,1,2,16,0,1,0,0,0,2,1,1,6,0,0,0,4,1,0,0,0,1,0,2,1,0,1,1,1,0,0,1,1,1,0,0,0,0,0,3,0,0,0,0,0,0,4,0,0,0,3,0,0,0,0,2,0,1,2,0,0,0,0,1,1,0,3,0,0,0,0,0,1,2,1,0,1,0,0,0,3,0,0,0,1,0,2,0,0,0,0,0,2,0,0,0,1,3,1,1,0,3,0,2,1,0,3,0,0,0,0,0,0,1,0,0,1,0,2,0,0,0,0,7,0,0,0,0,0,0,0,0,0,0,0,1,0,0,0,0,1,2,1,0,0,3,6,0,1,1,0,0,0,0,0,0,0,4,0,0,0,1,0,4,0,0,2,0,0,0,1,0,1,1,0,0,0,4,0,0,1,1,0,0,1,0,0,1,0,0,1,0,0,1,0,1,8,0,0,1,0,5,0,0,0,1,0,0,0,1,0,0,0,0,0,0,2,1,0,1,0,0,0,0,0,0,0,0,1,0,0,0,1,0,0,2,0,1,0,0,0,0,0,0,0,1,0,0,0,2,0,2,2,3,0,1,0,1,1,0,3,1,0,0,0,0,2,0,0,0,0,0,0,10,2,0,1,0,0,0,1,1,1,0,0,0,0,0,0,0,0,1,0,0,0,0,0,0,0,0,0,0,0,0,0,0,0,1,0,0,0,1,0,0,0,0,1,0,2,1,0,1,0,0,1,1,0,0,5,1,0,0,0,1,0,2,1,0,0,1,0,2,0,0,2,0,1,0,0,2,0,0,0,2,0,0,0,0,0,0,1,1,0,1,0,0,0,0,0,0,0,1,0,0,0,0,0,0,3,0,0,1,0,0,1,0,0,0,0,0,0,0,0,0,3,1,0,1,0,1,2,1,1,0,0,1,0,0,0,0,1,0,2,2,2,0,0,0,0,0,0,1,0,0,0,0,1,1,0,0,0,5,0,0,2,0,0,1,0,0,0,0,5,0,0,0,0,0,0,3,0,1,0,0,0,0,0,3,1,2,0,0,0,1,0,0,0,1,0,1,0,0,0,0,0,0,3,0,1,0,0,0,0,0,0,0,0,2,0,0,0,0,1,2,1,0,1,0,0,0,0,6,0,1,0,0,0,2,0,0,3,0,0,0,0,0,2,1,1,0,0,0,0,0,1,1,1,0,2,0,0,0,0,0,0,0,0,0,0,0,0,0,0,0,0,0,0,0,0,0,0,0,0,2,1,0,0,0,0,0,0,1,0,0,1,1,1,0,0,0,0,2,0,0,1,0,0,0,0,0,0,0,0,0,1,0,0,0,2,0,0,0,0,0,2,0,1,0,0,0,0,1,1,1,1,0,0,0,0,1,1,0,1,0,0,3,0,6,0,0,0,0,0,0,0,1,0,0,0,1,0,2,0,5,0,0,0,0,0,0,0,0,0,0,0,0,0,0,0,0,1,1,0,0,0,1,2,0,0,0,0,2,0,0,0,0,0,0,0,0,0,0,0,1,0,2,0,1,0,3,1,0,0,0,0,0,1,0,0,0,1,0,0,0,1,3,0,0,0,0,0,0,1,1,0,0,0,0,1,1,1,0,0,1,0,0,0,0,0,0,1,0,0,1,0,0,0,0,0,0,1,0,0,0,0,0,0,0,0,0,0,0,0,2,0,1,0,5,0,0,0,0,0,0,0,0,0,1,0,0,2,0,0,0,0,0,0,2,0,0,0,0,0,0,9,0,1,0,0,3,1,0,0,0,1,0,2,1,0,0,0,1,0,0,3,0,0,0,1,0,0,0,1,0,0,0,0,1,0,0,1,1,3,0,0,0,1,0,0,0,0,1,0,0,0,0,1,3,0,0,0,0,1,2,2,0,6,0,1,0,0,3,0,0,0,0,0,0,0,0,0,0,0,1,0,0,0,0,0,0,1,0,1,0,0,0,0,0,1,1,2,0,0,0,0,0,1,0,0,0,1,0,0,1,0,0,0,0,2,1,0,0,0,0,0,1,1,0,0,0,0,0,2,1,0,0,0,1,1,0,0,0,2,0,0,0,2,0,0,2,0,0,0,0,1,0,2,1,1,0,1,0,2,0,0,0,0,0,0,0,0,0,0,0,4,2,1,0,0,0,0,0,0,0,1,1,0,0,0,0,0,0,1,1,0,0,0,0,1,3,1,0,0,0,0,0,0,1,0,1,0,3,0,0,0,3,0,0,0,0,6,0,0,1,1,0,1,2,0,0,0,0,0,0,0,1,0,0,1,0,19,0,1,0,0,0,0,0,0,0,1,0,0,0,3,0,1,0,0,0,0,1,0,0,1,0,1,0,1,3,0,0,0,0,0,0,7,0,4,0,1,2,0,0,1,0,0,0,2,0,0,1,1,0,0,0,1,0,0,0,0,0,0,0,1,1,0,0,1,0,0,0,0,0,1,1,0,0,0,0,0,0,0,2,0,0,0,0,0,0,0,0,1,0,1,0,1,0,1,0,0,0,0,0,0,0,2,0,0,0,0,0,0,0,1,4,0,2,2,1,0,0,0,1,1,0,0,1,0,0,1,0,0,0,0,0,0,0,0,0,0,0,0,0,0,0,1,0,6,0,0,0,0,0,0,0,0,0,0,0,0,0,0,1,0,0,1,1,0,0,3,0,0,0,0,0,3,1,0,0,0,0,0,2,1,0,1,0,0,0,0,0,0,1,0,0,0,1,0,0,0,0,0,0,0,0,0,2,0,0,2,1,0,0,0,0,1,0,0,0,0,2,0,5,0,0,0,0,0,0,1,0,0,0,0,1,2,1,0,0,5,0,0,0,0,0,0,1,0,0,0,0,0,0,1,1,0,1,2,0,0,0,0,0,0,0,3,0,0,0,2,0,0,0,0,0,0,0,0,0,0,0,0,0,0,0,0,0,0,0,0,0,1,0,0,0,3,0,0,0,2,0,0,0,0,0,1,0,0,0,0,0,0,0,0,0,0,1,0,0,0,2,0,0,0,0,0,1,0,0,0,1,0,2,0,0,0,0,0,1,0,0,0,0,0,1,0,0,0,0,0,0,0,0,0,0,0,0,0,0,0,0,0,0,0,0,0,0,0,1,0,0,0,0,0,0,0,0,0,0,0,0,0,0,0,0,0,0,1,0,0,0,0,0,0,0,1,0,0,1,1,0,0,1,0,0,0,0,1,1,0,0,0,1,0,0,0,0,0,1,1,0,0,0,0,0,0,0,0,0,0,0,0,1,0,0,1,0,0,1,0,0,0,0,1,0,0,0,0,0,0,0,0,1,0,0,0,1,0,1,1,0,0,0,0,0,0,1,0,1,0,0,0,0,0,0,0,2,0,1,0,0,0,0,0,0,2,0,0,0,0,0,0,0,0,0,0,0,0,1,0,0,1,2,0,2,0,0,2,0,0,0,0,0,0,0,1,0,1,0,0,0,1,0,0,1,0,0,1,0,0,0,0,0,0,0,0,0,0,0,2,0,0,0,0,0,0,0,0,0,1,1,2,1,3,0,0,0,0,1,0,1,0,0,0,0,0,0,0,0,0,0,0,0,1,0,0,1,0,0,0,0,0,1,0,1,0,0,0,0,1,0,0,0,0,2,0,0,0,0,0,0,0,0,0,0,5,0,0,1,2,1,0,0,0,0,0,1,0,0,0,1,0,0,0,0,2,1,0,1,0,1,0,0,0,0,0,0,0,0,1,0,0,0,0,0,0,0,0,0,0,0,0,0,0,0,0,0,0,0,0,1,0,0,0,0,3,0,0,0,0,0,1,1,0,0,0,2,0,0,0,0,1,1,1,1,0,1,0,0,0,0,1,0,0,2,0,0,0,0,0,2,0,0,0,0,1,0,0,0,0,0,0,0,0,0,0,0,0,0,0,0,0,0,0,0,0,0,0,1,0,3,1,0,1,0,0,0,0,0,1,0,0,0,0,0,4,0,0,1,0,0,2,0,0,0,0,0,0,0,0,0,0,0,1,0,0,0,1,0,0,0,0,0,0,0,0,0,1,1,0,0,0,0,1,0,1,0,1,0,0,0,0,0,0,2,0,2,0,0,0,0,0,2,0,0,0,0,0,0,0,0,0,0,3,2,0,0,0,0,0,0,0,0,0,0,0,0,0,0,2,0,0,0,0,0,0,1,1,0,0,0,3,0,0,0,0,0,1,0,0,1,0,0,0,0,0,0,0,1,0,0,0,1,1,0,0,0,0,0,0,0,0,0,0,0,0,0,0,0,0,0,0,0,0,0,0,0,0,0,0,0,0,0,1,0,0,0,0,0,0,0,0,0,0,0,0,0,0,0,0,0,0,0,0,0,2,0,1,0,1,0,0,0,0,0,0,0,0,0,0,0,0,0,1,1,0,0,0,1,0,0,0,0,0,0,0,2,0,0,1,1,0,0,0,1,1,0,0,1,1,1,0,1,0,0,0,0,0,0,1,0,0,0,0,0,0,0,0,0,0,1,0,0,0,1,0,1,1,0,0,0,0,1,0,0,0,0,0,0,0,0,0,0,0,0,0,1,0,0,0,0,0,0,0,0,0,1,0,0,0,0,1,0,1,0,0,1,0,2,0,0,2,0,0,0,0,0,0,0,1,0,0,0,0,0,0,0,2,1,0,0,0,0,1,2,0,0,1,0,0,0,0,0,0,0,1,0,2,1,1,1,0,0,0,0,0,0,0,0,0,0,0,0,0,0,0,0,0,0,0,0,0,0,0,0,1,0,0,0,1,0,0,0,1,0,0,0,0,0,0,0,0,0,0,0,0,0,1,0,0,0,0,0,10,1,0,0,0,0,0,0,0,0,0,0,0,0,3,0,0,0,0,0,0,0,0,0,0,0,0,0,1,0,0,0,0,1,1,0,0,0,0,0,0,0,0,1,0,0,0,0,0,0,1,0,0,0,1,0,0,0,0,0,0,0,0,3,0,0,0,0,0,0,0,0,0,0,0,0,1,0,0,0,0,0,3,0,0,0,0,13,0,2,0,0,0,0,0,0,1,1,0,1,0,0,1,0,0,2,0,0,0,0,0,0,1,0,0,3,1,0,0,0,0,0,0,0,0,0,0,0,0,0,0,0,0,0,0,1,0,0,0,0,0,0,0,0,0,0,0,0,0,0,0,0,0,1,0,0,0,0,0,0,0,0,0,0,0,0,1,1,0,0,0,1,0,0,2,0,0,0,0,1,0,0,0,0,0,0,0,0,0,0,0,0,1,0,1,0,0,0,0,0,0,0,0,0,0,0,0,0,0,0,0,0,0,0,0,0,0,0,1,0,0,2,0,0,0,1,0,1,0,0,0,0,0,1,0,0,0,1,0,0,0,0,0,2,0,0,0,0,2,0,0,0,0,0,1,0,0,1,2,0,0,0,0,0,0,0,0,6,0,0,0,0,0,0,0,0,1,0,0,0,0,0,0,0,0,1,0,0,0,0,0,0,0,1,0,0,0,0,0,0,0,0,0,0,1,0,0,0,0,0,0,0,0,0,0,0,1,0,0,0,0,0,0,0,1,1,0,0,0,0,1,1,0,0,0,0,0,0,0,0,0,0,1,0,0,0,0,1,0,2,1,0,0,1,0,0,0,1,0,0,0,0,3,0,2,0,2,0,1,2,0,0,0,0,0,0,0,0,0,0,0,1,0,0,0,1,2,1,0,0,0,0,0,0,0,0,0,0,1,0,1,0,0,3,0,1,0,0,0,0,2,2,1,0,0,0,0,0,0,0,0,0,0,0,0,0,0,0,1,4,0,0,0,0,0,0,0,0,0,0,0,0,0,0,0,0,0,0,0,0,0,0,0,0,0,0,0,0,0,0,0,0,0,0,0,0,0,1,0,0,0,0,0,0,0,0,1,0,0,0,0,0,0,0,1,0,0,0,0,0,1,0,0,0,0,0,0,0,0,0,0,0,0,0,0,1,0,0,1,0,0,1,0,0,0,0,0,0,0,0,0,0,1,0,0,0,0,0,1,0,0,0,0,0,0,0,0,0,1,0,0,0,0,0,0,0,0,0,0,0,0,0,0,0,2,0,1,0,0,0,0,0,0,0,0,0,0,0,0,0,0,0,0,0,0,0,0,0,0,1,0,0,0,0,0,0,0,0,0,0,0,0,0,0,0,0,0,0,0,0
K72 If It Bleeds,king,2747,1447,1337,1249,966,658,620,734,337,685,632,454,643,1064,876,504,136,381,396,103,401,531,279,241,159,252,177,148,202,638,229,190,231,340,298,275,80,193,105,229,256,159,202,155,185,196,162,146,121,135,113,109,78,99,143,133,131,137,151,171,95,122,136,113,115,112,52,58,218,77,84,106,97,92,57,107,83,50,89,62,84,262,100,104,75,17,89,164,91,81,46,97,79,38,107,82,44,67,105,73,59,77,71,58,35,87,108,69,81,60,45,70,17,49,64,49,50,38,22,56,32,135,22,55,44,23,67,62,22,65,39,30,98,20,45,43,25,74,21,23,23,34,13,47,125,43,39,57,45,74,39,69,22,67,27,148,217,26,55,17,29,4,33,66,20,22,39,27,37,40,20,35,71,74,26,25,38,28,47,78,50,10,73,16,28,29,17,15,42,24,24,25,47,43,21,42,7,44,33,18,55,9,51,50,26,35,32,30,6,37,57,16,13,19,8,23,40,13,26,4,20,34,35,19,79,19,38,39,40,41,14,24,1,41,16,13,22,29,18,38,23,22,28,24,20,27,38,39,24,18,19,3,18,0,7,37,14,22,20,15,20,22,34,20,52,21,22,27,30,21,24,19,32,19,11,24,14,33,36,29,31,16,24,33,45,13,18,13,18,11,5,337,68,32,17,18,9,41,174,19,42,17,32,6,3,75,18,18,2,52,9,16,14,19,16,2,30,12,29,13,17,49,5,21,42,10,32,13,18,5,11,50,18,6,9,23,12,20,12,23,18,14,15,29,15,6,32,47,19,16,44,7,29,11,19,19,32,7,15,18,15,1,71,8,14,4,24,16,29,12,24,13,19,13,21,38,14,9,26,113,8,17,18,1,12,24,1,12,35,15,7,16,27,6,16,27,11,5,13,3,73,19,5,15,10,12,14,20,12,20,5,14,10,4,9,11,14,9,13,13,7,1,10,19,16,11,7,5,18,5,9,30,17,5,2,8,5,13,21,9,29,10,15,15,12,19,8,15,16,14,1,5,7,15,48,22,11,16,2,8,12,15,0,24,12,23,17,11,3,15,10,5,14,0,7,14,4,28,0,9,39,17,9,12,7,4,20,1,10,9,13,5,13,9,13,0,19,1,1,13,4,17,11,8,7,10,6,5,18,14,6,11,9,0,16,19,0,12,2,15,10,12,21,11,8,12,14,53,7,10,17,4,12,11,1,0,14,17,4,12,4,7,29,9,12,8,0,3,16,4,6,15,9,4,8,16,19,16,10,5,15,18,7,40,20,9,7,1,1,3,13,16,21,9,4,1,13,9,9,10,12,16,14,3,3,14,7,19,6,2,5,10,3,4,13,6,2,3,6,23,7,2,21,5,11,0,2,9,0,52,5,1,13,23,2,7,10,7,8,9,14,17,2,21,10,10,8,4,0,7,2,2,3,4,1,0,13,2,4,4,9,4,2,4,4,18,6,3,5,7,0,9,10,18,3,6,1,3,12,7,5,4,2,13,7,3,11,12,3,2,16,10,1,10,5,9,20,7,7,6,15,16,8,11,7,2,1,6,8,11,12,8,2,26,4,14,3,0,2,14,46,2,7,6,12,5,13,10,46,1,1,2,0,4,2,5,6,4,6,10,1,4,4,0,5,7,10,6,6,4,10,13,0,1,0,3,12,2,1,3,11,20,6,19,0,0,13,7,13,2,2,5,4,9,11,4,12,0,7,2,1,1,4,6,24,18,46,1,3,16,3,5,1,11,1,5,2,2,3,1,0,5,2,11,0,10,1,4,27,9,6,2,10,3,1,9,1,6,0,1,6,5,0,5,3,0,36,9,7,2,2,6,9,2,7,53,3,0,5,4,11,4,3,11,8,2,4,16,9,8,13,7,1,6,0,8,1,14,0,5,5,1,3,5,4,4,4,0,3,7,5,6,0,4,12,10,2,31,3,9,3,1,12,6,0,7,4,1,1,8,13,7,8,21,0,3,7,2,2,7,3,9,18,10,3,4,12,10,7,4,15,9,1,4,3,4,1,0,1,3,6,1,6,0,14,2,10,3,6,1,3,0,13,1,9,5,2,2,11,28,3,2,4,0,4,5,11,0,6,2,3,0,3,0,6,4,10,3,4,9,6,5,4,9,1,0,7,2,11,2,12,4,5,6,1,1,0,4,19,2,0,10,5,0,8,3,2,2,1,0,6,0,2,1,2,7,4,10,3,23,0,2,7,0,6,2,5,0,6,3,0,0,10,3,4,2,0,4,0,0,1,0,8,0,0,9,0,0,1,4,4,13,3,11,10,8,7,0,0,5,8,10,13,13,2,4,2,1,10,10,12,7,6,2,10,10,5,17,10,13,1,2,6,2,0,8,4,3,8,4,2,3,1,1,4,0,7,8,1,4,4,2,0,14,0,7,2,3,1,0,0,2,6,3,5,4,7,0,1,5,4,1,13,7,0,0,0,15,8,13,7,0,5,1,10,3,3,4,4,3,3,0,3,11,2,1,2,5,5,7,4,1,0,4,0,0,1,3,3,0,3,14,44,4,18,3,7,11,2,0,1,13,5,2,0,3,1,3,64,8,6,2,1,5,1,1,0,4,12,4,5,0,1,2,0,0,0,6,2,5,2,0,2,11,0,12,58,6,0,0,0,5,7,2,3,2,0,4,4,0,3,6,1,2,3,2,1,4,3,0,7,2,0,3,2,3,0,4,1,3,3,0,2,4,2,0,0,1,0,6,0,1,4,7,7,0,0,5,0,0,6,3,3,1,4,2,33,8,3,6,4,3,0,1,2,0,5,2,6,11,2,3,1,0,4,0,0,1,4,11,32,4,4,5,0,1,0,7,0,0,0,0,17,10,0,3,4,2,3,6,0,5,8,0,0,12,3,0,0,2,2,1,9,5,3,4,6,1,1,20,0,0,7,133,3,1,0,2,0,1,1,1,1,1,3,1,3,3,2,1,0,0,1,0,2,3,2,3,4,1,4,6,17,0,3,0,6,1,5,0,0,15,1,5,5,2,10,1,1,5,7,4,3,0,1,56,2,3,4,1,3,1,13,2,5,3,1,2,3,2,6,1,4,1,1,4,4,2,0,3,11,0,3,3,4,0,0,2,0,5,0,0,6,8,1,3,0,6,4,2,0,10,1,5,51,9,0,0,1,0,0,0,0,1,8,1,0,0,6,1,2,13,0,4,0,0,1,5,3,2,0,0,3,12,0,0,9,0,4,5,0,0,0,0,1,4,1,2,4,5,1,5,1,7,2,9,2,4,5,1,1,4,0,3,3,0,3,5,5,1,6,7,2,0,2,8,1,0,2,45,4,5,0,6,0,0,1,13,0,0,13,0,0,0,8,1,2,2,1,0,4,6,6,2,0,2,0,0,0,1,7,0,3,0,0,0,0,2,7,0,4,2,1,3,5,1,6,0,2,3,1,7,6,1,2,6,4,5,0,4,3,1,1,2,0,1,4,0,1,4,2,1,3,8,3,1,5,0,4,1,5,5,1,4,2,2,10,3,0,1,9,0,1,2,4,3,1,0,5,1,5,3,5,0,3,3,2,2,5,1,0,1,7,3,5,2,0,1,1,0,0,1,16,40,2,4,4,0,3,13,89,0,0,1,2,3,6,4,1,2,9,2,1,1,4,0,0,1,0,2,7,7,1,0,30,1,4,1,1,2,3,4,0,2,0,1,2,3,1,4,2,2,10,2,0,0,5,1,2,0,1,0,4,0,5,1,5,4,1,2,1,8,4,1,1,0,1,0,11,1,0,2,4,2,2,0,2,0,0,0,1,2,1,0,9,0,7,2,0,2,2,0,3,0,0,1,4,1,1,1,4,2,2,1,0,3,3,3,1,7,3,2,3,2,1,2,1,1,0,3,0,4,0,4,7,1,8,0,1,1,0,5,5,0,0,5,4,1,6,3,2,0,6,4,0,6,0,2,4,1,5,1,1,4,1,1,0,1,1,0,3,2,0,1,1,2,5,1,2,0,3,0,0,3,18,63,3,0,3,0,1,11,5,2,0,0,2,9,0,3,1,4,0,3,1,3,1,27,2,8,0,2,2,1,0,1,4,1,0,0,7,3,9,0,1,2,0,0,2,3,7,2,0,0,3,0,0,6,0,0,0,1,5,2,0,2,0,1,0,2,0,1,0,12,3,8,2,4,1,3,8,0,0,2,1,1,11,6,1,0,0,3,2,57,1,0,0,0,0,3,0,1,2,2,1,5,2,1,4,0,0,0,4,13,0,1,3,4,1,3,0,3,1,0,1,10,4,0,1,5,0,0,7,0,0,0,5,0,4,7,0,1,0,0,4,4,0,3,0,1,2,0,1,3,2,1,0,3,1,0,7,10,0,1,5,0,4,11,0,1,0,1,0,1,0,2,1,6,1,0,0,1,8,0,0,0,0,2,3,2,2,3,3,2,0,1,0,2,3,5,3,4,0,0,1,1,0,2,10,2,1,1,6,15,1,4,10,3,1,1,1,8,2,2,5,1,0,0,6,1,2,0,1,1,2,1,5,1,4,0,0,3,2,2,1,2,1,1,2,4,0,1,1,1,0,0,1,1,1,0,1,0,2,2,0,6,0,0,5,1,7,2,0,1,0,2,1,7,3,3,0,6,5,2,2,2,8,0,7,1,3,4,1,2,3,2,0,1,1,2,0,0,3,5,0,0,3,0,2,0,4,3,2,5,2,1,0,0,2,2,5,1,0,0,2,2,0,0,5,0,3,0,2,31,1,0,0,0,1,4,0,2,1,0,1,0,39,3,0,54,2,0,1,2,0,0,0,3,2,4,1,2,0,2,0,1,2,2,0,31,0,4,1,0,1,4,3,1,0,0,1,6,0,0,2,0,3,0,5,0,0,0,0,2,1,6,2,0,2,2,0,0,0,0,10,0,0,0,0,1,1,0,0,0,1,3,2,2,4,0,3,5,1,5,0,5,0,3,1,4,0,1,0,2,0,1,0,0,0,4,1,0,2,0,0,1,9,6,1,2,6,1,0,0,0,4,0,1,0,0,1,2,3,9,10,0,1,0,1,0,7,0,0,11,4,2,1,2,3,0,1,3,0,1,8,3,7,2,2,2,0,2,2,0,3,1,2,2,8,6,0,0,10,1,3,1,1,1,2,3,0,6,1,0,2,1,3,0,7,0,0,3,1,1,1,4,1,5,11,1,0,4,1,3,1,2,1,2,0,1,4,1,1,2,5,2,0,0,0,3,0,3,0,2,0,0,0,0,2,5,0,3,9,9,2,2,3,2,0,1,5,1,1,1,2,0,6,1,2,0,6,1,0,1,1,4,6,1,0,0,0,0,1,0,3,1,6,0,0,0,1,0,0,2,1,0,2,1,3,3,81,0,1,4,0,1,0,0,4,0,2,4,3,0,3,0,0,1,0,1,2,2,0,0,1,1,4,1,1,6,2,0,7,1,2,1,0,0,0,21,1,2,3,2,0,0,0,54,6,0,1,1,0,1,1,7,0,0,5,0,0,0,0,15,4,0,0,0,1,1,1,1,1,7,0,3,0,0,2,1,3,0,1,1,2,0,1,6,4,1,0,1,0,1,2,3,0,0,3,1,0,0,1,6,0,3,0,0,0,1,0,0,1,0,0,2,0,3,2,10,1,2,1,0,2,1,0,0,0,0,0,1,0,0,0,1,3,1,1,13,0,1,0,0,17,2,0,0,2,0,2,0,12,0,1,2,2,1,1,5,1,0,2,6,0,1,0,2,3,0,3,3,0,3,1,2,0,0,0,0,0,0,4,0,1,2,0,0,0,0,1,0,0,0,0,0,1,1,0,2,0,0,1,5,1,0,1,1,0,1,0,0,2,0,0,1,0,6,2,1,3,3,0,2,2,3,0,2,1,3,2,2,2,0,4,3,2,0,0,5,3,1,4,1,1,0,1,2,0,1,0,0,0,0,0,0,0,0,2,1,4,0,2,0,16,0,1,0,12,0,0,1,0,1,3,10,0,4,2,1,1,0,2,0,0,0,1,1,4,0,2,0,1,1,2,1,0,3,0,0,0,1,1,0,2,2,0,1,2,0,22,0,2,3,1,0,0,2,2,1,0,2,2,2,4,1,1,0,8,5,4,3,0,1,0,1,1,2,5,1,6,0,1,6,0,0,2,0,1,0,1,0,3,2,0,0,4,4,1,0,2,0,6,1,5,0,4,12,0,0,0,0,0,5,4,2,0,6,2,3,2,2,0,0,0,0,9,0,0,0,1,0,0,2,3,0,17,2,1,2,0,1,2,4,0,1,0,4,2,0,2,2,8,0,20,0,3,1,0,5,2,2,3,0,0,0,0,0,0,2,0,0,2,2,1,0,0,0,0,0,4,3,2,1,1,0,0,3,0,2,4,1,2,0,1,3,2,8,0,0,3,0,2,1,0,0,0,1,0,0,0,0,0,0,0,5,1,0,0,0,0,1,2,12,0,0,0,5,3,0,6,0,0,0,0,0,1,0,3,1,1,3,0,4,2,0,0,1,5,0,1,0,0,0,0,1,0,11,0,0,12,2,1,4,0,0,0,0,2,0,0,0,0,4,1,3,0,1,0,1,0,1,2,0,0,2,0,2,4,3,0,0,2,0,0,1,1,2,0,1,0,1,2,0,0,0,1,0,0,0,4,3,4,11,1,0,0,0,1,0,1,0,0,0,0,1,0,0,1,2,0,4,1,0,6,0,0,0,0,1,0,0,0,3,0,0,0,0,1,0,1,0,0,4,3,1,0,1,0,0,3,0,0,2,0,3,0,0,2,1,2,0,0,2,0,0,0,0,1,1,0,8,0,2,2,2,2,2,0,1,0,4,0,1,1,1,5,1,3,0,1,0,1,0,0,2,0,2,0,2,1,1,1,0,6,2,2,2,0,1,0,5,0,0,5,4,1,1,4,1,0,0,0,2,0,0,1,0,2,8,4,1,0,0,0,1,0,0,0,1,3,0,2,1,4,0,1,0,0,0,3,0,16,2,2,17,4,11,1,0,0,0,0,0,0,2,1,0,1,3,1,1,1,1,0,0,1,10,0,8,0,0,0,0,0,2,1,0,0,7,2,1,0,0,0,1,0,0,0,0,1,1,0,0,0,3,0,0,0,0,0,3,2,1,0,3,1,0,0,2,4,3,0,0,0,1,0,0,4,1,0,0,9,0,0,2,0,0,1,0,0,3,1,0,1,0,0,0,2,5,5,0,0,1,0,2,0,1,1,0,4,3,0,20,0,0,0,0,1,53,1,0,1,1,0,2,0,0,0,0,0,0,1,1,1,1,0,0,0,0,1,0,3,5,0,0,1,3,2,0,0,6,0,0,7,0,2,1,1,0,0,1,0,1,0,2,1,0,0,2,1,1,0,1,6,1,0,1,0,13,0,0,0,0,1,0,0,1,1,2,3,0,1,0,0,0,0,1,5,2,0,0,2,0,0,0,1,0,0,2,0,10,0,1,0,1,2,2,1,0,0,1,1,2,5,0,0,0,5,2,0,0,6,0,0,0,1,0,0,2,2,0,0,0,0,0,0,0,0,3,0,1,4,1,0,0,4,0,1,5,1,2,0,0,1,2,0,0,3,1,8,0,0,1,0,0,0,1,1,0,0,1,1,0,1,0,0,0,2,0,2,1,0,1,2,2,3,1,0,2,1,0,0,1,0,2,0,0,0,0,0,1,1,0,0,0,0,2,1,0,1,0,1,0,22,0,0,0,0,0,4,1,0,3,0,0,1,2,0,2,4,1,0,0,0,0,0,0,3,0,0,0,0,0,1,0,1,0,0,1,3,0,4,0,1,0,1,0,1,2,5,2,2,2,0,0,1,0,0,2,0,0,0,0,2,3,1,1,0,0,2,3,5,2,1,1,0,2,0,0,0,0,0,2,0,5,1,0,0,0,3,1,3,0,2,0,2,1,4,0,2,2,0,0,0,0,0,0,2,0,2,0,0,0,0,0,1,0,0,1,0,2,1,1,1,0,9,0,3,0,0,0,2,1,0,0,0,1,1,0,0,0,0,0,0,0,2,0,1,3,0,0,0,2,3,0,1,1,0,0,2,0,0,0,1,2,4,16,0,0,0,1,0,4,2,0,0,0,0,1,1,0,2,0,0,0,0,2,2,1,0,0,7,0,2,1,1,0,2,0,0,1,0,0,0,1,0,0,0,1,0,4,0,0,0,4,2,0,2,1,0,0,1,0,1,0,1,0,0,0,0,0,0,0,0,0,0,0,1,2,0,0,2,4,0,0,0,0,3,2,2,0,1,0,1,1,1,0,1,0,2,2,0,1,0,1,1,0,0,4,0,1,0,0,0,0,1,2,0,0,1,0,0,0,3,0,0,0,0,13,0,0,0,0,1,2,2,0,1,3,1,1,3,0,1,0,1,5,0,1,1,0,1,1,1,0,1,2,0,0,2,0,0,0,1,0,1,2,1,0,1,1,0,0,0,0,0,3,0,0,0,0,0,0,2,0,0,0,0,0,2,0,1,0,0,4,0,0,4,0,2,0,1,1,0,1,0,0,1,0,0,0,4,1,0,0,7,1,0,0,3,0,1,0,0,0,3,0,1,1,0,1,0,1,0,0,0,0,0,2,1,5,1,0,0,0,1,0,0,0,13,0,1,0,2,0,2,0,1,0,1,2,0,0,0,0,3,0,3,0,11,0,0,0,2,1,1,4,2,2,1,0,0,0,0,3,0,0,0,0,1,0,0,2,0,1,0,0,121,3,0,0,0,1,0,2,5,1,0,0,0,0,4,3,0,3,0,4,0,2,0,0,3,0,0,1,0,0,0,0,0,0,0,1,0,2,0,1,0,1,0,0,0,0,0,0,0,0,0,0,4,0,0,2,0,0,0,0,1,0,2,0,2,0,1,0,0,0,3,0,18,0,0,6,0,0,1,0,0,0,1,0,0,10,0,0,0,4,2,0,1,0,1,0,0,2,0,23,0,0,0,0,2,1,0,0,0,0,0,0,0,1,0,0,2,0,3,0,2,1,0,2,1,1,4,0,0,14,2,0,0,0,1,0,1,2,0,0,0,0,0,2,11,0,0,1,1,0,0,0,0,1,2,0,2,0,1,0,0,0,3,0,4,1,1,0,0,1,5,2,0,6,2,0,0,0,0,4,0,10,0,0,0,1,0,0,2,1,0,1,0,0,0,4,1,2,0,0,2,3,1,0,0,0,0,0,2,0,0,0,6,4,0,2,5,0,0,2,1,0,3,8,0,0,2,0,0,0,0,0,2,0,0,4,0,0,0,1,3,3,0,0,0,0,0,0,2,0,0,0,0,1,0,0,0,0,0,0,1,0,0,6,0,0,2,0,1,0,1,0,1,0,0,0,0,0,0,0,1,1,0,0,2,0,0,0,1,2,0,0,1,0,0,0,0,0,0,0,0,0,0,0,3,0,0,0,0,1,0,0,1,1,2,1,2,0,0,3,0,3,0,0,1,0,0,0,0,2,0,0,0,0,1,0,6,1,2,0,1,3,0,0,2,0,0,0,1,1,1,0,0,0,0,1,0,2,1,0,0,0,3,0,2,1,2,1,4,2,0,0,1,0,3,1,1,1,0,0,1,2,0,0,0,6,1,0,0,2,0,3,1,1,0,0,0,2,1,0,0,0,0,0,0,3,1,0,2,2,0,2,1,1,0,0,0,1,11,0,0,0,1,0,0,1,1,0,0,0,0,1,0,0,17,0,0,0,3,0,0,0,1,2,2,0,3,0,0,4,0,1,0,1,1,1,6,1,21,0,2,1,0,0,1,0,0,1,2,0,0,0,16,1,1,0,1,0,0,2,0,1,0,0,0,0,2,0,0,2,0,1,0,0,0,2,0,0,2,1,0,0,3,1,6,0,2,4,0,1,0,1,0,0,1,0,0,0,0,1,5,0,7,1,0,1,2,0,1,0,0,2,0,2,1,0,1,0,0,0,0,0,0,0,1,0,2,0,1,0,0,0,2,2,0,1,0,0,2,1,2,1,0,0,0,0,0,3,0,0,0,1,1,0,0,0,0,2,1,0,0,2,1,0,0,0,0,0,0,0,0,1,0,0,0,1,0,0,1,0,1,8,0,1,1,13,0,1,0,0,2,2,1,3,0,0,0,0,0,0,0,25,0,0,0,0,1,1,0,0,0,1,0,0,0,1,0,14,0,0,5,0,1,0,3,1,3,0,1,0,2,0,0,1,1,1,1,1,4,0,0,2,0,5,3,0,0,0,0,0,0,0,1,0,0,0,0,0,1,0,0,1,1,4,0,1,4,0,1,1,0,0,4,2,1,3,0,0,1,0,2,2,0,0,1,4,0,1,1,0,0,0,0,1,1,0,0,0,0,0,0,0,0,0,1,0,1,0,0,0,0,1,0,2,0,0,0,0,0,0,0,0,0,0,0,0,0,1,4,0,0,8,0,0,1,2,0,11,0,1,0,2,3,0,0,1,0,0,0,0,0,1,6,0,0,1,1,1,0,0,1,0,1,0,0,2,2,1,1,3,3,1,0,0,1,1,0,0,1,0,1,1,0,0,3,0,0,6,0,0,0,1,0,0,0,0,0,0,3,0,0,0,0,1,0,0,1,0,1,1,2,0,4,2,0,0,0,2,3,1,2,1,0,0,0,0,0,0,1,0,1,0,1,2,0,0,0,2,3,1,0,1,0,0,2,0,0,2,0,1,1,0,2,0,0,1,0,0,1,0,2,0,0,0,17,0,1,1,0,0,0,1,0,1,0,5,1,0,0,0,0,0,0,0,0,0,1,3,0,1,0,3,0,0,0,1,7,0,10,0,0,0,0,0,0,4,0,1,0,0,0,0,3,4,0,0,0,2,0,0,0,0,0,3,0,3,0,0,0,1,0,3,0,0,0,0,0,0,0,1,0,0,0,0,0,2,0,0,0,0,0,0,0,0,0,0,1,0,0,1,0,0,0,0,0,3,0,0,1,0,0,1,0,0,1,0,1,0,0,0,0,0,0,0,0,3,2,0,1,0,0,0,1,0,0,0,0,0,7,0,0,0,1,6,0,0,0,0,0,0,0,0,0,0,1,0,0,0,0,0,0,1,0,0,0,1,0,0,0,1,0,0,0,4,0,0,0,0,1,0,0,0,0,0,0,0,0,0,0,0,0,0,0,0,2,0,0,0,0,0,0,0,0,0,0,2,0,0,0,0,0,2,0,0,0,0,0,0,0,0,0,1,0,6,0,0,0,0,0,0,0,0,0,0,0,0,0,0,0,0,0,0
K73 Rat,king,1699,782,721,695,527,229,877,370,600,525,300,397,346,130,106,224,338,170,161,147,183,247,168,134,30,152,58,75,111,64,82,136,96,167,119,90,72,100,17,128,113,100,138,103,94,110,121,85,133,81,83,46,87,41,58,55,104,44,56,89,86,31,28,66,47,51,22,40,28,54,51,36,40,26,39,39,44,88,34,48,48,58,29,49,43,44,30,38,52,33,21,34,52,39,35,43,32,28,48,40,41,41,60,28,69,31,51,40,35,28,37,70,3,37,26,15,22,41,31,10,22,24,52,31,15,27,30,24,28,16,28,35,23,25,29,31,4,8,28,18,15,18,51,25,41,37,21,45,22,45,32,29,36,25,26,6,2,19,34,38,15,40,32,25,13,30,16,21,12,23,7,18,30,27,3,16,14,15,39,41,13,22,16,13,13,23,7,18,19,23,19,20,28,24,6,12,5,41,7,10,5,30,28,27,14,8,22,17,21,27,3,16,5,11,9,12,19,5,9,16,5,14,6,11,19,23,12,9,25,25,10,10,14,17,15,3,6,13,10,12,12,6,13,12,11,14,12,20,5,11,28,11,11,5,2,4,7,10,16,6,10,6,14,22,24,15,6,15,19,12,10,3,21,18,20,12,12,11,24,22,10,10,11,17,42,4,11,22,6,7,11,3,20,14,16,9,10,8,1,17,25,0,24,6,18,12,4,5,0,2,7,2,8,17,7,13,5,12,8,2,3,26,7,9,4,7,10,10,10,7,14,9,5,9,31,16,7,2,1,8,6,5,7,4,5,4,10,3,12,3,18,5,18,2,19,2,4,18,9,9,4,2,4,0,6,3,6,4,4,12,7,2,12,9,9,10,5,12,7,8,5,5,5,9,1,0,0,27,7,4,2,10,17,2,15,22,4,14,11,5,6,5,11,4,7,8,6,25,6,2,5,2,23,13,3,5,6,4,6,4,18,1,2,4,8,6,3,6,12,9,5,15,6,6,6,18,8,25,8,12,6,12,2,4,8,3,4,8,6,5,2,4,0,26,7,1,4,41,7,14,20,2,0,1,2,5,6,2,0,2,2,3,4,2,8,5,5,0,0,9,12,2,3,6,3,5,4,2,6,9,11,7,4,5,5,3,2,6,1,4,8,6,12,7,9,1,5,2,2,5,1,4,5,9,5,9,0,7,4,7,4,9,11,4,2,8,6,0,5,5,3,1,10,5,2,0,12,11,2,5,7,0,17,3,2,1,0,2,8,5,2,6,4,0,2,2,1,7,5,1,6,3,2,0,4,13,1,6,2,1,7,7,4,6,3,5,3,3,4,2,3,10,5,1,4,3,3,11,3,6,6,5,5,2,4,5,1,2,2,7,6,24,16,4,4,0,0,3,3,1,5,2,5,5,0,1,3,3,6,0,6,9,2,8,5,13,9,7,9,5,2,6,6,1,4,0,12,0,9,6,1,1,1,2,2,6,12,3,2,4,0,2,4,4,3,1,1,1,4,3,4,3,7,2,2,4,1,7,3,2,1,3,4,2,9,3,1,1,4,2,5,2,4,8,16,4,0,1,4,3,5,1,0,4,6,6,0,0,3,13,5,1,5,5,8,14,1,6,3,1,0,7,26,1,2,13,0,6,2,4,4,3,4,1,5,2,4,1,1,1,2,5,8,0,0,5,3,4,7,2,4,3,0,0,3,0,2,2,7,0,4,16,4,1,1,6,5,1,5,4,1,1,5,1,1,35,1,2,0,4,7,0,5,9,0,2,0,2,0,2,2,4,0,2,1,8,1,4,2,3,10,1,0,3,4,3,0,9,0,2,12,1,0,2,9,5,14,10,2,4,2,1,7,0,1,4,1,0,0,2,2,8,2,1,2,5,0,1,1,9,5,0,12,4,0,3,13,0,0,0,1,1,1,6,15,3,3,0,2,1,6,2,0,0,1,1,0,4,15,5,3,3,9,3,5,0,10,0,10,4,4,2,3,1,0,2,2,4,1,1,3,3,3,3,0,0,2,3,2,0,6,0,0,0,1,5,2,0,1,16,1,1,2,2,3,1,4,3,1,6,4,0,4,0,3,0,2,4,4,3,4,0,3,1,2,3,1,0,5,0,3,1,1,1,0,1,5,3,2,6,3,9,1,4,3,1,2,2,6,2,3,9,5,5,0,2,7,2,2,3,0,8,3,0,1,6,1,4,3,2,2,0,4,1,0,7,0,2,1,0,0,6,2,0,3,2,2,0,5,7,0,0,2,2,1,0,1,3,4,0,3,0,1,0,1,1,0,0,0,2,1,3,1,2,2,2,3,0,2,1,0,1,0,0,3,0,1,1,3,4,1,3,2,0,0,1,2,3,9,1,2,1,4,3,4,5,8,1,0,2,1,1,5,0,0,0,0,1,2,1,0,2,0,2,0,0,1,0,0,0,0,0,3,1,1,0,0,0,2,3,1,0,2,1,1,0,0,6,2,2,8,0,2,2,0,6,2,0,4,1,1,7,7,1,2,3,2,2,6,2,3,2,3,1,0,0,3,0,8,2,1,5,14,3,1,2,1,6,1,0,3,10,3,1,3,5,1,2,0,5,3,2,1,2,0,0,239,0,4,0,6,0,0,1,4,1,1,1,2,6,0,2,3,1,0,3,0,5,0,0,16,3,3,2,1,3,8,16,1,0,0,0,4,1,0,3,0,1,2,0,7,1,0,2,0,9,3,0,0,6,0,0,2,1,3,1,1,3,2,1,0,0,1,0,1,0,0,3,1,1,5,9,5,1,4,4,0,4,1,0,0,1,0,1,1,0,0,5,0,1,0,0,9,0,1,0,0,0,2,2,3,1,0,1,1,1,1,5,3,4,1,0,0,2,0,0,1,3,3,2,0,0,1,1,0,4,3,2,0,5,6,0,5,10,3,2,1,2,8,0,0,0,2,1,3,2,0,3,0,0,1,4,4,1,0,4,1,0,0,1,0,1,0,2,3,0,0,2,3,1,4,4,0,0,3,2,0,2,0,0,0,2,4,1,0,1,0,1,1,3,3,6,6,0,0,5,1,9,1,1,5,0,0,0,5,0,0,3,2,0,1,2,2,0,8,0,6,1,1,9,0,0,3,7,6,0,0,6,0,1,0,0,3,1,7,1,0,1,1,2,3,0,3,2,1,0,0,0,0,0,0,1,0,2,0,5,0,0,2,0,1,5,3,2,65,4,1,0,3,3,2,3,0,1,13,0,1,0,2,3,2,0,0,0,0,3,1,0,3,0,0,0,2,1,0,2,3,2,1,3,2,3,0,5,4,0,0,8,4,1,0,0,2,0,0,2,2,4,1,0,3,0,1,1,0,1,22,0,12,0,2,1,2,1,0,1,0,2,0,4,2,0,3,1,1,0,0,0,0,0,3,0,0,0,0,0,0,4,4,4,0,1,0,0,4,7,0,0,0,0,1,5,1,7,4,5,0,6,0,1,0,0,2,1,0,1,1,3,7,0,2,1,5,2,2,0,3,0,2,0,5,0,3,7,1,1,1,0,3,1,2,0,3,0,2,2,0,0,0,2,0,9,0,0,3,1,2,1,2,4,1,4,1,1,1,0,2,2,0,0,0,1,4,0,5,1,3,0,6,0,1,0,0,4,0,2,2,0,1,1,1,0,0,3,5,0,0,0,0,4,2,4,4,0,1,0,0,1,1,2,0,0,0,0,0,0,1,0,0,0,0,0,5,1,0,0,0,3,4,0,1,0,0,0,0,1,0,1,1,0,0,2,2,0,1,0,4,0,14,0,0,5,1,5,0,0,0,1,40,2,2,0,1,1,0,0,0,2,0,3,2,0,4,0,0,0,0,0,4,2,2,0,2,0,0,0,1,0,0,0,3,0,7,5,0,2,0,2,0,0,0,2,1,4,3,0,5,14,1,0,0,2,5,0,0,3,2,1,0,1,2,2,0,1,0,1,0,1,4,1,0,0,0,3,0,7,0,0,1,1,1,0,0,1,0,0,0,1,5,0,0,0,0,2,2,0,4,0,0,0,2,0,0,2,3,3,0,0,0,1,0,0,0,1,1,0,1,0,2,7,1,0,13,0,0,1,2,0,0,1,1,0,2,0,0,5,0,0,1,1,2,1,0,0,4,1,0,2,0,0,0,1,0,1,0,6,1,0,0,0,1,0,0,0,0,3,0,2,2,0,1,0,0,4,3,0,0,3,1,0,5,0,0,1,2,1,0,0,0,4,0,1,0,0,0,2,2,0,3,0,0,1,0,0,0,0,1,3,1,5,1,2,0,1,0,1,1,0,4,1,0,1,1,4,0,1,2,0,0,2,0,1,2,0,1,0,0,4,2,1,0,0,0,1,0,0,1,0,0,0,0,0,0,1,0,0,0,0,0,1,2,1,0,2,0,2,0,2,1,4,0,3,0,0,0,0,0,4,0,2,1,0,1,0,3,0,0,2,0,0,0,0,0,0,0,2,0,0,0,4,5,1,0,5,5,0,3,1,0,0,0,0,3,0,0,6,0,0,0,0,0,0,3,2,0,2,0,1,1,0,0,1,0,0,0,3,0,0,1,0,3,0,0,3,1,0,3,0,0,0,0,0,0,4,6,1,0,0,0,1,2,1,0,0,2,1,1,0,3,3,4,3,1,0,2,0,3,3,2,0,2,3,0,0,0,0,1,1,4,1,0,0,0,1,0,0,3,0,1,0,0,0,0,3,2,1,0,0,0,0,0,3,0,4,0,3,0,0,4,2,0,2,3,1,0,0,0,0,1,0,3,0,0,1,0,1,0,0,0,0,0,0,0,0,0,0,0,0,3,0,2,4,2,0,0,1,4,6,1,1,1,0,0,0,1,1,1,2,0,1,0,7,0,0,0,0,0,0,2,0,0,0,0,1,0,0,8,3,0,10,0,0,0,1,0,0,0,1,2,0,7,0,0,0,0,1,2,3,1,0,0,1,1,0,2,0,0,0,1,3,0,0,0,0,1,0,0,0,0,1,0,0,0,1,0,0,0,0,0,3,1,1,1,0,0,4,0,2,0,0,0,0,0,4,0,1,0,0,0,0,1,3,2,1,0,0,1,0,0,0,1,0,0,2,3,1,0,1,1,0,0,0,0,0,2,0,3,0,0,0,0,0,0,0,0,1,0,0,0,1,4,2,0,1,0,3,0,2,0,0,2,0,0,0,0,0,0,0,0,0,1,0,2,1,1,0,0,0,0,0,0,1,0,1,0,1,0,0,1,0,0,6,0,0,1,0,1,2,1,0,0,0,2,0,0,0,0,5,1,2,1,0,1,0,0,0,1,0,3,0,1,0,0,1,0,1,0,1,0,0,2,0,1,0,2,9,0,1,2,0,0,0,1,0,12,0,0,1,1,0,0,6,0,1,0,0,0,0,0,1,0,1,1,1,0,3,0,0,0,0,0,1,1,0,0,0,0,5,1,1,1,2,1,0,3,0,4,0,0,0,0,0,0,4,1,0,3,1,2,0,0,0,5,0,0,0,1,1,0,0,0,3,0,0,0,0,0,0,2,0,0,0,1,1,0,1,1,0,0,0,0,0,0,0,4,2,0,2,1,0,0,5,0,2,0,1,0,0,2,0,0,0,2,3,0,0,2,0,0,1,2,0,0,0,1,0,0,0,0,1,0,1,0,2,0,0,0,0,0,0,0,0,0,0,0,0,2,0,2,0,0,0,0,0,0,0,0,0,1,1,1,0,0,0,1,0,2,1,3,0,3,0,0,0,1,0,0,3,1,0,0,0,0,0,1,2,5,0,0,1,1,0,1,0,1,3,0,0,4,0,1,0,0,0,0,0,0,0,0,3,1,1,1,1,1,1,2,1,0,3,0,0,0,0,0,1,0,0,0,1,4,0,2,3,0,0,4,0,0,7,0,1,1,0,0,3,0,0,0,0,0,0,1,0,0,1,1,0,0,0,5,0,0,0,0,0,0,0,1,0,1,2,2,0,0,0,0,4,43,0,0,2,11,0,0,0,0,0,4,1,0,26,0,2,0,0,0,0,0,0,0,0,2,3,0,0,0,3,0,3,0,0,0,0,0,0,0,0,1,0,1,0,0,1,1,0,2,1,1,2,0,1,0,0,0,0,0,0,1,0,0,0,0,1,0,1,0,0,2,2,1,0,1,2,0,3,0,0,0,0,0,0,0,1,0,0,2,1,0,3,0,0,2,0,0,0,1,0,0,0,0,0,0,4,0,0,0,0,0,0,0,4,0,1,0,3,1,1,2,0,0,0,0,1,7,0,1,0,1,0,0,0,3,1,0,0,0,0,1,0,1,0,0,0,2,0,0,1,0,2,1,0,0,0,0,0,0,0,0,1,0,0,1,1,2,0,0,0,2,0,0,0,1,0,0,1,0,0,1,1,4,0,0,0,1,0,0,1,0,0,1,0,0,0,0,0,1,1,0,0,0,0,0,1,0,0,0,0,0,2,1,0,1,0,0,0,0,0,1,0,0,2,2,0,0,0,0,0,3,1,0,5,2,0,1,0,0,0,5,0,1,3,0,0,0,0,0,0,1,1,0,1,0,0,3,1,0,0,0,0,0,1,0,1,0,0,0,1,0,0,0,0,0,0,0,0,2,3,0,1,1,0,0,0,0,2,0,3,2,0,0,3,0,0,0,0,0,0,0,0,1,0,0,0,0,0,1,1,0,0,0,0,1,3,0,1,0,2,0,0,0,0,2,0,3,2,0,0,0,0,0,0,1,0,1,0,1,0,0,0,0,0,1,0,0,0,2,0,0,0,6,0,0,0,0,0,0,0,1,0,1,1,0,0,0,0,0,0,2,1,0,1,0,0,1,1,0,2,1,0,0,0,0,0,0,0,4,0,1,0,0,0,0,2,1,0,0,0,0,1,1,0,1,0,0,0,0,1,3,0,0,1,0,0,0,0,0,0,1,2,0,0,0,7,0,1,0,0,1,3,0,0,0,3,4,1,0,0,0,0,0,0,1,1,4,0,1,0,2,0,3,1,2,10,0,0,0,0,0,0,0,0,0,0,0,1,0,0,2,0,2,0,0,0,0,0,0,0,1,0,0,0,0,1,0,0,0,1,0,0,2,2,0,1,0,0,0,2,0,0,0,0,1,1,1,0,0,2,0,0,0,1,0,1,0,3,1,0,0,0,0,1,0,0,0,0,1,0,1,0,0,0,2,1,2,0,1,0,0,0,0,0,6,1,1,0,0,1,3,0,0,0,4,0,1,1,1,0,0,0,0,0,3,0,2,1,0,0,1,0,1,2,1,1,1,0,0,0,0,0,0,0,0,0,1,0,1,0,1,0,0,1,0,1,0,0,1,3,2,0,0,0,0,0,0,1,0,0,0,0,2,0,1,2,0,0,1,0,0,0,0,0,1,0,3,0,0,0,4,2,0,0,0,0,0,1,2,1,0,0,0,1,0,1,0,2,0,0,0,0,0,2,0,2,0,0,1,1,0,1,0,1,1,0,1,0,1,1,0,0,0,1,4,0,0,1,0,1,1,1,1,2,0,0,0,0,0,0,0,0,0,0,0,0,0,0,0,1,0,0,0,0,4,0,0,0,0,0,1,0,0,0,0,0,0,0,1,0,0,0,1,1,1,1,1,0,0,7,1,0,0,0,0,1,1,0,0,0,2,0,1,0,0,1,0,0,0,5,0,0,0,0,0,0,2,0,1,0,0,0,0,0,1,1,1,0,0,1,0,1,0,0,0,0,0,0,0,1,0,0,0,0,1,0,1,1,0,0,0,5,0,0,0,0,0,0,2,0,0,4,0,0,0,0,1,0,1,0,0,1,2,0,0,0,2,1,0,0,0,1,0,0,0,0,0,1,2,0,0,1,0,0,0,1,0,1,0,0,0,0,0,0,0,0,6,0,1,2,0,0,1,0,0,0,0,2,1,0,0,0,0,0,1,0,5,0,2,0,0,6,2,1,0,0,0,3,0,0,0,0,1,0,0,0,0,0,0,0,0,0,0,0,0,0,0,0,0,0,3,1,0,0,0,0,1,0,1,0,0,2,1,0,0,0,0,1,0,0,0,0,0,0,0,0,2,0,1,0,1,0,12,0,0,0,1,0,0,0,0,0,2,1,1,3,0,0,0,1,0,3,0,0,0,0,1,0,0,0,1,1,1,0,0,0,1,0,0,0,0,1,3,0,3,0,0,0,0,0,0,0,0,2,0,0,0,1,1,0,0,0,0,0,2,0,0,0,1,0,0,2,0,0,0,0,0,0,0,0,0,1,0,1,0,4,1,1,0,0,3,0,2,0,0,0,0,0,2,0,0,0,1,0,0,2,0,0,2,1,0,0,0,0,0,0,0,2,0,1,0,0,1,0,0,0,0,0,1,1,0,0,1,2,2,0,0,0,1,0,1,0,1,0,1,1,0,0,0,2,1,1,0,0,0,0,0,0,1,0,0,0,1,0,1,0,0,0,0,0,0,0,3,0,2,0,0,1,2,0,0,0,1,0,1,0,0,0,0,0,0,0,1,80,0,0,0,2,0,0,0,0,0,0,0,0,0,0,0,0,0,0,3,0,0,2,0,0,0,0,0,0,0,2,3,0,0,0,1,0,0,0,0,0,0,0,0,0,1,1,0,0,0,0,3,0,0,0,0,0,2,0,0,0,0,0,0,0,0,0,0,0,0,0,0,0,2,0,1,0,1,0,0,0,0,0,4,2,0,0,0,0,0,2,0,1,0,0,0,0,0,0,0,0,0,0,3,1,0,1,0,1,0,0,2,0,0,0,1,0,0,0,0,1,0,0,1,0,0,0,5,1,0,0,2,0,0,0,0,0,0,0,0,0,0,0,0,0,0,0,1,0,0,0,0,0,0,0,0,0,0,0,0,0,0,0,3,0,0,2,1,0,0,0,0,0,0,0,2,0,0,0,0,0,1,1,0,0,0,0,0,0,1,0,0,0,0,0,0,0,0,0,0,0,0,0,0,2,0,1,1,0,0,0,0,0,0,1,0,1,0,0,1,0,0,0,0,0,1,0,0,0,0,1,0,0,0,0,1,0,0,0,0,0,0,0,11,0,5,0,0,0,0,1,2,0,0,1,0,0,0,1,0,0,0,2,0,0,0,0,0,4,0,0,0,1,1,0,1,1,0,0,0,0,5,2,0,0,0,0,0,0,0,0,0,0,1,0,0,0,0,0,0,0,0,2,0,0,1,0,0,0,1,0,0,2,0,0,1,0,0,0,0,1,0,0,3,0,0,0,0,0,0,0,0,0,0,1,0,0,0,0,0,0,0,4,1,0,0,0,1,0,0,0,7,0,0,0,0,2,0,0,0,0,0,0,0,0,0,0,1,2,4,0,1,0,0,0,1,0,0,0,0,0,0,0,0,0,0,0,0,1,0,0,0,0,4,0,0,0,0,0,0,0,0,0,0,0,1,0,0,0,0,0,0,1,0,0,1,2,0,0,0,0,0,0,1,0,0,2,1,1,0,0,1,0,0,0,0,0,0,0,0,1,2,0,0,3,0,0,0,0,0,0,0,0,0,0,2,0,0,0,0,0,0,0,0,1,0,0,0,1,0,0,16,0,0,0,2,3,1,1,0,0,1,0,0,1,0,0,1,1,19,0,1,0,0,0,0,0,0,0,0,1,3,0,0,0,0,1,0,1,0,0,1,1,0,1,0,1,1,0,0,1,2,0,0,0,0,0,0,1,0,0,0,1,0,0,0,1,0,0,0,1,0,0,0,0,0,0,1,0,0,0,0,0,0,0,0,0,0,1,1,0,0,0,0,1,2,0,0,0,0,1,0,0,0,0,0,1,0,0,1,0,0,0,0,2,0,0,0,9,5,0,0,0,0,0,1,0,0,0,0,0,0,0,0,1,0,0,0,0,3,0,0,0,2,0,0,0,1,2,0,0,1,0,0,0,1,0,1,0,1,0,0,0,0,0,0,0,2,0,0,0,0,0,2,0,0,0,0,0,0,0,0,0,1,0,1,0,0,7,1,0,0,0,0,1,0,0,1,0,0,0,0,0,1,0,0,0,0,0,1,0,2,1,1,1,0,1,0,1,2,0,0,1,0,0,0,1,0,0,0,0,0,0,0,0,0,2,0,0,0,1,0,1,0,0,0,0,0,3,0,1,1,0,0,0,0,2,0,0,0,0,1,0,0,2,0,0,0,0,0,0,0,0,0,0,0,0,0,0,0,0,0,0,2,0,0,0,0,0,0,1,0,0,0,0,0,0,3,0,0,0,0,1,0,0,0,0,0,0,0,0,0,0,2,0,1,0,0,0,2,0,0,0,0,0,0,0,0,0,1,8,0,0,0,0,0,0,1,3,0,0,0,0,0,0,0,1,0,0,0,1,0,0,0,0,0,0,0,0,1,0,0,0,0,0,0,0,0,0,0,0,0,0,0,0,0,0,4,0,1,1,0,1,0,1,0,0,0,0,0,1,0,0,3,0,0,0,0,1,0,0,1,0,0,0,1,1,0,0,4,0,1,0,1,0,2,0,0,1,0,0,0,0,3,1,0,1,0,0,0,0,0,0,0,4,1,0,0,0,0,0,0,0,0,0,0,0,0,0,0,0,0,0,0,0,1,0,0,1,1,0,0,0,5,0,0,3,3,1,0,1,1,0,0,0,0,1,1,0,0,0,1,0,0,0,1,0,0,0,2,1,0,0,0,1,1,0,0,0,0,0,0,0,0,0,0,0,0,1,0,0,1,0,0,0,0,1,0,0,0,0,0,2,0,0,0,0,0,0,0,0,0,0,0,0,0,0,1,0,0,1,0,0,0,1,1,0,0,0,0,3,0,0,0,0,1,0,1,0,0,0,0,0,0,0,0,0,0,0,0,1,1,0,0,0,0,0,0,0,0,0,0,0,0,0,0,0,0,2,0,0,0,0,0,1,0,0,0,1,0,0,0,0,0,0,0,0,0,2,0,0,0,0,1,0,0,0,2,0,0,0,0,0,0,0,0,0,0,0,0,0,0,0,0,0,0,0,0,0,0,0,0,0,0,1,1,1,0,0,0,0,0,0,0,0,0,0,0,0,0,0,0,1,0,0,0,0,0,1,0,0,0,0,0,0,0,0,0,0,0,1,3,0,0,0,0,1,0,0,0,0,0,0,0,1,0,0,0,0,0,0,0,0,0,0,0,0,0,0,0,0,0,0,0,0,0,0,0,0,0,0,0,0,0,0,0,0,0,0,0,0,0,0,0,0,0,0,0,0,0,0,0,0,0,0,0,0,0,0,0,0,0,0,0,0,0,0,3,0
"1970 O'Brien, Tim, Going After Cacciato",high,6121,3324,1743,2287,1490,657,2283,1160,1525,1731,651,1226,576,240,181,579,341,443,498,664,465,555,287,413,77,500,108,736,388,343,237,418,382,275,236,136,488,301,242,239,163,301,400,461,186,208,321,271,360,631,166,296,160,220,236,204,100,147,162,216,255,105,122,215,78,196,177,149,105,224,81,73,213,130,140,96,110,58,95,55,131,148,224,124,166,114,155,79,122,59,112,91,83,217,75,66,45,65,91,66,83,67,50,43,75,63,146,134,48,79,47,175,50,132,124,29,124,49,129,50,31,70,95,178,29,67,88,94,77,97,70,101,130,92,82,38,32,89,51,22,13,57,88,41,36,44,69,79,49,104,72,78,69,58,73,42,27,111,32,119,55,78,80,63,76,45,54,44,138,51,5,21,31,16,12,48,27,61,42,62,63,29,120,66,42,41,12,45,26,16,18,25,24,51,62,62,61,21,15,28,69,70,40,68,30,1,71,49,71,70,22,40,109,41,74,44,49,56,30,90,72,22,20,39,17,47,17,54,16,31,44,49,47,46,48,9,36,54,70,50,41,3,25,35,67,106,13,73,16,58,49,53,107,34,36,31,43,32,20,16,52,9,29,25,17,24,20,33,67,51,49,21,24,59,29,5,48,19,16,45,31,30,34,24,26,24,20,20,27,29,27,32,3,33,30,25,82,9,6,21,63,49,36,14,74,22,8,53,72,7,12,6,52,32,26,61,21,63,29,29,51,3,137,109,0,24,23,80,23,42,30,26,37,54,89,24,70,9,18,52,11,44,16,4,22,11,65,21,48,40,8,79,41,28,80,9,13,21,20,7,36,42,22,34,24,107,27,23,11,45,42,44,24,8,27,26,21,4,62,11,20,30,19,47,27,17,0,14,12,24,15,43,29,19,20,15,36,11,23,26,10,11,43,10,14,7,24,38,15,25,32,21,60,15,47,17,2,20,27,24,23,3,3,9,53,24,4,12,17,2,7,11,10,61,5,45,26,16,0,33,38,23,15,32,26,17,16,24,7,29,20,23,19,17,28,26,14,5,30,36,54,3,0,34,2,9,22,62,5,4,6,42,18,13,16,12,6,17,0,19,11,48,24,26,6,30,25,16,33,17,36,14,40,17,9,12,27,16,189,10,18,5,4,30,21,5,22,9,14,6,22,21,9,47,4,49,0,19,31,9,14,22,25,17,41,5,12,19,25,21,0,51,20,5,23,0,19,21,20,18,24,3,1,5,12,9,0,0,25,49,54,10,11,103,21,15,12,29,14,26,10,14,6,4,13,17,31,37,8,14,8,12,25,20,44,7,13,4,8,37,10,5,12,19,17,15,19,12,17,93,7,24,30,11,43,4,19,12,4,6,12,28,13,9,7,0,0,21,18,6,82,18,6,10,6,9,38,17,16,17,4,5,14,16,13,30,3,28,27,8,13,3,23,2,15,0,29,17,33,11,42,6,18,11,10,3,11,11,7,17,0,27,21,13,41,54,7,17,15,16,13,7,7,11,3,9,31,8,19,32,5,17,8,15,2,14,8,19,9,1,19,4,16,26,1,7,0,14,19,13,15,2,13,12,1,9,16,62,15,13,13,12,33,7,3,9,1,5,1,12,2,9,61,17,33,28,16,48,10,9,16,4,16,65,56,17,5,2,16,17,11,10,61,26,0,22,18,7,16,24,26,5,1,3,0,0,6,14,0,13,5,9,26,6,2,19,3,2,2,2,19,16,26,21,15,12,15,6,34,8,11,5,18,10,0,29,15,33,10,1,26,14,8,9,41,6,51,8,10,8,11,14,432,18,27,3,0,10,59,4,6,3,56,3,11,18,0,9,3,3,53,21,16,22,25,11,8,0,19,11,7,18,15,4,22,10,13,21,7,12,5,43,8,5,31,15,18,11,0,3,23,6,29,13,18,30,4,0,18,9,22,21,14,17,8,25,1,0,1,7,20,12,3,7,43,28,1,0,7,17,10,8,13,6,0,1,12,10,16,7,9,19,26,11,6,3,9,5,33,7,4,11,4,13,13,18,4,189,21,16,4,14,26,5,4,14,8,11,6,23,11,0,9,0,7,13,11,10,1,11,11,10,4,4,11,4,21,0,1,3,8,41,7,0,17,4,12,13,4,6,11,7,3,0,7,15,4,12,17,13,21,9,9,3,9,9,6,23,5,3,0,9,2,1,1,4,6,26,2,11,2,1,9,4,1,11,22,0,6,2,0,2,17,2,1,16,12,7,6,3,29,4,13,10,2,5,108,4,16,0,9,0,7,309,35,42,0,0,1,23,23,6,1,17,2,6,1,0,4,2,4,11,0,0,0,9,10,2,31,5,1,1,13,23,3,1,11,3,5,3,1,8,5,14,13,14,7,10,1,1,3,12,6,2,13,0,3,8,4,1,2,3,0,1,4,1,12,2,0,0,0,0,7,3,4,9,5,0,8,21,2,11,8,18,8,15,2,6,7,1,1,0,3,23,13,7,9,27,31,12,13,10,10,5,5,6,5,10,18,7,6,27,29,5,0,0,13,24,7,28,10,23,2,7,12,5,11,11,2,3,7,1,13,5,3,13,14,3,11,10,8,1,6,19,19,20,3,1,0,3,4,1,6,4,44,10,15,22,2,4,15,2,9,4,0,3,3,0,0,1,0,7,9,23,3,7,7,43,12,0,12,6,30,6,7,2,0,8,13,0,7,5,0,13,3,17,12,13,0,5,21,0,13,9,12,6,2,8,5,12,0,11,2,11,24,0,0,15,4,1,5,1,5,8,17,9,3,24,2,12,10,2,2,8,0,0,1,18,32,1,9,20,16,0,19,3,428,1,10,2,8,1,14,4,4,7,19,2,378,20,19,0,17,6,0,27,19,1,12,10,2,3,2,10,0,9,6,9,0,2,2,20,2,3,5,3,9,3,1,19,0,3,3,8,7,3,1,17,2,5,6,4,4,1,6,4,1,5,15,6,13,5,13,2,4,3,13,6,37,4,3,13,4,2,3,11,16,16,4,2,0,6,11,7,6,27,2,0,3,6,10,11,3,0,7,5,10,29,10,9,15,4,2,1,43,12,2,55,8,2,5,9,6,0,8,4,4,5,4,4,1,6,3,0,5,0,0,3,0,5,67,0,3,2,3,1,44,0,2,11,1,9,2,33,3,1,7,0,2,3,0,0,0,4,0,3,13,0,5,0,1,8,8,16,0,3,38,3,3,11,28,0,6,1,5,12,2,1,3,2,18,6,0,0,2,8,2,34,12,1,8,1,1,4,3,4,1,4,7,1,11,5,0,6,9,0,11,1,14,5,1,10,13,0,6,6,13,0,2,11,4,0,6,8,0,44,5,2,9,15,9,6,2,12,0,2,5,8,1,36,4,2,1,3,11,1,0,0,5,16,5,0,0,0,0,14,0,6,10,7,4,2,30,0,12,3,11,0,1,0,30,12,14,3,3,1,4,2,3,6,2,15,0,2,7,0,5,0,9,6,2,7,3,1,2,2,11,0,17,11,2,7,3,4,3,9,15,8,11,7,0,1,9,1,2,7,22,1,5,1,28,4,2,0,2,1,4,1,1,4,4,20,13,3,3,3,3,3,1,7,0,7,10,0,8,11,8,0,2,0,0,13,0,5,28,13,0,0,7,7,1,16,4,18,8,4,0,16,0,5,1,1,4,0,6,1,2,10,2,0,2,0,2,0,15,1,7,3,6,0,5,1,11,10,0,4,0,1,11,2,0,9,7,15,20,3,4,0,12,1,2,5,3,7,2,6,2,0,3,6,0,1,4,2,0,3,1,4,0,9,4,1,4,2,2,1,3,16,9,17,0,0,6,2,1,1,3,20,13,1,7,4,9,1,15,5,3,0,11,0,4,3,1,2,8,15,0,1,0,1,10,7,4,5,9,2,1,0,7,1,6,5,17,1,2,11,0,10,12,3,3,7,8,0,0,3,10,4,4,3,2,1,27,6,6,4,0,11,3,16,2,2,6,7,0,3,1,5,4,0,2,9,21,0,0,0,3,5,2,1,4,1,0,7,3,11,8,3,2,6,17,6,0,5,2,2,7,7,1,2,6,1,0,4,14,5,1,4,0,2,2,2,7,0,9,12,7,0,3,4,9,2,0,0,13,4,1,2,0,0,0,13,3,1,52,8,5,2,0,3,1,9,0,1,2,1,3,6,1,0,6,5,1,4,5,0,7,2,1,3,4,2,12,0,0,2,3,15,0,3,74,6,0,10,4,9,0,2,4,2,0,5,5,0,2,6,1,0,5,0,4,7,324,48,15,0,6,35,2,7,0,5,4,11,0,6,3,3,0,9,0,0,4,0,9,1,13,8,6,5,3,0,0,4,7,9,4,0,11,6,8,5,0,6,4,0,2,9,0,0,0,0,0,4,12,5,0,0,3,0,9,2,1,1,27,31,0,2,1,2,1,3,2,3,5,1,1,0,1,3,8,10,0,0,4,2,1,7,0,4,0,6,5,6,1,4,2,1,3,3,24,12,0,0,1,1,1,0,4,0,1,0,3,9,0,2,3,4,0,3,0,4,3,1,9,14,1,3,1,4,7,1,2,3,3,0,6,7,0,0,3,12,12,4,0,0,18,10,7,5,0,1,19,1,4,3,5,0,2,4,41,2,0,3,1,2,10,24,1,21,3,1,1,14,1,14,39,11,5,1,0,0,14,1,0,1,14,2,3,3,2,2,1,3,5,3,0,0,0,4,9,5,2,0,5,2,1,3,4,0,0,0,3,12,3,1,0,7,2,10,8,1,3,1,3,4,2,3,0,0,3,0,7,3,0,0,4,5,5,5,3,3,6,1,0,2,2,4,3,0,6,9,10,6,2,2,0,5,0,2,196,3,0,0,6,0,3,1,2,6,0,2,0,0,9,0,0,3,2,1,4,3,10,0,3,0,0,2,1,10,5,0,1,2,4,2,0,2,4,3,1,8,10,2,3,4,4,1,5,2,0,1,1,1,7,3,0,0,1,5,6,5,3,2,1,0,0,1,4,0,1,0,3,7,1,2,1,1,5,0,0,0,3,0,6,1,0,0,10,0,2,3,9,13,0,1,6,1,4,0,4,9,0,7,4,2,2,4,1,2,0,1,5,20,0,5,3,2,0,2,3,0,5,6,0,3,0,3,0,8,0,1,2,4,9,8,1,0,4,3,1,2,1,6,2,1,0,7,3,0,16,1,2,0,5,5,0,1,6,12,1,5,2,15,4,7,3,1,7,5,4,2,0,9,4,3,10,9,4,5,2,5,5,2,0,1,0,2,1,2,0,2,5,2,3,0,2,3,0,0,3,13,0,8,1,10,0,2,4,1,0,3,3,0,2,3,2,3,10,18,8,1,0,0,0,0,20,6,4,1,0,6,10,0,24,0,4,0,2,2,2,5,1,4,3,1,3,1,7,3,6,1,1,0,0,7,3,0,1,1,7,6,1,4,10,9,1,2,0,9,15,2,7,0,1,0,0,4,5,0,2,1,0,1,2,9,2,0,1,1,0,8,4,0,1,0,5,0,0,0,3,4,6,7,0,1,11,0,2,1,4,10,12,0,0,2,0,0,0,0,0,1,6,1,2,1,0,3,2,7,6,2,0,4,0,3,6,0,4,7,2,0,0,3,7,2,3,3,5,1,1,9,9,4,5,1,0,0,5,0,10,2,0,0,0,0,1,18,1,2,15,6,4,1,0,1,0,0,6,7,6,0,2,5,1,1,1,9,11,0,1,0,4,2,0,1,1,0,3,1,0,2,0,34,1,9,11,6,0,0,6,5,1,15,1,2,4,32,6,0,4,0,0,2,0,0,4,4,0,1,2,6,4,3,3,0,13,1,0,0,3,2,3,0,2,1,2,1,0,2,4,0,5,4,1,5,3,0,2,13,2,0,9,0,3,2,11,62,0,0,3,2,5,2,0,4,1,1,1,27,0,0,0,4,4,3,0,4,0,0,0,39,3,0,2,0,0,3,0,0,0,4,1,0,5,3,0,6,0,0,0,3,5,2,9,10,2,3,1,0,1,2,1,1,10,2,6,0,1,0,1,10,5,19,0,4,0,6,2,1,0,0,1,2,6,0,0,5,0,1,4,0,7,2,4,2,0,0,1,0,2,2,21,0,5,4,0,1,0,1,1,0,2,4,0,1,2,0,2,6,2,0,4,8,12,0,3,1,1,1,6,11,0,0,0,0,0,1,3,5,0,0,0,1,4,2,1,0,0,2,0,10,1,2,46,2,0,5,1,1,4,18,0,2,2,0,5,1,0,3,4,1,10,4,0,2,0,1,2,2,4,0,0,6,1,1,1,2,3,2,2,4,25,1,0,0,5,9,4,1,0,10,1,20,0,0,1,0,3,8,7,5,12,2,5,0,1,2,1,3,1,4,4,0,1,0,3,8,0,0,1,6,4,1,0,0,2,4,5,1,0,0,1,0,4,6,1,1,1,0,0,7,7,0,0,0,0,8,1,2,4,8,4,4,11,0,1,0,1,0,3,0,2,3,0,18,2,6,1,0,8,3,10,8,2,1,1,1,7,4,1,5,0,0,0,10,207,0,0,5,1,2,6,1,0,0,1,2,4,1,0,0,0,4,0,0,0,0,2,0,0,2,0,2,0,3,0,0,2,8,0,7,0,0,2,4,1,0,1,0,1,4,0,0,0,6,0,4,0,0,6,0,0,0,0,4,0,8,1,2,0,1,0,2,1,9,3,2,0,2,0,0,3,0,0,5,2,2,1,9,0,0,1,12,0,2,4,1,0,2,6,0,0,0,3,2,22,0,0,7,13,0,1,4,1,26,0,2,1,0,0,5,0,3,20,0,1,0,0,8,0,0,0,16,2,0,23,3,4,2,5,3,3,11,8,1,2,3,0,0,0,9,1,12,0,2,2,0,1,2,2,0,0,0,2,0,14,2,1,2,5,0,2,2,2,2,2,6,1,0,0,5,7,0,2,0,0,0,1,0,4,0,4,9,1,3,2,1,0,1,2,1,3,2,3,8,0,1,0,4,0,1,0,0,0,1,0,0,4,1,1,4,4,1,0,53,14,0,1,4,0,5,0,0,1,3,0,2,0,0,7,2,0,5,0,7,1,0,1,5,0,1,18,3,0,1,0,0,1,3,0,3,0,2,5,14,4,7,2,0,0,8,0,0,19,13,3,1,1,4,0,0,1,1,0,0,1,0,1,1,6,3,0,5,4,1,0,1,2,2,8,0,0,4,0,0,0,7,0,8,3,0,0,0,6,4,2,0,2,2,5,3,1,0,4,4,8,2,2,3,3,0,5,1,1,2,1,6,2,0,3,2,14,2,3,3,1,0,1,2,0,0,0,0,6,16,3,4,11,12,2,0,1,0,3,0,0,0,0,2,0,1,0,0,2,1,0,0,9,2,6,3,17,0,0,6,9,2,2,2,0,0,3,1,2,1,0,1,0,0,0,0,1,4,6,1,1,2,0,3,0,0,1,0,14,2,1,3,0,0,2,2,0,0,1,2,0,1,2,0,1,1,2,0,0,2,1,0,2,1,2,0,1,0,0,1,0,0,3,2,2,1,11,2,0,1,7,10,1,2,1,6,5,8,6,1,2,3,0,1,0,1,3,4,2,1,0,4,0,0,1,3,1,0,0,0,0,1,0,6,2,1,2,2,2,5,17,1,0,2,0,0,0,1,5,0,2,0,0,0,3,0,4,0,5,1,5,6,4,10,0,0,0,0,0,0,0,0,6,0,10,1,0,6,2,3,7,1,3,1,0,0,4,0,0,0,2,1,1,0,0,0,0,0,1,1,0,0,0,0,0,1,0,0,1,5,1,2,0,4,0,2,1,2,3,19,4,1,0,3,0,3,2,0,5,0,0,5,8,4,5,2,3,0,1,3,0,1,0,0,2,0,0,0,0,1,0,0,2,0,4,7,2,0,6,6,14,0,10,0,4,4,4,1,0,5,4,0,5,1,3,3,0,0,1,2,2,1,2,1,0,3,0,0,1,4,0,0,1,0,6,0,1,2,1,9,5,0,5,7,1,2,1,1,2,3,2,1,0,0,1,1,13,0,4,0,1,0,0,0,1,2,5,0,0,1,18,0,2,0,0,1,8,4,0,1,0,3,3,1,0,0,0,0,0,4,0,1,3,4,0,2,0,1,1,1,0,0,1,0,1,2,3,1,0,0,3,0,1,10,0,4,13,2,0,0,0,0,1,3,0,24,2,1,0,4,3,2,3,2,0,0,6,0,3,2,1,0,1,3,2,2,0,4,0,1,0,0,1,2,2,3,7,0,1,0,2,2,0,6,4,1,4,0,3,0,2,6,16,1,1,6,0,0,0,1,0,0,1,1,4,1,1,0,2,1,1,0,0,0,1,0,0,1,2,4,8,1,3,1,2,2,0,5,0,0,4,0,10,0,12,1,2,1,0,5,4,7,0,3,13,0,1,6,1,0,0,0,0,0,0,2,1,6,5,0,5,4,0,0,1,5,0,0,0,4,1,0,7,2,0,0,1,0,4,0,2,0,1,1,0,0,1,6,3,1,0,3,0,0,2,2,1,2,0,43,0,3,1,0,1,0,2,0,1,1,0,2,0,2,5,0,4,2,2,0,1,0,0,4,2,1,1,4,0,0,0,0,1,1,0,5,7,3,2,2,2,0,3,2,2,0,1,3,2,6,0,1,3,5,1,5,1,5,0,2,1,0,0,2,2,12,4,5,44,2,0,0,2,0,2,2,1,2,2,15,0,4,0,1,0,5,1,0,1,0,3,4,0,2,1,8,4,3,0,1,0,1,1,1,2,0,1,1,0,1,2,3,0,1,1,1,0,3,0,6,0,1,0,14,12,6,1,1,0,4,2,0,0,0,0,2,0,6,1,0,2,0,1,0,0,0,0,2,2,0,4,7,3,1,1,3,1,4,3,2,0,5,0,0,0,0,9,1,1,4,1,2,0,0,0,1,0,0,0,5,7,4,3,0,3,1,1,5,4,1,0,5,1,2,4,0,0,0,6,0,3,2,1,0,2,4,0,0,3,0,2,1,0,4,15,0,0,0,0,2,4,0,1,0,2,0,2,3,0,2,13,0,0,3,0,1,2,3,0,0,0,1,0,1,1,1,1,2,1,6,0,0,0,0,0,2,2,1,4,0,0,0,0,2,1,0,2,0,0,0,0,1,0,4,0,0,0,0,2,0,3,4,2,1,0,0,1,3,1,1,1,2,2,0,0,2,1,2,2,1,2,15,7,0,0,0,4,4,3,0,4,0,1,1,2,8,1,2,1,0,3,2,3,0,1,0,14,0,3,0,0,0,0,0,2,0,0,1,0,7,2,0,0,1,2,8,0,1,1,0,1,2,2,6,0,0,1,1,0,0,3,0,0,2,0,2,0,0,2,0,4,5,0,0,0,0,0,2,0,0,0,0,3,0,1,0,0,0,8,3,23,1,5,0,6,0,1,6,5,0,0,0,0,0,0,1,0,1,5,0,0,2,1,2,2,1,0,0,1,3,1,1,0,1,0,0,2,1,2,0,7,0,2,3,1,1,0,1,2,2,2,0,10,0,2,5,0,0,0,6,2,0,1,2,7,43,0,4,1,1,0,2,3,1,3,4,8,2,1,1,1,4,3,2,0,1,0,0,1,0,1,1,2,5,2,3,3,2,4,0,0,4,0,1,2,2,4,0,0,0,2,0,0,5,1,1,7,1,0,0,0,6,0,0,3,0,1,0,0,3,2,5,6,0,1,2,2,0,3,0,1,2,3,0,1,9,5,1,2,0,1,0,3,3,0,3,0,1,4,1,2,3,1,0,5,4,0,0,0,0,2,0,1,0,4,0,1,0,1,1,0,2,0,0,0,0,0,0,12,0,0,0,0,3,2,2,5,7,1,3,2,0,0,5,4,0,2,7,0,6,0,2,1,1,0,3,0,3,2,2,0,4,0,0,1,0,0,0,4,2,2,0,0,0,0,0,0,0,2,6,4,2,0,0,1,0,0,4,6,3,1,0,2,2,3,0,2,0,0,4,4,8,0,1,2,1,0,12,1,6,1,0,0,1,1,1,0,1,0,0,3,0,0,0,0,1,2,1,7,0,1,12,2,1,0,2,5,0,0,0,2,0,2,2,1,0,0,2,0,0,2,2,0,2,0,4,0,1,0,1,0,0,3,0,3,0,0,0,0,4,0,0,0,0,2,0,0,0,1,2,2,7,1,0,0,3,0,22,1,0,1,0,1,0,1,0,2,4,0,0,11,1,0,0,1,1,0,1,5,0,0,0,1,1,1,0,3,4,0,2,0,0,0,0,0,2,0,0,0,1,2,1,0,0,3,0,0,1,1,0,0,0,0,0,0,5,1,0,0,0,0,1,0,2,9,0,1,0,7,0,0,1,0,2,2,0,0,0,2,0,0,6,1,3,3,3,0,1,2,0,0,1,0,0,0,2,2,2,0,0,0,2,3,0,0,1,0,0,0,1,2,1,0,0,1,0,0,1,0,1,2,0,1,1,1,0,3,1,0,1,5,2,0,1,0,1,3,0,7,0,1,0,0,0,0,0,8,3,2,1,1,12,2,0,0,24,1,1,2,0,11,8,2,0,0,1,1,0,0,1,5,0,0,3,2,1,2,0,0,1,2,0,1,3,2,0,0,0,2,0,0,4,1,1,4,1,0,0,1,1,2,0,0,0,1,0,0,3,0,0,0,19,0,5,0,0,0,2,1,0,1,0,0,0,7,3,3,0,1,1,3,3,1,1,3,0,2,0,2,0,0,0,6,2,8,0,4,3,5,3,0,1,2,0,0,0,1,0,1,0,1,0,3,0,0,0,2,0,0,1,0,0,0,1,1,1,0,3,4,0,0,0,0,0,2,0,0,0,0,0,0,0,4,4,0,0,0,0,0,2,0,0,0,0,0,3,0,0,1,0,0,0,1,1,3,0,4,0,0,6,1,1,1,0,0,3,0,1,2,1,6,4,2,2,1,0,3,8,1,0,1,0,1,2,0,0,1,1,1,3,0,0,0,0,1,0,0,1,5,0,0,0,0,3,0,2,2,0,0,3,0,0,2,1,2,10,1,0,0,0,0,0,2,1,0,0,0,0,0,1,1,0,1,2,0,0,0,0,0,3,2,0,0,0,0,0,0,0,0,0,11,0,0,0,0,0,5,3,0,0,0,0,0,0,0,0,0,0,0,0,0,0,1,0,0,0,0,0,0,0,0,0,1,1,0,0,0,0,0,0,0,0,0,0,0,0,0,0,0,0,0,0,0,0
"1974 Heinemann, Larry, Close Quarters",high,7705,6458,1978,2473,2223,2144,967,1548,793,971,596,1243,870,298,448,1085,417,1095,637,362,625,448,343,329,931,250,542,249,624,330,404,718,157,203,222,142,237,398,741,438,115,392,370,211,174,269,350,296,263,391,630,202,199,338,327,211,115,123,166,276,492,108,135,73,140,195,203,392,126,102,223,88,105,145,263,185,231,75,277,115,269,70,167,142,153,127,125,100,82,86,162,149,81,164,54,143,363,151,82,58,106,87,126,58,35,50,105,144,55,85,135,85,202,205,146,50,135,102,76,22,52,102,135,200,72,72,118,107,35,60,52,194,56,114,188,54,180,151,106,57,22,61,23,18,103,91,61,16,106,28,83,35,79,87,43,42,54,155,170,50,61,36,22,52,147,29,29,103,39,152,21,13,93,33,23,31,15,49,66,28,85,57,44,23,54,113,48,37,133,104,143,9,55,64,73,148,18,49,43,67,25,13,71,43,25,12,110,142,40,38,8,104,34,27,100,72,106,27,53,172,17,23,31,95,37,76,15,40,8,12,39,80,157,41,32,11,84,67,53,17,27,12,54,54,50,58,98,34,40,62,25,107,116,107,71,30,45,45,79,30,55,8,19,49,8,13,28,16,109,14,47,16,5,99,36,32,39,24,10,14,61,44,74,20,35,14,47,46,21,91,96,93,12,26,69,25,26,24,7,18,79,38,22,30,34,33,45,20,44,12,4,53,50,25,29,49,9,71,58,9,10,7,66,19,8,31,31,43,21,28,50,2,22,20,105,55,68,2,18,18,48,35,27,11,30,56,20,63,30,23,10,45,27,32,36,2,13,12,23,22,39,19,19,24,27,13,15,49,16,49,15,33,36,24,79,50,10,6,26,12,33,97,62,26,17,2,0,27,10,16,9,46,11,49,52,5,95,17,10,19,19,40,18,10,10,11,29,8,37,21,25,4,48,18,38,7,7,43,18,9,57,10,10,8,52,79,5,35,16,94,48,28,36,22,5,82,38,13,0,3,34,41,8,12,24,21,18,3,7,76,30,50,20,3,8,17,27,2,21,18,19,12,0,5,10,11,5,28,1,24,24,42,22,56,13,5,78,15,0,35,16,13,54,84,1,47,37,14,17,25,45,25,39,15,7,21,48,20,12,8,16,23,7,16,19,16,8,3,12,67,24,72,12,41,4,4,0,18,27,60,62,10,47,16,2,6,9,15,27,13,13,54,64,12,6,1,16,4,39,5,21,4,1,14,55,27,0,8,40,117,20,6,21,30,52,3,7,4,0,7,37,30,7,14,9,9,58,41,7,11,22,12,21,14,3,27,55,4,83,3,42,2,12,28,12,68,6,16,22,13,6,35,15,20,19,1,82,15,11,28,1,11,8,2,12,0,0,0,34,20,39,9,6,16,4,11,28,86,26,25,25,24,6,12,56,5,15,26,23,45,40,0,12,2,3,0,54,22,7,20,24,1,38,4,22,19,5,9,3,16,0,33,2,17,8,33,35,16,14,3,1,19,51,12,12,18,29,6,15,3,25,25,0,1,15,27,15,6,9,9,17,5,5,37,3,2,6,3,40,31,6,26,171,11,7,172,4,9,17,11,32,39,38,12,17,37,4,14,5,11,5,11,19,18,7,71,9,6,22,12,55,20,19,10,5,29,5,2,20,9,3,23,48,23,0,24,13,1,13,23,6,12,2,33,1,5,9,22,11,36,51,42,44,0,2,1,15,10,20,17,8,48,8,11,18,9,8,25,7,2,15,95,58,7,0,6,5,18,3,0,31,3,9,3,17,4,82,13,22,2,21,24,0,30,10,9,0,12,2,14,18,28,3,3,1,2,1,0,1,78,4,7,14,20,10,20,85,1,51,5,7,13,0,3,20,13,5,5,68,33,4,1,24,16,3,52,6,6,0,17,23,28,33,1,19,7,4,0,12,2,10,48,1,0,5,5,18,12,4,18,52,7,5,19,5,5,9,2,9,7,23,19,26,2,0,10,73,12,1,54,7,3,14,22,18,25,4,4,41,5,11,5,17,3,14,7,9,20,12,8,8,5,5,2,0,108,3,12,21,19,2,270,19,0,2,1,15,7,9,2,12,1,14,5,22,2,2,0,0,26,90,5,19,0,5,12,14,27,20,8,8,73,8,3,6,14,6,2,6,20,3,12,20,39,19,5,8,22,5,14,0,13,15,0,6,5,12,3,11,20,8,2,1,5,4,23,10,0,5,0,0,6,21,0,16,18,24,29,0,8,5,9,15,33,3,12,1,2,29,0,25,0,14,17,39,9,0,0,29,0,7,0,4,15,7,3,9,0,3,13,1,16,0,0,4,5,2,8,31,11,20,3,5,5,0,6,5,1,3,13,19,1,0,6,1,10,23,44,15,3,3,22,1,20,7,0,3,3,48,1,3,38,0,1,9,23,8,1,0,0,0,0,7,9,22,16,5,0,4,10,6,17,8,24,8,5,5,0,51,2,6,0,3,15,19,9,1,10,17,6,6,24,9,0,13,49,34,2,9,1,8,15,27,2,0,0,2,20,8,16,21,2,2,13,26,4,14,14,18,0,21,4,8,3,25,4,25,21,16,34,2,1,6,7,20,4,8,2,25,0,53,2,14,0,18,1,2,3,5,5,8,9,2,4,0,2,2,3,0,0,0,10,0,24,1,28,36,21,4,0,33,11,33,11,25,11,0,6,21,0,0,0,0,1,34,6,4,21,0,4,9,0,1,3,8,26,3,1,16,5,0,11,37,90,8,0,0,6,29,1,4,23,8,0,16,7,4,15,4,13,40,6,9,1,13,0,0,4,2,12,18,2,5,0,18,9,0,3,4,4,8,2,18,25,11,11,16,3,3,8,25,0,15,8,0,16,9,2,9,30,15,6,2,1,0,17,16,24,0,4,19,14,13,11,3,17,8,3,4,7,0,6,3,7,2,1,0,14,27,0,23,3,2,2,3,25,13,0,22,4,3,18,0,3,0,28,53,6,7,10,0,30,10,1,12,20,3,13,3,9,2,10,11,2,16,23,0,12,14,7,20,9,2,0,14,4,1,4,7,9,25,0,0,13,10,13,29,2,3,0,0,2,10,1,0,14,0,0,10,1,1,0,1,1,3,0,0,8,0,1,1,0,5,5,8,3,8,2,9,4,0,11,14,2,11,41,3,1,13,2,56,5,0,8,0,7,3,0,3,8,0,5,2,15,0,2,9,7,5,7,5,2,2,2,3,12,7,1,4,11,12,2,0,0,1,24,4,8,12,2,28,6,2,2,29,3,9,22,7,0,3,5,0,7,1,0,15,1,15,8,2,0,2,0,1,7,6,0,17,12,3,2,1,8,0,25,1,7,25,47,6,2,0,17,0,2,5,7,3,1,5,2,7,0,15,1,0,0,10,4,1,1,2,0,0,2,0,7,2,1,5,4,5,0,16,7,24,0,0,2,9,21,0,4,5,1,20,5,0,16,0,0,12,10,3,1,2,0,1,2,2,12,3,4,6,10,2,6,5,11,7,33,4,1,8,2,9,0,15,5,4,0,6,1,9,1,47,13,4,22,0,3,1,0,5,7,1,0,2,6,0,12,4,15,1,2,3,40,0,2,0,6,2,5,0,49,27,0,0,1,2,13,0,8,1,3,1,0,7,3,4,21,2,0,0,20,0,12,0,10,6,2,3,0,7,1,0,11,0,21,1,1,0,1,8,4,1,2,3,1,0,1,21,5,0,0,0,0,11,1,10,13,7,9,5,0,4,5,0,18,7,1,1,3,6,0,4,0,4,75,10,2,6,4,1,8,0,2,1,20,2,2,8,6,2,0,2,21,29,14,4,0,3,4,8,11,5,2,11,1,12,1,9,0,8,0,6,3,4,7,11,22,1,0,8,15,0,24,1,5,9,1,2,23,2,0,9,4,17,9,39,8,2,0,7,1,0,0,27,4,1,23,8,13,0,2,7,13,19,1,2,3,0,16,29,34,0,18,0,2,14,7,11,3,5,16,0,3,2,0,0,7,17,2,0,4,3,9,4,0,45,7,3,9,2,4,6,0,17,1,4,5,0,0,4,3,3,10,8,1,19,1,0,11,3,15,4,0,4,3,3,5,4,0,6,6,4,0,0,10,6,0,0,0,4,21,0,3,0,0,0,10,12,2,5,11,2,2,0,0,3,5,2,15,2,0,19,7,4,0,3,6,1,0,1,1,9,2,1,0,8,0,7,0,0,7,0,5,0,3,0,0,0,5,25,1,11,5,11,4,0,2,4,3,1,26,0,1,3,1,5,13,0,5,7,0,14,1,0,0,0,0,0,2,0,0,0,0,0,2,0,1,0,0,2,0,15,3,3,0,0,0,0,11,1,4,2,0,5,4,0,0,0,8,4,0,0,5,0,3,0,0,0,2,39,1,3,0,4,2,22,13,2,4,47,3,0,2,1,4,0,1,17,17,10,5,7,0,0,8,8,9,0,0,1,3,5,12,0,5,2,7,5,7,3,3,3,3,1,2,4,5,0,0,3,1,4,0,2,0,3,0,0,9,0,3,3,1,1,2,0,1,5,2,9,8,5,2,2,3,1,2,23,22,9,0,2,3,1,0,52,1,0,10,1,1,8,7,0,9,3,29,5,0,12,12,14,0,3,20,13,1,0,7,4,2,31,3,3,5,0,0,2,6,11,12,1,4,4,15,0,3,0,1,0,3,2,23,0,0,4,0,26,0,2,4,0,5,0,2,3,0,3,1,0,11,48,1,0,1,0,0,12,1,0,3,0,1,0,17,4,1,12,1,1,3,3,9,0,0,1,0,0,7,0,0,0,1,5,4,3,0,9,2,0,2,6,2,7,7,5,1,5,14,3,9,1,1,0,0,20,3,1,0,8,0,4,0,7,2,0,10,0,0,12,0,2,1,6,0,3,0,30,0,9,0,0,9,6,8,1,0,1,1,11,1,2,0,0,0,0,4,0,2,10,1,0,6,12,4,0,1,0,0,0,0,0,1,2,10,1,31,1,6,0,0,4,0,1,6,0,0,0,2,0,15,3,1,4,1,6,0,1,0,3,3,1,0,2,0,0,4,10,8,4,1,15,0,8,1,6,0,0,23,2,3,12,8,8,1,0,3,3,2,3,4,3,0,0,3,4,0,0,4,0,6,0,2,23,1,3,3,1,1,0,9,0,1,10,13,3,8,0,10,0,6,1,3,9,0,13,0,1,1,3,3,3,1,7,0,5,25,6,2,0,0,1,1,2,39,0,24,0,1,5,9,4,11,8,1,2,6,1,5,0,14,4,4,5,3,0,1,2,8,1,0,1,5,0,0,0,0,58,3,10,7,0,10,0,0,2,0,1,1,2,5,17,4,13,0,4,1,7,0,0,0,5,7,1,9,0,1,90,4,3,0,1,1,1,1,0,1,0,8,7,2,8,2,0,13,8,3,1,0,1,1,1,1,8,64,0,6,5,0,4,0,0,4,0,6,1,0,1,0,1,0,1,0,3,1,0,1,3,3,7,0,2,3,3,1,0,12,5,1,0,0,12,5,5,0,1,1,0,4,0,0,7,1,26,1,1,0,5,3,0,1,0,0,0,1,0,20,5,2,0,8,0,0,3,1,3,21,4,12,0,12,4,0,2,1,10,0,0,6,5,0,8,0,0,0,0,2,27,15,62,2,0,0,0,0,5,0,0,3,0,0,6,14,0,5,1,10,1,0,2,0,0,0,3,0,1,0,3,8,1,4,3,2,4,0,2,0,0,3,0,4,5,1,3,0,0,0,0,1,3,1,2,9,0,0,11,0,1,6,0,3,1,10,0,1,18,0,0,8,0,0,12,14,1,0,1,1,0,5,8,39,1,0,0,2,14,0,0,14,7,1,0,0,1,10,4,3,6,1,5,6,7,9,0,0,6,8,1,124,2,0,4,0,0,2,0,0,0,0,0,0,0,8,0,7,2,0,0,1,1,3,1,1,4,0,1,1,11,3,14,3,12,21,0,0,0,1,14,2,6,0,1,17,1,3,1,11,4,4,4,3,10,0,0,1,5,0,1,0,2,0,7,2,0,0,6,0,2,6,0,11,0,1,17,0,1,0,0,5,10,0,0,9,0,2,12,2,14,2,2,0,1,0,4,5,0,1,9,2,7,0,0,0,0,0,0,0,1,0,0,0,0,0,11,2,3,0,10,14,4,0,1,1,0,48,0,0,6,0,0,0,3,1,0,11,0,0,0,0,2,0,8,0,5,11,2,0,0,0,0,1,0,12,0,7,0,4,0,16,2,0,3,2,0,5,2,1,9,0,0,0,1,0,3,0,5,1,6,2,6,0,0,13,2,8,0,1,0,2,0,0,18,5,10,2,0,25,0,5,9,1,0,0,1,9,12,1,0,1,0,4,4,0,0,2,1,2,1,0,1,0,2,4,1,0,0,2,0,0,0,1,2,0,0,4,1,3,2,0,9,14,0,0,3,10,0,0,0,0,0,0,0,9,0,5,0,7,1,10,19,0,1,0,19,1,1,7,1,10,2,6,0,3,1,0,37,0,22,38,3,1,2,4,7,21,0,0,0,0,0,4,0,0,1,9,14,0,0,0,0,4,3,1,8,44,0,0,8,1,0,2,9,1,1,1,0,3,1,0,4,8,1,0,4,9,0,36,0,0,0,1,4,2,0,0,0,6,0,2,1,0,0,2,1,0,7,0,6,0,0,5,0,4,0,3,0,0,6,2,2,2,1,0,0,7,0,0,7,1,0,7,0,0,0,10,0,0,2,2,11,6,3,0,0,0,2,0,0,1,4,0,0,0,1,14,2,3,4,1,0,2,0,0,1,0,1,11,1,15,40,1,4,1,0,4,0,0,0,6,10,1,1,3,1,0,0,17,11,9,2,6,1,0,0,3,1,0,4,31,47,0,0,0,15,3,1,0,0,0,13,0,18,2,1,21,0,0,1,5,0,2,1,3,0,1,2,12,13,3,11,0,76,0,12,1,0,0,6,5,4,1,0,0,0,0,18,3,3,0,25,5,0,3,2,0,0,4,0,15,0,1,0,1,1,5,0,4,0,0,1,15,14,0,0,17,0,4,0,2,1,13,0,3,0,0,0,11,0,0,5,3,5,0,0,3,12,2,16,0,1,7,0,1,51,0,0,0,4,32,14,10,11,12,6,2,0,0,0,0,1,12,5,1,3,25,0,1,0,31,0,13,1,0,0,7,0,5,0,1,2,2,1,5,3,1,8,0,13,2,11,3,6,4,0,1,9,4,0,1,13,2,4,0,4,0,0,6,9,0,4,2,6,0,1,6,0,0,8,0,0,0,6,2,0,0,10,1,0,0,7,7,0,0,2,8,0,0,0,0,1,12,0,0,0,0,8,0,0,0,10,0,2,0,0,4,0,0,5,0,1,2,0,0,0,0,15,0,1,1,0,5,5,7,10,0,2,0,3,5,6,5,2,0,3,0,2,15,0,2,0,5,0,0,0,4,0,5,0,2,4,3,3,7,0,0,0,0,0,2,1,8,0,0,2,1,0,52,4,0,0,0,1,0,1,0,7,0,0,3,0,4,0,0,8,3,3,5,11,17,0,0,5,1,13,0,0,0,1,6,1,7,1,2,0,0,6,0,1,0,1,1,0,7,1,0,0,4,1,4,0,1,3,1,2,10,12,2,1,32,7,0,0,0,4,0,0,0,2,0,3,0,0,0,4,0,0,0,9,3,5,4,3,2,1,12,3,0,0,9,4,3,7,1,3,0,1,0,1,0,6,1,0,0,5,0,1,2,1,0,0,0,1,1,0,1,0,2,0,2,0,2,4,0,0,0,1,1,6,0,0,1,2,1,0,11,0,1,3,0,2,0,16,1,0,0,7,1,0,20,8,0,0,7,1,5,0,0,16,0,0,5,2,8,0,6,1,0,0,1,0,0,1,0,5,0,3,2,1,7,0,0,9,0,0,5,0,8,2,2,0,2,0,1,2,3,3,0,0,1,0,0,0,1,3,0,0,0,0,0,7,1,1,0,11,0,1,0,1,2,5,3,6,1,6,1,9,1,0,0,1,25,7,0,1,0,1,11,0,1,3,0,6,0,0,1,1,0,0,0,0,1,3,0,0,0,0,0,1,5,0,2,2,1,0,4,1,1,1,0,2,4,0,0,1,3,1,0,1,0,0,1,0,0,2,3,4,0,8,1,0,14,1,0,2,7,0,7,3,2,0,5,0,0,6,9,10,8,2,2,1,1,4,0,2,0,1,0,0,1,0,0,2,2,102,33,12,0,4,2,2,0,1,0,5,0,6,14,0,1,0,0,2,0,0,1,3,0,3,0,1,0,2,6,0,1,1,7,0,0,0,1,4,0,0,0,2,0,10,0,0,13,0,0,0,10,0,0,0,0,1,1,5,14,0,0,0,6,1,2,2,196,0,0,12,1,1,0,1,4,0,15,1,3,0,7,4,0,3,0,17,0,0,0,1,6,1,0,0,9,0,0,11,3,4,0,2,0,18,0,0,1,7,0,26,14,0,2,0,0,0,0,1,0,0,1,0,1,3,0,1,5,0,0,0,0,4,0,1,0,0,0,6,2,9,1,7,2,10,0,3,4,1,4,0,0,8,17,0,2,1,0,2,0,0,1,0,0,0,4,0,1,4,0,1,7,5,1,8,11,0,1,0,0,1,0,1,0,0,0,2,3,0,1,0,0,10,6,0,1,0,0,2,0,1,0,1,8,2,22,0,0,1,0,2,0,1,3,3,4,0,0,1,2,0,0,0,1,4,0,0,0,5,0,0,7,4,0,0,0,0,0,0,1,2,3,5,0,1,0,0,2,1,3,0,0,5,2,0,4,0,0,9,0,1,0,0,0,2,0,2,1,1,0,0,0,4,4,0,10,3,0,3,3,0,0,1,0,0,0,1,11,1,6,0,2,2,10,0,4,0,0,2,4,1,0,0,0,10,4,3,2,8,0,0,1,0,0,0,0,3,2,4,7,0,0,0,2,0,9,7,0,0,5,0,21,7,0,1,0,5,1,3,1,0,1,8,2,0,0,1,3,3,3,13,5,3,0,0,0,0,1,0,0,0,0,2,1,4,2,4,1,9,0,2,1,0,0,1,7,0,0,0,2,6,11,1,0,20,5,0,3,8,2,2,0,1,0,4,2,0,2,0,1,0,7,6,0,1,1,7,0,0,0,0,9,2,1,0,0,6,0,4,0,0,1,0,0,2,2,0,1,3,0,2,0,0,1,0,3,0,5,3,5,5,0,3,1,0,0,0,0,7,2,0,7,1,5,6,0,0,1,0,0,1,0,0,0,3,5,4,0,1,4,0,0,0,0,0,6,0,1,0,1,0,2,0,2,0,5,9,1,0,0,1,4,0,2,0,1,0,0,0,5,0,1,0,0,0,0,23,5,4,1,0,0,0,0,0,5,1,0,1,0,2,0,2,0,3,4,0,1,8,1,0,0,1,2,0,1,1,0,0,1,0,1,0,2,6,0,0,0,0,0,0,1,0,1,2,0,2,5,2,0,0,8,0,0,2,0,3,0,16,0,1,1,3,17,15,8,0,0,1,8,70,0,0,14,0,0,2,10,0,2,1,1,0,1,0,1,5,0,0,0,1,2,0,0,2,0,9,0,0,4,6,0,0,2,0,0,1,0,2,10,0,0,0,0,0,2,8,0,0,1,2,0,1,0,0,0,1,0,1,0,0,2,0,0,2,0,1,0,0,1,0,0,0,0,0,0,0,5,0,2,8,5,1,6,0,0,8,1,1,3,2,0,1,1,2,4,3,0,2,0,0,4,2,1,1,0,0,0,0,2,1,0,0,16,4,53,0,1,0,0,2,2,1,0,1,0,1,0,0,6,0,0,2,1,0,0,5,0,0,1,3,0,0,1,0,0,2,5,1,0,3,7,7,0,14,3,0,0,1,0,0,1,0,13,1,3,0,0,0,0,0,0,0,1,0,0,5,0,0,0,0,0,0,0,2,0,0,1,1,3,1,1,19,0,0,2,7,1,7,0,0,3,4,2,3,0,0,6,6,3,0,0,1,0,10,10,0,4,1,0,0,1,0,0,1,0,0,1,0,0,1,0,0,0,6,4,0,2,0,0,7,0,1,0,7,0,0,7,0,5,0,1,1,0,0,0,0,0,0,1,0,0,0,1,0,0,0,1,0,0,6,0,3,0,31,0,1,1,0,1,0,0,0,1,2,0,2,1,4,0,0,0,1,5,0,1,4,0,0,0,0,0,3,1,0,13,0,0,5,4,0,0,5,0,0,19,5,0,0,0,5,7,4,2,0,0,0,1,0,0,2,0,0,0,0,0,0,0,0,1,0,0,1,3,0,0,1,0,0,2,0,1,0,3,0,0,1,0,0,17,0,5,0,0,0,0,12,0,0,0,0,1,1,0,4,4,4,8,0,2,0,1,1,0,0,0,0,5,3,2,0,2,0,2,3,17,0,2,0,0,2,2,1,1,1,0,5,1,3,2,4,3,0,0,0,1,0,0,5,0,5,14,0,0,6,0,0,0,11,0,0,0,0,0,2,0,11,8,0,0,0,0,0,0,2,1,9,0,3,4,0,0,0,1,0,1,1,0,8,6,0,1,0,0,0,0,6,0,10,0,12,2,0,0,0,0,3,2,0,0,0,5,2,0,2,0,3,0,0,6,0,2,1,0,0,0,5,0,0,1,0,0,1,0,0,0,0,0,0,0,0,1,3,0,1,0,3,0,0,10,0,7,2,0,9,3,0,2,0,0,3,0,0,1,0,0,2,0,0,1,15,0,0,1,1,0,0,5,0,0,5,0,0,0,0,0,0,1,0,1,18,0,1,0,4,1,2,0,0,0,0,0,0,0,0,1,2,5,1,0,3,1,0,0,1,0,1,0,0,0,7,1,0,0,0,0,0,6,0,0,0,0,0,3,0,0,1,0,0,0,15,12,1,0,0,0,0,0,4,9,0,0,0,1,2,1,0,0,1,0,1,4,1,0,4,1,2,0,0,0,0,3,0,0,11,23,0,6,2,0,0,0,3,0,1,1,2,0,8,0,0,4,0,0,0,6,0,0,0,0,0,6,0,0,1,0,0,0,0,0,1,0,0,0,1,0,0,1,0,0,0,0,0,0,0,0,9,0,1,9,1,0,0,0,0,0,1,5,0,0,0,0,0,0,1,3,1,0,0,0,0,0,0,0,0,0,0,0,0,0,0,0,1,0,0,0,0,0,0,0,0,0,0,1,0,0,0,0,0,0,0,0,0,0,0,0,0,0,0,0,0,0
"1974 Pynchon, Thomas, Gravity's Rainbow",high,19420,7780,7764,8135,9307,1333,3193,6489,1502,3123,2418,2847,2692,1007,1611,2468,564,2394,2383,111,2113,1970,2053,1307,304,1295,432,1554,1692,3296,1492,1314,1075,1593,1370,1136,485,1800,638,1219,669,793,1049,1155,697,466,1165,935,391,590,878,754,365,1105,1008,1200,678,581,447,686,891,420,633,1172,525,680,852,784,1410,231,393,220,501,448,240,585,391,146,729,932,478,731,267,453,539,40,488,746,583,485,202,466,755,619,229,363,454,384,313,322,442,441,267,415,135,545,365,339,212,361,524,491,232,242,317,111,498,421,112,193,25,727,92,316,259,62,458,306,118,180,118,158,289,80,204,294,186,358,197,417,130,239,103,197,141,124,182,187,168,113,346,312,56,239,211,456,1000,394,119,228,181,76,72,124,263,498,347,226,116,211,39,150,252,80,39,462,184,140,423,174,220,69,250,170,161,124,151,91,163,197,91,161,259,224,502,154,51,119,68,219,253,45,82,194,258,37,149,354,82,119,82,366,174,235,241,392,40,163,244,28,177,207,147,302,64,390,97,177,101,296,162,99,29,110,157,36,190,127,209,208,87,55,337,116,119,84,33,142,65,116,90,159,277,12,140,92,134,171,229,147,169,84,346,169,178,203,123,246,62,190,146,177,122,155,28,97,189,92,96,50,58,73,101,103,72,152,168,78,156,129,18,17,13,176,157,113,32,69,129,65,82,161,3,139,53,222,53,131,54,222,117,15,64,135,113,56,43,200,117,79,197,32,59,83,51,101,96,194,49,8,23,87,66,27,73,108,174,98,61,55,160,74,67,66,61,59,54,12,167,141,100,34,54,133,132,31,44,31,159,91,13,2,197,67,141,13,85,63,144,102,137,26,49,24,33,104,216,22,51,135,80,66,43,2,68,30,2,114,83,154,73,36,56,42,86,108,81,103,44,31,20,84,23,64,147,66,77,77,125,111,19,115,153,78,103,153,93,94,80,55,58,4,19,54,112,87,43,86,89,36,39,54,29,69,69,93,57,96,46,53,79,88,36,71,39,109,60,54,84,82,20,72,53,55,162,96,75,33,45,89,87,28,0,142,8,30,40,185,21,44,38,44,102,25,47,138,54,37,0,45,87,93,36,21,84,30,43,26,31,68,109,34,207,61,122,6,108,27,217,136,45,19,21,14,148,65,35,59,28,42,30,52,65,29,79,74,0,94,10,52,95,27,74,39,62,31,57,215,69,74,22,62,38,63,11,3,65,135,26,59,34,19,108,61,33,101,0,29,9,162,91,40,38,46,34,33,43,104,124,1,29,100,43,29,66,43,41,95,64,99,36,26,57,115,9,29,81,7,64,28,61,47,82,48,19,59,41,35,104,69,65,9,18,31,44,44,299,6,20,61,22,176,64,80,39,1,2,41,2,98,33,2,62,98,22,63,71,71,16,142,29,22,33,71,12,29,17,10,139,35,8,2,68,30,6,0,58,9,13,25,45,24,27,15,16,58,20,61,30,21,0,74,32,43,210,96,104,69,44,120,36,46,27,71,15,93,42,22,34,77,90,57,10,124,31,25,110,77,58,44,82,63,38,13,78,20,39,70,27,38,59,10,55,29,8,27,141,48,17,78,257,62,72,72,20,66,19,47,30,22,22,8,71,57,21,66,36,86,52,51,67,37,61,176,43,31,60,5,56,15,37,15,126,72,0,16,85,18,82,42,90,17,6,23,9,54,29,100,25,64,69,47,54,34,28,41,24,8,53,114,26,46,51,30,25,38,52,50,35,64,10,43,34,6,2,38,71,20,122,2,66,52,10,32,18,33,89,17,89,30,51,14,5,21,30,17,3,25,3,61,24,30,34,23,115,2,14,21,19,40,14,15,116,23,63,175,72,5,32,80,54,14,82,34,19,90,32,53,10,6,31,6,20,29,10,48,19,18,0,14,119,23,63,41,30,82,41,0,19,15,34,42,50,34,45,46,9,21,14,47,25,19,21,41,52,68,7,0,16,75,50,6,28,12,2,53,37,6,41,25,51,46,39,34,40,22,32,26,34,35,4,30,12,9,70,14,33,13,97,86,39,18,21,4,24,91,51,18,33,30,31,0,16,0,25,59,77,8,49,56,60,57,12,10,13,39,71,0,3,24,41,3,56,5,30,31,54,9,11,128,36,46,16,79,45,69,25,62,29,44,58,28,18,19,33,68,3,52,133,116,1,59,11,5,60,21,45,30,58,10,10,6,20,18,46,22,30,43,13,0,10,7,35,15,3,10,41,23,29,4,9,71,25,26,35,25,9,14,27,0,34,0,63,17,27,59,0,3,27,13,48,30,8,67,5,29,70,3,18,31,31,28,3,0,3,13,41,9,52,34,18,21,34,17,38,25,38,16,7,36,0,28,23,32,3,17,4,19,0,9,23,18,7,30,25,0,51,65,73,37,48,24,0,26,33,17,5,20,0,0,2,11,16,55,26,54,28,0,51,15,4,44,9,26,7,27,45,40,14,9,38,0,18,10,16,17,63,19,12,26,11,4,43,52,29,25,46,72,27,18,20,30,6,8,0,1,3,61,33,37,36,24,7,27,112,20,26,49,14,23,5,11,83,15,69,22,11,32,71,36,60,16,28,38,24,19,9,28,20,19,23,1,28,30,43,9,8,9,28,16,51,18,41,16,0,8,5,30,3,8,3,53,14,53,27,29,19,34,40,2,22,67,47,26,15,41,0,10,47,0,27,11,0,35,25,42,17,88,9,11,57,0,17,42,32,96,24,29,41,9,1,52,13,51,24,0,0,21,7,21,23,11,16,2,18,24,25,15,17,51,46,29,29,7,13,0,13,17,29,20,40,18,41,0,62,10,78,26,25,40,15,9,34,16,44,26,3,20,0,21,31,0,24,18,0,16,21,30,20,39,4,31,7,7,0,32,19,49,1,0,32,25,21,27,19,24,17,10,29,11,0,4,21,57,1,17,17,34,3,8,11,8,5,32,25,31,16,20,7,24,22,125,12,42,4,38,37,21,17,40,38,13,22,0,15,7,19,6,24,15,14,52,63,11,6,77,20,5,28,15,11,16,6,7,15,0,21,15,41,9,33,14,25,22,16,75,13,8,21,3,1,13,65,1,10,41,8,50,6,32,5,3,15,2,13,0,0,21,0,2,24,0,28,51,40,11,35,23,29,27,75,34,48,16,19,20,68,1,33,31,7,1,0,54,5,43,29,0,17,2,13,15,100,12,1,10,16,21,15,5,44,10,25,47,21,33,12,10,11,8,2,47,0,0,8,33,12,16,13,32,9,11,7,13,1,23,9,40,18,5,35,12,0,60,11,0,79,11,32,5,12,10,22,0,16,5,21,1,16,69,36,18,6,42,0,9,30,40,18,42,46,25,31,55,4,27,6,14,3,0,9,28,17,9,12,50,0,2,33,12,75,2,69,0,0,46,0,10,27,41,14,7,67,3,73,11,21,0,11,19,23,35,19,6,72,58,20,15,20,3,39,8,13,8,29,0,54,3,26,12,37,0,22,13,9,18,16,1,48,6,32,12,12,11,14,7,26,20,31,25,7,44,2,8,12,26,15,0,22,8,33,41,14,0,38,21,20,3,62,15,20,14,33,18,10,5,0,21,3,5,0,30,6,7,27,28,110,0,11,11,3,23,0,41,5,30,14,12,23,8,11,34,4,6,18,36,71,18,0,48,25,1,12,2,23,29,46,19,27,40,6,9,24,3,50,10,9,4,12,12,9,3,41,17,0,20,1,39,11,19,6,30,37,29,43,27,59,7,9,21,4,32,16,23,5,7,6,0,8,26,66,19,15,14,7,3,2,13,0,27,0,31,40,9,18,5,9,38,14,6,17,0,22,24,7,5,7,40,25,8,101,14,7,25,44,34,39,49,71,0,28,9,3,5,33,20,14,9,1,6,13,27,41,9,28,2,5,8,27,25,22,18,27,76,19,4,13,22,52,24,13,30,64,13,0,34,11,36,14,0,13,16,21,20,9,18,0,17,10,19,24,7,34,4,6,14,8,6,20,0,17,6,4,29,19,9,2,17,2,30,19,7,9,32,2,4,21,13,16,11,23,6,0,60,7,2,25,94,27,15,38,6,7,12,19,40,10,4,33,6,14,6,21,10,14,26,3,2,27,5,16,10,0,0,24,51,0,6,0,0,0,3,25,14,9,16,17,11,0,9,1,25,5,27,24,8,19,7,10,3,31,28,5,18,15,5,22,15,8,19,10,2,39,6,1,27,170,19,20,6,42,9,10,19,13,8,8,3,27,27,0,33,21,4,6,20,13,33,20,5,22,17,0,10,48,1,47,22,6,24,0,28,4,23,0,17,12,36,2,10,0,11,20,0,16,8,6,22,16,28,8,0,0,11,11,20,10,1,13,19,0,7,0,24,52,0,8,36,0,8,12,8,0,32,11,24,0,2,9,5,23,19,5,5,5,9,0,5,9,68,11,14,18,28,4,9,5,4,7,18,12,22,34,0,5,14,7,12,10,27,1,8,24,23,7,9,23,9,23,32,18,3,4,3,18,9,24,1,15,19,20,1,8,7,10,9,52,6,5,2,11,9,55,11,35,19,23,9,11,5,8,5,30,32,1,0,22,9,29,0,24,17,11,7,5,7,58,21,6,20,19,42,34,1,16,16,21,5,19,16,14,9,4,45,53,26,24,1,30,32,13,5,16,32,31,13,20,13,4,11,23,7,12,8,4,6,19,33,4,2,18,10,0,16,19,20,22,9,21,46,40,14,56,4,2,12,1,2,10,20,18,7,12,51,40,41,6,0,24,16,10,7,14,15,2,16,23,10,0,0,13,0,6,26,967,0,9,10,32,17,13,25,12,1,0,13,18,8,3,31,25,3,23,0,25,16,6,19,0,15,4,15,4,0,11,0,14,9,16,13,0,21,76,20,27,7,12,11,5,10,30,5,10,3,58,4,0,12,32,17,35,1,3,11,28,1,11,25,5,11,19,21,12,7,21,56,28,3,11,10,0,54,8,34,15,16,0,5,7,12,7,13,18,12,7,3,19,1,15,6,2,6,9,34,3,6,47,8,22,8,12,31,11,19,27,10,2,0,9,0,23,3,38,59,20,38,10,12,23,8,22,9,19,12,7,20,55,53,16,11,0,20,6,5,4,18,16,26,54,5,11,3,21,13,6,9,2,2,13,8,14,15,1,20,14,13,2,10,35,33,17,1,7,6,1,5,1,15,28,4,6,2,15,4,14,14,12,0,0,25,45,11,10,4,3,12,5,6,10,7,12,3,1,3,22,15,15,11,40,9,3,12,4,23,0,15,3,7,0,38,4,11,1,10,15,0,16,12,20,5,21,11,8,15,7,11,2,34,24,1,11,1,13,20,11,23,26,7,14,20,52,13,1,4,0,0,12,4,9,7,0,10,1,9,18,3,12,7,4,17,15,2,8,8,11,10,7,7,5,5,16,2,5,0,2,3,37,10,12,0,15,2,4,12,2,3,14,11,0,22,6,29,14,0,2,0,4,8,16,1,11,8,8,1,10,14,5,6,13,30,0,14,3,4,13,0,1,18,5,17,8,41,23,31,2,13,22,13,5,4,8,2,36,8,0,4,3,15,3,0,0,17,36,9,9,8,0,6,25,6,10,8,1,21,1,7,2,0,24,29,14,5,22,13,3,5,23,32,7,24,10,7,28,11,8,20,0,1,8,2,37,4,0,9,0,29,1,17,7,32,6,10,14,8,6,13,0,3,1,9,10,8,44,4,19,38,0,8,12,15,0,0,6,10,9,7,2,10,16,0,6,7,0,1,18,28,11,11,0,5,23,4,16,0,17,10,10,33,38,9,10,0,0,12,1,0,9,18,0,5,15,25,5,5,0,2,4,0,0,3,7,20,4,9,25,29,8,11,1,4,16,16,11,8,25,19,12,49,4,3,0,9,17,47,13,3,7,0,19,2,19,5,11,16,49,4,2,15,4,9,26,7,0,1,7,6,0,30,6,3,13,4,7,5,46,2,7,16,9,0,2,16,7,15,2,11,24,15,0,3,15,35,7,11,25,0,10,5,19,3,38,38,4,0,6,3,24,20,6,2,8,18,13,6,3,35,0,22,42,7,76,0,5,4,19,0,12,3,17,5,16,3,16,45,5,5,8,3,7,6,5,16,17,6,14,21,3,4,13,3,26,11,53,2,7,2,5,3,2,5,6,0,5,22,8,8,9,2,5,11,44,19,2,16,20,0,6,2,1,5,0,0,9,4,3,1,26,3,3,10,9,23,13,19,0,5,22,25,14,15,3,0,0,16,2,0,25,11,8,14,0,11,26,10,1,2,0,6,7,2,11,21,0,9,32,4,3,7,2,19,2,8,7,12,0,0,15,23,3,9,0,5,31,33,2,0,6,1,17,11,7,9,14,14,19,22,5,5,0,11,27,10,8,10,10,9,12,10,9,0,14,6,22,4,23,21,2,4,9,3,0,2,6,5,17,15,19,8,0,12,9,7,17,2,0,14,0,18,19,13,7,4,3,3,5,4,2,0,4,26,20,1,6,63,1,11,32,9,3,5,38,4,2,23,3,13,2,16,18,4,5,14,5,3,1,1,0,0,11,14,21,41,5,16,2,3,6,16,9,4,10,6,5,11,0,26,7,21,8,5,2,9,3,1,5,6,23,3,5,12,1,12,8,2,13,1,40,3,3,1,10,4,11,8,0,14,46,16,10,0,8,3,51,1,6,2,1,7,3,8,0,3,14,14,25,17,11,17,0,4,0,0,4,4,25,6,11,1,0,9,3,27,2,3,17,27,25,18,0,12,12,0,0,9,15,24,7,0,5,3,15,17,0,13,1,2,0,4,6,5,17,3,2,20,1,13,6,0,4,5,0,1,9,3,15,5,2,2,12,17,2,31,10,9,5,4,8,18,4,5,6,12,8,0,7,1,8,3,30,26,6,15,0,8,11,3,8,3,2,4,1,0,4,15,0,4,3,10,15,24,5,52,9,1,8,5,9,8,0,0,15,1,14,7,20,7,6,24,5,10,9,16,79,12,4,58,0,0,12,3,3,5,0,3,0,20,5,4,18,14,2,6,3,22,1,1,14,31,5,69,0,3,0,20,9,18,5,2,0,3,8,1,2,7,15,6,7,7,5,2,24,1,3,1,2,12,1,8,5,10,0,1,7,4,5,7,17,8,5,17,3,49,0,5,11,3,18,11,14,4,6,0,18,26,2,20,17,0,7,14,26,6,13,2,8,2,10,16,15,12,1,0,9,24,8,10,3,6,2,2,23,4,1,1,5,11,6,2,25,1,7,1,4,24,0,7,5,0,3,17,7,0,4,3,3,7,13,26,6,0,10,3,7,2,1,10,17,24,10,9,0,10,0,0,2,9,6,32,21,18,7,8,5,3,5,4,3,2,2,10,7,9,6,2,10,3,0,12,12,10,9,19,3,3,10,3,12,3,8,4,0,1,10,10,2,8,19,4,8,3,4,6,6,5,14,14,3,1,10,14,0,26,1,16,2,15,19,1,3,0,18,6,8,10,7,1,0,5,1,3,1,5,4,0,0,13,3,9,1,2,19,0,15,8,2,1,0,0,32,2,1,14,17,21,1,37,11,5,25,41,22,2,5,9,8,2,18,43,5,0,19,1,1,4,0,19,2,5,3,1,4,15,20,263,13,4,11,14,6,10,8,5,13,182,7,3,6,6,4,17,2,9,4,12,12,6,1,4,1,3,5,5,8,11,23,1,5,3,1,7,3,1,11,3,38,0,12,1,3,0,5,8,9,9,14,6,6,10,6,2,0,5,2,3,1,0,3,20,7,5,0,1,2,8,15,9,10,0,1,19,3,2,9,0,5,5,3,5,22,10,4,15,6,4,2,2,4,21,0,1,9,7,9,11,4,6,10,11,14,4,24,4,11,0,12,126,4,13,0,18,9,0,0,8,1,11,8,0,4,0,2,12,3,9,6,11,19,7,5,7,1,8,4,0,7,13,7,3,10,4,8,3,1,10,6,7,1,5,1,7,0,5,17,2,19,12,6,0,22,5,8,2,11,6,3,17,11,2,14,6,7,2,9,4,2,22,9,3,3,0,9,13,12,11,2,1,5,19,4,2,8,4,7,8,3,1,7,3,6,0,2,10,32,40,8,20,6,1,3,14,9,0,0,2,7,3,0,6,10,3,3,0,14,4,6,5,5,4,1,14,5,3,3,0,3,8,8,3,3,16,6,21,15,6,3,5,15,9,11,9,1,30,14,12,0,10,0,0,15,3,12,17,6,4,2,5,7,4,15,19,18,9,8,11,7,18,1,0,9,10,6,10,37,5,14,16,7,9,15,3,20,0,5,6,9,4,3,16,15,30,5,6,0,4,0,4,2,7,5,1,10,1,8,4,4,78,9,3,9,28,2,0,17,11,10,9,4,13,28,1,1,0,5,0,13,0,4,9,7,9,0,9,6,5,7,18,2,12,6,3,32,14,2,3,14,13,2,6,3,5,0,7,6,14,0,4,0,10,3,0,18,3,8,0,0,18,7,0,2,30,1,5,36,0,2,6,4,0,2,13,1,8,16,1,10,1,0,14,8,0,8,1,2,8,13,2,16,6,8,3,0,4,0,8,39,9,9,4,0,3,0,13,0,21,15,6,0,1,5,3,7,1,8,4,2,12,1,13,0,12,23,8,14,3,7,3,9,2,15,7,8,5,6,6,13,13,4,2,3,6,8,10,6,12,0,12,3,3,6,2,11,9,3,7,1,13,1,0,25,13,4,0,1,5,27,5,0,1,0,2,6,5,28,5,4,5,6,16,2,84,7,4,4,13,11,3,0,19,5,12,4,0,3,7,0,24,12,1,0,1,7,6,0,10,5,3,5,3,2,1,4,20,9,5,0,13,6,19,1,0,4,1,11,5,10,8,5,1,4,0,26,0,2,25,1,1,3,0,0,5,3,14,5,13,3,9,8,6,9,0,4,2,1,47,8,12,6,3,4,23,3,19,5,0,29,17,16,23,8,0,0,0,5,16,21,72,0,6,7,7,0,0,8,0,3,4,6,2,3,16,0,3,6,27,10,7,5,18,12,14,6,1,3,0,1,2,15,12,5,0,11,6,32,4,11,6,14,1,8,4,7,17,5,11,2,7,6,2,0,4,11,5,6,1,6,5,5,7,1,12,6,22,5,8,1,23,1,0,0,24,12,0,8,4,2,1,4,15,2,1,5,5,7,5,8,10,15,0,7,1,17,0,9,12,0,7,0,19,2,5,14,3,3,2,5,9,3,7,11,0,4,0,22,30,3,5,0,12,20,7,4,9,0,6,4,0,4,1,3,5,19,9,6,9,10,0,23,2,1,0,10,6,0,3,0,9,14,34,1,7,7,11,1,6,3,7,7,5,21,7,2,3,8,10,0,3,0,3,2,23,0,4,2,7,2,5,20,2,1,0,0,4,0,6,3,0,20,1,4,0,4,4,8,1,8,11,4,5,14,2,2,22,17,8,3,0,1,2,2,14,4,3,11,10,5,0,3,8,4,2,28,12,7,8,10,10,6,6,16,2,0,8,8,6,12,8,14,0,8,2,8,5,51,1,4,4,3,8,0,15,6,0,0,7,0,4,2,6,1,1,1,15,3,10,2,2,0,10,22,13,5,13,2,16,7,0,4,5,18,4,11,19,5,8,2,13,5,11,3,5,8,7,0,16,14,3,2,8,3,3,17,5,7,2,2,1,12,0,0,1,4,6,6,4,2,0,1,12,19,7,1,8,12,0,0,1,4,8,11,6,4,0,7,6,9,0,5,2,15,6,26,2,4,8,52,15,4,1,2,1,12,23,1,0,1,6,17,3,20,0,40,14,6,43,0,5,8,0,19,2,7,7,3,3,2,15,10,6,3,1,5,14,3,0,13,9,2,6,8,8,5,3,1,3,3,15,0,6,7,9,11,0,17,1,9,2,17,9,2,12,0,15,11,6,12,3,15,8,1,7,1,7,1,0,4,8,5,0,0,0,3,0,3,30,5,6,4,4,4,1,6,0,0,2,19,4,2,4,3,2,0,2,15,0,0,5,8,8,9,3,10,12,2,1,16,42,5,4,27,2,14,14,0,4,0,1,1,5,4,3,3,13,17,3,8,55,3,15,5,1,0,5,8,3,0,11,19,6,4,4,3,3,4,1,0,0,6,6,9,13,0,15,1,11,27,2,16,1,9,0,5,0,0,30,2,23,3,10,0,129,1,4,1,5,2,2,3,2,0,1,7,6,12,6,1,0,0,0,7,9,1,6,6,2,7,4,12,14,5,0,8,7,6,19,8,10,2,1,11,2,1,6,2,0,1,11,6,49,10,2,10,15,1,18,13,0,9,22,4,1,2,5,0,5,2,4,18,4,0,7,2,5,0,2,1,5,0,8,1,2,0,0,1,3,14,0,2,5,3,4,1,36,3,2,20,12,0,9,3,6,5,1,0,0,1,5,8,7,0,6,0,1,1,3,1,26,3,2,1,11,4,6,9,1,1,3,15,7,4,13,4,4,4,7,5,2,15,0,5,7,6,0,14,2,26,7,2,21,14,4,18,2,8,6,6,11,7,0,1,13,0,1,3,2,10,28,20,3,43,1,1,4,10,15,9,0,10,8,5,10,8,17,3,8,0,4,4,4,8,23,3,6,9,0,0,1,5,6,2,10,11,3,5,0,19,6,9,11,3,10,23,5,0,7,0,5,9,4,3,1,5,0,6,2,0,0,0,15,8,9,7,0,1,5,15,3,16,10,1,2,7,4,16,13,7,17,58,1,0,6,2,4,3,49,7,2,0,0,6,5,8,7,16,4,37,32,3,4,5,6,0,1,3,0,12,2,4,8,13,39,4,8,3,11,3,5,14,0,1,0,7,0,15,5,46,14,0,5,9,1,8,6,1,7,2,13,0,1,23,30,3,4,4,34,7,11,7,3,0,6,12,3,23,21,7,1,0,0,0,22,17,4,11,9,9,6,13,17,9,9,0,13,5,27,6,15,13,2,0,5,10,6,15,12,2,0,11,0,8,20,1,27,16,35,3,7,13,0,0,1,12,1,3,5,6,19,27,0,33,18,2,16,6,6,0,13,0,0,11,3,18,2,16,12,6,0,0,0,9,9,0,0,65,14,0,1,6,4,35,56,13,4,0,2,42,0,17,20,0,0,0,0,1,0,0,0,4,0,8,0,0,0,5,0,16,0,0,1,0,0,0,0,2,3,0,0,0,0,0,1,0,0,0,0,3,0,0,4,4,1,0,0,0,2,0,0,0,162,158,156,156,0,0,0,0,0,0,132,0,0
"1975 Stone, Robert, Dog Soldiers",high,5662,2448,2071,2442,1884,1155,2337,1458,1561,1664,1321,1182,767,863,786,807,800,749,615,1154,637,303,467,800,151,458,305,715,417,332,448,549,422,357,228,293,436,312,237,251,230,306,515,272,244,315,128,209,201,149,256,403,221,241,244,150,224,284,257,166,311,305,180,127,213,131,168,289,203,169,191,190,123,172,192,108,86,63,191,171,148,270,273,166,138,221,163,147,56,74,80,125,53,119,172,122,122,87,91,109,73,101,87,71,151,146,61,111,142,102,99,70,102,133,86,103,85,86,95,192,164,32,189,136,93,175,54,113,41,92,102,152,143,155,122,64,35,104,62,48,54,74,15,184,71,102,74,99,106,67,37,113,150,81,47,131,41,43,43,89,28,78,27,75,68,93,52,90,72,67,36,38,51,65,50,36,53,86,53,56,50,29,65,59,68,23,36,40,50,36,50,52,32,44,43,68,23,24,17,75,65,93,71,30,38,44,37,36,23,30,29,75,43,30,91,55,53,97,38,96,59,33,32,103,38,69,41,21,32,75,84,50,124,31,34,1,22,29,38,28,32,47,58,32,13,16,25,37,26,31,54,48,43,94,37,57,54,40,56,37,35,60,43,25,15,28,40,47,23,48,27,33,27,33,24,23,20,28,35,24,52,33,38,17,36,97,49,27,18,24,37,30,27,34,29,34,43,42,38,31,42,30,0,65,69,57,39,46,47,17,9,14,26,28,31,51,21,30,28,52,33,19,41,40,42,40,35,23,23,41,34,27,34,44,63,20,30,15,20,15,32,22,19,26,15,21,32,52,26,34,12,77,19,26,27,7,11,4,45,15,30,41,28,11,24,44,19,10,80,29,16,40,15,12,6,38,17,18,30,26,38,50,19,68,18,13,0,17,29,32,5,12,25,28,26,5,19,37,9,21,9,26,43,23,33,9,22,22,22,11,34,10,45,13,14,16,8,17,16,11,22,3,8,18,31,30,14,19,25,19,16,30,34,11,9,28,18,11,2,15,34,11,38,20,28,24,24,34,11,13,24,20,23,25,25,14,13,18,34,17,21,1,2,15,16,7,99,8,24,26,26,24,10,18,12,8,39,24,0,35,23,62,47,17,14,32,14,28,26,12,25,15,13,13,15,41,28,28,18,17,15,9,25,34,19,18,13,9,10,19,25,21,13,27,23,16,0,14,38,21,13,4,25,41,19,2,31,19,13,29,28,14,21,12,13,5,10,18,28,16,12,15,9,28,15,38,0,18,21,100,7,18,13,5,11,25,29,7,11,9,69,8,8,14,22,6,24,38,14,20,7,24,9,24,11,20,26,1,16,13,19,13,19,15,5,12,10,18,17,27,2,14,17,4,7,17,31,17,13,6,26,39,11,11,9,0,0,13,38,8,4,15,8,11,11,9,13,27,4,25,11,19,3,8,7,25,15,9,24,37,21,13,13,5,11,13,16,7,6,14,14,13,28,8,13,14,20,28,3,13,0,13,5,9,23,10,36,18,25,24,11,6,14,11,2,13,19,16,31,19,31,18,22,19,5,13,21,19,18,14,31,9,8,10,17,5,0,7,17,6,6,3,6,22,17,6,9,2,35,16,11,19,16,11,2,7,4,11,4,20,2,18,8,8,12,33,9,16,12,4,15,24,14,7,22,10,5,3,13,7,1,17,28,18,0,18,10,6,5,15,22,17,13,5,0,2,9,7,18,11,8,12,10,7,7,8,12,4,16,2,6,10,14,24,13,15,13,8,22,14,15,9,76,3,0,9,6,13,33,2,10,13,25,26,7,8,8,11,9,3,24,14,0,19,26,4,0,7,0,21,7,3,32,13,2,6,17,14,16,37,32,2,13,18,17,13,21,0,17,3,11,3,2,8,13,14,15,11,4,6,4,3,15,15,4,8,16,3,0,10,10,16,8,14,10,19,17,0,5,6,9,10,14,5,5,10,7,3,11,18,8,10,19,15,4,24,9,0,3,4,4,7,13,12,0,6,19,13,4,12,9,10,11,11,5,8,17,8,2,16,12,5,8,3,12,8,1,172,17,9,8,15,11,9,16,20,6,2,3,13,5,0,16,0,5,6,6,11,5,16,14,5,10,6,7,2,5,0,3,22,62,36,12,0,3,35,9,16,13,7,4,46,10,20,11,12,14,1,8,26,10,13,16,8,5,21,2,2,1,98,0,3,10,1,7,1,14,1,6,11,9,12,3,0,8,23,10,6,13,0,0,18,4,2,18,3,6,6,3,8,10,26,7,5,5,4,2,17,27,0,12,715,13,1,20,24,0,1,2,19,3,3,7,3,29,8,8,0,4,1,5,8,4,0,1,3,2,6,3,3,9,12,20,4,12,3,2,3,5,13,8,3,2,8,10,20,4,11,8,2,4,15,5,17,3,0,26,2,3,4,3,8,0,14,11,2,9,7,0,0,0,6,13,6,8,6,3,0,14,8,9,14,10,18,12,9,3,11,8,4,4,0,3,9,2,1,3,5,27,3,8,6,12,10,11,3,8,6,4,5,23,14,29,7,0,0,13,17,8,9,5,1,4,10,8,1,9,2,10,1,3,2,8,0,4,13,2,10,6,23,5,2,3,1,9,9,13,2,4,6,3,4,9,5,5,6,1,5,5,9,14,0,10,11,0,4,2,4,1,7,0,20,2,4,8,20,3,14,7,0,5,17,2,6,6,12,0,7,0,0,3,6,0,5,4,9,5,12,32,4,8,0,7,2,34,7,0,0,6,5,0,9,3,11,5,0,0,11,13,2,6,0,9,4,16,3,7,16,2,9,4,3,0,1,4,0,2,7,1,8,20,6,19,0,0,1,0,2,4,4,1,4,8,3,0,1,22,2,2,37,2,0,7,7,548,12,1,9,1,13,2,4,13,7,0,3,9,3,0,1,13,9,7,4,16,5,6,6,1,3,0,7,10,2,6,5,8,17,0,12,10,22,9,4,1,7,6,9,11,3,7,9,5,5,1,8,15,22,2,2,14,9,7,2,7,28,11,10,16,3,0,4,5,1,3,5,3,17,0,9,16,10,6,0,3,0,5,21,8,8,16,2,2,12,6,1,25,8,1,16,23,4,1,0,7,5,5,1,12,12,0,9,14,0,2,22,0,4,0,11,3,0,17,9,5,4,52,9,11,1,21,7,3,1,2,4,4,0,1,7,0,1,0,4,0,3,0,0,3,0,6,2,2,2,0,10,18,7,2,2,4,5,6,4,4,5,3,0,3,2,13,4,0,0,7,7,4,11,11,5,11,1,2,7,1,4,2,3,2,7,24,8,0,2,3,0,11,3,4,4,6,4,4,0,4,8,5,0,8,5,7,0,5,2,0,31,3,6,6,25,4,6,67,5,1,5,12,14,2,10,6,7,2,5,9,13,0,0,4,1,9,0,0,0,0,17,0,7,4,7,3,2,3,1,3,6,4,0,2,7,45,9,5,10,5,9,8,2,1,2,2,14,4,15,4,4,5,2,1,1,4,18,2,6,6,16,6,0,8,6,10,9,9,6,1,15,5,13,9,3,19,12,5,2,1,2,9,0,3,3,5,5,7,0,11,7,5,2,6,4,3,8,2,9,7,2,6,0,0,0,0,5,5,0,4,6,8,12,2,1,1,2,0,2,5,8,0,8,5,8,1,5,4,1,1,7,0,2,0,3,4,1,9,414,6,3,7,5,5,3,7,0,3,2,7,9,2,5,6,16,1,2,6,9,0,7,0,7,5,1,15,6,8,13,8,7,11,6,2,6,4,2,1,5,4,2,8,0,1,29,4,2,8,0,5,2,2,3,3,1,3,6,4,2,5,1,1,3,2,8,4,0,2,2,16,0,0,7,10,1,10,3,13,0,17,2,9,4,6,3,2,5,3,0,4,9,5,0,0,1,6,3,2,3,10,3,4,0,6,5,16,15,1,0,3,1,3,6,5,16,6,9,10,2,0,0,3,2,10,1,1,5,3,14,10,11,0,10,5,3,6,10,7,5,3,2,3,6,1,1,4,4,1,9,8,3,0,5,10,10,10,2,2,0,0,1,2,2,5,11,1,5,0,4,1,2,14,1,3,0,1,3,1,2,3,1,2,3,3,13,7,6,1,1,9,7,6,0,8,6,9,4,0,0,3,7,0,2,0,0,0,6,6,3,5,8,8,3,0,6,11,4,2,6,8,14,7,4,11,1,8,10,4,7,3,1,2,1,7,3,5,3,2,0,2,4,4,3,0,11,17,0,6,5,4,3,5,7,5,3,0,4,25,0,1,6,2,1,8,7,2,6,4,1,6,0,3,12,3,4,0,0,0,2,0,3,5,3,0,3,0,3,5,0,5,1,9,7,5,2,3,0,0,5,5,10,4,1,4,6,0,4,0,4,3,0,3,1,0,0,0,2,0,0,13,2,1,0,1,0,8,3,1,9,1,1,0,12,2,3,1,3,0,10,5,16,1,3,0,7,3,1,0,0,2,5,6,6,6,6,1,3,3,0,4,3,11,2,3,2,20,17,3,1,4,5,3,1,3,1,3,7,6,3,4,1,6,4,0,7,3,4,2,5,3,2,4,22,2,0,1,0,6,11,6,0,1,2,2,0,3,1,0,4,6,2,2,5,1,4,5,5,4,40,0,2,2,0,3,2,13,10,4,8,0,16,6,2,1,6,1,1,0,5,5,17,11,3,1,4,0,2,3,0,0,0,15,6,2,4,12,6,3,2,7,1,0,0,0,6,4,1,14,7,4,8,8,4,4,1,4,0,1,1,0,5,0,19,1,15,6,3,9,4,5,11,2,1,0,0,5,0,1,0,0,0,6,1,8,5,1,2,4,0,0,3,5,3,1,3,5,0,2,2,5,4,5,1,0,0,0,5,0,0,9,0,2,0,11,3,0,5,2,0,0,5,4,1,2,3,7,9,5,0,5,0,0,11,4,4,1,1,0,7,18,8,5,4,2,1,2,5,0,3,2,1,1,6,5,6,0,3,1,2,3,5,0,0,4,1,1,5,7,3,2,6,0,1,2,1,6,3,6,3,4,11,5,4,3,0,0,1,2,2,7,4,3,0,3,3,6,0,2,2,1,5,9,3,1,5,2,2,0,4,3,9,6,3,5,2,2,1,3,0,3,7,3,3,0,3,6,0,2,1,0,3,2,3,6,5,10,5,8,3,2,0,1,2,8,4,1,0,3,18,1,1,2,1,4,11,1,1,0,2,0,7,0,4,11,2,3,11,5,3,0,1,4,4,4,1,5,8,0,31,2,9,2,7,1,0,1,9,2,1,6,3,1,6,4,0,1,1,2,6,8,2,2,2,0,0,5,1,1,10,0,2,0,3,1,0,3,0,2,1,12,4,1,4,6,4,5,3,3,0,0,0,1,2,1,6,0,0,8,5,13,0,2,0,3,1,3,4,3,2,2,1,8,4,2,1,0,1,5,0,0,0,4,1,2,11,3,0,1,0,11,2,0,2,0,4,7,5,4,0,8,0,1,10,1,0,1,9,0,18,3,19,3,5,1,1,0,4,4,1,1,0,3,0,5,2,4,12,1,0,0,1,5,0,3,1,2,6,1,3,8,0,0,0,2,1,0,0,2,0,1,2,0,1,1,0,6,5,0,8,0,3,2,0,1,2,1,0,0,2,0,2,2,5,1,2,3,4,3,6,2,2,0,0,0,0,2,4,0,3,0,2,1,12,2,1,8,2,3,0,19,1,6,0,16,4,1,5,2,7,1,2,6,4,3,0,4,0,0,2,0,2,5,6,0,5,0,0,0,0,3,2,1,6,0,4,4,1,2,4,1,2,19,7,1,0,2,0,0,3,0,0,5,8,0,4,1,2,8,4,1,5,3,0,0,0,1,2,6,3,0,4,1,3,1,2,4,1,4,2,0,20,4,1,1,2,2,8,3,2,1,0,1,0,4,3,2,1,5,1,49,3,0,4,1,2,1,1,0,11,0,2,0,3,0,0,2,14,1,4,0,0,1,1,0,0,0,1,9,2,4,3,40,2,1,3,1,3,2,4,3,8,13,4,1,2,0,0,4,0,1,2,2,2,3,0,2,1,2,4,0,7,0,1,3,1,1,0,0,1,2,0,4,1,0,3,1,0,3,7,1,2,0,0,3,1,0,0,3,2,5,0,0,0,4,1,3,5,2,5,1,1,3,1,1,0,0,0,3,0,0,0,2,5,1,24,5,0,4,4,7,0,0,2,0,3,0,0,0,0,2,4,1,0,9,1,1,5,4,3,0,2,2,3,2,1,3,4,0,5,4,0,4,5,3,0,0,0,2,2,1,1,1,0,1,2,0,4,1,1,0,1,5,1,1,5,3,1,0,3,0,0,4,4,11,2,1,13,2,2,7,1,4,0,1,4,5,1,0,0,1,2,1,4,6,4,0,1,1,3,1,2,1,1,1,0,2,3,3,2,0,1,4,8,8,0,0,1,4,3,1,6,5,5,2,10,5,5,1,0,0,1,0,3,2,2,0,8,1,4,4,2,2,0,16,0,0,2,10,2,0,2,0,0,0,0,2,1,2,1,0,0,7,2,3,1,0,0,1,0,0,1,0,0,3,6,2,4,1,0,1,1,1,3,6,2,3,4,3,2,0,7,1,2,0,4,0,2,0,2,0,2,4,2,2,5,0,8,4,1,0,0,2,0,5,0,7,1,1,0,0,0,1,9,4,2,2,0,1,0,1,6,60,4,1,0,0,2,2,2,1,2,6,4,0,3,0,0,6,2,0,1,0,3,0,1,0,0,0,4,0,1,2,4,0,2,3,0,0,2,0,1,5,0,1,5,1,6,1,0,0,0,0,0,4,1,12,0,4,4,1,1,0,5,0,8,0,9,0,0,7,1,6,0,1,0,20,59,1,3,0,2,2,2,1,3,1,1,4,2,3,1,1,4,14,0,0,4,0,0,7,3,7,3,3,1,1,0,2,2,0,2,1,4,9,3,4,0,1,4,2,2,2,0,2,0,4,0,4,1,4,6,0,2,1,2,0,5,0,2,2,3,0,4,1,0,0,1,0,3,0,1,3,2,1,3,0,6,0,2,5,1,0,1,1,1,0,3,0,7,0,6,3,1,188,3,3,2,1,3,1,3,1,1,0,1,3,4,0,1,0,2,0,4,2,0,2,1,2,1,0,2,12,6,3,0,0,2,159,8,3,1,5,4,1,2,3,0,0,0,1,1,0,0,0,0,5,0,0,0,2,0,3,5,1,2,6,0,0,0,1,2,9,1,7,0,0,2,1,2,4,3,2,0,0,0,3,2,1,2,2,3,1,2,5,9,1,0,4,0,0,1,1,9,0,0,2,0,1,9,1,0,0,0,4,3,0,1,0,0,1,0,2,1,1,5,1,7,1,1,3,1,1,2,4,5,1,3,0,0,5,4,0,3,0,0,1,2,5,0,2,2,1,0,6,0,0,0,2,3,2,2,4,4,0,3,0,1,4,4,9,2,0,1,2,3,0,0,5,1,1,3,2,4,0,0,2,1,2,3,1,2,0,0,2,0,3,0,1,0,0,2,3,1,2,1,1,0,1,6,2,3,0,0,4,1,3,3,1,0,8,2,1,1,3,1,0,4,0,1,3,4,2,6,0,0,1,1,2,8,0,1,0,3,0,12,1,3,0,1,1,0,3,1,1,2,2,3,1,0,4,2,0,0,15,7,0,2,3,0,0,0,2,7,0,1,5,0,0,0,8,4,1,1,2,2,0,0,1,13,0,0,0,4,2,0,1,4,0,0,1,0,4,0,1,1,7,1,1,0,0,0,0,0,0,3,155,0,0,1,1,1,8,0,1,2,5,1,1,0,9,1,2,3,0,3,0,2,2,6,3,0,1,4,0,4,4,2,4,4,4,1,1,1,8,1,2,1,0,0,2,1,1,0,0,0,2,0,0,5,0,0,6,0,2,0,2,1,1,1,1,1,0,11,0,1,3,1,1,6,0,7,1,1,3,0,1,3,1,0,0,3,0,0,9,4,1,0,4,2,6,0,2,0,5,2,0,0,0,1,3,0,7,4,13,8,0,3,4,3,3,7,3,0,1,0,0,0,0,0,1,0,1,5,0,0,9,5,1,1,1,0,4,0,4,0,1,1,5,1,1,0,1,1,1,4,1,5,0,0,0,0,0,0,0,5,3,0,0,0,1,2,0,1,0,1,1,2,2,2,0,0,4,2,5,4,0,6,2,5,0,1,0,0,0,2,0,1,1,3,0,2,4,4,1,0,0,2,1,1,0,2,1,4,1,2,7,4,1,2,3,2,0,0,3,1,1,1,2,0,4,2,0,5,2,0,6,3,2,1,4,1,0,1,1,3,1,3,0,0,0,1,2,0,2,0,1,2,1,0,1,1,0,0,2,4,0,0,2,2,5,0,3,0,8,0,5,3,2,0,0,0,1,9,1,0,0,0,8,0,1,0,5,0,0,2,0,2,5,0,2,6,0,0,1,4,1,6,1,2,0,0,0,4,1,0,2,7,2,0,0,5,1,0,1,1,3,8,0,0,3,0,0,0,3,0,0,5,2,2,2,4,0,1,0,0,1,2,1,4,0,0,0,4,0,0,8,4,2,0,0,0,3,6,0,5,1,0,1,2,0,4,2,2,0,0,0,0,4,7,0,0,3,0,3,9,0,2,2,0,6,1,0,1,0,2,3,2,0,0,0,2,0,0,3,0,0,2,5,1,0,0,1,2,0,1,0,2,1,4,0,1,1,0,1,2,1,0,2,2,4,0,1,0,0,0,0,4,2,0,2,0,0,12,3,2,3,1,0,0,0,0,0,1,3,3,0,0,0,5,0,0,1,1,0,0,8,4,1,1,0,30,0,0,12,3,0,4,0,1,3,0,2,0,1,0,1,5,1,0,2,1,0,3,0,0,0,0,0,0,1,4,0,0,14,3,4,0,6,1,5,2,2,6,1,0,0,2,1,0,1,1,0,0,1,0,0,3,0,0,0,2,0,0,8,0,0,5,1,1,2,5,0,5,1,1,0,44,0,0,1,1,1,1,1,1,0,2,1,0,2,1,1,6,8,0,6,0,0,0,2,0,2,5,1,0,0,0,2,0,1,0,1,0,2,1,0,0,3,1,0,3,0,0,0,3,4,1,1,0,1,1,1,5,0,1,1,0,0,0,2,10,4,0,0,1,1,0,3,1,1,0,1,5,0,1,0,0,0,1,2,3,1,2,0,2,0,2,1,1,0,1,3,1,0,0,0,1,0,0,0,0,0,1,0,0,1,0,0,1,0,50,1,1,4,1,1,4,6,1,0,0,1,0,0,0,2,3,1,1,9,0,1,6,0,0,0,12,0,4,0,2,1,0,0,3,0,4,0,3,2,0,0,0,3,2,1,0,1,2,0,0,25,1,0,3,0,1,0,0,4,1,0,0,0,0,5,1,0,13,0,0,0,0,1,0,0,0,0,5,1,1,2,3,2,0,0,0,0,0,0,0,0,2,0,0,4,1,1,0,1,0,1,1,0,0,0,0,0,33,0,3,6,3,2,5,0,0,3,1,2,0,7,0,3,7,1,2,0,2,2,1,0,1,1,0,0,0,0,1,0,0,0,0,4,3,0,0,0,1,0,0,0,0,4,2,1,1,0,0,1,0,1,4,0,0,0,0,0,0,0,1,7,1,1,0,4,0,0,0,0,1,0,2,0,2,1,1,0,0,0,0,0,0,0,3,2,0,1,1,0,2,1,0,0,1,0,1,0,1,1,2,0,0,2,3,0,3,5,0,0,0,3,2,4,0,1,0,6,2,1,0,0,0,1,1,1,1,1,1,3,0,6,1,3,0,0,1,0,0,0,3,1,1,1,6,1,0,1,1,0,0,0,0,2,0,0,0,0,1,2,5,0,2,1,2,0,1,1,5,4,1,2,3,2,1,1,0,2,1,0,3,0,3,0,0,0,1,5,0,0,0,0,1,7,0,0,0,0,0,2,4,0,0,0,0,0,0,3,1,1,1,4,3,5,2,3,0,0,1,1,3,1,3,0,0,0,1,2,1,1,2,0,2,0,0,0,2,4,0,7,2,3,0,1,2,1,1,0,0,0,1,6,0,3,3,1,0,3,2,0,3,2,0,2,2,3,5,1,0,0,2,0,0,3,1,0,1,4,0,0,0,0,0,3,0,0,0,1,0,2,0,0,0,0,1,0,0,0,0,1,0,0,0,0,0,3,2,1,2,2,0,4,1,0,4,0,0,0,0,5,2,0,0,0,0,7,1,1,0,0,0,1,11,0,0,0,0,5,0,3,1,0,3,1,0,0,3,0,2,0,1,0,2,1,6,1,0,1,1,1,0,1,3,0,0,1,2,0,0,0,0,1,3,0,1,0,2,1,0,0,1,0,1,2,1,0,0,0,0,2,1,0,1,2,1,1,3,0,0,2,0,0,0,0,6,2,0,0,1,1,0,3,1,0,4,0,0,0,1,0,0,0,2,2,1,0,1,10,0,0,1,2,1,0,0,0,3,1,0,0,0,2,5,0,1,1,0,1,3,0,3,2,5,1,0,0,3,0,0,3,0,0,0,1,1,0,0,1,4,1,1,0,8,4,1,1,1,2,3,1,0,1,0,10,1,2,3,1,0,3,0,1,0,0,1,0,1,1,0,0,0,0,1,0,1,0,2,0,0,0,1,4,0,1,2,4,2,0,3,9,2,0,1,3,0,1,0,0,1,2,0,0,0,1,0,0,0,2,0,3,0,0,1,1,1,1,2,0,1,1,2,0,1,0,1,4,0,0,2,0,0,0,0,0,1,8,0,1,2,2,2,0,0,4,0,0,0,0,0,0,1,0,3,0,0,1,1,0,0,0,2,0,0,0,1,1,2,0,0,0,1,0,0,1,0,1,2,4,0,0,1,0,2,1,1,0,5,0,1,2,0,0,0,0,3,0,3,0,0,3,0,0,0,17,1,2,4,2,1,0,2,3,1,2,0,0,0,0,1,0,0,0,0,0,0,0,0,1,3,0,0,0,0,0,0,0,5,0,0,0,0,4,4,0,3,2,0,0,1,0,0,2,0,0,0,0,1,0,2,0,1,0,0,5,5,2,2,0,0,0,0,0,0,2,2,0,0,0,0,0,3,1,0,2,2,1,0,0,2,1,0,2,1,0,0,0,0,0,1,4,1,3,0,2,0,0,0,2,1,1,0,0,0,0,0,0,0,2,0,0,0,0,0,0,0,1,0,0,0,0,0,0,0,0,1,0,0,0,0,0,0,0,0,0,0,0,0,0,0,0,0,0,0,0,0
"1980 Irving, John, The World According to Garp",high,10247,4597,4923,4215,3867,1466,3838,2680,3923,2233,1491,2357,2409,2840,2728,1087,1872,1332,1462,2237,1184,1405,938,1406,370,1196,349,926,583,707,620,572,681,785,658,796,812,667,188,731,650,568,652,520,530,671,513,588,1016,296,322,568,589,312,499,425,505,410,340,376,247,378,604,268,277,315,338,288,281,369,246,224,271,280,210,352,164,246,257,125,229,333,324,190,223,273,253,192,332,355,173,216,401,167,203,232,141,289,260,157,315,243,197,238,447,229,190,194,201,180,152,283,82,223,273,142,174,229,239,225,458,78,173,119,178,420,232,144,405,144,216,127,142,154,161,201,45,138,123,152,147,134,135,151,231,97,134,130,112,55,135,287,60,161,128,84,85,118,98,154,196,297,89,121,50,117,194,109,97,99,31,157,115,103,152,83,167,102,107,114,200,183,101,79,112,137,116,87,65,102,62,74,148,70,65,129,225,78,227,123,69,140,201,126,102,36,44,51,133,95,340,153,105,72,110,77,89,69,111,78,80,138,116,63,66,61,134,127,74,142,55,107,34,53,81,77,107,80,72,128,72,55,45,95,97,101,70,63,132,59,111,60,46,43,61,52,88,46,88,160,77,68,120,55,168,70,86,94,50,53,82,110,202,41,86,46,41,52,66,57,60,18,68,43,113,37,99,83,87,28,25,63,87,186,34,58,90,52,75,68,69,66,42,24,57,59,57,115,67,29,56,21,55,63,112,69,7,30,42,28,83,72,63,163,116,59,50,72,195,33,48,46,74,49,53,36,37,190,76,60,24,41,61,37,34,96,79,6,54,56,110,47,53,61,42,130,35,48,39,81,29,31,43,127,53,30,39,57,38,60,60,38,18,49,27,72,85,53,69,40,30,44,18,32,24,62,0,50,47,25,159,32,143,12,37,87,34,41,62,11,156,62,20,53,50,57,45,42,25,60,66,56,68,48,24,114,35,20,22,71,27,0,11,40,50,21,63,26,49,13,14,61,21,35,38,31,52,27,9,33,23,40,29,41,74,22,72,33,52,25,23,31,58,35,52,41,45,181,34,67,28,18,0,53,39,60,70,24,65,33,29,20,41,15,0,47,31,15,3126,35,21,22,50,21,157,35,20,8,23,19,46,25,28,67,61,40,22,24,62,36,41,37,10,15,28,16,12,67,21,12,47,32,19,54,35,46,0,38,30,19,56,42,31,58,57,38,44,32,21,31,271,27,50,37,37,2,31,47,46,24,34,23,62,23,33,37,0,14,15,40,22,14,12,13,33,38,83,25,53,38,30,13,43,184,148,19,21,8,84,28,82,26,29,25,108,50,13,32,22,34,45,24,18,19,2,14,27,33,23,21,33,13,24,29,34,25,60,21,30,27,52,22,21,24,27,0,41,16,6,18,19,3,14,32,5,30,38,9,21,39,50,35,41,28,35,10,2,32,7,11,38,43,21,96,47,0,9,15,39,10,23,14,19,17,1,17,37,32,29,39,0,19,22,20,12,28,18,25,24,7,29,24,14,11,68,28,19,24,37,23,16,8,70,21,23,22,23,27,21,16,19,11,22,40,32,18,2,30,14,2,18,18,10,12,26,6,69,8,11,32,8,5,22,4,18,38,37,23,36,39,5,10,39,19,37,66,21,13,9,36,11,90,4,31,10,21,19,24,45,17,14,12,43,11,0,29,14,44,16,9,18,21,58,44,111,0,12,31,12,27,18,5,39,37,3,13,7,34,12,56,29,20,17,37,11,35,17,14,32,51,22,6,3,19,126,16,60,43,36,40,35,45,11,3,85,22,5,34,12,30,12,36,2,43,11,54,0,18,1,11,23,31,22,42,6,8,97,29,10,24,14,59,30,8,8,11,5,0,13,25,33,232,16,22,26,17,14,14,15,9,36,1,3,9,0,16,39,13,0,7,18,20,39,24,36,9,18,0,7,3,30,22,20,19,8,5,4,3,126,19,10,19,1,11,3,14,113,0,14,35,15,7,14,15,1004,32,11,20,51,18,27,24,18,18,5,13,18,20,35,11,27,23,38,8,26,32,38,0,5,78,35,25,11,13,21,17,30,5,27,9,19,0,17,0,26,16,4,14,11,14,21,0,13,8,36,31,33,1,22,0,23,8,6,20,16,10,17,24,19,4,12,34,24,6,13,5,14,10,14,6,15,23,47,30,6,13,19,12,19,23,0,24,15,1,38,28,18,11,18,18,8,0,14,85,58,20,23,38,13,0,0,18,18,6,12,0,13,0,7,5,5,13,17,14,35,13,1,25,32,0,11,0,28,0,11,10,0,0,49,9,20,11,17,9,15,13,18,0,24,17,1,17,26,2,5,3,12,9,6,15,30,3,23,15,12,16,19,59,20,18,25,20,2,4,6,20,10,4,5,3,32,11,42,22,12,12,13,24,3,16,25,27,0,16,4,34,9,15,3,0,0,1,13,24,5,20,32,0,23,18,2,6,10,31,4,12,8,45,18,3,13,0,23,13,13,7,6,14,30,8,16,16,18,10,13,3,3,35,8,9,22,16,3,31,0,70,22,11,24,7,10,7,15,13,10,8,17,8,46,10,3,58,10,2,14,34,23,10,9,12,46,27,9,12,7,6,6,7,4,5,8,1,10,12,9,4,3,26,10,55,9,8,11,22,0,7,7,21,1,1,3,11,2,11,11,6,0,7,10,0,22,14,8,5,9,19,0,8,19,0,10,33,0,28,7,5,13,64,3,12,6,0,48,26,5,8,1,11,41,14,0,5,32,6,44,0,0,11,6,8,12,1,5,0,11,67,14,10,34,10,7,3,21,33,9,0,25,75,5,18,2,14,13,0,9,20,0,3,14,9,7,17,19,7,2,13,12,38,0,4,9,0,10,21,0,19,12,0,2,6,0,1,13,2,0,7,6,13,0,20,14,28,9,19,26,12,10,9,16,12,0,22,15,21,11,12,66,10,3,4,10,10,4,26,3,7,3,15,5,15,5,0,67,31,7,7,14,99,21,10,9,15,13,0,12,6,8,17,21,17,2,12,11,15,21,16,6,0,64,14,12,15,38,0,8,13,0,3,12,7,9,26,46,5,19,7,8,7,12,4,10,14,1,0,11,12,14,13,3,11,6,13,8,8,6,0,0,19,0,6,21,0,7,18,10,6,3,4,1,4,12,27,19,4,13,26,26,0,21,4,878,0,0,10,0,15,10,0,57,5,22,17,22,12,0,25,18,3,28,16,3,6,8,11,19,7,5,2,6,12,16,7,0,0,1,3,2,2,5,17,4,15,9,11,6,26,2,13,27,37,13,14,0,28,6,0,7,27,49,0,21,21,8,0,5,10,37,0,5,7,7,3,28,8,0,4,5,34,1,7,14,17,2,2,13,8,6,9,15,7,25,11,3,28,11,4,0,0,283,1,22,0,10,0,0,4,0,4,10,0,7,20,9,89,26,12,5,0,0,8,2,11,13,15,15,6,6,3,1,43,16,14,11,7,10,0,2,44,6,16,15,0,8,21,5,7,9,0,3,2,9,12,25,6,49,16,11,0,2,5,17,3,35,1,16,4,9,15,7,0,5,17,23,0,6,11,11,7,12,11,49,15,11,3,11,12,8,11,0,14,0,19,3,0,6,4,2,0,18,4,0,0,0,11,8,4,20,30,9,9,6,10,7,42,10,4,0,13,0,4,4,14,17,0,18,8,15,8,10,3,13,0,2,26,13,2,18,15,7,10,4,24,5,9,0,0,0,6,2,13,0,1,9,10,1,23,3,3,4,6,4,17,15,21,17,9,10,0,10,0,4,15,15,7,13,15,1,14,1,2,4,3,6,5,10,0,7,3,5,9,6,0,7,2,1,8,2,0,21,10,1,5,12,15,9,19,3,7,5,12,3,6,19,3,3,8,2,1,0,8,10,14,2,5,28,15,3,1,25,16,2,7,9,0,7,15,9,26,12,8,4,3,4,4,0,24,7,0,7,5,2,2,7,8,0,15,4,11,7,8,20,9,19,11,12,15,4,8,23,0,1,10,1,8,8,5,9,17,0,17,4,5,7,9,3,18,4,11,5,13,18,3,2,28,5,3,2,17,1,14,15,12,21,19,14,2,7,14,10,12,15,7,6,5,17,0,3,0,4,4,16,6,0,0,15,11,0,19,0,0,0,28,3,3,24,29,13,19,0,17,1,4,0,2,1,9,15,19,10,0,3,8,11,8,6,5,8,8,12,9,10,10,1,0,6,3,14,6,0,28,1,3,1,5,3,7,10,26,11,5,0,1,15,23,2,7,13,12,4,13,3,1,0,4,2,0,3,4,34,8,0,1,11,3,0,13,0,4,0,7,0,11,2,1,9,3,4,12,6,8,20,0,0,10,7,2,7,4,3,3,5,28,0,1,31,0,8,2,0,3,0,13,0,6,26,3,5,27,1,0,2,12,2,3,1,0,1,13,8,3,1,1,3,7,4,7,2,5,24,19,2,11,0,0,3,9,1,8,17,6,0,7,5,1,2,9,1,26,0,7,3,7,22,9,1,14,9,0,12,3,11,0,17,4,0,6,1,4,4,4,3,8,1,11,5,5,5,16,11,15,11,4,10,6,11,0,4,27,2,0,14,19,9,11,4,4,0,1,8,2,2,17,4,0,0,7,1,7,8,1,7,11,7,3,6,13,7,4,9,8,8,3,7,9,6,3,2,1,9,4,0,2,3,3,0,1,10,29,0,17,3,8,18,9,7,12,0,0,4,2,7,2,7,2,7,5,10,2,13,9,0,2,3,6,1,9,545,0,6,2,2,11,4,11,6,1,14,1,0,147,11,0,4,5,0,0,3,14,1,8,6,7,9,3,0,9,1,11,4,2,24,5,9,1,6,9,1,0,0,5,3,0,3,2,16,0,9,1,3,0,0,4,2,4,10,4,3,2,20,12,3,0,10,0,5,0,0,1,11,2,5,0,0,1,6,17,5,11,4,2,14,1,9,7,2,23,8,2,8,1,0,1,19,2,5,8,0,0,5,7,1,7,4,9,10,2,0,23,25,8,5,5,9,6,8,1,4,5,1,6,2,3,9,1,4,7,8,249,4,0,9,1,2,7,8,6,4,7,2,9,9,10,9,10,4,1,4,4,5,2,12,2,1,1,7,3,5,14,8,0,0,0,4,12,0,1,17,25,3,28,1,3,9,3,3,4,35,5,9,4,6,4,13,9,16,10,1,2,7,4,9,2,5,18,25,9,6,4,3,3,7,1,5,6,13,5,14,1,2,11,2,0,0,2,5,2,6,1,11,8,0,21,13,6,1,0,3,1,3,2,4,3,0,7,12,1,5,4,16,10,6,4,8,8,286,10,0,0,1,1,2,8,5,8,5,2,3,1,2,11,6,63,15,1,87,0,7,5,8,11,45,1,0,1,1,0,2,306,5,5,15,4,1,2,8,1,2,0,0,8,8,10,2,0,0,21,0,7,3,0,8,0,20,6,1,1,1,0,0,5,9,11,6,10,33,0,2,2,25,0,7,21,18,0,13,1,3,0,9,8,0,5,32,0,22,0,4,4,8,43,11,11,7,1,0,5,5,1,2,11,3,5,1,3,94,9,0,32,1,4,0,1,2,6,10,5,0,8,6,13,2,4,4,5,0,15,9,0,2,4,9,0,8,5,4,9,6,3,17,0,5,3,2,3,0,8,433,0,0,0,3,5,0,6,0,1,23,5,5,3,2,5,14,5,9,3,1,11,6,25,3,16,5,2,4,0,2,4,7,3,11,0,6,1,11,5,2,8,4,12,5,2,0,5,5,6,6,0,0,3,1,2,11,1,8,10,1,1,6,8,12,0,0,8,0,0,8,10,0,4,1,8,2,12,6,13,5,20,0,3,4,6,6,12,3,8,4,10,12,0,1,1,3,8,1,4,1,2,10,0,4,0,2,2,6,4,10,0,15,1,13,4,3,19,0,0,31,2,0,6,1,4,0,0,1,3,0,2,4,0,3,0,3,1,4,0,7,7,0,0,234,2,9,3,9,1,6,2,3,6,6,4,6,10,6,1,14,5,14,2,0,29,14,80,4,6,7,10,4,0,1,7,13,4,2,3,0,3,4,10,3,0,2,5,4,0,1,12,6,0,8,3,12,4,4,17,6,9,4,5,8,6,5,9,12,8,0,1,8,2,7,5,4,4,6,4,6,4,0,1,7,0,11,3,1,0,0,6,5,6,0,0,0,4,3,0,8,3,3,5,0,0,0,2,1,0,9,0,5,2,0,6,0,7,6,13,6,6,2,2,13,2,0,4,2,0,9,7,7,2,16,0,4,5,2,14,4,0,8,71,4,6,2,14,3,3,0,3,10,3,6,4,2,6,0,0,3,1,1,3,0,0,10,2,8,10,6,0,2,3,0,8,5,5,7,2,13,5,8,2,1,0,10,0,3,4,7,4,2,0,3,2,0,43,0,14,0,3,3,8,0,24,8,0,4,2,5,0,2,12,8,6,4,2,0,11,0,8,39,1,16,0,1,4,5,11,18,0,1,0,34,4,2,4,5,8,3,0,0,0,9,8,1,1,4,3,1,2,6,9,6,5,8,0,0,2,0,0,1,3,3,2,7,9,5,16,5,1,0,1,0,18,6,6,0,3,0,11,16,2,8,3,5,6,7,5,1,8,0,7,0,8,1,17,0,0,7,1,1,0,6,1,2,1,0,12,5,10,0,0,2,0,2,0,4,1,0,4,7,0,0,4,13,9,3,9,11,3,0,2,0,0,1,5,11,6,3,3,0,9,0,0,0,5,9,4,1,2,0,6,1,0,0,15,5,3,1,0,1,24,5,4,12,2,0,0,0,15,0,0,2,0,3,5,2,5,11,4,19,0,0,2,0,8,15,9,23,2,2,10,2,1,0,5,2,0,0,6,4,5,7,1,4,0,2,7,5,4,8,2,0,1,0,6,1,5,6,5,5,4,0,0,3,2,0,4,4,6,4,6,0,0,0,3,3,14,0,1,3,0,1,0,3,2,3,6,0,4,12,19,2,16,2,2,3,2,2,1,1,6,3,11,0,23,0,7,9,5,4,4,5,3,10,10,1,0,6,3,5,17,0,2,0,2,6,0,1,5,0,1,9,10,8,4,0,7,0,1,3,7,2,8,4,0,1,8,0,8,1,14,0,6,7,3,4,2,0,7,9,4,13,4,0,2,1,5,4,4,2,5,4,0,3,2,9,1,0,0,0,2,11,5,3,1,1,1,3,0,1,0,0,0,4,3,1,7,1,10,12,6,4,5,10,0,1,10,10,2,9,0,4,16,10,2,0,16,0,7,13,3,1,0,2,6,21,8,5,3,3,0,2,1,16,1,3,0,4,3,11,4,0,11,0,0,2,4,1,0,10,1,1,6,1,1,8,0,3,0,12,9,12,6,3,8,2,12,0,0,5,3,3,0,5,2,2,2,4,0,4,7,3,0,8,3,10,3,3,1,2,3,4,2,1,6,4,3,3,0,1,4,0,8,0,0,0,3,4,6,2,0,3,5,17,1,1,6,0,1,6,3,5,1,2,8,0,2,1,0,1,5,5,2,11,4,14,0,0,2,2,1,2,9,0,3,4,0,9,2,0,4,3,2,3,14,5,0,4,3,3,0,1,3,2,24,0,1,4,3,101,6,18,9,7,0,0,2,4,10,4,0,3,2,1,26,2,0,5,14,0,9,2,10,7,2,6,3,2,5,1,6,4,0,2,7,0,1,0,2,4,4,8,0,0,1,3,0,0,4,2,0,8,2,0,1,1,2,3,0,0,22,0,2,2,0,0,0,7,3,5,1,0,0,1,5,0,5,3,0,4,0,1,0,1,0,3,7,4,6,4,5,0,5,6,5,0,5,9,0,0,4,2,8,2,9,2,1,2,0,0,7,3,2,6,0,0,3,0,2,0,2,19,8,0,5,0,5,3,0,4,0,4,4,7,0,1,3,4,6,1,4,12,5,2,10,0,2,0,3,1,5,11,2,1,1,16,5,1,1,12,2,0,1,4,3,6,2,1,0,3,5,5,0,0,3,1,2,3,10,1,2,3,3,10,4,6,2,3,6,0,0,0,4,8,7,1,0,5,0,3,14,0,8,0,3,0,5,1,0,1,0,2,3,4,2,8,2,7,9,4,2,6,0,1,0,3,0,305,1,3,2,3,0,1,0,9,0,8,6,0,3,0,3,1,12,0,1,12,0,1,1,0,3,0,4,1,1,8,2,2,4,0,2,0,7,0,1,0,4,2,3,1,3,6,10,0,2,0,9,0,3,2,1,2,4,3,4,2,0,0,3,5,0,11,1,9,1,2,6,0,1,1,10,6,0,3,3,6,3,0,3,6,2,0,0,0,1,0,2,2,3,0,1,3,1,1,4,3,2,2,30,0,0,0,0,6,3,2,1,0,5,1,1,0,4,1,0,0,1,2,2,4,2,14,3,0,12,2,0,2,0,3,4,3,0,2,8,0,0,2,6,22,8,0,10,32,0,2,1,1,0,6,1,3,0,17,6,6,0,0,1,3,0,4,0,0,1,0,0,5,0,0,0,1,15,0,0,0,1,0,0,4,0,2,3,1,0,0,5,0,4,1,1,0,0,0,0,2,3,0,2,2,2,6,1,1,3,0,22,9,3,8,0,5,2,0,4,0,0,6,0,6,0,3,1,17,14,1,5,12,3,1,5,0,4,7,7,0,0,7,4,4,0,5,2,1,2,7,0,3,16,1,1,1,1,0,5,34,0,0,5,0,14,0,4,0,0,0,2,0,0,0,2,1,3,7,2,5,2,0,9,2,8,5,6,4,2,1,0,2,2,0,0,1,2,0,2,6,0,0,0,0,2,0,1,0,7,2,12,2,1,8,5,3,10,0,4,9,1,9,0,1,8,5,2,3,3,4,0,1,0,2,0,0,2,1,4,4,0,1,1,0,3,4,1,5,1,3,3,3,20,2,5,0,12,13,0,3,0,6,2,8,0,4,0,0,0,3,3,0,0,0,0,1,5,0,0,0,0,0,3,3,0,1,0,7,5,2,5,0,7,0,2,12,2,1,6,13,1,3,7,0,0,2,0,24,10,10,2,0,0,0,2,2,4,0,7,0,1,3,11,5,0,1,5,0,0,8,10,4,13,1,2,4,0,2,3,0,6,3,1,1,4,0,2,1,5,4,1,0,4,1,0,0,2,7,21,6,6,9,2,3,0,0,9,3,4,0,2,4,3,4,0,9,1,17,1,12,0,6,0,0,1,1,1,3,5,1,0,3,0,12,2,1,4,0,0,1,1,2,1,0,5,1,4,9,0,2,2,1,5,4,4,2,8,1,0,2,0,0,0,1,0,0,7,0,0,1,1,5,1,1,3,12,6,1,5,2,5,2,3,3,2,6,1,0,1,0,0,6,1,0,3,7,3,0,3,3,3,0,0,1,0,0,4,2,0,0,0,3,0,1,7,0,0,3,0,0,2,2,0,2,0,2,4,6,0,4,1,9,7,10,2,0,3,6,0,0,4,2,5,0,1,3,0,1,6,15,1,11,28,0,2,1,0,10,5,2,0,3,6,0,0,0,0,0,2,1,0,0,22,6,14,0,0,0,2,6,0,4,2,2,0,84,8,3,3,0,3,2,0,0,1,5,5,3,1,1,2,0,6,0,5,0,1,0,0,2,4,5,1,4,0,2,2,2,0,0,5,4,8,0,3,0,0,5,2,10,0,0,7,2,6,0,2,0,0,3,4,1,0,6,1,0,0,5,2,4,2,0,1,7,4,1,0,1,4,1,5,3,0,1,8,1,0,2,1,2,22,4,0,1,1,1,6,2,5,3,3,1,0,3,1,3,0,0,1,2,0,0,1,4,0,3,5,3,0,0,1,6,0,5,0,0,0,1,3,0,4,3,4,3,0,1,14,3,0,0,2,2,7,0,0,1,3,5,5,1,1,8,1,0,1,1,2,2,3,5,0,4,0,8,3,0,0,2,1,1,1,0,0,7,2,1,1,1,1,0,1,0,0,4,0,0,1,3,0,0,3,10,36,3,4,4,7,0,3,1,2,6,0,3,4,0,1,9,4,2,3,4,3,2,4,6,0,0,0,0,3,2,6,2,1,3,0,3,0,1,2,0,29,0,4,1,0,0,4,0,6,1,1,6,5,8,0,13,0,1,8,1,3,0,18,11,1,5,4,1,0,2,0,3,0,5,8,2,4,0,0,3,0,4,7,0,1,1,0,2,0,2,3,2,0,1,6,0,9,0,0,1,1,7,3,3,1,1,1,1,6,8,1,1,2,0,3,1,3,1,1,11,1,1,3,8,3,0,1,1,12,3,2,14,1,4,1,0,5,2,0,1,4,4,1,1,1,0,4,0,4,0,2,0,4,1,2,4,8,0,1,22,0,9,16,6,3,3,0,0,2,6,0,0,3,2,2,0,1,0,0,0,3,4,1,0,6,4,0,1,4,0,1,213,11,2,0,0,6,3,8,4,3,1,1,5,1,5,3,4,1,2,0,3,1,2,1,0,3,1,0,0,0,0,0,0,2,7,0,1,0,2,1,0,9,0,8,2,0,0,0,1,2,0,0,4,8,1,3,0,5,0,5,0,2,3,0,0,0,2,7,0,3,8,4,6,7,0,3,1,2,2,2,2,5,2,2,12,4,1,1,0,2,4,4,1,0,0,4,1,0,6,5,3,2,0,6,1,3,7,1,0,6,0,0,0,1,2,0,0,0,4,1,13,0,6,1,1,1,2,2,1,4,5,2,3,2,4,0,6,0,0,1,8,3,0,3,2,4,0,0,2,3,0,7,2,1,1,3,1,0,3,0,0,6,4,3,1,1,3,5,0,1,0,4,1,1,2,3,1,0,1,4,2,6,2,3,0,0,7,4,0,118,1,1,3,2,14,0,2,3,0,0,0,9,0,1,2,3,3,1,3,1,4,0,0,1,5,2,1,1,0,0,1,0,1,0,0,0,7,0,3,3,0,0,0,1,4,12,0,2,1,3,0,3,2,0,0,0,1,0,4,3,0,0,2,3,9,1,3,2,0,3,0,7,14,0,12,0,3,93,37,0,0,5,1,2,0,2,0,0,3,1,3,0,3,2,3,62,0,5,1,1,0,14,0,3,0,0,32,0,4,2,35,0,0,0,3,0,0,2,0,0,0,0,0,0,2,0,0,0,1,0,3,0,7,0,0,0,41,0,0,0,0,0,0,0,0,0,0,0,1,0,0,0,0,0,0,0,0,0,0,2,0,0,0,0,0,0,0,0,0,0,0,0,0,0,0,0,0,0,0,0
"1982 Johnson_C, Charles, Oxherding Tale",high,2813,1465,1367,1654,1257,1458,904,1065,837,537,877,935,641,468,647,482,324,453,543,315,354,332,507,212,729,348,542,130,114,239,303,134,245,209,393,193,163,212,207,190,262,313,139,250,113,176,218,201,165,275,174,85,160,181,161,207,106,118,137,51,116,86,151,154,106,60,92,93,111,146,44,44,76,95,32,80,87,53,46,83,74,56,142,55,74,65,63,69,77,86,104,52,120,96,56,129,30,54,60,81,80,54,21,82,103,118,57,75,41,69,41,71,71,78,80,57,62,66,98,44,71,112,45,86,57,52,61,29,59,61,57,50,24,57,71,53,69,62,59,32,72,33,29,36,56,45,45,36,30,25,49,33,44,33,57,24,41,54,26,47,43,57,24,37,57,51,33,11,68,28,46,44,18,19,0,76,71,28,31,16,31,30,41,35,32,33,28,36,24,35,25,33,37,19,38,47,85,70,57,36,32,35,34,34,51,14,20,47,29,27,17,38,74,20,40,45,37,42,30,40,48,40,48,17,20,23,32,31,23,17,31,24,28,59,38,11,48,21,18,28,25,28,45,34,16,17,35,14,29,29,27,20,12,29,28,20,24,24,40,67,24,7,28,27,15,49,25,47,20,25,46,23,17,23,44,30,28,16,30,27,20,47,15,18,12,10,6,26,10,31,37,8,0,10,13,12,6,10,17,14,20,27,2,11,35,18,20,47,28,20,30,48,33,15,17,22,9,11,16,4,31,7,25,36,22,17,12,19,28,13,8,17,21,15,16,2,24,27,25,13,11,12,21,2,16,21,9,1,11,6,15,20,15,9,27,25,5,1,45,22,19,10,22,45,10,15,18,16,4,21,23,12,13,15,15,26,32,70,15,10,9,20,14,13,18,1,0,18,15,10,6,18,15,5,10,7,12,38,27,7,6,17,13,12,9,15,10,10,6,46,11,11,19,22,22,36,17,10,13,18,16,0,1,16,8,8,8,15,6,2,16,10,26,32,4,14,7,14,20,26,9,9,6,16,5,1,16,26,7,16,11,13,14,13,10,6,16,20,17,5,17,3,1,1,18,8,20,30,21,18,7,25,18,51,22,10,11,6,0,16,14,16,17,2,10,13,17,6,8,4,23,16,9,17,18,8,8,9,23,12,12,10,13,11,22,10,7,17,9,2,5,34,15,16,20,12,0,10,19,20,4,16,11,1,24,14,11,14,6,15,4,22,8,13,17,1,19,13,10,19,19,8,1,5,22,22,0,24,9,0,9,9,18,24,21,12,7,12,38,0,4,18,16,9,17,9,8,10,0,8,22,1,9,4,6,10,16,6,12,7,14,6,7,21,0,14,23,0,13,11,13,12,20,13,10,17,9,19,13,8,8,19,3,3,14,0,0,19,4,1,21,6,8,6,13,13,40,25,12,9,23,1,18,7,27,1,6,16,4,3,3,9,8,4,6,0,15,21,7,12,8,25,1,15,0,10,15,5,19,11,0,23,12,4,8,7,5,10,10,8,14,7,9,0,0,2,25,12,17,17,18,8,7,10,13,19,10,8,10,6,2,2,9,16,5,5,3,4,13,5,3,13,5,7,12,3,15,6,6,10,3,8,14,14,9,7,26,8,4,17,1,5,5,6,10,0,8,7,3,10,0,0,20,2,11,4,4,9,10,3,13,17,12,7,0,7,20,4,12,14,6,1,4,3,5,1,2,11,1,8,3,14,11,20,1,21,0,11,2,3,4,16,8,2,3,1,8,2,9,11,23,6,18,9,0,12,12,19,2,9,18,17,14,13,9,9,11,8,4,3,12,8,1,8,8,20,0,7,0,3,3,12,4,0,9,3,8,4,1,3,5,10,12,1,8,7,2,0,13,3,11,17,4,4,9,5,8,10,15,17,14,0,13,4,0,14,20,5,0,20,7,14,6,6,16,7,12,0,8,1,6,12,1,11,12,7,3,2,9,2,3,6,5,14,11,7,6,0,5,14,8,2,9,7,0,4,0,12,1,6,21,7,5,18,13,8,3,1,12,6,19,3,20,3,6,11,22,0,6,13,3,0,3,5,9,2,7,0,10,0,10,0,12,0,4,3,3,5,3,5,8,2,10,19,6,7,24,0,2,1,0,1,5,3,2,0,12,19,4,9,6,1,0,6,5,4,7,2,12,1,7,14,5,0,1,10,22,1,2,1,0,7,3,5,1,6,3,5,6,7,5,0,6,5,12,12,13,2,7,0,1,5,8,1,0,5,8,7,7,3,9,10,1,8,5,2,0,7,7,0,5,0,3,0,7,0,0,0,0,3,3,4,5,8,0,1,8,0,0,5,0,1,0,0,3,0,25,11,0,4,0,0,3,7,3,10,5,1,2,8,0,6,1,2,9,1,5,8,13,1,13,1,24,5,3,0,1,3,105,13,4,4,0,3,2,13,7,4,0,0,0,1,5,6,0,4,3,0,9,11,0,9,0,16,0,5,2,4,1,2,1,0,6,6,3,11,4,5,1,7,6,8,2,3,11,3,3,17,4,7,6,7,5,2,0,0,6,7,8,6,4,1,5,3,2,7,6,2,1,0,3,0,3,13,10,11,16,5,3,15,11,6,18,7,2,4,13,2,12,14,5,0,8,4,7,5,9,7,4,8,5,3,20,1,0,2,2,2,1,1,6,7,13,5,1,4,4,8,1,1,7,6,12,10,4,4,0,2,3,0,4,5,0,5,6,2,3,13,0,1,2,0,4,11,3,1,2,8,3,11,0,4,3,14,5,0,0,1,5,7,3,3,1,4,3,4,3,2,7,5,5,0,12,4,11,0,2,4,1,3,4,8,7,0,0,2,0,0,3,4,3,1,8,13,1,8,8,9,0,0,16,0,0,2,0,4,3,0,1,5,1,1,0,12,0,12,6,2,0,0,0,10,11,2,2,1,1,2,2,0,0,12,6,1,1,2,4,0,6,0,5,2,4,2,3,11,5,6,4,6,4,0,1,2,3,2,7,4,4,5,8,8,1,0,5,7,7,10,6,2,1,8,2,2,1,2,2,4,2,1,5,6,1,0,6,0,1,2,2,0,6,5,7,3,16,15,12,3,3,1,0,7,3,0,3,9,1,5,6,1,1,7,0,1,8,0,0,7,0,0,0,0,7,4,14,2,4,3,8,1,0,5,2,0,1,1,11,0,6,1,4,0,0,1,0,5,3,0,5,0,1,1,5,7,2,2,7,1,7,6,10,1,0,5,2,13,1,1,2,4,3,3,0,0,3,3,5,1,2,4,10,1,5,0,0,6,0,2,4,11,1,5,0,2,9,0,6,1,11,9,1,1,3,0,5,1,5,0,2,3,0,3,8,2,0,2,2,0,3,2,7,1,6,11,0,2,5,3,10,8,0,5,3,0,8,10,0,0,11,1,5,0,1,0,0,5,0,3,1,1,7,2,1,0,2,4,0,0,0,0,1,4,7,1,1,7,5,3,1,8,5,3,0,1,1,0,0,18,15,6,9,9,2,1,5,5,4,0,5,0,14,1,1,4,2,0,14,3,8,4,2,7,16,3,1,4,1,0,7,0,5,5,11,0,4,4,3,1,1,2,2,14,3,16,3,8,2,1,2,3,0,2,1,115,8,5,1,0,2,3,0,0,0,4,7,7,3,3,6,17,3,3,0,7,7,3,0,3,0,0,0,1,2,0,2,3,4,6,43,2,2,0,2,0,2,1,4,9,2,1,2,4,3,5,0,0,0,2,5,12,2,4,11,2,3,2,0,1,1,2,0,4,9,10,1,7,2,0,10,0,2,2,0,2,1,10,1,1,41,3,2,0,5,7,2,2,0,6,1,3,1,0,0,3,0,10,1,2,4,3,8,22,8,10,1,6,2,1,2,0,0,9,0,1,2,2,2,1,0,8,5,10,8,6,1,0,3,13,7,2,1,2,8,0,15,7,0,6,1,2,4,1,6,3,0,2,2,3,6,6,0,1,10,1,0,3,0,5,20,3,4,1,1,13,6,5,3,7,2,0,6,2,1,3,4,0,2,8,0,3,0,2,6,1,0,1,2,0,1,1,9,6,0,4,0,0,1,2,3,1,3,0,6,8,4,3,3,1,5,2,6,4,4,0,2,0,6,0,7,4,2,9,0,0,3,2,0,2,0,0,0,0,4,2,0,7,2,2,0,3,0,3,1,2,0,2,3,2,6,1,5,5,2,8,6,2,3,2,0,12,4,1,2,5,6,0,0,2,1,5,0,4,1,1,5,1,5,0,6,1,0,3,6,1,0,4,6,3,0,4,5,3,0,3,3,0,0,4,6,2,0,3,1,8,0,3,0,3,2,7,0,2,5,0,1,2,11,6,4,1,3,0,0,0,11,1,4,0,0,4,0,0,0,2,1,0,3,3,0,3,0,2,0,6,0,1,0,5,0,1,1,1,0,2,0,0,1,0,1,2,1,0,3,7,4,2,1,0,1,4,2,2,0,0,10,1,5,4,1,2,1,3,4,2,0,1,4,9,2,0,0,0,1,3,2,1,0,1,0,2,2,0,11,3,0,3,2,4,1,0,15,2,1,3,0,3,5,2,4,2,1,15,1,4,2,0,4,5,0,0,1,12,3,3,21,5,0,2,3,5,5,5,0,0,0,11,1,0,1,2,3,1,1,4,0,6,3,1,3,6,6,3,5,4,2,0,0,2,5,5,0,0,4,2,0,1,0,2,1,3,4,10,1,2,4,2,5,14,7,5,3,4,2,10,1,1,1,0,3,1,1,28,4,4,2,0,0,0,1,6,5,7,0,3,1,4,0,8,0,0,0,0,3,7,0,0,0,6,7,7,0,4,1,1,0,2,5,8,0,4,2,1,5,0,1,4,0,1,0,0,0,4,2,0,1,1,1,4,2,1,0,9,2,1,1,0,2,5,0,2,1,5,1,0,1,0,0,3,1,0,3,0,0,0,5,3,1,4,1,0,1,3,2,1,3,2,4,1,3,0,2,5,0,7,2,0,0,0,2,3,3,3,8,2,2,0,1,5,4,4,1,3,14,2,2,1,1,1,0,11,6,1,2,0,1,6,6,0,7,0,3,1,2,1,2,2,2,3,1,0,0,2,46,1,6,1,1,0,7,0,9,0,5,3,3,0,3,3,1,1,1,0,2,8,0,1,1,3,3,0,3,3,0,2,2,1,5,3,1,1,2,4,3,3,3,0,3,4,3,2,11,4,1,1,1,6,2,0,0,2,5,1,1,4,3,1,2,2,1,1,4,0,159,2,6,1,1,1,1,1,5,2,0,2,0,5,0,0,4,0,0,0,1,0,2,0,2,3,1,2,2,1,2,2,0,3,1,2,21,0,4,2,0,1,0,4,1,0,2,1,3,0,1,0,11,0,5,0,0,0,2,5,0,4,1,0,3,1,2,7,4,1,0,4,0,2,0,0,2,9,3,0,8,0,0,3,3,2,2,9,4,0,2,1,0,3,6,0,0,5,1,5,0,8,0,0,1,3,3,0,3,3,4,5,5,10,4,3,2,1,0,5,0,0,1,0,1,6,1,8,4,0,0,2,0,2,2,32,2,2,2,3,1,3,4,2,0,4,1,0,0,0,2,8,4,5,0,4,1,2,0,4,0,2,0,4,2,0,7,3,2,0,1,8,4,0,3,2,1,6,1,1,14,5,2,1,0,0,4,0,0,1,0,0,0,2,4,0,2,2,0,4,1,0,2,2,0,5,7,1,4,4,2,0,0,1,0,2,0,2,0,0,0,3,2,0,7,3,2,4,0,1,0,2,2,1,5,4,0,2,2,1,5,4,0,2,1,1,0,0,0,0,0,34,0,0,2,2,0,2,3,1,2,3,0,1,2,1,0,8,0,5,4,1,4,2,0,12,2,0,0,0,2,3,2,2,3,1,3,0,3,5,1,2,2,1,2,0,0,0,6,1,5,3,0,7,0,2,0,4,2,7,0,1,5,3,0,5,0,0,0,0,0,0,0,0,3,5,0,0,0,3,2,0,2,2,0,2,1,3,3,5,6,4,0,2,3,6,0,0,0,2,2,0,0,0,1,1,1,0,2,6,3,1,0,1,0,4,0,7,2,0,3,2,3,0,5,1,5,2,0,4,1,2,1,6,0,2,0,0,6,1,0,1,5,1,16,3,2,0,1,5,0,4,2,6,2,0,1,2,1,0,8,2,1,0,0,3,2,0,2,0,0,0,2,0,0,7,6,0,0,0,0,0,3,1,5,0,1,4,0,0,2,1,0,4,2,4,1,3,6,0,0,2,0,0,0,6,3,0,0,0,0,2,0,7,0,6,1,0,2,0,5,0,5,0,0,3,0,3,6,3,1,4,0,0,3,1,0,0,2,4,2,3,6,4,2,0,5,0,1,2,1,1,2,3,2,4,3,2,0,2,1,0,0,2,2,0,0,0,3,0,1,4,4,3,8,7,1,2,0,0,1,1,7,7,0,0,4,0,0,4,1,4,0,0,0,1,1,3,3,2,0,4,2,0,0,0,0,2,0,1,1,1,1,6,2,7,4,0,3,4,1,0,2,1,7,1,1,4,0,0,3,0,2,0,0,0,1,0,4,7,0,1,0,0,2,0,0,6,0,14,0,2,0,3,0,3,2,0,1,0,2,0,7,1,0,1,2,2,0,0,0,8,2,0,1,1,0,1,0,1,0,1,94,0,0,2,2,0,1,0,0,0,2,1,0,2,3,0,0,3,3,0,3,1,6,1,0,1,0,0,7,1,0,2,2,5,0,5,0,0,1,0,6,2,4,0,0,1,6,0,0,1,1,3,4,0,0,1,1,0,1,0,0,4,0,0,2,0,0,3,1,2,0,10,2,2,6,6,0,0,0,0,1,1,4,5,0,3,0,0,1,1,5,1,5,0,0,3,3,2,3,1,0,1,2,1,0,0,1,2,0,0,4,0,1,1,1,4,1,0,1,1,0,3,0,2,0,2,0,0,0,1,3,1,0,1,0,0,0,0,1,0,1,1,0,0,0,1,1,6,2,4,1,1,0,0,0,4,3,0,0,2,0,0,6,4,1,1,4,3,0,3,0,0,1,1,5,1,0,3,0,4,4,3,0,0,0,1,7,2,1,3,1,1,1,2,5,1,1,0,0,0,1,0,0,2,0,4,0,1,2,0,1,3,0,0,1,0,3,2,0,0,1,4,6,10,5,3,0,3,2,1,0,2,5,0,0,3,9,3,1,0,2,6,4,0,0,1,0,0,2,5,3,1,4,0,5,1,2,2,0,1,2,0,0,0,4,0,2,0,1,1,1,0,2,1,3,2,1,0,0,2,0,0,1,2,6,0,2,1,1,2,3,1,0,2,4,3,0,2,6,0,0,4,2,4,2,2,0,3,0,1,1,0,2,0,1,0,4,4,0,2,2,4,0,0,2,6,3,1,2,4,1,2,0,1,0,2,0,0,0,0,1,4,3,2,0,3,2,2,2,4,0,2,0,0,0,0,0,1,0,2,1,2,0,1,0,0,7,1,2,1,0,0,0,0,1,0,2,3,0,0,0,0,4,2,1,0,0,1,1,0,0,1,0,0,0,3,2,1,3,1,4,0,3,4,1,0,1,0,1,1,2,0,1,0,0,0,0,0,1,1,0,5,7,5,0,0,0,3,3,0,1,3,0,0,3,0,1,2,1,0,0,0,0,1,5,2,0,1,3,3,2,0,1,0,0,0,2,0,2,3,1,1,3,0,0,1,0,0,2,0,2,30,0,2,1,1,0,4,0,1,4,3,4,0,3,7,0,1,0,0,5,0,3,4,0,0,0,0,8,5,5,3,1,0,1,1,2,0,3,0,0,0,0,3,2,0,0,4,2,6,1,0,0,0,0,1,1,2,1,0,3,7,1,1,0,0,0,1,1,0,5,0,0,3,0,0,8,0,0,1,0,2,4,0,1,0,2,1,1,1,6,7,1,1,0,4,3,0,2,5,0,2,9,0,0,1,2,1,0,1,10,2,1,0,1,2,0,0,0,3,2,1,0,0,4,2,2,0,1,0,0,2,2,1,0,0,5,4,3,3,2,0,0,2,0,0,0,3,0,1,1,16,2,0,1,1,1,0,0,0,0,0,0,1,3,0,1,1,7,5,1,1,0,0,3,0,3,0,0,0,1,1,0,3,2,2,1,0,0,1,2,0,1,2,1,0,1,2,1,1,0,1,3,0,2,3,0,1,1,6,5,2,0,0,0,0,24,0,0,0,0,4,0,0,1,0,3,0,1,0,0,3,3,5,0,2,2,1,0,0,2,1,0,0,1,0,3,4,1,0,3,0,2,0,0,5,3,0,3,0,2,0,2,0,0,0,0,0,0,0,0,2,5,0,2,0,2,1,4,2,1,0,5,2,0,0,1,0,0,0,2,0,3,1,0,4,0,1,0,7,2,0,0,0,2,3,0,0,2,0,1,1,1,2,1,5,2,0,3,0,7,1,0,0,3,0,1,1,3,1,1,1,0,0,1,0,2,1,1,3,0,0,2,0,0,1,0,0,0,0,4,0,0,0,4,4,0,5,0,0,0,0,0,9,0,0,0,5,6,2,4,1,0,0,6,0,0,0,1,0,2,0,2,0,0,1,0,1,1,1,1,1,1,1,0,0,0,1,4,1,0,1,0,3,8,0,1,1,0,3,3,1,5,1,5,0,2,2,1,1,6,2,0,0,0,1,4,11,0,0,0,1,2,1,4,0,1,6,0,1,0,1,0,0,1,1,2,0,0,0,0,2,0,1,0,0,0,1,1,0,5,1,5,0,1,2,0,1,2,7,0,0,0,2,0,1,0,0,2,6,0,0,1,0,0,0,0,1,0,0,1,3,7,3,0,0,1,1,1,4,0,1,2,2,4,0,1,0,2,1,4,0,0,0,0,0,1,0,0,1,3,0,2,0,4,2,0,2,1,0,3,3,0,1,0,2,0,3,0,0,0,1,0,0,0,0,2,2,0,0,2,4,0,0,5,0,0,0,3,1,0,0,0,2,2,0,4,5,3,1,3,4,3,0,0,0,0,3,0,1,1,1,3,1,5,0,1,0,0,0,3,2,1,0,1,0,3,0,0,1,2,3,3,0,0,3,1,5,1,2,1,0,0,2,3,2,6,0,2,2,1,0,0,0,1,1,2,3,6,4,4,0,0,0,0,0,0,0,0,1,0,0,2,1,3,3,2,2,0,0,2,2,1,3,0,2,1,0,0,1,2,0,2,2,2,0,0,1,5,2,1,1,1,2,0,0,0,0,0,1,0,2,1,2,3,4,3,0,2,1,2,0,1,3,0,0,3,1,2,0,2,0,1,1,0,0,1,1,0,0,0,2,2,2,0,0,0,1,0,0,1,1,1,2,4,0,6,2,5,0,0,3,0,2,1,1,0,2,0,0,0,1,0,3,0,0,1,1,0,1,1,0,2,0,2,0,2,1,0,1,1,0,0,3,1,1,1,0,2,0,0,0,1,0,1,0,3,0,0,2,1,0,0,0,2,0,0,1,2,0,1,0,0,0,1,0,0,4,3,4,0,0,5,0,1,2,3,1,7,1,6,0,1,0,0,1,0,0,0,1,0,2,1,1,2,1,5,0,0,1,3,1,0,1,0,3,1,2,1,2,0,0,0,0,1,1,0,1,1,1,0,3,0,0,0,1,1,2,0,1,0,1,0,0,2,1,3,0,1,0,2,0,0,0,0,0,3,1,0,1,2,2,0,3,2,0,2,0,0,0,0,1,2,3,1,0,1,2,0,9,0,0,2,0,1,0,0,0,0,0,0,1,2,0,1,3,2,2,1,1,0,0,0,0,1,0,1,1,0,0,0,1,2,0,1,8,0,0,0,0,1,2,0,2,3,1,1,0,4,0,0,6,3,0,4,2,1,1,0,2,6,0,0,0,0,2,0,0,1,1,1,0,2,0,0,0,0,0,5,0,1,0,3,0,2,0,2,3,0,0,2,2,0,0,0,0,4,0,1,2,1,2,0,1,0,0,1,0,0,1,1,2,0,2,0,2,2,0,1,0,0,1,2,1,0,0,0,3,0,0,0,1,2,0,0,0,0,2,0,6,0,0,3,3,0,3,2,1,1,2,5,0,2,1,2,0,0,3,1,0,0,0,0,1,1,0,0,2,0,2,3,0,0,2,0,0,0,0,2,1,0,0,5,1,0,0,0,0,0,0,0,0,0,1,1,0,2,2,2,0,1,2,0,1,1,1,0,0,0,1,0,1,0,0,1,1,4,3,3,1,1,1,0,0,1,0,3,0,4,1,4,0,3,1,1,2,0,2,0,0,0,2,1,0,1,1,0,2,0,0,0,0,0,3,0,0,0,0,1,0,2,1,1,0,0,1,0,0,0,0,2,0,0,0,3,4,2,0,0,0,1,0,0,0,0,1,0,0,1,0,0,0,3,0,2,2,4,0,0,2,1,0,1,1,0,0,0,1,0,0,0,1,4,3,1,2,0,0,0,0,6,1,1,0,1,2,1,2,2,0,0,1,0,4,0,1,0,0,0,2,2,0,0,1,7,0,0,0,0,1,0,4,0,0,2,0,0,0,0,8,0,1,4,2,1,1,0,0,1,0,2,0,0,0,1,3,0,1,3,0,1,0,2,4,1,1,1,0,0,0,0,2,0,2,0,0,2,4,1,0,2,0,2,0,0,1,0,2,0,0,0,0,1,17,1,1,0,0,0,1,2,0,0,2,2,0,2,0,0,1,0,5,0,2,1,3,0,0,1,2,1,0,3,2,0,0,0,1,1,0,2,0,0,0,0,3,0,0,1,3,1,0,7,1,0,2,0,0,2,1,1,3,1,0,1,0,0,2,3,0,1,1,0,0,1,0,0,0,3,0,3,0,1,2,0,0,2,1,6,1,0,0,3,1,0,1,0,0,2,2,1,0,2,3,1,0,0,0,0,3,0,0,0,4,0,0,2,7,1,0,3,0,4,0,1,2,0,0,0,0,0,1,1,3,2,0,1,1,0,1,0,0,0,0,3,0,0,1,0,0,0,1,0,2,0,1,0,1,0,1,0,7,2,0,0,0,0,0,0,0,0,0,0,0,1,0,0,0,1,3,0,0,0,0,0,1,0,0,0,0,0,0,0,0,1,1,0,0,0,0,0,0,0,0,0,0,0,0,0,0,0,5,2,0,0,0,0,0,1,0,1,0,0,0,0,6,0,0,0,0,0,0,1,0,0,0,0,0,0,0,0,0,0,0,1,0,0,0,0,0,2,0,0,0,0,0,0,0,0,0,0,0,0,0,0,0
"1982 Walker, Alice, The Color Purple",high,2439,2000,1890,1144,888,2126,1072,770,398,812,1005,366,456,1478,827,452,133,402,400,173,381,572,256,215,441,297,620,627,282,436,187,374,365,282,246,278,109,435,230,254,163,528,166,174,170,224,151,283,70,234,166,210,82,56,48,151,103,308,257,269,157,391,131,147,188,174,130,142,124,67,47,133,211,131,245,120,92,61,151,125,94,19,113,101,97,31,99,153,128,159,1432,143,76,55,207,87,34,86,155,60,166,236,67,76,79,51,83,49,122,116,246,80,389,73,92,31,42,130,47,126,26,75,31,77,38,53,71,372,14,121,31,16,57,33,56,94,110,59,42,50,115,61,4,4,71,88,138,13,64,65,88,44,14,36,175,13,43,56,29,12,39,29,16,73,14,9,58,67,49,69,16,41,9,20,40,56,48,44,41,42,63,28,28,12,62,116,51,31,27,68,27,14,49,37,143,21,18,87,81,40,82,12,16,33,38,234,36,62,19,109,32,34,53,31,10,41,17,7,60,10,19,36,24,4,53,19,21,55,33,44,0,10,9,8,38,11,75,26,7,36,73,5,14,58,10,49,27,26,13,38,39,36,16,3,8,62,54,41,6,30,15,57,61,17,21,179,44,36,8,20,106,27,24,22,9,40,17,35,43,44,21,23,63,35,21,8,58,44,18,7,2,19,1,28,46,32,19,30,5,17,28,37,4,16,16,13,32,49,4,11,9,38,28,26,20,2,7,20,19,0,11,12,9,26,21,17,165,67,19,3,17,39,7,3,44,7,11,219,12,4,7,24,36,0,31,12,35,0,20,4,6,2,15,40,40,32,3,7,8,19,9,0,3,81,8,2,52,37,2,20,10,2,9,10,21,25,15,58,30,4,4,22,5,2,5,0,0,20,30,12,10,21,13,50,39,16,27,20,17,10,27,10,0,24,5,16,26,38,8,24,5,16,13,32,9,3,13,16,5,10,20,1,100,11,24,0,1,24,84,7,9,32,25,19,20,7,26,9,0,15,19,9,1,29,13,1,4,14,33,17,5,15,7,2,8,19,25,2,5,20,32,20,0,2,9,5,1,7,37,33,4,4,10,104,1,2,13,7,0,31,25,14,10,2,25,25,3,2,19,17,40,1,5,35,4,0,9,1,6,13,5,2,1,1,18,17,6,7,4,7,12,8,12,17,14,4,0,15,8,9,16,16,11,28,8,2,2,10,32,34,0,8,14,4,8,27,8,9,4,12,9,11,5,9,3,2,0,5,3,8,4,8,16,3,4,10,11,6,6,0,3,9,8,4,8,72,14,31,35,10,10,13,15,3,2,8,46,87,66,25,16,15,22,16,19,4,24,19,10,12,5,4,1,23,5,8,9,0,12,15,20,5,5,1,23,0,2,6,0,13,18,0,12,6,37,3,14,79,7,6,29,24,11,19,3,27,9,3,9,1,1,2,5,15,2,0,2,0,7,4,6,9,4,8,0,19,3,9,3,10,0,14,26,14,5,10,7,47,2,4,2,11,5,11,1,8,6,14,17,3,1,25,3,1,10,31,7,8,44,6,1,12,3,19,1,0,3,9,4,3,28,14,24,4,3,2,7,1,24,9,4,52,9,13,18,12,2,5,8,10,0,2,2,4,6,0,8,3,19,5,2,3,2,3,5,0,2,7,5,5,6,10,2,2,0,30,11,2,8,9,14,14,8,1,1,0,1,12,3,13,3,9,6,6,0,1,0,27,4,6,2,1,2,4,2,5,7,15,6,4,3,5,14,0,0,5,21,2,24,0,11,10,1,11,1,5,16,6,3,6,1,0,0,0,3,7,0,1,3,6,3,56,20,2,1,4,5,1,4,2,0,4,16,0,6,2,37,0,2,4,4,8,1,17,6,7,4,3,2,2,7,0,3,19,0,9,36,7,0,17,16,2,4,0,10,9,1,0,1,0,15,6,1,9,3,6,2,1,18,3,6,9,0,5,2,2,27,0,9,0,6,6,66,2,0,12,0,3,8,11,3,1,2,13,56,17,4,10,6,24,6,3,11,0,19,4,3,0,12,11,9,0,2,1,5,4,8,2,5,0,6,0,18,0,4,3,4,4,15,2,5,0,1,0,5,1,3,34,0,2,9,0,0,0,1,8,11,0,11,0,2,3,3,0,3,0,5,1,9,0,1,4,2,0,2,1,39,8,5,3,0,7,16,0,4,4,0,3,1,0,3,0,6,1,5,9,0,3,2,0,0,0,6,0,0,48,6,0,0,23,0,0,1,5,4,11,0,5,24,0,6,0,1,0,1,0,0,0,0,19,0,8,3,1,1,4,20,55,4,8,0,4,0,0,0,1,2,24,6,7,9,2,3,2,22,1,2,4,2,7,1,2,1,5,0,7,0,4,1,1,2,11,1,17,35,0,0,8,2,101,1,11,0,0,4,1,11,5,0,0,0,0,2,5,2,14,1,0,34,4,3,41,2,3,1,6,0,1,0,3,0,0,2,3,1,9,1,0,2,5,2,3,3,2,1,4,10,6,2,8,8,3,0,3,0,3,2,2,14,4,18,3,1,12,10,15,7,5,1,1,0,0,17,12,13,8,0,4,0,9,3,0,3,3,0,2,0,2,2,2,2,0,7,6,4,1,12,2,3,1,7,2,0,37,7,0,9,3,0,0,7,5,2,1,2,11,3,39,0,0,23,1,2,9,27,0,0,4,4,0,4,1,0,2,2,9,1,13,0,1,6,0,4,6,4,8,0,2,3,5,0,1,2,7,4,0,0,0,1,0,4,5,3,1,2,6,5,1,10,1,6,4,2,1,6,0,2,5,2,3,9,17,3,0,0,0,0,0,4,13,0,1,0,4,0,5,0,3,0,4,10,0,1,0,0,2,2,0,7,6,76,1,0,2,0,8,0,1,0,0,2,10,9,8,0,5,6,1,4,8,0,0,1,5,18,34,0,5,157,2,10,0,0,0,1,1,0,0,0,7,2,9,0,7,2,2,3,3,12,1,30,14,0,0,2,0,9,1,2,6,0,0,1,2,3,7,0,0,1,4,3,1,3,0,1,0,3,1,1,0,1,4,3,5,1,2,0,1,13,0,0,3,0,0,0,0,0,0,1,2,0,1,0,4,2,0,0,0,0,0,0,0,2,43,19,2,3,2,55,1,16,9,2,0,9,0,1,0,13,0,0,0,0,8,0,8,10,0,3,0,3,2,3,5,0,2,0,1,3,1,3,1,1,1,4,0,0,8,6,9,0,4,0,0,0,3,1,0,2,2,1,0,3,5,0,4,0,6,0,3,3,17,0,6,1,0,1,5,6,0,2,2,2,0,5,6,12,0,5,1,5,7,4,2,0,0,2,0,6,0,0,5,1,2,0,0,0,12,5,0,7,7,1,0,3,6,0,0,15,5,7,0,0,0,291,7,0,1,1,0,1,11,1,6,2,3,0,0,4,0,1,12,0,0,4,2,1,5,1,3,0,0,2,0,0,0,1,8,4,2,1,1,14,4,1,0,10,0,1,0,0,2,8,3,1,0,12,8,0,2,1,0,1,0,27,18,4,0,9,10,2,3,2,0,0,20,0,1,0,1,2,5,3,3,6,3,0,7,16,0,0,8,10,0,0,0,0,0,7,9,0,0,282,3,0,1,1,0,0,1,1,10,3,0,1,0,0,5,0,1,1,3,2,0,3,2,2,8,0,2,5,0,1,0,7,1,3,2,1,1,0,1,0,3,0,0,0,0,5,0,1,3,1,0,13,3,0,5,0,9,0,1,5,3,0,2,0,0,16,0,1,1,4,0,0,0,0,7,0,3,0,4,2,1,2,1,2,4,2,0,1,0,2,1,0,2,2,1,0,1,1,11,3,1,0,0,0,4,17,0,0,1,0,31,2,0,2,2,0,1,2,4,1,6,0,0,2,2,3,2,0,0,0,0,8,2,1,0,2,0,5,1,1,9,0,0,6,9,1,0,4,3,1,1,0,3,0,0,2,4,5,2,4,0,7,6,0,0,4,245,1,0,0,5,6,0,1,1,0,2,1,4,4,4,6,0,2,1,1,2,0,7,3,10,0,5,0,18,4,3,6,0,1,3,0,3,4,0,2,4,2,2,0,1,1,1,0,0,0,9,1,0,0,0,2,1,0,0,0,0,0,0,3,2,0,3,1,2,0,1,1,6,0,1,3,0,2,2,5,1,4,2,1,3,1,1,2,1,0,3,0,1,4,2,79,12,1,1,7,1,1,1,1,2,0,0,18,0,2,0,0,48,1,1,1,2,0,0,1,0,7,0,0,3,3,0,1,1,0,3,0,0,2,0,0,0,1,0,2,1,0,0,5,0,1,1,0,2,14,0,5,0,0,1,0,6,0,0,1,0,0,0,0,4,1,0,3,0,0,1,0,2,0,0,0,0,1,3,2,0,2,4,0,0,4,1,0,4,1,0,1,0,3,3,0,0,0,4,2,1,1,1,0,0,8,6,8,1,4,3,0,6,3,0,0,4,0,5,0,0,1,0,0,1,1,0,2,0,0,4,1,0,4,3,0,3,3,0,1,0,2,2,0,2,3,0,1,0,0,5,3,2,3,7,0,0,1,6,3,201,11,5,1,13,20,0,0,0,6,2,3,4,0,0,0,2,0,0,7,0,4,6,1,0,0,0,4,0,1,1,0,1,1,0,1,3,1,6,7,4,0,0,0,1,0,1,0,2,2,1,3,1,0,0,1,0,57,150,0,11,3,1,2,0,0,0,0,0,4,1,0,3,3,0,0,0,0,0,1,0,1,0,3,1,3,5,1,5,0,0,0,0,0,0,0,0,0,3,2,3,2,0,1,1,0,0,1,1,0,0,0,0,2,8,0,0,0,4,193,0,1,4,1,0,1,0,2,3,1,1,0,3,2,0,1,1,19,4,0,0,0,3,0,0,1,0,0,17,2,1,0,0,0,0,1,0,9,0,2,3,0,2,0,1,4,2,0,0,0,0,0,0,0,1,0,0,0,0,9,1,5,3,3,0,0,0,1,0,1,2,0,1,3,1,0,1,0,1,0,0,3,3,0,0,0,0,0,2,0,0,1,0,5,1,5,0,3,0,4,0,1,0,0,1,10,2,1,7,2,0,29,0,6,0,0,2,5,0,0,0,0,0,0,0,0,1,1,1,1,1,3,0,1,0,1,0,2,0,0,0,4,0,1,0,2,0,20,0,4,0,0,0,0,1,13,7,4,0,0,3,2,2,2,0,0,3,0,2,0,0,0,2,0,5,0,5,3,0,0,3,5,2,1,2,0,0,0,2,0,2,4,1,1,0,0,0,2,0,29,0,0,4,0,1,0,1,0,1,0,0,0,1,0,2,0,0,8,3,3,0,1,0,0,0,0,0,1,0,0,2,0,6,0,1,0,0,3,0,0,2,5,0,0,1,1,0,1,0,2,0,0,1,1,0,2,4,0,4,14,2,1,1,4,0,0,2,1,0,0,0,3,0,2,5,0,0,0,2,12,88,0,1,1,0,0,0,0,6,9,0,0,0,0,0,0,0,0,2,0,0,3,0,2,1,0,0,1,0,0,1,3,0,6,3,1,1,4,0,0,16,0,1,1,17,2,2,0,1,6,2,0,4,0,0,0,0,2,0,1,7,2,0,6,1,0,1,6,1,1,0,4,0,1,0,0,0,0,0,0,0,0,4,0,2,0,2,7,0,0,0,0,4,1,0,0,1,4,0,0,1,0,0,2,3,2,0,0,1,4,1,0,0,0,0,7,1,1,0,3,0,0,0,0,0,1,5,1,1,0,0,1,12,9,0,7,3,1,0,0,1,0,0,0,1,0,0,1,10,2,0,0,0,1,7,2,1,5,1,0,3,0,0,0,2,1,0,0,1,1,1,0,6,0,0,0,0,0,7,0,0,0,2,1,0,0,2,0,0,1,2,0,1,0,0,0,0,0,0,0,1,0,2,131,0,10,0,0,1,3,0,2,0,0,0,0,1,0,4,0,0,0,3,10,8,6,0,0,6,1,0,1,1,3,2,4,1,6,0,0,0,3,4,2,0,2,0,4,1,0,0,2,0,4,0,0,3,0,1,3,0,0,0,0,0,1,0,0,0,0,2,0,1,2,0,0,0,0,0,0,25,0,0,2,1,0,0,3,3,2,1,1,4,1,1,0,6,2,0,5,7,0,0,4,0,0,0,0,0,0,0,0,20,0,0,2,0,2,0,0,2,0,0,0,1,10,0,0,0,1,1,0,0,0,0,4,0,8,6,0,1,0,0,0,8,0,0,0,1,5,2,4,0,2,0,0,0,0,2,0,0,0,0,14,1,0,0,0,0,0,4,2,0,0,1,0,0,1,0,0,2,0,1,0,0,0,4,0,0,0,0,0,1,3,5,1,2,0,3,0,0,0,0,1,0,0,0,0,0,0,0,1,1,0,0,16,1,2,0,0,2,0,0,0,0,1,2,4,0,0,0,0,0,0,0,0,0,0,0,0,0,4,0,0,0,1,1,0,0,2,2,0,0,0,1,4,1,0,5,0,0,0,0,0,0,1,5,0,2,1,2,0,2,0,39,0,0,0,0,0,0,0,6,0,2,1,0,3,2,0,0,0,2,4,2,0,4,1,0,2,0,0,0,2,0,0,2,6,1,2,0,0,2,1,5,1,0,1,6,0,0,1,4,1,0,0,0,1,0,3,0,0,0,0,0,0,0,0,2,0,0,0,1,0,7,1,4,0,1,0,0,0,0,1,0,1,0,0,1,0,1,0,0,1,0,1,0,0,2,0,0,2,0,0,0,0,2,2,0,0,0,0,0,2,1,0,0,0,0,0,0,1,1,4,2,0,2,13,3,1,0,0,0,0,0,2,0,0,0,0,0,0,1,10,1,1,0,0,1,0,1,0,2,2,1,1,4,9,0,0,1,0,0,0,0,0,1,0,0,2,1,0,0,0,1,0,4,0,0,0,1,0,0,2,1,0,0,0,0,1,0,0,0,0,0,2,0,0,1,0,2,2,0,0,0,0,1,0,2,0,0,0,1,0,4,0,0,1,2,3,1,0,0,1,0,0,0,4,1,0,1,0,0,0,2,1,0,3,0,0,0,1,0,0,1,0,0,4,1,3,0,1,2,0,0,12,0,0,2,0,1,0,2,0,1,6,1,4,0,0,0,0,0,0,0,0,0,0,0,5,2,0,0,0,4,0,1,2,0,2,0,3,1,0,0,0,0,0,1,0,2,0,0,0,0,0,0,0,1,1,0,1,2,0,0,1,2,2,0,1,0,1,1,1,1,1,2,0,0,1,0,0,0,0,0,1,1,4,0,0,0,0,0,3,1,2,1,0,0,5,0,0,1,9,0,0,0,1,1,0,8,1,0,1,2,0,0,0,0,0,0,0,0,2,4,0,0,0,0,2,0,4,0,1,2,0,0,0,0,0,0,0,0,3,1,1,1,1,3,0,0,1,0,0,0,0,0,0,0,0,11,0,0,21,0,0,1,1,0,0,0,2,1,0,0,2,1,0,0,1,0,0,3,1,0,4,5,1,0,0,0,2,0,0,3,0,0,0,0,1,0,0,5,0,0,1,0,0,0,1,1,1,0,1,0,0,0,0,1,0,0,0,0,0,2,0,0,0,1,0,0,0,2,2,0,1,0,6,0,0,0,5,0,0,0,1,1,0,0,1,2,0,1,0,4,2,0,2,1,0,0,4,0,1,0,2,0,0,1,1,1,0,0,1,0,0,0,38,0,2,1,1,1,0,0,0,1,0,0,7,0,0,0,5,1,0,0,0,0,3,0,0,0,1,0,0,0,2,0,0,0,0,0,2,0,0,4,0,0,1,2,0,1,3,0,0,0,2,1,0,1,1,0,0,1,4,0,1,0,4,2,1,1,1,0,1,0,0,0,0,1,2,0,0,0,0,0,6,0,3,0,0,0,1,0,5,0,0,0,6,0,4,0,1,0,0,2,3,0,0,5,2,0,1,5,4,0,2,0,0,0,0,0,0,1,0,1,0,0,1,0,0,0,0,8,0,0,0,4,0,0,6,0,0,0,0,1,0,3,0,0,0,0,1,0,0,6,1,0,2,0,3,0,0,0,0,0,0,0,0,0,2,0,0,0,0,2,0,0,7,0,2,0,0,0,4,0,0,1,0,0,1,0,1,0,0,0,0,4,0,4,4,0,0,0,0,0,0,0,0,0,0,0,1,0,2,0,1,0,0,0,3,0,1,0,16,2,0,0,1,0,1,0,0,0,1,0,1,0,0,1,0,0,1,0,2,2,0,0,5,0,0,0,0,0,0,0,3,0,0,4,0,3,0,0,0,4,1,0,0,0,0,4,0,0,0,4,1,1,0,0,0,0,0,1,0,0,0,0,0,1,5,0,0,0,0,0,0,1,2,1,0,1,0,3,15,0,0,0,1,2,1,0,0,2,0,1,1,1,0,1,0,4,1,0,0,0,0,0,0,0,0,0,0,2,0,15,0,2,7,0,1,1,0,3,0,1,1,0,0,1,0,2,0,0,0,0,0,0,2,0,0,0,0,0,0,0,0,0,0,0,4,0,1,1,0,0,57,0,2,1,0,0,0,0,0,0,0,0,0,0,0,0,0,2,3,2,1,0,1,0,0,0,2,0,0,0,1,0,0,0,0,0,1,0,0,0,1,1,0,0,0,1,1,1,0,0,1,11,2,0,0,2,1,1,0,1,3,0,0,0,0,3,1,2,0,0,1,0,0,0,0,0,1,0,1,1,0,0,0,0,0,0,5,0,0,0,18,1,1,0,0,0,0,0,0,1,0,0,1,1,4,0,3,0,0,0,0,0,0,0,0,0,0,2,0,0,0,0,0,0,0,0,1,0,0,1,1,1,1,0,0,0,1,2,0,0,0,0,0,0,0,0,1,0,1,0,2,0,0,0,0,0,0,2,0,0,0,1,0,1,0,1,0,0,0,5,0,0,2,0,0,0,0,0,4,0,0,0,1,0,0,0,1,1,0,0,0,0,0,2,0,0,0,8,0,0,1,4,0,0,0,2,0,2,0,2,0,0,0,6,0,0,3,0,0,0,0,0,0,0,0,0,1,1,1,0,0,0,1,0,0,4,1,0,0,0,1,0,1,1,0,0,1,0,2,1,0,1,0,0,0,0,0,1,0,0,0,0,0,0,0,0,0,1,0,0,1,0,0,0,0,1,3,0,0,0,2,0,2,1,0,4,0,0,0,0,2,0,0,0,1,0,0,3,0,6,0,0,0,0,1,0,0,0,0,0,4,2,0,0,0,0,0,1,0,0,0,0,0,0,1,0,3,2,1,0,0,0,0,0,0,0,0,1,3,0,0,0,0,1,0,0,0,1,0,3,0,0,0,6,7,0,0,0,0,0,0,0,0,0,0,1,1,0,7,0,0,1,0,0,0,0,0,0,0,0,2,0,0,0,0,0,0,0,1,0,0,0,0,0,0,0,1,0,0,0,0,1,1,0,0,2,1,0,0,0,0,1,0,1,1,0,4,0,0,1,0,8,1,0,0,0,0,1,0,0,2,0,0,0,1,0,0,0,1,1,0,0,0,0,0,0,0,1,0,0,1,0,0,0,1,0,0,0,2,0,0,0,0,1,0,0,0,0,0,0,0,0,0,1,0,1,0,0,3,2,0,0,0,0,1,0,0,3,2,1,0,0,0,3,1,0,0,0,6,0,0,0,0,0,0,0,0,1,0,0,0,2,1,0,1,0,0,0,0,2,0,0,0,0,4,0,0,0,1,3,0,0,0,0,0,1,0,0,0,0,1,0,3,0,2,0,1,0,0,0,0,1,0,0,1,0,2,0,1,0,0,0,0,0,1,1,0,0,1,0,0,0,0,0,0,0,0,0,0,0,0,0,1,2,0,1,2,0,1,3,0,0,0,1,0,0,5,0,4,1,1,0,0,0,0,0,0,2,0,0,0,0,0,0,0,1,0,0,0,0,0,0,0,0,0,1,0,1,0,0,1,0,3,0,1,0,1,0,8,0,1,1,0,2,0,0,1,0,0,0,0,0,0,1,2,0,0,1,0,0,3,0,0,0,0,0,0,0,0,0,0,0,0,0,1,0,1,1,0,0,0,0,3,2,0,1,1,0,0,3,0,1,0,3,0,0,0,4,0,0,1,0,0,0,0,0,0,0,1,0,1,0,1,0,2,0,0,0,0,1,0,1,0,0,1,1,0,0,2,0,0,10,0,1,0,0,0,0,0,0,0,42,2,0,0,1,1,2,0,2,2,0,0,0,0,0,1,3,1,0,1,0,0,2,0,0,0,1,0,1,2,2,7,1,0,0,1,1,0,1,0,6,0,0,0,0,4,0,0,0,0,1,0,0,0,0,2,2,0,1,0,0,1,0,0,0,0,0,0,0,0,0,0,2,0,0,1,0,0,0,0,0,0,0,0,0,0,0,2,3,0,0,0,0,0,0,0,0,0,0,0,1,0,0,0,0,0,0,1,0,1,0,1,0,0,0,1,0,0,0,2,0,0,0,2,0,0,0,0,0,0,0,0,0,0,1,1,2,0,0,1,0,1,1,0,0,0,0,0,0,0,0,0,0,3,0,1,0,1,0,5,0,0,1,0,2,0,5,2,2,0,0,0,0,0,1,0,1,1,3,0,0,0,0,0,0,0,0,1,0,1,2,0,1,0,0,0,0,2,0,0,0,0,1,0,0,0,1,0,0,0,0,1,0,0,0,1,0,1,0,0,0,0,0,1,0,0,0,1,0,1,1,0,0,0,2,0,0,0,0,6,0,0,0,0,0,1,0,1,1,0,1,0,0,0,0,1,0,1,0,0,0,1,0,0,0,2,0,1,0,0,0,0,0,1,0,1,0,1,4,0,0,0,0,1,0,0,1,0,1,0,0,1,0,0,1,0,1,0,1,1,0,0,1,0,0,0,1,0,0,0,0,0,0,1,1,0,0,0,0,0,0,1,1,0,0,0,0,0,0,0,0,3,0,0,1,1,0,0,0,0,0,1,2,0,0,3,0,1,0,0,1,0,0,0,1,0,0,0,0,0,0,0,0,0,0,0,0,0,0,0,0,0,0,0,0,0,0,0,0,0,1,0,0,0,0,0,1,0,0,0,0,0,0,0,0,0,0,0,0,0,0,0,0,0,0,0,0,0,4,0,0,0,0,0,0,0,0,0,0,0,0,0,0,0,0,0,0,0,0,0,0,0,0,0,0,0,0,0,0,0,0,1,0,0,0,0,0,0,0,0,0,0,0,0,0,0,0,0,0,0,0,0,0
"1987 Heinemann, Larry, Paco's Story",high,4159,3231,1011,1527,1701,260,679,883,264,445,438,1094,690,129,328,520,130,682,329,55,393,214,624,235,93,107,108,162,299,300,244,412,94,115,202,90,77,260,195,245,112,224,131,95,121,138,164,159,168,188,295,121,91,250,115,142,77,59,66,126,219,59,70,72,119,102,168,168,71,28,94,24,68,73,104,96,77,24,166,44,134,26,109,97,111,32,75,98,30,44,78,30,39,115,30,58,159,82,95,42,56,73,53,39,16,38,57,44,32,50,85,107,64,102,64,76,39,111,32,22,9,98,23,84,92,18,75,70,22,58,13,30,17,26,83,64,72,75,42,54,11,30,47,14,24,29,25,19,52,10,70,21,18,72,26,70,67,110,40,84,23,21,16,45,64,25,34,44,12,107,9,20,122,11,8,33,24,65,44,39,57,8,9,10,16,31,20,32,61,75,57,2,36,45,21,65,8,97,27,66,26,6,30,22,15,20,46,67,13,79,7,63,26,12,46,26,22,25,30,12,10,18,18,66,22,77,7,23,4,9,17,38,16,25,18,6,51,39,26,62,11,17,15,45,24,78,12,12,24,42,15,75,35,11,40,23,19,23,44,9,26,7,19,45,6,3,22,10,16,21,9,16,3,34,7,10,26,24,23,29,22,24,59,22,25,49,21,49,5,68,16,132,7,28,37,23,5,6,8,9,16,20,8,18,2,20,25,32,4,13,6,5,16,13,23,10,6,40,22,14,8,1,14,40,6,22,20,19,4,3,5,5,10,4,17,25,53,3,21,9,11,18,9,3,13,58,13,94,37,12,6,7,32,9,17,4,4,3,10,11,9,0,14,16,7,1,17,27,9,58,3,14,9,30,12,26,17,10,23,16,20,38,12,3,8,0,0,13,5,11,16,15,6,5,20,3,34,5,14,20,5,24,5,9,3,13,22,11,18,14,4,0,31,41,31,2,4,24,9,4,29,6,1,12,10,24,9,31,5,45,33,9,32,23,3,32,16,1,0,5,20,24,5,11,12,5,21,30,9,43,5,27,47,1,6,7,7,3,9,7,26,6,0,6,3,9,1,5,0,10,7,11,18,38,15,5,20,7,0,21,5,3,20,6,1,59,15,14,10,15,24,14,16,4,7,2,23,6,26,27,8,8,13,2,19,11,11,1,4,46,21,34,11,12,1,4,0,7,5,27,14,5,28,18,4,0,8,19,15,7,5,44,14,8,0,1,9,2,17,2,2,3,0,15,34,20,0,3,9,78,1,3,10,9,31,0,7,3,8,7,37,11,2,0,1,5,37,6,4,21,18,12,14,0,0,11,36,1,39,2,30,5,7,16,24,18,4,7,14,7,4,3,2,5,10,15,25,4,2,38,2,8,1,4,16,0,0,1,6,27,12,2,1,6,1,4,12,26,2,24,24,5,0,10,16,2,5,9,19,25,4,0,25,4,0,0,20,4,3,3,18,4,15,1,44,9,0,6,6,6,0,25,1,15,3,28,18,6,5,1,0,2,11,7,13,4,8,9,3,2,22,5,1,0,15,10,8,7,2,3,18,2,3,54,3,3,4,5,13,9,3,16,14,8,10,3,3,17,28,3,47,1,13,3,3,17,0,11,2,1,3,3,14,17,2,26,6,6,18,5,13,18,5,1,1,18,4,0,13,1,10,17,29,19,0,11,10,1,6,14,25,1,4,18,205,1,17,16,3,20,15,2,59,2,0,3,4,0,11,4,1,55,6,7,15,2,20,20,7,5,9,83,17,14,1,3,10,4,5,0,7,2,4,13,9,4,21,7,17,2,20,4,0,7,1,4,0,2,0,10,10,9,3,4,2,0,0,2,0,29,1,6,2,17,8,25,12,3,17,10,0,0,1,7,4,13,6,2,4,10,4,0,18,3,4,11,4,4,0,3,9,2,23,2,7,5,2,0,2,1,10,19,3,3,0,3,16,10,8,4,30,1,2,0,9,6,1,0,5,1,3,4,14,2,0,12,9,2,7,14,1,0,4,4,2,13,12,1,18,7,6,7,1,0,9,1,6,0,4,16,9,6,8,1,0,38,4,5,13,10,1,0,10,0,6,7,5,2,3,9,5,2,4,0,9,3,0,0,0,5,42,0,10,0,2,1,6,3,4,6,3,88,5,3,2,3,4,2,6,13,1,1,6,8,12,0,12,20,1,5,16,4,1,0,3,6,0,3,3,1,8,0,3,3,1,38,7,6,1,0,0,1,9,0,8,2,20,13,0,7,4,2,7,20,11,21,0,0,14,0,19,0,11,29,5,0,0,0,10,2,8,1,2,4,2,1,4,0,2,4,0,7,1,0,0,0,2,9,12,0,7,4,2,0,3,7,6,2,0,8,3,3,0,2,1,10,5,16,5,11,1,23,2,6,4,0,5,6,7,4,1,11,0,2,7,18,3,4,0,0,0,1,1,3,3,6,1,0,3,13,3,8,39,15,1,3,4,3,3,1,3,0,2,4,4,4,0,1,3,6,3,1,7,0,6,13,17,1,5,4,0,9,2,3,0,0,0,5,10,12,24,2,1,10,14,1,8,14,31,0,2,2,9,5,12,2,11,8,35,9,2,1,4,5,5,6,3,1,13,0,8,6,7,0,10,0,0,2,3,3,13,0,0,11,0,0,4,0,1,1,0,4,0,8,5,5,16,10,5,3,3,11,17,6,18,5,0,3,16,426,1,0,0,6,6,10,0,9,0,0,8,0,3,1,8,11,0,0,11,4,0,12,14,27,5,0,0,7,0,2,2,25,5,0,3,5,13,7,1,2,18,7,3,0,4,0,0,0,0,6,4,3,5,0,5,2,0,3,4,8,4,1,4,15,2,9,1,0,0,6,6,0,3,2,0,3,3,10,11,17,1,3,2,0,0,5,10,13,0,3,4,7,12,9,4,8,5,11,9,5,0,0,1,12,7,1,0,14,2,0,10,1,3,1,1,15,6,3,8,1,5,9,1,0,0,14,21,1,1,8,4,8,1,0,9,3,6,7,0,6,5,9,3,3,2,3,1,9,16,1,14,4,6,0,5,0,2,11,1,40,2,0,2,1,0,11,23,3,4,1,2,7,3,0,0,1,1,1,1,0,2,0,0,9,6,0,0,2,0,5,3,0,7,4,8,4,4,1,21,3,2,5,8,2,4,4,7,0,5,0,0,0,0,6,0,4,5,0,3,4,2,5,2,9,0,1,5,4,5,1,2,5,8,0,7,15,1,0,4,2,1,2,0,0,3,5,3,0,9,0,4,5,1,1,1,2,11,11,4,1,3,1,0,10,2,0,3,1,7,8,0,0,1,0,4,32,8,0,13,29,1,3,0,1,0,5,6,3,18,20,6,5,2,26,2,8,2,3,2,0,4,4,0,0,5,2,0,0,1,3,4,0,3,0,0,0,0,4,3,3,1,8,3,8,10,2,3,0,0,2,0,5,3,12,0,2,13,0,0,13,4,0,4,6,2,0,3,0,0,0,4,1,2,4,2,5,2,0,12,0,0,20,5,0,5,2,7,6,6,1,1,0,3,1,4,1,3,0,2,8,0,2,3,0,5,5,1,2,0,0,11,27,7,14,2,0,0,12,9,0,0,5,2,3,5,20,9,0,0,1,1,2,0,1,3,6,0,0,8,7,3,8,2,0,0,4,0,4,0,10,5,1,4,0,4,1,2,3,1,2,0,2,0,1,15,2,1,0,2,0,1,0,10,2,0,0,2,1,5,1,0,8,3,6,1,0,1,6,1,22,4,0,0,1,2,0,3,0,8,3,0,1,16,2,0,2,0,4,2,5,1,2,8,1,4,0,4,20,5,8,1,0,6,6,2,2,2,1,3,3,3,0,5,0,0,2,16,2,4,0,4,23,2,3,6,9,0,4,0,2,2,2,0,6,3,0,0,1,9,2,30,6,1,1,2,1,8,0,9,0,1,10,4,3,0,2,5,1,3,0,0,7,1,2,4,14,1,3,1,20,0,6,3,1,2,9,1,7,0,0,0,1,1,3,3,1,14,0,1,0,3,3,6,3,2,0,28,1,3,3,2,2,0,1,1,2,1,12,3,1,6,1,3,6,1,1,4,0,2,1,1,5,4,0,4,4,3,1,15,17,2,3,0,0,2,5,0,1,0,0,0,5,4,7,1,4,2,1,0,0,3,2,2,2,1,5,8,3,1,0,6,2,1,7,2,1,4,1,0,1,5,2,4,3,0,0,2,13,1,0,0,6,1,0,1,7,6,3,2,1,0,1,7,4,2,24,2,0,13,9,2,5,0,1,4,0,1,0,1,0,0,3,0,2,0,1,0,0,1,2,0,3,14,1,2,1,2,1,1,0,0,0,0,11,12,2,1,0,1,2,0,7,0,5,4,0,0,3,0,2,0,0,0,3,1,1,1,1,7,2,7,9,0,0,19,3,0,2,1,11,0,2,1,6,2,3,0,4,0,1,8,0,0,0,4,2,5,10,0,2,3,3,3,4,0,0,3,0,2,3,0,6,0,1,0,1,4,0,0,0,3,0,1,4,0,0,1,4,0,0,2,0,1,2,11,2,9,1,2,6,4,2,6,13,4,0,5,1,2,0,7,1,6,20,0,0,3,1,0,10,9,5,0,0,3,4,4,0,0,4,9,2,2,3,0,1,9,1,0,3,0,1,0,2,1,6,3,1,3,9,0,2,0,1,0,0,1,6,1,0,0,1,0,0,1,4,0,0,3,1,1,1,1,0,0,2,20,0,2,1,1,1,5,12,1,3,0,10,0,1,11,0,6,0,2,1,18,2,0,0,2,0,0,10,0,0,0,1,0,5,1,0,8,4,0,1,8,0,0,8,0,4,2,4,2,2,1,5,0,1,6,5,3,0,7,0,2,1,1,6,0,6,0,0,0,1,2,5,2,1,2,2,18,1,5,0,0,8,2,4,0,0,0,2,11,0,1,1,1,0,2,1,0,2,8,0,2,0,13,6,1,1,0,0,0,1,0,0,4,9,3,19,0,7,1,0,0,0,1,2,0,0,0,0,1,4,0,3,3,0,9,0,0,0,15,2,0,0,0,0,2,0,2,7,1,5,5,0,0,1,1,0,1,7,3,3,28,9,4,2,0,0,6,1,2,0,5,0,0,1,2,0,0,0,0,10,0,1,5,2,7,0,4,0,0,0,0,1,4,5,2,0,0,1,1,2,0,1,4,3,6,0,1,0,1,3,0,0,12,2,9,5,5,3,1,1,2,0,4,30,1,2,0,1,4,1,2,4,9,0,0,9,3,1,1,5,1,3,2,1,0,1,0,5,1,0,0,0,1,3,0,3,14,10,0,1,3,4,1,0,4,7,2,0,1,5,11,3,4,0,5,2,9,0,0,0,1,1,0,4,0,3,4,4,0,0,1,2,0,0,1,3,0,2,2,6,0,0,1,4,1,3,0,0,0,1,1,4,3,20,0,4,2,0,16,0,0,3,0,0,0,0,2,0,1,0,1,1,1,0,0,4,1,2,2,1,0,1,2,0,0,15,1,0,0,0,8,0,2,0,1,2,0,5,0,0,2,0,9,0,9,0,1,4,0,0,1,4,0,0,0,6,0,0,1,2,0,0,6,2,0,15,1,6,0,3,1,0,2,0,6,0,1,10,1,0,5,1,0,0,2,1,11,3,8,3,0,0,0,0,0,0,0,2,0,1,40,1,6,2,1,4,5,2,1,1,0,1,1,0,1,0,4,3,1,5,0,0,7,1,0,0,1,0,0,4,0,0,1,0,0,0,0,0,1,0,2,2,0,0,3,2,0,2,0,1,3,0,0,1,12,0,0,3,0,0,4,16,0,0,0,2,0,5,1,7,7,0,0,0,2,0,1,2,6,3,0,0,5,2,3,4,3,0,5,4,0,9,0,0,2,4,4,3,7,0,0,2,0,2,0,2,0,0,1,0,0,2,0,3,1,0,0,2,1,2,0,2,4,0,0,50,0,5,26,1,7,5,0,0,0,0,4,3,1,1,1,7,2,0,0,11,8,0,0,0,2,1,2,1,1,0,0,0,1,0,9,5,0,1,2,0,3,3,0,2,0,0,12,0,2,0,0,2,9,0,0,5,0,5,6,0,2,0,0,0,0,1,1,0,1,0,1,3,16,2,0,0,5,14,0,0,2,1,0,1,0,1,8,1,1,0,1,1,3,0,2,0,0,17,0,0,0,0,1,0,2,1,0,3,0,0,0,1,1,2,14,0,1,5,0,0,0,0,0,1,2,4,0,2,0,0,0,7,2,0,1,0,0,3,1,0,3,0,2,0,1,0,0,0,1,1,0,0,6,3,2,6,0,5,0,0,0,8,0,0,3,3,2,7,3,3,1,4,2,2,1,0,1,4,6,1,6,0,2,14,0,1,0,0,0,0,0,0,1,0,4,5,0,0,0,1,0,0,1,8,2,0,0,2,0,0,0,0,19,10,2,0,2,5,0,2,0,0,0,0,0,4,0,2,0,1,7,5,1,0,0,0,10,3,4,1,2,6,0,0,0,4,4,0,10,0,2,12,1,6,0,1,2,10,1,1,0,0,0,0,0,0,1,11,8,3,0,0,2,7,1,1,1,2,0,0,0,1,0,1,5,0,0,3,0,4,0,0,0,0,1,0,0,2,0,4,3,0,1,2,1,1,0,0,1,1,0,1,0,0,0,2,4,1,3,1,3,0,1,0,0,1,0,0,0,0,2,1,1,1,0,11,0,3,0,0,6,1,1,4,0,0,0,3,0,0,0,1,4,2,4,0,1,0,1,0,0,0,0,0,1,0,0,6,2,0,1,0,0,1,0,0,0,0,0,1,1,6,3,0,4,0,2,0,0,1,0,6,1,2,1,0,1,1,0,8,5,2,0,2,0,0,0,1,0,1,3,5,1,1,2,1,6,0,0,0,0,0,3,0,3,0,1,15,0,0,0,0,0,3,4,0,1,3,2,0,3,0,0,1,0,0,0,0,0,0,6,6,0,0,0,0,0,0,4,3,9,2,17,1,0,1,2,0,0,8,0,5,0,0,0,0,0,4,0,1,0,0,0,0,10,0,0,5,0,10,1,1,0,4,2,1,0,0,3,2,1,0,1,3,3,3,0,1,2,0,1,0,2,0,0,4,2,1,0,1,3,7,2,7,10,3,0,0,0,0,0,0,0,2,2,0,0,1,0,0,2,2,2,4,0,0,5,2,8,8,0,0,4,0,0,0,0,0,3,0,7,3,15,0,4,7,0,0,11,3,0,0,7,0,11,0,1,0,0,1,11,0,1,3,5,0,1,1,2,0,1,0,0,0,0,3,0,0,6,1,6,0,0,2,0,0,4,3,0,1,9,0,0,3,2,0,0,3,4,1,0,3,4,0,0,0,0,3,0,1,1,0,0,0,0,0,1,1,9,1,1,0,1,4,5,1,3,0,0,0,8,4,0,1,0,1,0,0,1,4,2,0,0,2,0,0,0,8,0,5,0,2,1,1,6,2,1,0,0,3,0,0,1,6,0,0,3,1,0,0,3,0,1,2,2,0,1,0,3,0,0,10,0,4,0,0,4,0,2,2,3,14,0,0,2,0,4,0,1,0,1,8,0,6,0,4,0,1,0,0,0,1,0,0,0,0,0,0,0,11,0,1,1,1,0,2,0,6,4,0,0,0,3,0,1,0,5,1,0,1,2,0,10,0,0,0,1,2,0,0,2,3,3,0,0,2,13,3,1,0,0,11,8,0,2,0,0,0,0,3,1,3,1,2,0,1,6,0,2,0,5,1,2,0,0,0,0,1,0,0,0,0,0,1,1,0,1,0,4,0,5,0,0,7,0,0,1,7,0,5,3,3,0,0,5,0,0,0,3,0,3,1,1,2,0,0,7,1,0,0,9,1,2,2,1,2,0,6,2,0,0,1,0,1,0,0,4,0,2,1,0,18,1,4,0,1,0,10,2,5,1,0,0,1,0,2,0,0,2,0,0,2,1,2,0,3,1,0,0,0,3,0,7,0,0,0,18,0,0,0,0,1,3,0,4,1,2,0,1,0,0,0,0,13,4,3,0,0,1,3,2,0,1,0,1,0,5,0,2,0,0,1,0,3,1,0,3,0,0,1,1,2,0,0,0,2,0,0,0,0,0,2,0,9,0,2,0,4,0,0,20,0,0,0,1,1,13,0,1,0,2,0,0,2,0,8,1,1,61,3,2,0,0,3,0,1,0,0,0,2,0,2,1,3,16,0,4,6,0,0,3,1,0,0,46,0,0,12,5,0,3,1,2,0,0,0,12,1,3,0,3,1,0,2,5,0,0,0,2,3,0,0,1,0,2,4,0,0,0,2,0,0,0,0,6,0,0,0,5,1,6,0,2,2,0,0,0,6,8,0,0,1,0,0,2,2,0,0,0,1,0,1,7,0,0,1,4,1,4,0,0,9,0,8,5,0,0,10,2,0,2,20,6,0,0,1,0,0,0,2,1,4,0,0,6,3,3,0,0,1,4,1,1,0,1,0,9,7,0,1,0,0,2,0,0,0,0,0,0,7,1,4,1,1,0,1,0,0,1,1,1,1,0,1,0,0,2,0,1,1,0,1,1,4,0,0,0,0,2,3,1,0,2,4,0,0,1,3,0,0,1,7,0,1,3,0,0,4,6,2,6,0,0,2,0,3,2,1,0,0,4,0,3,2,1,0,1,1,14,1,0,0,0,0,1,1,5,7,0,3,2,2,0,2,1,0,2,0,6,1,1,0,0,0,0,1,0,0,0,0,1,0,1,0,0,1,0,7,3,0,0,0,2,1,0,2,10,3,29,0,0,0,0,2,2,0,0,0,0,0,0,0,0,0,3,0,4,0,1,0,0,0,0,0,1,1,0,0,0,1,0,1,0,0,0,0,1,0,5,0,2,1,1,3,0,0,2,1,33,2,1,1,2,0,0,2,0,0,0,1,35,1,0,1,0,2,1,0,1,0,0,0,2,1,0,4,3,0,0,2,0,3,2,0,0,4,1,15,2,0,0,0,6,0,2,0,0,1,34,4,0,1,5,3,9,4,2,5,1,0,4,0,0,0,1,0,6,0,1,0,6,6,1,2,3,0,0,0,2,0,0,2,0,0,0,0,5,9,1,0,11,0,1,0,11,4,0,0,0,0,1,6,3,0,0,1,0,6,5,0,2,2,0,0,0,0,1,0,1,2,0,0,6,0,3,0,0,0,0,1,0,0,0,4,1,1,0,0,0,0,0,0,1,1,1,1,1,0,1,0,2,0,1,0,12,1,3,6,0,1,3,0,0,0,1,3,0,0,0,4,3,1,1,0,2,0,0,0,0,0,0,3,0,1,3,0,1,0,0,1,0,0,2,2,1,1,0,12,0,6,0,0,0,0,1,2,0,7,0,0,0,0,4,3,4,0,0,0,0,0,0,2,1,0,0,0,0,0,4,0,0,0,0,1,0,1,0,1,1,0,0,0,0,0,0,1,0,0,0,0,0,0,0,0,0,0,0,3,0,0,2,0,0,2,0,0,0,2,0,0,0,1,3,8,3,0,0,1,5,2,4,2,0,2,0,10,5,0,2,0,0,1,0,10,3,2,1,0,0,0,1,7,3,0,0,1,2,0,0,0,1,0,5,0,0,1,3,0,0,1,0,0,1,3,0,4,0,0,0,0,0,0,1,1,0,1,0,0,1,0,0,0,0,0,0,0,0,2,0,2,0,2,0,0,0,1,3,0,2,1,0,0,0,2,0,5,2,4,0,4,0,0,2,0,0,0,0,0,2,0,1,3,7,3,1,1,0,0,0,0,5,0,1,0,0,0,2,0,0,1,0,3,0,1,0,0,2,0,1,0,0,0,0,1,0,1,0,0,0,5,0,0,1,0,1,0,2,0,0,0,2,0,0,7,1,0,9,0,3,0,1,1,0,0,0,0,0,0,0,2,0,1,1,0,0,0,0,1,1,3,0,0,2,0,0,0,0,0,1,0,0,1,1,2,2,1,2,0,6,0,0,0,3,0,3,0,0,4,2,0,4,0,0,5,1,0,1,0,1,1,3,6,0,4,1,2,2,0,2,0,0,0,0,3,0,0,0,0,0,0,5,1,1,0,0,3,1,0,0,1,7,0,0,1,2,8,0,2,0,0,0,0,0,0,0,3,2,6,1,0,1,0,1,0,0,0,2,1,2,0,1,1,0,19,2,4,0,0,0,0,1,3,0,2,1,0,0,0,1,1,0,0,0,0,0,0,1,0,1,0,0,8,1,0,3,1,0,0,0,1,0,5,1,0,0,2,1,6,0,2,0,0,0,1,1,0,1,1,0,0,2,0,3,5,0,0,0,0,2,1,2,0,1,1,0,1,0,3,0,1,1,0,0,1,0,6,0,0,0,0,0,0,3,5,0,0,1,0,2,0,1,2,2,8,0,4,0,0,1,1,4,0,0,2,0,0,0,2,0,1,1,0,0,6,0,0,3,1,12,0,1,0,0,8,5,0,2,1,0,1,0,0,0,1,2,0,0,7,0,0,1,0,0,2,2,3,0,0,1,1,0,0,5,0,0,0,0,0,0,0,1,0,0,9,0,1,1,0,1,0,1,1,5,0,1,0,0,0,1,1,0,0,2,0,8,0,0,1,0,0,0,0,0,0,0,0,0,0,0,1,1,0,2,1,1,1,0,1,1,2,0,0,0,6,0,1,0,0,1,0,0,0,0,0,0,1,0,1,0,0,3,2,8,0,0,7,0,0,1,0,5,1,0,1,2,1,1,1,0,0,0,2,1,1,0,0,3,2,0,0,2,0,0,3,6,4,0,0,0,0,0,0,1,0,0,2,5,0,0,0,1,2,1,0,0,0,0,0,0,0,0,1,3,0,0,0,0,0,0,2,1,0,0,0,0,0,0,1,0,0,1,1,1,0,0,0,0,0,6,3,0,0,0,0,0,0,3,0,1,0,1,0,0,0,0,2,1,0,0,0,1,0,0,0,2,0,0,0,1,0,0,0,1,0,1,0,0,4,0,0,2,4,1,1,3,0,0,0,1,0,5,1,0,0,5,0,0,0,0,0,0,2,0,0,0,0,1,1,2,2,1,0,1,0,0,0,0,1,0,0,2,3,0,1,0,0,0,1,0,0,0,0,13,0,0,0,0,0,0,0,0,0,0,0,0,0,0,0,0,0,0,0,0,0,0,0,0,0,0,0,0,0,0,0,0,0,0,0,0,0,0,0,6,0,0,0,0,0,0,1,0,0,0,0,0,0,0,0,0,0,0,0,0,0,0,0,0,0
"1987 McDermott, Alice, That Night",high,3138,1738,1331,1061,1115,523,623,756,698,524,217,522,557,1081,1344,357,732,345,270,333,316,267,499,251,247,211,136,370,152,55,206,153,203,189,163,200,278,193,190,229,214,143,198,122,88,207,270,95,333,216,137,219,145,174,83,145,165,87,62,152,91,46,147,113,43,114,321,119,25,46,45,36,79,92,45,91,68,37,95,33,33,26,31,47,61,69,79,36,122,59,58,44,128,97,46,56,55,81,34,106,47,62,49,38,49,27,101,133,20,78,52,49,84,55,72,94,46,32,71,24,78,31,53,65,87,84,49,35,74,36,94,42,18,37,69,36,173,48,35,39,149,14,23,11,38,40,42,47,16,33,38,25,88,75,22,12,19,104,45,19,28,26,25,8,56,51,90,35,20,34,18,38,48,8,115,25,37,25,32,23,33,24,10,25,23,51,20,39,51,30,68,22,44,29,57,42,102,9,55,5,13,108,41,68,16,51,30,48,19,9,184,32,43,15,31,61,35,40,20,28,24,21,38,56,23,51,23,20,12,17,28,61,33,56,39,38,46,36,49,15,16,8,29,14,32,18,8,28,43,14,20,21,20,23,11,13,10,24,39,19,33,21,16,16,10,49,29,35,17,19,20,34,22,48,12,14,37,10,6,26,15,16,24,30,21,60,21,27,51,39,41,6,25,24,27,23,22,11,23,13,17,25,5,24,43,5,13,26,30,8,27,5,2,33,10,39,6,20,10,7,10,14,14,21,30,33,1,19,3,19,7,16,16,22,28,21,27,81,17,13,33,16,12,8,11,4,17,4,16,6,8,22,9,17,42,25,2,18,24,18,9,22,5,26,15,20,17,14,4,8,23,3,11,30,6,23,17,18,14,11,12,36,5,22,6,37,0,19,7,32,8,16,7,23,25,17,36,19,10,3,45,13,21,26,17,8,10,10,22,14,18,16,15,15,6,18,9,12,16,6,21,0,9,2,10,14,12,17,4,13,17,6,9,8,0,2,11,17,3,12,6,12,3,7,2,12,35,8,6,11,14,4,8,7,6,10,10,3,37,15,12,13,0,9,5,11,31,20,28,5,0,37,13,0,23,15,5,1,0,20,8,7,23,0,41,18,19,9,8,3,9,10,20,13,10,3,15,5,2,18,15,4,3,23,10,9,26,17,4,4,10,18,15,2,12,13,0,11,10,4,9,29,14,8,14,4,12,5,6,4,0,19,23,3,19,1,8,12,30,10,10,24,4,20,9,10,0,1,3,0,14,1,2,0,7,26,4,2,8,1,9,15,3,54,12,10,11,27,26,25,3,10,13,12,3,27,8,9,9,2,9,5,12,14,0,15,11,4,15,3,13,7,9,15,0,4,8,20,24,21,5,0,15,1,5,0,0,5,29,6,6,15,20,19,1,6,12,10,6,11,15,12,22,22,5,3,2,6,15,3,16,6,28,40,7,0,9,12,8,20,6,3,6,16,2,3,2,5,11,2,0,5,3,9,19,15,22,2,6,1,5,8,12,6,18,10,14,1,11,8,7,6,10,21,5,5,3,19,19,8,21,3,8,0,6,6,1,24,10,4,9,9,3,9,17,2,6,0,4,1,1,4,7,18,0,12,12,12,10,4,3,23,0,14,11,5,2,11,10,4,1,2,3,2,9,26,7,48,19,4,6,0,10,0,0,3,33,9,4,10,27,7,0,2,0,0,10,15,1,2,9,2,12,17,1,7,5,22,2,0,3,29,8,2,23,16,4,8,3,3,8,4,0,12,0,9,8,17,32,19,11,4,4,34,14,2,9,3,5,2,6,27,1,3,11,9,0,14,14,5,1,8,5,10,1,8,33,3,3,6,9,37,6,3,12,1,3,0,17,49,3,0,3,7,7,4,2,5,0,1,12,0,4,4,6,13,4,4,0,7,20,5,7,10,16,11,2,0,13,4,3,7,1,14,17,0,12,17,0,5,14,3,10,9,3,6,1,0,3,7,6,9,4,1,4,12,1,4,13,8,5,7,11,8,2,9,2,1,8,8,4,6,0,4,5,9,11,0,10,4,0,6,22,9,18,0,19,13,31,6,8,0,1,0,12,0,8,1,6,1,5,0,10,13,10,9,7,0,9,2,1,15,36,13,1,4,8,8,6,5,1,0,54,1,7,7,1,0,0,12,1,11,2,9,1,8,14,2,8,0,0,3,3,1,6,10,2,1,2,6,3,0,6,1,3,8,3,8,2,0,0,3,6,1,2,0,6,0,1,12,12,15,9,5,18,5,0,5,1,0,6,0,2,0,24,7,0,0,0,0,6,3,2,6,14,1,7,0,3,4,2,3,16,1,0,0,11,5,5,5,8,2,9,4,5,7,6,30,0,10,4,0,1,5,17,4,3,8,5,0,2,10,22,3,20,0,1,11,1,0,6,4,0,6,1,2,2,4,0,0,0,4,2,5,6,3,1,0,0,4,1,5,3,8,0,19,1,5,0,1,2,0,2,4,0,5,0,5,9,7,17,4,11,0,6,10,6,15,1,8,3,1,13,6,0,25,4,4,3,5,6,1,5,6,6,3,3,2,5,0,2,9,13,0,3,4,12,6,0,2,7,0,0,4,0,1,8,5,0,0,9,0,2,2,2,4,0,3,4,4,1,6,6,9,0,0,8,11,0,0,0,6,0,13,3,7,1,0,6,0,3,4,1,3,2,5,0,2,5,0,2,8,0,3,1,12,10,1,0,5,22,0,3,1,0,1,0,7,8,4,0,13,6,4,5,0,0,10,7,3,2,7,1,2,13,4,1,1,9,13,13,1,0,2,4,0,4,4,3,1,3,9,8,0,0,0,0,1,9,5,1,7,6,9,0,1,4,4,0,1,8,0,1,3,0,5,4,0,11,2,2,0,5,7,0,3,0,16,0,2,7,5,0,1,4,4,0,2,3,0,0,6,1,0,0,5,3,2,0,5,1,3,3,2,3,3,2,1,7,1,1,2,22,13,2,1,6,14,5,2,1,12,0,7,2,2,0,4,10,1,1,5,8,2,1,2,6,0,5,5,3,6,2,0,2,7,3,3,1,5,2,1,2,4,5,2,4,6,3,7,12,0,6,0,8,2,2,0,4,3,1,4,11,0,2,0,0,8,0,2,0,0,0,11,0,5,2,3,0,1,0,16,10,1,6,2,9,0,1,0,0,0,0,0,0,5,0,0,5,6,2,4,9,2,0,7,19,0,3,7,4,2,0,1,0,2,3,1,1,0,2,6,0,0,0,3,1,1,7,2,2,0,2,2,0,9,4,2,4,4,1,3,0,6,2,0,21,3,2,13,0,3,3,0,3,2,0,19,2,2,2,2,2,2,0,0,0,9,9,1,1,3,1,11,3,5,7,3,5,5,5,1,5,7,2,0,0,0,1,1,1,0,0,0,0,2,0,0,0,1,1,0,14,8,0,1,2,0,0,0,0,3,4,9,14,5,0,5,0,15,1,1,0,1,0,1,3,15,3,2,1,1,2,6,2,2,4,0,7,2,4,8,3,1,1,3,1,0,2,2,8,0,0,0,6,5,2,0,1,0,1,4,0,0,1,2,8,0,27,1,0,4,4,3,0,3,6,1,15,1,0,9,7,1,7,6,1,0,7,2,0,2,0,3,0,3,0,3,7,2,4,4,2,4,3,8,0,3,0,5,2,2,5,0,4,4,1,6,3,0,0,0,2,28,4,13,1,5,0,3,0,0,5,4,0,1,1,1,4,8,0,3,1,0,1,1,0,1,2,2,3,3,2,5,44,1,3,0,2,2,2,4,5,5,2,2,0,3,0,0,5,7,1,0,2,0,11,2,1,2,1,0,2,0,0,1,3,0,6,3,9,0,4,1,1,1,4,1,2,3,0,4,35,0,1,4,0,0,0,1,0,2,0,0,6,0,0,0,1,2,0,0,5,0,3,1,5,2,1,2,1,2,3,6,0,1,3,0,1,2,1,5,0,3,0,3,0,9,4,8,2,4,1,4,2,11,0,2,3,0,6,0,0,2,5,0,9,3,8,2,4,2,0,3,3,3,2,2,2,3,1,1,0,3,1,0,6,0,3,1,0,2,6,2,3,0,6,2,0,0,1,7,1,4,1,1,1,0,1,5,2,6,196,0,2,0,0,0,0,0,0,5,8,2,0,2,4,3,0,6,0,0,0,5,0,0,2,1,0,8,3,2,11,0,3,0,7,6,7,5,4,5,6,0,2,0,0,4,1,5,0,4,0,2,1,1,5,17,1,1,0,0,0,2,0,1,3,0,6,8,3,9,0,1,0,0,0,0,1,1,0,0,1,0,0,10,1,0,1,1,0,1,3,0,2,3,2,2,5,0,0,0,0,4,2,5,1,0,11,0,0,8,0,2,2,0,2,2,0,1,0,2,0,7,2,3,1,6,2,0,0,1,1,1,0,0,0,1,3,0,2,2,0,11,5,1,0,0,0,2,1,10,0,0,3,6,2,6,0,4,1,1,1,8,1,0,2,0,0,0,0,0,1,0,1,0,6,0,3,4,3,0,2,0,1,1,2,3,1,0,4,0,1,3,3,3,1,2,6,0,6,1,1,1,1,0,4,3,1,0,6,1,0,1,0,2,2,0,4,4,2,0,0,0,2,2,0,0,0,1,2,2,1,7,3,6,2,4,1,1,15,0,3,1,3,5,6,4,0,3,0,0,2,4,0,0,0,5,4,29,0,2,0,4,0,2,0,0,2,3,0,4,3,2,0,2,0,0,2,5,1,1,0,2,0,2,0,0,2,1,1,2,0,4,1,1,1,0,0,0,0,0,1,1,0,0,1,2,2,5,4,1,15,3,0,0,2,2,2,1,2,0,1,0,1,2,0,1,0,3,0,0,1,42,2,0,2,1,4,4,0,2,0,0,0,1,1,0,4,0,1,0,0,0,1,0,0,3,1,1,1,0,0,0,0,4,3,1,6,0,0,2,2,0,0,1,2,7,1,1,0,3,1,0,2,3,0,0,3,0,1,1,0,5,0,0,0,5,0,0,1,5,4,0,0,0,1,1,2,1,1,3,0,0,4,1,2,0,0,0,1,0,5,0,3,0,1,0,2,0,1,1,1,6,0,4,0,2,2,1,2,0,0,2,1,5,2,0,1,0,0,0,2,0,0,2,1,6,2,2,2,2,0,1,0,5,2,1,1,7,2,0,0,4,1,0,0,1,0,0,1,0,3,0,1,5,1,0,2,1,0,3,1,2,3,4,0,0,2,0,0,0,0,0,3,0,0,3,2,5,1,3,5,3,0,0,2,1,6,1,0,0,2,2,1,1,1,0,0,0,1,1,0,5,0,0,1,3,1,0,2,0,1,6,0,4,0,0,0,0,3,0,20,0,0,0,3,1,0,6,0,1,0,0,0,0,1,1,1,0,4,0,2,2,0,0,1,1,3,2,3,11,1,0,0,1,0,3,7,0,3,7,2,2,0,0,0,0,0,1,0,0,1,3,0,0,0,6,2,0,3,1,0,0,7,2,1,1,0,2,0,2,0,0,1,0,0,0,1,1,4,2,2,0,0,1,2,0,6,0,3,0,0,2,0,1,0,0,0,0,0,0,1,1,3,0,0,2,2,3,0,2,3,0,0,0,0,0,0,2,1,1,5,1,1,10,10,0,0,2,20,3,1,0,0,3,0,0,0,0,0,1,0,3,0,0,4,2,1,0,0,0,5,1,0,6,11,12,5,2,0,2,1,0,2,0,2,1,3,0,0,0,0,0,12,2,1,0,2,1,2,1,0,0,5,0,0,3,0,1,1,3,0,0,0,0,0,0,1,0,5,0,0,1,0,0,1,8,0,0,3,5,0,0,0,0,2,0,0,1,0,3,0,3,6,0,2,0,4,0,2,1,5,2,0,0,1,0,1,0,1,0,2,1,2,2,0,0,1,1,1,1,0,5,0,3,6,6,0,2,0,1,0,7,0,4,0,4,0,0,0,0,0,7,1,0,4,2,0,0,0,1,1,5,0,0,1,0,1,1,1,5,1,2,4,3,1,0,0,0,0,0,4,0,0,1,2,2,1,0,1,0,0,0,0,4,104,1,2,1,1,0,3,0,2,0,1,5,2,0,2,0,3,1,2,10,1,1,1,4,2,2,0,2,0,2,0,11,0,0,1,1,0,2,0,1,0,3,1,1,1,0,5,1,2,0,1,1,0,0,0,0,0,1,1,0,1,1,3,1,0,0,0,5,0,0,1,0,1,1,0,0,2,1,0,2,0,0,2,4,0,3,0,5,0,0,5,5,0,1,0,0,2,2,1,0,0,1,1,4,0,0,0,0,1,0,10,1,0,0,1,0,5,10,0,0,3,3,0,2,0,0,0,1,2,0,2,1,0,4,3,0,1,0,1,1,0,0,0,0,0,0,3,0,1,1,0,0,0,0,0,5,2,2,0,2,1,1,5,0,0,0,0,0,1,2,0,1,5,1,0,2,1,0,0,0,0,0,2,0,0,0,2,2,4,3,0,0,0,1,0,0,1,1,3,3,0,6,0,0,11,2,0,0,2,1,2,0,2,10,2,6,3,0,0,0,0,0,0,0,1,0,1,1,2,1,1,1,0,1,0,2,0,1,0,1,0,0,1,1,0,4,0,1,2,3,1,3,3,2,0,1,0,1,0,0,1,8,2,0,1,1,0,1,0,0,0,0,0,0,5,0,4,0,0,2,0,1,3,2,0,0,1,23,2,2,0,0,0,0,0,0,6,0,2,0,1,2,0,4,0,0,1,3,1,0,5,0,0,0,4,0,0,1,0,0,1,0,0,0,2,0,4,0,0,2,0,3,0,2,0,0,1,2,0,1,0,0,0,1,0,0,0,0,1,1,0,1,1,0,0,1,2,5,0,0,0,0,0,3,1,5,2,0,0,0,3,3,0,0,0,2,0,1,2,1,1,0,0,0,2,0,0,0,0,1,1,1,2,0,0,0,1,1,0,0,0,0,1,0,1,0,5,2,5,0,0,0,0,0,2,0,1,0,2,1,0,4,0,0,0,0,0,2,0,0,1,1,0,2,0,1,1,0,8,1,3,0,1,4,0,0,0,1,0,0,0,2,0,17,5,1,0,0,0,3,2,10,2,0,2,1,0,0,7,0,0,0,0,0,0,2,0,0,1,0,0,6,5,0,7,0,0,0,3,0,2,0,0,3,1,0,0,2,4,2,0,0,4,1,0,2,0,0,0,1,2,3,0,2,6,0,1,0,0,0,0,2,4,0,0,3,4,1,1,0,1,0,1,0,0,1,3,0,0,4,0,0,1,0,0,0,0,0,6,0,0,1,0,0,0,0,3,0,1,1,0,0,0,2,0,0,0,0,0,3,0,1,0,2,1,0,0,0,2,0,1,0,9,3,0,2,0,8,2,2,0,0,0,1,2,0,0,1,2,2,1,0,1,0,3,1,6,3,1,0,0,0,0,0,0,1,4,1,2,3,1,0,0,0,0,2,0,0,2,1,0,5,2,0,0,2,1,1,4,1,0,0,1,1,3,1,0,0,0,1,0,3,0,0,2,1,0,0,1,1,0,0,0,1,0,4,0,2,1,0,1,1,1,0,1,0,2,1,3,2,1,5,0,0,0,3,3,3,0,1,2,1,3,0,0,1,3,0,0,1,1,0,1,4,3,0,2,2,0,2,3,1,3,3,0,1,1,2,0,0,5,0,0,0,1,0,2,0,0,0,0,1,2,1,0,0,0,0,0,0,0,0,0,0,0,0,0,0,2,1,5,0,4,0,0,2,0,2,0,0,1,0,0,4,0,0,0,0,0,2,2,0,3,1,0,0,0,0,1,3,0,2,0,4,0,0,5,3,0,2,7,0,0,1,3,0,0,3,0,0,4,1,1,0,1,2,0,0,1,0,0,0,0,1,0,0,0,1,0,0,4,0,1,0,0,4,1,1,0,2,0,1,1,0,2,0,3,2,0,1,0,0,0,4,5,0,0,0,0,5,0,0,0,0,0,1,1,2,0,0,1,0,2,1,3,0,0,4,1,0,0,1,0,2,0,1,0,9,3,1,0,0,2,0,2,0,2,0,0,0,4,0,2,0,0,6,0,0,0,0,7,0,1,0,1,0,0,0,2,0,0,1,1,0,2,11,0,0,3,1,0,0,0,0,1,1,0,1,0,4,0,2,0,0,0,1,0,0,0,0,6,0,3,0,0,0,0,3,0,0,3,1,3,3,0,0,1,1,0,4,1,0,5,2,2,2,1,2,0,0,0,3,0,0,1,0,2,3,2,0,0,0,1,0,1,0,0,1,1,1,0,4,0,0,3,1,1,0,6,0,0,1,0,0,1,0,0,0,0,2,0,0,0,0,5,0,0,0,0,0,0,0,0,0,0,0,0,1,0,0,2,2,4,2,0,0,0,1,5,0,0,1,3,1,1,0,1,0,0,1,1,0,0,0,1,1,0,1,0,0,0,0,5,5,0,0,1,1,0,1,0,0,0,0,0,1,0,0,1,1,4,0,0,2,1,0,0,0,0,0,0,0,1,0,0,0,0,4,3,0,0,0,0,0,1,2,0,0,0,0,0,3,1,1,2,4,1,0,3,1,1,0,0,0,2,3,0,1,0,2,2,1,0,0,0,1,3,2,0,0,1,0,1,2,0,0,3,0,1,0,0,0,6,1,3,6,0,0,0,1,0,0,0,0,1,3,0,0,0,0,5,2,0,0,0,1,4,2,0,0,1,0,0,0,3,0,0,0,0,0,3,0,0,0,0,0,0,0,0,0,0,0,1,0,1,0,0,1,0,0,0,2,1,1,2,0,0,2,0,0,0,0,0,0,1,1,0,0,3,1,1,0,0,3,0,0,0,2,1,0,3,0,0,0,0,5,1,4,0,0,1,0,0,0,0,0,0,0,1,0,1,1,0,2,0,0,1,0,2,0,0,2,0,0,11,0,0,1,1,0,11,1,0,0,2,0,0,0,0,2,3,2,0,0,1,0,0,0,0,0,0,0,2,1,3,0,3,0,1,5,3,1,0,0,0,1,1,0,0,0,0,0,0,2,1,0,0,0,0,2,2,1,0,0,0,1,1,0,0,2,2,0,1,0,8,0,2,1,0,0,1,1,0,0,1,0,0,1,1,0,1,2,3,0,2,0,1,0,0,1,1,3,0,0,0,1,0,1,1,0,0,0,0,0,2,0,0,1,1,0,1,1,2,0,1,0,0,0,0,0,1,0,1,0,0,1,1,3,2,0,0,0,0,1,5,3,1,1,0,0,0,0,0,2,0,0,0,1,2,0,0,2,0,1,0,1,0,10,6,0,3,0,0,0,0,0,0,0,0,4,2,0,0,2,0,0,1,0,0,2,3,0,0,0,0,0,0,0,0,0,0,0,3,1,0,2,1,0,0,1,1,1,0,0,0,7,0,1,1,0,0,0,1,0,0,0,0,0,0,0,0,0,0,0,0,0,3,1,1,0,0,0,0,0,2,2,2,0,0,0,0,4,2,0,1,0,0,0,0,0,0,0,0,1,0,0,0,0,3,1,1,0,1,2,0,0,0,0,0,1,1,0,0,0,0,1,0,1,0,0,0,2,2,1,0,0,0,0,0,1,0,3,0,3,0,0,0,0,0,1,0,1,3,0,0,0,0,2,12,4,0,0,0,0,1,2,0,0,3,0,0,0,0,1,0,4,0,0,4,0,0,0,0,0,1,1,0,1,0,0,4,6,1,0,0,0,0,0,0,0,1,3,0,0,1,1,0,0,1,0,0,2,0,3,4,6,0,0,1,0,0,1,2,2,1,0,0,1,1,0,0,4,0,0,0,0,1,0,0,1,0,0,12,0,1,0,0,3,2,0,1,5,0,0,1,0,2,0,0,0,1,2,3,0,0,0,0,2,0,1,9,2,0,0,1,0,0,1,0,2,1,0,3,0,0,0,0,0,0,1,0,0,0,0,0,0,0,0,2,0,0,0,0,0,0,0,0,0,0,0,0,4,0,0,1,0,0,2,1,0,2,0,2,0,1,1,2,0,0,1,0,0,1,0,0,0,1,0,0,0,0,0,1,1,0,0,0,1,0,6,1,0,0,0,0,0,1,0,1,0,1,2,0,2,0,1,0,0,0,0,0,2,0,0,0,1,2,1,0,0,0,1,0,0,0,0,0,1,4,0,0,0,5,0,1,0,0,0,0,0,0,2,0,0,0,0,0,0,0,0,1,0,0,1,1,0,0,0,1,3,0,0,1,0,0,1,0,0,0,0,0,1,0,0,1,0,0,2,1,1,3,0,1,0,1,0,1,2,0,1,2,0,0,2,1,0,0,1,0,2,0,2,0,2,0,2,0,0,2,3,0,0,0,2,0,4,2,0,1,0,0,1,0,0,0,0,0,1,1,0,0,1,1,0,1,0,1,0,0,0,0,0,0,0,1,1,0,0,0,0,1,0,0,0,0,0,1,0,0,0,0,1,1,0,0,3,0,0,1,1,0,0,2,0,0,0,0,0,2,0,0,0,0,1,0,0,1,0,0,0,0,0,0,0,0,0,0,0,1,0,0,0,0,2,0,0,0,1,0,0,0,0,0,0,0,0,0,0,0,0,1,0,0,1,0,1,0,5,1,0,0,0,1,1,0,0,1,0,0,2,1,2,0,2,1,0,0,0,0,1,1,0,0,0,1,1,0,3,0,1,0,0,0,0,0,0,0,0,1,0,0,0,0,2,3,0,0,0,1,0,1,1,0,2,0,2,0,0,0,0,0,2,0,2,1,1,0,1,0,1,0,0,0,1,0,0,1,0,0,0,1,1,0,0,0,0,0,0,0,1,3,0,0,0,0,0,0,0,0,0,0,0,0,0,2,0,0,0,0,0,3,0,0,0,0,0,2,0,0,0,1,0,0,0,0,0,1,0,0,2,0,0,0,0,0,0,0,0,2,0,0,0,0,0,0,0,0,0,0,0,2,0,0,0,0,0,0,2,0,0,0,0,1,3,1,0,0,1,0,0,0,0,0,0,0,1,2,0,0,0,0,0,0,1,0,0,0,3,0,0,0,0,0,0,0,3,0,1,0,0,0,0,0,0,0,0,0,0,0,0,0,0,1,0,0,0,0,0,0,0,0,0,0,0,0,0,0,1,0,0,1,0,0,0,0,0,0,0,0,0,0,0,0,0,0,0,0,0,0,0,0,0,0,0,0,0,0,0,0,0,0,0,0,1,0,0,0,0,0,0,0,0,0,0,0,0,0,0,0,0,0,0,0,0,0,0,0,0,0,0,0,0,0,0
"1988 Dexter, Pete, Paris Trout",high,6957,3383,2532,2008,1868,1009,3081,1774,1737,1540,1249,1410,1032,1993,1698,780,837,470,550,1711,744,399,524,713,190,623,234,353,512,360,395,513,440,275,333,266,358,281,127,317,299,205,546,291,124,305,164,95,266,613,428,286,244,394,190,134,235,186,197,144,232,219,144,208,247,206,75,226,92,415,134,67,118,204,259,104,130,154,155,148,197,141,127,137,246,294,174,94,67,118,90,95,86,112,90,84,96,127,52,161,112,67,94,119,156,68,174,256,132,140,143,68,54,171,97,229,102,35,77,118,48,61,138,123,186,67,121,97,71,101,226,186,90,195,157,55,22,98,131,68,173,33,70,34,42,169,61,93,84,13,76,14,147,86,67,47,58,29,49,136,37,112,62,69,123,38,112,42,96,96,13,56,45,55,182,12,38,68,39,32,23,42,22,91,71,56,33,132,112,42,136,66,41,92,62,92,7,65,116,43,48,88,46,50,24,333,57,25,36,16,69,68,32,35,133,47,113,44,35,139,121,37,31,88,36,32,15,40,58,1,171,32,143,52,46,26,59,67,35,17,39,18,114,33,85,27,59,105,40,31,23,73,30,164,58,27,38,41,66,21,75,6,7,73,8,5,49,21,32,33,27,17,19,75,24,27,15,31,39,49,99,79,38,26,28,70,38,59,31,23,73,2,20,29,49,31,49,23,13,31,20,30,0,30,120,36,75,144,134,29,19,27,44,39,9,77,43,19,30,11,4,9,41,62,112,90,10,12,35,84,41,35,35,99,36,22,12,26,35,62,24,26,39,85,24,24,32,0,11,14,14,58,34,28,38,32,34,20,43,21,28,43,29,22,55,55,16,32,12,17,24,90,23,50,24,52,12,49,29,20,40,44,33,70,17,63,0,43,19,6,24,13,26,0,21,16,24,50,14,19,22,33,56,17,25,8,23,6,28,11,34,21,22,54,16,19,10,50,28,22,71,1,66,56,48,35,11,71,27,5,34,17,64,49,0,4,36,56,42,23,36,15,15,35,10,8,59,33,15,31,54,27,12,13,48,12,14,5,53,26,13,7,0,11,22,14,11,12,83,3,12,43,19,123,18,13,40,14,0,31,43,30,28,83,66,8,11,19,5,11,13,11,5,15,21,45,36,42,11,22,36,10,79,45,11,46,4,23,80,12,4,41,13,40,4,12,0,14,14,42,12,11,59,9,12,12,5,14,28,14,4,51,7,9,58,77,31,3,8,13,29,12,1,31,24,7,0,3,27,3,26,19,21,91,40,8,12,14,8,1,8,44,28,48,9,6,27,10,8,4,7,8,5,28,10,56,14,5,19,5,16,4,18,54,1,7,30,11,3,4,8,30,64,14,8,10,6,43,21,29,26,7,4,2,12,0,83,47,35,9,47,4,19,10,14,10,14,4,10,9,19,19,5,29,25,0,21,38,21,0,28,21,22,12,24,0,40,43,15,18,4,1,22,28,0,18,13,4,55,24,0,28,14,9,8,18,24,30,13,2,12,8,35,8,2,32,21,32,21,6,6,15,19,10,10,9,12,35,24,10,9,32,6,20,12,8,0,2,29,23,11,7,10,66,12,12,7,1,34,6,11,42,26,20,24,9,0,29,5,6,2,8,8,22,17,0,16,18,23,22,1,33,15,0,5,15,56,2,16,11,10,25,12,2,0,14,11,41,11,28,1,13,2,21,1,0,15,14,3,4,13,16,8,9,4,25,4,17,24,2,13,13,9,10,16,0,7,5,10,2,30,4,0,48,0,16,7,38,6,4,16,2,4,39,5,7,16,11,10,6,46,8,0,9,24,6,0,40,0,13,18,24,3,16,0,3,13,2,2,0,24,0,12,15,9,9,19,0,18,4,16,10,2,4,17,2,2,6,14,30,0,0,0,16,18,14,14,6,0,4,5,29,29,4,13,9,6,0,39,3,8,25,0,1,12,0,3,9,5,29,11,0,12,32,1,3,10,0,16,6,9,13,10,48,0,29,1,18,11,7,0,6,10,35,3,13,48,10,4,13,10,3,12,22,8,11,1,0,2,1,4,5,22,10,0,5,24,12,6,2,11,0,17,0,3,8,2,37,17,9,4,0,15,13,12,3,5,10,7,14,0,25,3,0,9,38,4,8,16,7,7,0,10,6,13,6,12,10,4,2,5,15,13,1,0,1,47,18,6,1,0,9,6,1,14,2,13,19,3,24,8,0,21,18,2,3,2,4,17,0,46,14,7,9,4,1,10,0,6,68,22,3,7,10,9,9,252,5,8,0,21,0,0,0,7,21,0,810,0,15,8,2,14,1,15,5,5,0,5,5,2,7,2,0,0,10,3,13,2,12,7,8,3,8,1,37,12,11,7,7,5,4,0,6,11,7,15,10,34,0,13,8,0,31,14,0,4,11,0,6,1,28,0,3,44,4,7,15,0,0,0,13,22,6,2,4,13,0,13,1,5,29,7,11,12,8,2,5,8,92,4,0,9,8,0,11,3,17,1,25,10,6,13,9,6,23,2,5,7,13,30,3,17,8,0,1,7,11,17,7,7,4,17,7,6,14,13,5,13,0,17,0,17,13,8,8,6,11,2,19,0,0,26,18,27,1,7,12,23,17,9,1,0,15,18,2,30,5,1,14,0,0,2,25,0,67,0,3,0,7,93,20,15,2,22,11,4,0,3,0,1,4,1,7,2,10,0,8,3,0,6,5,0,4,2,11,9,5,106,0,13,0,3,9,4,6,0,1,4,4,0,2,3,9,4,0,0,8,13,6,16,15,35,25,16,2,4,10,1,5,1,8,1,2,10,0,4,14,3,2,5,0,13,0,0,0,0,3,16,8,2,0,14,13,3,1,5,6,1,4,31,677,0,6,0,0,13,0,2,11,0,5,0,1,0,4,3,8,0,0,16,3,2,7,7,11,4,3,12,21,0,14,6,2,3,20,1,5,3,10,3,12,11,10,10,6,3,3,12,6,0,3,13,5,1,2,11,11,3,4,6,25,1,0,21,15,9,10,1,4,72,2,1,0,2,5,2,33,1,6,6,12,14,0,4,0,2,3,5,2,1,2,5,6,7,6,15,5,21,31,0,5,6,0,10,1,9,0,0,4,8,1,3,63,3,7,0,15,0,0,0,0,1,13,3,10,1,7,6,5,29,13,9,0,5,1,11,0,5,9,0,0,0,6,103,6,0,0,1,5,0,4,1,4,22,6,7,33,3,14,2,8,5,3,3,3,1,6,7,6,3,9,0,0,0,8,0,8,10,12,21,0,7,1,0,13,6,9,1,3,4,2,0,5,1,0,4,8,6,15,2,3,17,0,12,2,5,0,1,0,1,1,8,3,0,3,6,0,6,5,2,3,1,1,2,5,8,1,0,3,0,11,2,13,5,1,0,3,0,1,6,0,0,0,0,20,0,11,6,0,7,10,4,22,5,3,0,0,3,2,4,2,5,17,7,1,5,7,1,16,8,18,0,4,7,0,9,8,4,0,5,5,1,6,15,11,4,0,1,5,10,16,13,6,0,0,2,0,4,3,0,1,1,13,2,0,15,7,1,1,0,4,1,0,0,2,3,2,5,4,2,0,8,3,10,1,10,10,0,10,0,4,23,0,11,7,1,1,0,2,0,8,0,1,6,12,2,2,3,2,7,2,1,0,0,4,0,1,0,5,6,13,7,0,0,1,0,1,0,0,4,0,0,1,0,2,5,6,3,19,7,3,2,2,0,12,0,5,9,0,0,2,4,0,1,4,0,4,4,0,12,0,4,6,7,4,11,0,6,16,2,2,1,1,1,1,11,1,0,6,1,1,0,1,4,0,1,7,12,1,3,0,3,1,0,10,0,0,4,3,2,0,14,1,0,2,4,0,1,0,0,9,1,2,2,3,1,0,0,2,3,7,2,14,2,0,3,4,5,6,0,1,0,0,5,1,5,2,6,1,3,0,7,11,0,0,2,0,11,7,7,4,0,4,0,4,0,3,1,2,12,2,5,1,6,7,9,3,3,0,1,0,0,2,0,1,2,17,14,7,2,13,4,3,11,4,1,2,17,4,4,7,0,5,0,0,2,2,17,6,3,4,1,4,0,6,6,0,0,0,9,1,1,6,2,1,1,11,2,1,1,6,0,0,4,0,0,0,0,0,1,3,4,0,2,12,0,6,0,5,0,6,0,1,0,1,0,1,1,0,8,16,2,2,6,4,17,1,3,0,8,0,1,110,3,0,1,0,0,7,0,1,0,7,19,0,0,10,0,3,0,0,1,7,0,1,1,0,12,10,1,2,0,2,1,0,2,0,0,3,0,0,1,3,0,2,0,0,1,8,0,16,2,0,8,1,9,3,4,0,4,0,0,1,0,0,1,3,0,1,0,19,0,3,7,0,2,4,0,1,4,3,0,0,0,11,4,3,21,1,1,2,0,0,0,3,1,2,0,1,0,9,2,5,3,0,12,0,4,4,2,12,0,0,7,1,55,6,3,0,0,8,3,1,2,0,4,8,1,0,7,3,1,0,0,0,1,0,1,1,9,0,3,0,0,10,1,5,25,0,7,0,0,13,0,1,8,5,1,2,1,0,3,6,0,0,3,14,1,0,1,0,0,6,1,11,0,0,5,1,4,1,2,0,0,11,1,2,0,2,0,5,6,2,2,6,3,0,1,0,0,3,2,4,10,3,0,2,5,1,0,0,3,1,0,0,0,5,2,0,2,3,2,1,1,3,0,1,0,12,3,4,6,3,2,2,7,1,2,3,0,1,8,0,1,1,0,0,8,2,4,3,1,3,10,24,2,3,0,7,1,0,4,3,0,0,6,8,0,2,10,2,6,0,0,4,4,2,0,1,0,6,4,2,1,2,0,1,0,1,0,3,0,0,1,0,3,0,4,2,0,6,0,1,2,1,3,4,1,0,6,0,3,0,4,0,0,2,0,0,0,13,0,0,1,0,7,0,5,0,1,4,0,3,4,0,3,3,2,7,1,0,5,0,0,0,0,0,1,4,4,3,3,2,1,0,0,2,3,5,3,3,1,0,0,4,1,0,0,1,0,2,0,1,4,3,3,0,0,0,1,0,1,3,4,0,1,3,4,4,6,3,1,5,8,3,0,4,0,0,2,0,3,11,1,0,0,0,0,0,0,0,3,3,0,3,0,8,2,5,2,3,0,8,4,1,9,6,0,7,0,1,5,1,9,9,8,0,3,0,3,1,2,0,5,0,0,30,13,4,2,4,1,4,3,3,3,9,6,1,0,6,0,1,1,2,4,2,1,1,1,0,2,7,0,0,3,0,7,2,0,9,2,3,1,54,1,2,0,2,0,7,0,4,0,2,4,3,0,32,0,0,3,9,0,1,2,7,2,1,0,0,4,0,1,0,1,0,4,2,10,3,0,0,0,0,2,2,2,1,2,3,2,1,14,4,2,0,5,11,1,6,1,0,24,9,0,7,0,0,6,0,0,1,0,1,1,0,0,3,5,1,0,4,1,0,0,7,0,3,3,3,3,1,0,1,1,6,3,1,0,0,0,0,0,0,2,0,6,2,0,0,6,0,0,12,2,27,1,4,2,6,0,3,0,0,0,0,1,0,0,2,2,2,2,3,0,7,4,6,3,8,2,4,0,6,15,0,4,1,1,0,0,8,2,2,5,3,9,1,0,0,6,5,3,0,0,0,4,0,1,6,0,1,0,1,2,1,2,0,3,1,9,2,1,3,0,1,11,2,0,2,1,0,3,26,5,4,1,2,1,0,1,0,0,4,0,1,1,0,2,1,0,1,2,4,0,0,0,0,2,7,2,4,3,1,0,3,0,0,0,0,0,3,0,0,1,1,0,5,1,0,3,1,9,1,0,0,0,3,1,0,1,7,0,0,0,0,1,2,3,2,8,1,0,0,6,0,10,0,3,6,0,0,5,2,2,0,1,3,1,5,2,1,0,2,0,1,29,3,0,6,0,0,0,0,0,0,5,0,1,0,3,0,0,0,2,3,0,0,0,1,4,0,3,0,0,1,3,8,0,1,0,5,6,5,3,2,12,2,5,0,0,2,13,8,2,0,1,2,0,0,0,5,0,3,0,0,1,2,0,0,3,11,0,0,0,9,1,1,31,2,0,0,2,0,1,0,3,4,2,0,0,4,7,0,0,7,8,4,0,2,0,0,0,3,4,1,1,1,0,0,1,1,0,0,2,6,7,0,0,0,0,1,1,0,2,1,1,1,0,0,1,2,1,16,0,0,1,11,0,0,1,5,0,2,0,3,1,11,4,5,0,0,3,0,0,0,2,0,2,0,9,4,0,0,1,0,7,18,0,5,7,0,1,0,4,1,0,1,2,1,1,4,0,0,0,1,1,1,0,4,3,0,8,8,3,0,0,13,3,0,1,0,2,4,1,0,0,6,0,0,6,2,2,13,2,4,0,0,0,3,4,1,0,0,0,0,0,6,0,5,1,0,2,7,0,0,1,0,0,2,0,0,0,2,0,2,0,0,9,0,2,5,3,1,0,0,0,1,0,3,1,3,4,0,0,2,0,0,1,0,0,0,1,0,3,2,0,4,3,0,3,0,0,0,0,0,1,0,4,1,6,2,0,4,1,0,7,8,0,0,0,2,0,1,0,0,0,1,0,0,2,0,1,3,2,0,0,2,0,2,2,2,2,0,0,3,0,0,2,0,0,1,0,1,0,7,2,0,7,0,2,0,3,0,0,1,4,0,0,2,1,2,0,2,1,8,0,4,0,0,2,2,0,1,5,0,0,8,0,0,0,8,2,4,1,1,0,0,3,0,0,1,3,0,6,0,1,17,0,1,0,0,0,0,0,0,0,3,0,8,6,0,2,2,2,3,2,6,0,0,0,1,6,2,1,14,2,0,1,0,4,6,2,0,2,1,2,2,2,1,2,0,3,0,3,0,0,0,0,2,0,2,3,2,1,1,2,6,10,0,3,3,0,4,0,0,0,0,0,0,0,0,3,0,0,0,0,0,2,0,4,0,0,1,1,3,5,0,0,2,0,0,1,0,0,0,7,1,2,4,0,8,0,0,0,2,4,1,3,16,1,0,3,0,0,2,0,0,0,0,0,0,0,7,0,0,0,1,21,0,3,3,0,3,0,1,0,3,0,1,0,0,1,0,0,1,0,0,0,2,0,0,5,4,1,2,3,0,5,0,0,0,0,0,2,0,1,2,0,1,1,0,6,0,0,0,2,0,1,3,0,4,4,0,0,1,2,1,10,0,2,0,1,2,23,11,1,0,2,4,0,1,2,0,1,0,1,3,1,1,16,1,11,1,1,0,1,1,2,0,0,2,0,7,1,0,1,0,1,0,6,4,0,0,4,0,1,6,0,1,0,0,0,0,0,0,1,0,0,3,0,5,2,0,5,2,2,1,0,5,3,9,3,0,0,0,1,5,6,0,0,7,0,5,2,8,2,1,3,0,3,1,3,0,0,1,2,2,4,2,0,2,0,0,1,52,0,0,0,1,0,2,1,3,1,1,2,0,1,2,3,0,1,1,0,0,3,0,2,0,1,10,0,6,4,0,4,1,7,9,0,8,1,4,0,0,2,3,21,1,1,4,0,1,4,0,2,1,2,0,1,1,5,0,1,0,1,0,0,2,6,0,1,0,0,4,0,0,3,1,0,0,0,4,0,1,0,1,4,2,1,0,3,4,1,0,8,1,2,2,8,0,0,0,4,3,1,0,0,0,4,3,0,0,0,3,12,0,0,0,3,0,0,0,0,5,0,0,1,0,0,2,1,0,0,0,4,0,0,0,0,0,0,0,0,0,1,2,0,0,0,0,0,2,1,0,0,0,1,0,2,0,0,0,0,3,1,0,0,0,0,0,1,0,0,0,0,1,1,2,0,0,4,0,1,1,8,17,0,0,0,1,6,0,0,2,0,2,2,0,0,0,0,0,4,0,0,0,2,1,0,0,2,1,0,1,0,4,2,0,2,0,0,2,0,0,1,7,1,0,4,1,2,1,1,0,2,1,0,0,2,3,0,0,6,0,5,2,0,0,8,0,4,0,3,6,0,5,1,1,0,0,0,0,0,0,1,0,0,0,1,7,3,0,5,0,3,0,0,0,0,0,4,1,0,0,0,0,0,1,0,0,1,0,1,0,2,1,0,0,4,0,0,0,0,0,1,1,1,0,0,0,0,1,4,5,0,0,9,4,7,2,115,2,9,0,4,5,0,0,0,1,0,0,1,2,1,1,0,0,5,0,0,1,0,0,1,1,5,1,1,0,0,4,0,0,0,1,0,6,0,0,1,1,0,0,2,1,0,0,8,0,1,5,0,0,0,0,0,2,0,0,0,0,0,0,3,0,3,0,182,0,0,0,1,0,0,1,3,1,0,0,0,0,0,2,0,0,0,0,1,0,0,0,0,6,0,0,0,13,7,2,1,0,0,0,0,1,0,0,0,1,0,0,0,1,0,0,1,4,2,0,6,7,11,0,1,1,0,1,0,5,2,19,0,0,0,166,1,6,1,37,0,0,8,0,2,0,1,0,0,0,0,1,0,0,4,0,0,0,0,0,0,0,0,0,0,0,0,0,13,0,0,0,0,0,3,3,8,3,2,0,0,2,8,0,0,1,0,1,0,0,4,2,0,1,2,1,1,1,2,0,0,0,2,0,3,2,0,3,0,0,0,0,1,4,1,0,4,1,0,0,8,0,0,0,0,0,0,3,0,0,7,0,0,0,0,0,0,1,1,0,0,0,2,0,0,0,6,0,0,0,5,2,0,0,0,3,0,5,0,2,0,0,0,0,1,0,3,0,0,1,1,0,0,1,4,1,2,0,1,0,0,0,0,0,0,0,5,0,33,0,0,2,1,1,1,0,0,1,0,0,0,0,0,0,0,0,0,0,1,0,1,0,0,0,0,0,0,0,2,1,10,0,1,2,1,1,0,0,2,0,0,0,0,1,4,1,2,0,0,0,1,0,0,0,0,1,1,0,1,0,0,4,0,0,0,0,3,3,0,5,0,0,0,2,0,0,3,0,0,0,0,0,0,1,2,0,0,2,0,0,4,2,0,0,0,4,1,0,9,0,0,0,1,3,10,0,4,0,2,2,0,5,2,0,3,1,0,2,1,0,0,0,2,6,2,0,0,0,0,0,2,0,0,1,0,0,0,0,0,0,2,1,3,0,0,0,0,0,1,1,2,0,1,0,0,0,1,0,0,1,2,3,2,0,0,0,2,20,1,0,2,2,1,3,0,0,0,0,0,0,0,0,2,0,1,0,14,4,0,0,1,0,2,0,0,4,0,0,1,4,0,0,0,3,1,0,2,0,1,3,0,0,1,0,0,0,0,1,0,4,0,0,0,2,1,0,0,0,0,2,0,4,1,0,0,2,1,1,0,0,0,5,0,0,0,0,0,1,0,2,0,0,0,4,0,0,3,4,0,0,2,0,0,0,1,0,0,0,0,0,0,0,0,0,0,0,1,0,0,0,0,0,0,0,4,0,0,0,0,1,0,0,0,5,5,0,0,0,0,0,0,1,0,0,4,6,0,0,3,0,0,0,0,0,1,2,0,0,0,0,0,1,0,1,0,0,0,0,0,0,0,0,1,0,3,1,0,0,2,0,4,1,0,0,0,0,0,1,1,2,0,0,0,0,0,1,0,1,4,0,0,0,0,0,2,1,1,1,0,0,0,0,0,2,1,1,0,0,0,0,4,0,31,0,0,0,1,1,0,1,4,0,1,0,0,0,0,3,0,0,0,0,1,0,4,1,6,0,0,10,1,0,0,1,1,0,1,0,0,0,0,0,2,9,0,1,3,1,1,1,0,0,0,1,0,0,0,4,0,0,0,0,1,0,0,0,0,0,0,3,0,0,0,2,3,8,1,0,0,0,0,0,0,1,2,1,6,3,0,0,0,0,0,0,4,1,2,0,2,0,0,8,1,0,2,0,0,0,2,2,0,1,1,0,0,0,3,1,0,0,0,0,0,0,0,0,0,0,4,0,0,0,0,0,1,0,1,0,0,1,1,0,0,1,1,0,3,0,3,0,0,0,5,0,0,0,0,3,1,0,0,0,4,4,0,0,0,1,0,0,0,0,0,1,0,0,3,0,1,6,0,0,0,3,8,0,0,0,1,0,0,0,0,0,6,0,1,1,3,1,2,1,1,2,0,1,0,0,0,25,0,0,15,0,0,0,1,0,0,0,0,0,1,2,0,0,1,3,0,3,0,0,0,24,2,2,0,0,3,2,0,1,19,0,0,0,1,0,0,1,0,0,0,0,0,0,2,2,0,1,1,0,0,1,0,0,1,1,0,2,0,0,1,0,3,0,0,2,0,0,0,4,0,0,1,0,0,0,2,0,3,1,2,3,0,0,0,0,4,0,0,0,0,10,2,0,4,0,1,0,2,0,0,0,0,0,0,0,8,0,0,0,0,0,1,0,0,4,0,0,1,4,0,0,0,6,0,0,1,0,0,0,1,3,4,2,0,0,0,2,3,2,1,1,1,1,1,2,0,1,4,1,0,0,0,0,0,0,0,0,2,0,0,0,0,1,0,1,0,2,1,1,0,0,0,2,0,0,0,0,0,0,2,0,0,5,96,0,1,0,0,0,0,9,0,0,0,1,0,0,0,0,2,0,0,0,0,0,2,0,0,0,4,3,6,0,2,0,0,0,0,0,0,0,1,5,0,0,0,1,0,2,0,0,0,4,0,0,0,6,2,0,0,0,0,1,1,0,0,3,2,1,0,0,0,0,0,1,0,0,2,0,0,2,0,3,8,1,0,0,1,0,0,0,4,0,0,0,0,2,0,1,1,0,0,0,0,0,0,0,0,0,1,0,0,0,0,1,0,1,0,1,0,0,0,2,1,0,0,0,1,0,0,7,0,1,1,1,0,0,0,0,0,2,1,2,0,0,1,0,0,0,1,0,0,1,0,0,0,0,1,1,0,1,0,0,1,0,0,0,0,0,0,0,0,0,0,1,2,0,0,0,2,0,2,3,1,0,0,0,0,0,0,0,0,2,0,0,2,1,4,0,0,0,0,2,0,1,2,0,0,0,1,0,0,0,0,0,1,0,0,2,0,0,0,1,0,0,1,1,0,0,0,0,0,0,0,0,3,0,0,0,0,0,0,4,0,0,0,0,1,0,0,0,0,0,0,0,0,0,0,0,0,0,0,0,0,0,0,0,3,0,0,0,0,0,0,0,0,0,0,0,0,0,0,0,0,0,0,0,0,0,0,0,0,0,0,0,0,0,0,0,0,0,0,0,0,0,0,0,0,0,0,0,0,0
"1989 Casey, John, Spartina",high,6706,2751,3113,2773,2203,1581,2511,1755,2088,1780,1764,1270,1143,1090,1379,1187,619,707,845,1289,703,866,659,754,287,385,320,507,793,396,333,981,574,526,360,418,308,497,172,394,480,355,374,316,474,473,274,447,226,342,485,312,404,302,195,337,267,277,314,543,354,318,94,271,349,251,167,235,135,124,509,288,230,300,600,232,192,359,358,181,286,265,104,251,356,249,116,162,162,210,200,320,92,130,158,158,256,141,290,116,60,303,280,164,236,57,256,177,175,136,166,161,47,156,115,64,136,127,142,76,69,43,170,55,37,120,107,183,85,167,160,199,170,186,137,115,33,85,91,82,161,70,415,153,54,216,138,112,167,213,92,36,129,143,57,78,28,54,79,129,95,230,198,113,38,35,97,87,104,50,71,53,58,189,39,45,82,44,81,89,48,81,66,49,127,67,129,81,89,50,67,67,131,66,51,89,63,99,29,90,88,65,43,67,112,32,59,32,145,89,28,64,19,45,74,74,41,63,47,60,38,38,56,75,44,118,49,29,24,54,20,45,39,28,52,106,33,39,46,15,57,96,38,75,36,115,76,71,66,20,80,182,111,29,86,59,124,74,58,15,62,77,71,131,25,20,52,40,48,62,97,47,48,37,64,26,54,53,77,52,8,31,57,49,44,2,33,46,20,42,103,32,20,13,68,66,32,70,74,94,79,32,105,66,53,86,137,41,47,342,35,25,29,94,19,63,13,47,27,37,26,28,82,50,56,35,27,45,18,35,78,21,42,55,26,77,53,10,49,11,42,29,49,22,64,26,19,37,43,41,47,17,38,60,18,40,17,83,27,43,38,34,30,18,79,15,12,16,43,76,21,32,48,25,33,37,7,27,29,23,16,40,65,52,33,2,0,19,48,36,15,34,26,37,42,23,29,39,11,47,31,5,17,15,21,48,36,81,9,1,42,27,22,5,28,4,18,43,47,15,14,1642,195,17,44,108,23,25,28,62,21,27,13,41,12,11,51,8,0,42,35,41,63,46,43,11,24,24,53,24,22,44,21,35,30,31,37,13,12,49,45,16,0,6,7,27,16,10,6,6,13,27,28,10,67,13,7,18,0,6,26,3,31,6,14,19,37,13,39,37,11,41,42,13,33,5,7,47,6,61,48,2,7,15,46,34,85,32,18,24,5,24,13,22,19,17,0,32,131,17,29,16,28,59,39,9,42,15,38,22,3,43,27,35,10,123,28,17,3,15,13,5,10,34,20,25,721,6,21,21,38,11,35,10,14,19,6,10,17,1,7,11,20,17,18,31,32,16,30,8,30,22,18,9,37,13,13,18,21,11,35,27,33,39,26,18,10,21,9,2,7,15,13,13,41,36,8,14,8,25,19,52,14,0,12,0,0,17,30,15,10,4,12,17,4,17,20,33,36,15,22,17,4,16,22,44,15,13,34,23,31,14,15,147,16,0,17,21,22,13,40,8,12,0,30,13,9,13,9,28,0,10,6,13,34,9,36,7,36,2,28,23,11,10,11,13,6,18,44,5,5,5,4,8,6,24,13,7,17,8,13,9,3,22,6,24,369,4,16,73,8,2,7,14,7,14,3,94,12,30,12,2,17,6,15,0,10,8,14,9,1,17,1,20,25,83,17,12,42,13,18,42,38,137,10,14,22,2,12,20,16,45,7,7,0,17,15,12,16,15,27,22,22,3,0,1,17,10,28,5,7,7,9,14,0,1,28,12,2,7,27,11,15,43,4,33,23,4,10,8,16,14,0,1,0,7,14,26,9,12,14,9,7,11,2,30,1,12,30,9,25,1,0,20,11,17,0,14,1,11,32,10,31,20,17,1,6,3,7,39,6,4,17,0,14,19,6,5,18,58,4,5,3,6,13,19,36,6,29,29,10,12,13,33,18,33,7,3,0,10,2,17,23,6,6,4,16,0,6,1,10,22,51,1,3,4,10,10,1,14,25,24,24,15,18,22,2,0,40,15,15,6,22,17,0,10,3,28,12,34,7,9,9,8,9,36,22,24,21,11,13,1,2,16,8,5,0,144,9,8,3,0,7,2,26,18,7,33,10,0,9,0,24,0,3,3,3,24,21,9,16,2,1,11,8,7,3,0,1,1,10,3,20,0,1,2,4,11,16,6,15,4,2,5,6,22,3,9,30,10,3,12,8,11,9,4,28,15,12,9,0,15,38,0,14,3,10,2,8,8,4,0,14,9,0,8,5,12,0,1,1,19,13,0,3,9,5,0,3,4,5,4,7,5,8,19,1,11,40,0,41,0,9,7,19,2,0,1,1,23,7,9,0,2,4,20,3,0,8,16,0,15,15,2,0,0,8,48,12,9,11,6,6,13,15,6,4,6,20,1,6,7,0,5,7,8,8,4,41,3,0,6,22,6,8,0,12,2,14,8,8,14,0,2,6,3,20,0,0,0,0,3,3,13,3,9,0,0,3,14,1,3,14,7,46,10,2,8,7,0,6,0,3,5,25,11,4,1,5,12,5,8,5,13,26,8,8,4,6,6,19,9,19,13,0,2,7,10,11,5,9,4,21,12,3,1,7,7,3,0,12,5,3,0,24,11,15,10,9,14,16,10,2,5,12,129,3,1,9,9,13,0,3,3,3,0,11,10,1,7,7,0,6,16,0,3,23,18,0,1,0,8,12,6,1,14,3,1,19,0,2,4,18,40,10,44,0,7,17,0,7,2,0,5,4,8,4,3,1,5,6,0,8,20,21,2,1,5,0,9,0,2,10,1,21,0,0,16,33,0,10,1,7,1,9,7,1,33,5,8,6,14,2,10,10,0,1,1,1,22,11,4,6,0,1,1,0,11,12,15,1,3,3,15,1,10,11,8,0,4,8,0,2,8,0,3,14,43,24,4,1,21,21,0,0,11,8,19,0,14,37,9,5,15,3,18,6,0,8,11,0,4,11,8,4,6,11,2,1,2,7,3,10,2,2,2,4,2,11,1,16,27,9,8,1,7,3,5,6,40,24,6,22,0,13,6,3,5,1,10,0,7,26,1,0,9,5,1,1,5,17,19,29,0,2,13,2,15,5,1,3,3,7,3,4,0,5,5,4,6,0,31,23,568,4,0,2,6,31,6,1,0,0,12,3,0,0,2,0,3,0,0,14,7,9,6,1,12,7,6,21,4,6,0,9,42,0,52,9,0,1,0,0,18,0,3,3,0,4,0,0,12,17,15,6,11,4,9,5,10,19,2,1,5,26,12,0,1,2,4,10,7,0,0,30,11,3,5,6,0,19,0,0,20,211,14,5,12,6,1,7,5,0,13,3,0,7,3,5,1,18,4,5,0,5,12,18,0,6,10,1,3,1,10,0,2,33,28,3,19,3,18,1,2,6,7,14,4,32,6,14,15,3,18,14,2,0,5,1,6,6,0,0,0,0,3,0,7,7,2,11,2,0,9,7,21,25,0,0,2,2,6,2,9,5,1,9,0,2,3,5,0,2,10,2,2,8,3,0,2,13,9,4,2,11,9,21,0,2,3,6,9,1,3,0,1,3,1,6,2,7,16,1,21,5,3,1,9,4,9,3,2,3,0,2,1,6,0,1,2,3,7,3,8,9,0,5,5,0,15,0,17,1,0,4,7,8,0,5,2,0,3,0,5,4,0,1,1,6,15,15,8,11,0,2,4,0,10,2,5,3,7,10,0,8,3,2,6,3,32,3,0,2,0,2,3,26,14,0,9,4,0,4,14,0,0,0,0,7,0,0,5,3,14,2,7,14,1,1,0,12,9,1,2,8,0,2,0,10,1,5,2,23,7,0,5,1,23,5,9,3,5,10,0,24,6,2,6,10,4,4,0,25,1,12,1,8,1,5,5,1,2,5,1,2,2,9,8,5,0,7,12,20,3,13,3,3,3,0,2,5,1,0,3,5,1,11,20,8,6,3,5,4,0,23,7,0,2,0,7,3,8,10,7,0,1,2,6,13,0,5,8,1,2,0,1,1,10,7,13,9,3,3,7,6,14,5,6,5,0,5,0,0,2,15,0,0,5,0,1,2,4,2,33,0,3,7,2,5,3,0,4,0,1,4,0,3,8,10,6,26,1,3,2,1,2,10,2,3,5,11,1,0,0,1,19,5,0,3,2,6,7,0,0,6,3,0,7,0,146,0,0,8,10,0,6,9,4,0,3,0,10,0,4,0,8,3,1,26,2,8,8,0,16,19,6,4,8,1,0,7,1,9,1,4,33,0,12,0,0,0,4,0,1,5,5,2,0,4,18,0,1,5,1,0,2,7,2,4,0,4,4,0,3,0,0,10,0,0,7,0,2,10,4,0,7,4,0,69,5,0,3,3,0,1,0,7,5,6,1,8,9,0,4,1,9,0,0,2,0,1,0,0,9,11,0,6,1,0,1,0,0,0,0,1,2,0,4,9,4,1,5,2,10,0,4,0,2,0,4,1,11,0,4,9,8,3,3,1,10,2,7,0,0,2,3,0,3,2,5,3,9,8,1,0,9,3,9,4,0,1,1,1,0,6,1,2,0,3,0,3,0,4,1,3,6,1,12,1,0,0,3,2,9,1,9,4,1,0,1,3,9,3,0,10,0,13,2,5,0,2,0,0,9,9,0,8,0,1,0,11,3,0,0,0,5,1,3,0,5,28,3,0,3,2,1,5,2,1,6,4,3,2,10,7,6,0,3,16,24,0,26,0,9,0,0,3,2,7,1,6,6,1,0,1,0,0,0,0,2,16,4,3,9,0,3,42,0,7,1,1,1,7,5,1,2,0,0,3,6,3,5,4,2,12,3,2,0,0,0,3,0,2,1,0,0,0,3,1,5,14,2,0,37,0,13,7,1,6,2,7,4,5,71,2,3,1,60,0,1,6,2,8,0,7,0,14,1,2,3,0,0,0,0,8,4,5,12,0,5,5,2,13,54,1,0,0,0,16,0,0,0,0,1,86,0,1,1,6,67,0,3,1,0,1,1,0,2,7,17,0,6,0,1,1,1,0,0,1,9,2,13,1,6,6,0,1,1,0,16,2,2,1,0,0,3,8,2,2,0,0,5,0,7,0,15,1,0,8,0,8,3,7,2,0,4,3,0,1,14,1,0,0,4,20,3,0,5,4,3,1,0,0,8,4,0,7,9,0,0,2,0,0,2,1,1,0,15,8,1,8,4,7,2,1,1,0,7,1,2,6,8,10,0,0,0,0,1,3,2,7,1,0,0,2,1,17,0,5,2,4,2,0,1,4,1,2,0,4,0,3,0,0,6,2,10,4,11,3,0,0,1,0,13,1,0,3,2,1,4,0,4,3,0,4,1,2,0,9,0,2,1,2,3,0,3,16,8,0,1,1,1,11,14,2,2,6,0,5,0,2,20,0,0,1,0,6,12,1,2,0,5,0,3,0,0,0,4,0,0,0,1,0,8,8,5,0,4,1,7,0,8,1,0,1,21,2,0,6,5,2,3,3,3,4,2,6,1,0,0,0,1,3,1,25,0,1,4,5,0,0,1,7,11,5,10,6,0,5,1,4,10,2,0,0,0,2,1,3,5,3,4,1,5,0,0,8,0,1,2,3,1,3,3,0,7,0,21,0,0,0,5,3,3,1,5,0,3,1,5,1,4,4,9,0,0,5,0,2,5,0,0,1,2,2,0,1,2,4,0,2,0,1,7,0,3,0,0,1,0,4,0,0,8,0,2,1,3,0,3,33,0,3,12,2,3,3,1,2,0,4,10,9,5,2,1,3,3,9,2,7,0,5,0,15,4,2,1,0,4,2,1,0,3,1,3,0,2,0,1,11,0,0,4,0,0,2,0,1,0,0,0,0,1,0,0,1,3,0,0,0,5,4,5,3,3,1,0,0,4,2,1,2,3,0,4,0,0,9,1,3,4,6,2,1,5,7,2,1,1,9,9,0,0,5,7,2,0,0,1,0,0,0,0,0,7,0,1,1,4,14,3,0,0,0,0,0,0,3,1,2,0,10,0,0,0,2,4,0,0,0,7,7,9,3,1,0,1,3,11,7,7,0,1,2,1,2,0,1,0,5,0,0,0,0,3,5,0,2,0,0,2,0,2,2,2,0,2,5,1,3,0,1,4,8,0,0,5,4,11,4,1,2,2,3,7,0,1,0,2,1,0,6,0,1,0,1,3,4,5,0,3,1,0,0,2,3,22,132,4,0,0,8,5,2,0,0,0,1,3,3,4,0,1,0,0,12,0,12,10,0,0,0,4,0,1,3,0,3,5,4,0,1,0,0,0,4,1,1,1,3,0,0,2,2,0,7,1,14,1,3,0,13,0,3,0,9,0,4,0,1,1,3,1,2,21,2,4,0,3,1,2,0,0,0,0,1,6,0,5,0,3,5,1,1,2,3,0,8,1,2,1,0,2,2,3,17,2,0,4,9,10,0,0,1,0,0,2,0,0,1,1,1,2,0,4,21,0,2,0,0,1,1,3,3,2,0,6,6,5,0,0,0,6,0,0,0,8,0,5,1,0,4,1,1,2,3,0,7,0,2,5,0,4,3,11,0,4,8,0,5,0,0,0,0,1,0,0,2,4,0,4,0,0,0,0,0,0,0,5,1,0,0,0,2,0,9,5,1,0,0,0,2,1,0,2,1,0,0,6,22,4,5,0,0,6,1,4,1,1,0,1,2,2,9,28,1,1,7,0,1,2,1,3,0,0,0,3,2,0,1,0,4,0,5,2,0,30,1,1,0,0,4,1,0,1,1,1,0,6,0,0,4,1,0,3,3,1,1,1,0,0,1,3,3,4,3,0,0,0,1,0,0,0,1,0,1,0,1,1,0,0,5,0,0,0,0,1,1,1,4,3,0,1,0,1,0,4,0,2,0,0,0,0,1,0,6,0,0,1,0,0,1,1,5,5,1,0,3,8,2,0,3,0,3,4,0,1,9,0,93,5,0,0,3,0,3,0,1,1,0,0,0,5,1,4,1,3,4,2,0,2,0,3,0,0,9,1,1,0,1,0,1,1,0,2,0,2,1,1,2,0,1,1,0,2,0,5,1,1,0,1,2,2,0,0,1,0,0,11,0,0,3,1,1,0,3,0,2,0,0,0,1,2,0,0,6,4,0,3,3,1,2,0,0,5,1,1,1,2,1,4,0,0,1,0,0,1,0,2,0,3,2,5,1,2,0,2,1,2,0,4,0,1,0,1,1,3,2,11,0,0,0,21,6,0,7,0,2,2,3,2,27,0,13,0,0,3,1,1,12,0,7,1,6,4,0,2,0,1,0,2,2,0,0,8,0,0,1,0,0,3,2,1,1,16,0,2,3,3,2,0,3,2,2,1,2,3,0,0,0,0,3,2,6,0,3,3,1,1,0,1,0,0,0,9,1,0,0,2,11,1,1,13,2,0,2,0,0,2,0,1,8,0,2,0,0,0,8,1,4,2,0,0,0,4,2,1,2,1,1,0,2,0,1,1,2,0,0,1,1,0,0,2,1,1,0,0,0,1,0,0,0,4,2,1,0,1,0,0,1,2,1,0,0,8,0,2,6,0,1,1,6,2,0,0,1,0,3,0,1,5,0,1,0,0,0,0,3,0,4,3,1,1,0,0,0,0,4,2,1,0,6,7,0,2,0,9,1,0,2,0,3,4,0,0,2,0,0,0,0,0,1,1,0,9,5,5,0,0,2,0,1,0,3,4,2,2,6,0,2,0,3,0,7,3,6,0,0,0,5,0,2,2,0,0,0,1,0,4,2,0,1,8,2,0,0,1,11,0,1,2,2,0,2,7,1,0,0,0,0,0,5,0,13,0,0,1,0,0,0,0,0,4,2,0,4,0,0,0,6,0,3,31,10,1,1,2,4,0,0,2,7,1,2,0,1,0,0,1,0,2,0,6,2,1,10,0,5,7,0,0,2,1,3,0,5,4,0,3,0,0,0,0,0,1,0,0,2,0,1,2,2,1,0,0,0,0,1,1,1,2,0,2,0,1,2,10,4,1,1,0,0,4,0,1,0,2,0,0,0,0,0,0,5,1,0,0,0,2,2,54,1,0,2,2,1,3,6,4,4,1,2,2,0,2,3,1,2,0,1,5,9,0,2,0,3,0,1,0,0,2,0,5,1,1,2,0,1,0,4,0,0,0,4,6,0,0,1,9,0,0,1,0,5,1,0,1,8,0,1,0,1,0,0,0,0,4,5,11,0,0,12,5,0,2,3,0,3,0,0,1,0,1,0,5,0,5,2,1,0,0,3,0,0,5,5,0,3,8,1,2,2,2,0,0,0,4,0,0,7,1,0,1,2,0,1,0,1,11,1,0,0,0,0,1,0,0,0,0,0,0,0,0,3,4,2,0,0,2,3,9,0,0,0,3,28,0,0,0,0,2,4,0,3,0,0,1,25,0,29,0,1,0,0,0,1,1,4,1,1,3,0,7,2,0,0,1,1,0,1,0,3,1,1,6,0,3,2,1,3,1,0,3,0,1,0,1,3,8,0,1,0,2,6,1,2,2,0,0,3,2,0,1,0,0,2,0,0,1,4,1,0,0,5,0,2,0,1,0,0,0,0,2,3,0,0,0,0,0,2,0,3,0,1,0,0,1,0,13,1,0,0,0,1,1,2,7,0,0,1,0,1,0,0,2,1,0,0,2,0,0,2,1,0,0,2,0,1,1,1,0,4,5,0,2,0,6,0,2,0,4,4,0,3,3,1,0,2,1,4,2,5,0,0,0,1,0,0,0,1,3,2,3,0,4,0,140,0,0,2,1,0,0,0,0,1,0,6,0,0,0,2,0,1,1,1,0,0,0,4,0,0,1,4,0,0,0,0,1,0,0,0,0,0,2,2,3,0,0,1,2,0,1,0,2,2,0,0,0,0,0,2,1,0,0,0,1,4,0,0,2,2,1,5,1,0,2,1,0,0,0,0,0,6,1,0,1,4,2,2,3,0,3,0,1,0,3,2,0,1,1,0,1,59,6,1,0,3,2,1,1,3,0,9,4,1,0,1,0,4,5,0,0,2,1,0,0,4,1,2,0,1,0,0,0,0,2,2,0,1,3,0,4,5,3,11,1,0,3,0,20,4,0,0,0,1,5,0,0,0,2,1,7,0,4,3,1,2,2,1,0,0,4,0,4,1,2,2,4,0,0,0,2,1,0,0,1,2,0,0,1,0,4,3,3,0,0,0,0,1,0,2,0,0,0,0,8,5,2,1,0,0,0,2,0,1,0,0,1,0,0,1,1,1,0,2,5,0,0,0,0,0,2,3,0,10,0,1,1,0,0,3,0,1,0,0,0,0,0,0,0,0,0,2,0,0,1,6,0,1,2,4,1,0,27,2,0,1,0,1,1,159,0,0,2,0,9,0,1,5,0,0,0,2,0,0,1,0,2,0,1,0,0,0,14,10,18,0,3,160,0,1,0,1,0,0,1,0,0,1,4,0,0,1,0,5,0,2,0,1,0,4,10,2,2,0,0,4,1,1,4,0,0,0,93,0,7,0,0,1,0,2,15,6,0,0,3,1,0,2,6,2,0,0,0,0,7,0,0,0,0,2,1,2,2,0,0,2,0,1,0,0,2,3,1,1,2,0,0,2,0,0,2,0,0,1,0,3,1,1,0,0,0,3,0,64,1,3,0,1,2,3,1,10,0,8,2,6,1,0,1,0,0,0,0,0,0,0,1,0,1,0,1,0,4,0,0,1,1,2,8,0,0,1,0,0,0,0,1,2,0,1,0,1,5,0,4,3,0,1,3,1,0,1,1,0,1,5,2,0,1,0,0,4,1,0,0,0,2,2,1,0,1,0,3,2,0,2,1,0,1,4,0,2,0,2,0,0,0,2,5,1,0,0,5,1,0,0,6,5,8,3,0,4,1,0,1,0,0,2,0,0,0,2,2,0,0,1,1,0,0,0,0,5,0,0,1,2,0,3,0,0,4,0,1,0,0,1,1,0,5,4,2,0,2,1,0,0,0,1,6,0,0,4,0,0,0,0,0,0,0,2,0,0,1,1,1,0,0,12,0,1,0,5,5,1,0,1,0,0,0,1,1,0,3,8,1,0,0,1,0,4,1,0,1,2,3,3,1,6,3,0,2,0,0,0,1,1,0,0,0,6,4,3,1,0,0,0,1,0,0,1,2,0,0,4,0,8,0,0,0,0,1,0,1,0,0,3,0,0,0,0,0,2,0,0,2,2,0,0,0,0,1,1,1,0,5,1,0,1,1,1,0,0,4,2,0,1,0,0,2,2,0,1,2,0,0,2,0,4,0,0,0,0,2,1,1,1,0,0,0,0,1,0,0,3,1,3,0,1,0,0,0,0,1,0,0,1,1,2,0,0,0,0,0,0,0,0,1,1,0,0,0,5,0,0,2,0,1,2,3,0,1,0,7,0,0,1,0,1,0,0,1,2,0,0,1,2,1,3,0,1,0,0,2,2,0,0,0,0,2,0,2,1,3,1,3,0,1,0,1,1,1,3,0,0,0,8,0,0,0,0,0,0,8,2,1,4,2,0,0,0,0,0,1,10,0,8,0,0,0,3,2,0,1,1,0,3,0,6,0,1,2,0,4,0,0,0,0,0,0,1,0,0,0,0,0,1,4,0,2,0,0,0,0,4,1,1,0,1,1,3,3,2,6,0,0,10,0,0,4,1,6,1,0,0,0,0,2,0,3,6,0,0,0,0,0,0,2,0,2,0,0,2,2,0,0,0,0,0,0,0,0,0,0,0,0,0,0,5,0,0,0,4,1,0,1,0,0,1,0,0,1,0,2,1,0,0,1,0,2,0,0,3,0,0,0,0,0,2,0,1,1,3,1,0,7,0,2,0,2,1,0,0,0,0,3,2,12,2,1,0,4,0,12,0,0,0,0,0,0,0,0,1,0,0,0,0,0,0,1,0,6,2,0,0,1,0,2,0,0,0,0,2,2,4,0,0,0,55,0,0,0,1,0,0,0,0,3,0,0,0,0,1,1,0,2,0,2,0,0,0,0,4,0,0,2,2,2,0,0,0,0,0,0,1,0,0,2,0,0,1,0,0,0,1,1,0,0,3,0,3,0,0,0,0,0,0,2,0,2,3,2,0,0,0,0,0,2,0,0,2,0,2,0,0,0,3,0,0,0,0,1,0,0,0,1,0,0,2,0,22,6,2,0,0,0,0,0,0,0,2,0,1,0,0,0,0,0,0,0,2,0,0,0,0,0,0,0,0,0,0,0,0,0,0,0,2,0,0,0,0,0,0,0,0,0,0,0,0,5,0,0,0,0,0,0,0,0,0,0,0,0,0,0,0,0,0,0
"1989 Irving, John, Prayer for Owen Meany",high,13515,5811,6741,4899,5464,5025,3463,3863,5030,2503,1769,1960,3900,1627,1698,1332,2063,1593,1828,2112,1357,1449,1366,1411,2061,1453,1631,995,557,1005,888,611,976,1067,674,1065,1328,750,1124,704,798,469,814,617,741,915,878,809,1151,370,280,521,638,349,675,667,638,548,441,451,199,478,696,189,361,392,511,260,441,321,265,285,507,333,222,497,176,383,275,124,224,359,187,149,231,205,278,233,592,472,294,205,438,147,335,281,159,208,271,252,426,339,186,425,334,349,207,137,214,185,156,314,424,164,273,112,144,169,297,157,485,143,121,116,213,417,149,171,263,168,184,98,190,133,144,279,471,166,132,238,158,192,221,162,307,130,202,200,136,122,219,280,85,149,113,148,154,148,70,158,264,104,130,110,61,131,183,145,118,116,129,161,256,88,78,144,113,76,88,188,258,178,110,92,98,160,138,162,51,185,198,96,184,108,161,126,243,77,79,29,82,91,225,142,155,734,83,95,142,79,583,139,73,81,97,78,108,53,168,93,115,186,159,38,72,151,216,126,75,82,44,123,64,262,110,114,78,56,85,178,75,115,34,127,80,86,41,83,135,88,126,75,52,33,51,97,129,77,83,71,121,81,43,61,174,73,113,147,56,74,90,131,132,97,93,68,76,53,38,47,78,55,136,222,138,187,51,95,117,70,15,60,29,113,43,129,78,73,73,118,51,74,21,43,99,110,31,60,68,59,106,70,68,150,213,63,12,114,45,41,105,51,82,140,72,60,180,51,130,33,54,140,70,41,32,55,90,151,80,55,43,77,61,50,44,90,45,50,58,58,115,46,77,31,45,106,53,50,39,180,45,26,73,58,66,21,43,24,69,77,52,51,38,39,27,50,123,73,59,77,20,24,31,16,27,25,0,50,42,25,38,46,86,5,51,124,76,50,94,7,258,31,40,50,43,58,51,63,45,42,29,56,79,93,26,84,25,42,19,33,43,38,24,63,53,30,79,36,48,28,59,35,32,32,45,40,49,32,58,63,49,35,21,60,34,38,31,41,65,53,22,26,91,61,51,67,36,56,33,30,30,32,1,14,21,51,35,30,35,19,53,15,58,15,11,57,36,35,1,28,39,20,16,7,71,28,25,40,43,29,45,22,16,50,86,36,49,24,96,20,32,52,36,23,32,17,36,73,21,8,23,18,43,29,52,35,0,61,18,51,23,46,19,32,39,50,19,38,27,40,49,27,43,46,49,159,41,130,41,19,37,52,78,16,14,58,0,4,18,24,36,42,36,21,22,32,18,68,93,43,34,29,46,197,32,23,23,36,68,27,47,23,23,25,63,28,34,27,33,33,21,20,37,31,8,25,50,36,12,58,71,15,21,16,27,28,49,16,27,24,16,31,23,18,18,0,35,63,4,28,26,4,29,99,219,33,40,8,25,36,100,54,53,37,31,20,22,25,26,15,48,31,30,91,20,2679,15,8,48,9,45,14,18,32,19,21,30,85,20,39,1,16,14,27,29,14,7,13,18,71,45,27,21,11,9,20,17,34,32,16,15,30,139,51,11,18,32,56,18,28,14,48,38,21,47,27,14,51,30,22,21,30,27,14,24,11,40,20,25,12,22,3,10,17,15,82,36,18,40,33,8,18,19,33,43,28,80,30,18,16,5,53,27,10,19,17,27,84,67,21,28,29,26,42,0,44,34,28,61,8,12,14,31,99,1,6,13,35,14,24,32,17,29,45,15,4,8,40,24,75,52,6,32,96,16,28,50,35,17,68,21,44,9,18,1,40,68,25,96,72,7,41,25,8,27,39,9,59,13,16,5,53,14,27,22,20,0,30,0,21,7,102,15,46,30,11,183,38,19,32,24,91,67,5,12,21,4,1,25,130,21,56,18,34,35,103,36,17,13,12,113,4,7,25,35,27,29,10,0,22,14,19,25,28,16,7,14,0,6,12,31,29,27,34,26,19,38,8,31,17,9,34,13,11,8,13,20,0,12,21,14,7,16,15,0,19,27,9,65,11,18,38,24,53,15,11,18,21,12,31,9,20,24,4,31,58,142,0,33,60,60,17,7,14,83,7,13,4,22,22,27,0,25,1,15,18,10,13,15,9,26,3,15,23,20,30,38,4,7,8,18,24,13,8,28,27,28,20,12,5,18,30,21,10,19,4,62,34,22,4,36,18,15,25,5,20,5,6,15,26,4,27,8,8,21,61,17,48,47,16,16,1,23,11,37,18,48,31,6,0,10,14,24,18,17,3,10,44,27,19,4,32,17,39,40,42,1,71,27,0,9,0,21,31,14,5,0,0,9,9,13,7,20,59,18,27,8,0,25,30,1,10,14,1,3,0,29,6,9,16,15,11,27,11,25,20,19,181,20,19,18,11,0,15,5,13,9,11,9,2,19,14,24,6,10,0,9,28,4,12,59,6,0,16,21,2,16,18,0,0,0,1,33,34,20,13,13,0,20,23,6,15,10,2,2,22,62,47,10,1,12,0,21,19,11,18,7,9,51,3,10,12,11,17,16,13,15,21,21,39,16,22,2,27,0,481,37,18,20,21,5,4,3,15,35,19,15,10,10,2,10,0,26,72,19,30,8,15,15,20,26,34,9,14,21,173,13,51,6,17,13,9,17,23,10,10,47,19,12,35,5,15,21,19,0,11,74,29,13,4,0,12,7,15,26,16,5,0,7,29,16,6,9,7,13,43,0,12,14,0,20,37,0,36,13,8,42,13,1,44,9,0,24,15,30,63,0,44,33,9,10,3,28,20,70,0,4,5,2,11,34,3,1,5,10,93,12,19,43,21,22,10,1,13,19,0,23,8,26,12,6,19,23,0,140,23,0,10,21,20,11,18,12,8,11,10,32,22,0,7,3,0,5,13,0,9,11,21,13,27,0,19,4,9,0,4,5,18,0,3,14,9,9,9,28,21,26,37,37,11,0,23,33,21,21,23,22,19,1,23,25,24,0,45,1,10,22,12,9,14,21,8,45,37,0,19,3,70,11,21,4,7,3,0,12,9,12,6,20,17,3,6,10,19,18,13,19,0,14,23,12,11,39,0,14,32,9,42,17,3,19,8,31,24,13,8,4,13,23,7,69,5,23,0,17,14,10,9,7,20,5,16,15,0,13,0,0,11,0,1,12,0,13,23,18,18,40,4,1,15,13,24,12,61,215,20,25,0,8,14,0,1,0,9,0,15,3,0,30,20,25,10,36,15,1,33,5,3,39,14,10,2,7,12,33,19,9,2,9,20,14,32,0,0,6,14,8,9,13,26,7,2,1,15,23,10,2,10,20,20,21,21,0,44,13,0,16,26,11,0,24,18,23,0,81,7,8,0,11,17,3,10,25,9,0,7,7,32,14,3,12,35,46,20,7,10,20,96,27,7,20,10,47,8,6,16,0,4,4,11,7,2,0,0,0,12,0,5,4,34,12,14,1,4,2,5,4,0,83,20,1,15,2,13,14,27,16,4,0,21,3,20,8,6,19,0,7,8,16,19,19,3,38,17,9,12,33,0,13,8,16,13,16,22,10,4,26,21,3,18,9,16,32,4,28,10,3,10,15,10,15,20,21,0,4,26,13,2,10,20,19,4,12,13,3,8,4,16,101,17,0,18,15,10,14,4,4,0,8,2,654,15,0,18,14,12,34,49,10,12,12,14,2,121,27,10,0,2,0,18,15,21,15,0,19,37,41,7,25,7,8,2,20,15,4,1,16,14,46,19,3,45,15,11,1,0,2,5,8,17,2,5,3,6,20,13,3,8,8,3,3,22,19,30,17,13,10,0,7,5,0,35,6,16,3,10,3,14,2,5,3,8,21,6,11,9,6,9,8,3,3,0,9,4,1,5,12,39,12,8,14,20,4,10,13,11,2,10,52,14,0,18,31,1,18,14,3,3,0,6,18,26,6,3,10,6,9,3,10,6,23,12,11,0,9,14,36,33,10,7,8,6,2,5,0,11,5,14,5,6,10,7,40,39,5,7,1,4,6,5,11,11,24,7,17,16,2,2,5,0,3,16,1,11,6,0,24,21,3,31,17,11,4,7,6,43,7,7,6,8,14,11,0,16,18,2,13,6,4,6,12,6,9,16,9,8,4,16,18,12,8,3,18,8,6,2,16,72,4,6,13,30,0,0,5,17,0,4,0,1,5,31,5,5,9,17,10,19,0,20,19,8,0,4,6,27,8,20,4,15,13,3,12,28,1,8,2,7,3,21,6,2,32,3,1,9,4,8,4,18,8,6,21,5,4,3,4,13,9,5,0,33,14,3,0,14,20,6,5,9,2,3,0,8,1,2,6,4,46,7,0,2,9,3,0,11,8,12,1,22,845,2,7,1,16,13,4,4,6,7,14,0,0,10,12,6,14,3,5,19,11,0,0,4,21,0,16,5,0,0,0,32,0,6,8,10,8,56,1,0,11,10,4,6,9,1,6,13,3,8,4,1,72,8,4,23,5,2,8,9,8,10,0,0,2,16,11,6,24,5,5,12,4,7,1,8,14,16,24,7,11,0,10,11,6,5,12,0,18,11,8,0,15,9,7,6,3,4,11,4,8,8,1,8,9,11,5,24,12,18,10,0,10,7,1,0,4,5,2,0,2,16,9,5,2,0,3,5,15,7,4,8,0,0,1,11,2,0,4,4,7,10,14,9,14,7,15,0,15,2,3,7,17,16,5,3,4,12,14,4,8,6,14,5,0,0,2,17,8,14,2,8,11,14,5,12,2,0,1,9,4,7,7,11,26,2,3,1,3,11,4,2,11,5,2,4,0,153,9,12,2,23,0,5,4,9,8,0,0,0,2,0,20,5,0,0,3,19,2,7,19,7,2,1,0,16,10,11,3,9,8,5,4,0,59,9,4,5,0,5,3,13,0,0,5,0,29,2,2,15,0,6,1,1,8,4,10,4,5,14,2,4,7,0,7,0,0,2,5,22,5,0,0,1,4,17,1,9,11,6,9,5,2,42,1,8,17,7,7,6,0,5,56,74,4,6,0,0,14,7,6,0,17,12,16,0,1,24,40,9,22,7,10,66,17,4,15,15,1,12,12,5,5,3,12,2,12,0,26,0,11,10,6,5,3,13,6,6,3,13,7,40,3,2,4,11,9,12,27,2,14,3,25,19,7,4,1,26,11,5,7,0,2,17,0,3,13,6,5,3,6,6,6,7,10,4,50,8,5,0,7,6,4,15,4,5,27,2,16,13,4,12,6,16,15,4,3,8,13,3,5,6,4,7,9,16,27,16,3,1,3,13,0,4,50,22,4,5,13,8,46,13,16,3,6,13,12,6,0,0,3,3,3,5,5,6,3,2,16,0,3,13,5,5,0,16,4,1,4,0,3,25,6,17,5,11,7,2,5,15,1,19,2,0,6,0,5,3,10,8,0,5,1,2,7,0,4,6,3,12,16,6,12,3,1,5,4,4,3,7,10,13,13,0,2,12,4,2,9,4,6,102,22,13,10,3,12,15,0,9,15,12,12,39,51,0,0,14,8,0,5,18,6,0,6,8,0,6,8,12,0,2,20,1,21,0,1,11,13,29,7,2,12,3,0,15,6,0,12,15,6,2,5,3,3,12,2,58,3,40,0,0,6,32,2,3,0,10,4,12,2,7,5,4,0,12,3,0,4,7,21,6,4,6,8,8,9,11,19,12,4,5,8,7,1,1,0,0,14,3,1,9,0,12,0,2,4,2,3,3,6,4,23,3,3,18,4,2,8,14,9,8,3,4,4,2,4,4,6,10,9,0,8,8,26,5,3,18,6,2,11,7,0,0,10,7,13,2,0,5,4,2,15,8,15,4,1,2,7,0,0,0,0,5,0,0,11,3,0,9,1,2,6,1,2,18,14,7,0,12,13,11,3,4,12,2,4,9,14,1,5,0,2,14,0,0,4,2,20,0,11,0,3,1,10,1,16,1,14,4,4,9,3,14,4,2,29,2,1,3,1,3,0,0,5,11,3,10,7,6,1,4,18,0,3,0,14,2,0,0,0,2,1,5,10,18,83,6,2,1,4,10,4,3,4,2,14,10,16,0,0,1,33,5,16,2,25,8,17,1,6,2,32,5,3,4,0,1,5,14,4,0,9,2,5,0,4,1,8,6,7,7,14,5,5,15,14,12,3,5,17,7,5,1,2,2,0,6,4,6,10,46,8,7,6,24,6,15,1,22,11,0,13,12,5,0,9,6,0,5,16,0,0,36,10,0,5,14,3,0,0,0,1,9,22,1,7,1,4,2,1,1,2,8,48,14,6,1,3,2,5,8,0,3,4,0,17,4,7,3,6,4,3,5,3,33,4,59,13,5,9,8,6,2,3,5,3,2,4,11,8,1,4,5,0,517,5,1,2,4,3,0,15,3,1,11,19,0,4,5,0,12,0,7,4,2,8,2,4,2,3,0,12,2,9,27,11,3,0,0,6,6,4,31,0,0,0,3,7,18,0,0,9,2,7,5,11,3,4,6,29,4,1,10,0,2,0,1,27,2,12,16,5,3,6,6,10,0,4,0,12,5,0,6,20,12,6,6,1,0,2,5,32,1,10,1,2,4,7,15,9,7,3,0,2,2,0,0,7,0,4,10,9,8,2,2,2,6,6,0,0,5,3,7,0,3,0,1,48,5,0,5,4,17,0,5,5,11,6,7,0,2,4,16,1,1,6,11,46,0,3,0,5,2,0,0,10,7,8,0,6,0,5,0,7,4,0,17,10,0,1,22,4,14,3,4,8,10,0,3,0,0,6,6,15,2,1,4,16,8,1,0,84,4,4,7,3,17,0,2,8,0,0,11,1,3,0,0,0,14,2,11,15,2,4,2,0,5,9,8,1,1,0,5,0,5,0,4,45,5,0,18,0,1,3,6,12,6,3,14,0,0,1,3,5,2,0,4,5,10,6,33,3,1,11,3,12,14,21,4,2,4,0,6,2,0,11,13,5,7,7,0,3,19,0,6,3,6,9,4,1,1,2,2,1,15,0,1,0,7,10,0,1,4,1,4,0,10,9,25,2,3,4,1,11,1,0,9,3,7,11,2,0,9,0,1,19,6,2,5,0,4,12,0,2,0,1,8,3,0,0,0,0,6,29,2,7,14,0,11,4,0,5,7,0,14,3,4,2,4,3,15,0,1,14,4,0,13,4,6,0,5,3,4,6,4,1,2,7,13,2,3,0,13,21,1,14,6,1,5,12,96,5,5,3,13,5,0,1,3,5,2,20,1,3,0,11,5,4,5,1,0,3,10,2,8,0,7,20,2,0,5,13,2,2,13,4,1,10,0,8,9,1,2,1,2,3,16,6,6,7,0,24,7,13,11,11,7,17,0,2,0,15,2,1,2,6,4,1,1,0,29,0,0,0,3,44,1,7,12,3,7,1,3,6,1,1,2,1,18,7,13,3,2,19,10,0,2,22,0,0,2,2,4,8,3,2,2,6,5,4,0,8,9,6,6,2,19,5,12,11,2,4,2,8,1,8,1,2,6,0,1,0,11,2,10,21,3,3,0,5,8,11,12,9,3,0,0,2,2,14,14,4,191,0,3,12,6,1,1,6,4,12,0,8,0,0,0,0,3,0,0,3,1,3,0,8,10,2,7,13,0,9,5,3,5,3,4,2,173,7,3,2,6,2,10,0,0,2,3,0,3,8,0,0,4,6,4,3,6,2,2,9,0,3,4,7,1,2,7,0,9,5,2,11,4,6,10,6,0,18,0,3,4,1,0,0,12,1,2,25,0,4,2,0,1,2,3,5,0,12,7,2,2,5,6,3,1,5,3,1,6,4,11,0,0,10,4,3,3,0,0,5,3,2,8,4,0,3,6,0,2,1,0,3,5,2,0,7,3,39,9,2,17,0,1,6,0,1,11,1,9,2,2,10,4,1,3,3,11,2,2,3,25,9,5,10,4,0,6,20,2,0,0,0,1,6,0,3,0,0,7,5,0,1,9,18,9,0,6,3,6,8,0,1,5,7,0,14,13,8,17,2,2,29,3,9,1,16,1,2,12,0,0,1,11,0,0,3,7,13,0,5,6,2,5,2,16,1,3,2,5,12,2,14,3,1,7,0,1,1,1,2,1,6,0,9,0,14,8,16,10,9,0,0,3,6,0,8,0,1,3,3,3,3,4,5,1,3,10,3,6,1,3,4,1,0,2,4,3,4,0,3,0,5,3,3,15,0,0,1,4,0,3,0,0,6,0,7,0,0,2,1,4,8,3,2,3,1,2,5,2,10,2,0,2,3,0,4,6,5,0,3,1,5,16,2,6,0,3,0,2,7,7,7,4,9,0,8,8,5,0,3,2,5,4,6,3,0,1,5,14,7,0,7,3,1,14,8,2,6,0,0,0,0,8,0,6,7,7,0,2,2,29,6,3,2,3,9,0,3,0,2,4,4,20,1,8,1,37,12,1,0,2,8,0,1,0,5,7,2,0,7,0,5,0,35,5,0,4,1,9,12,2,6,3,0,1,7,14,3,2,8,0,37,9,0,4,0,0,1,5,1,0,5,6,3,0,0,1,12,4,0,0,5,1,0,0,17,2,23,3,22,15,1,5,0,4,0,0,4,0,4,9,4,14,0,5,2,8,1,2,0,0,0,5,7,2,0,10,1,0,3,2,4,1,5,4,11,0,2,4,4,5,0,3,0,1,1,3,5,3,8,1,13,8,6,5,0,1,2,7,0,5,4,2,2,0,11,10,2,3,9,7,0,4,14,5,7,3,2,3,2,0,0,7,6,0,12,38,3,23,3,3,10,1,2,0,4,5,0,0,4,7,6,3,3,2,1,2,1,5,5,2,0,0,0,1,2,3,0,0,7,4,0,1,6,0,0,0,0,4,4,2,36,10,1,4,1,1,8,14,4,13,1,3,4,6,2,0,6,1,2,7,4,11,2,1,1,0,3,0,5,0,2,5,9,1,3,3,0,3,7,2,3,2,2,4,9,33,8,1,0,1,7,1,3,2,13,1,3,1,2,0,3,1,6,1,6,0,3,0,5,7,5,1,0,0,1,1,1,0,13,0,7,15,7,5,5,17,0,6,6,2,2,4,12,5,1,0,1,1,2,0,7,2,2,2,5,0,3,2,1,2,0,1,2,0,4,10,15,5,1,1,0,0,9,11,0,2,3,3,3,13,5,7,3,11,4,15,7,3,2,9,2,0,2,0,0,0,4,1,1,1,20,0,5,3,5,3,1,1,2,11,4,9,3,1,3,26,14,1,3,2,11,1,1,2,3,2,1,6,7,3,0,0,2,1,1,4,1,18,1,8,0,1,0,4,6,1,13,27,2,0,3,0,3,0,1,3,1,0,2,5,2,0,2,30,0,0,1,0,0,3,0,1,6,1,2,24,2,2,102,7,9,13,6,0,2,2,4,6,3,3,4,0,35,0,9,3,0,7,5,9,0,8,1,4,0,0,2,1,0,5,6,0,1,317,3,0,0,1,0,1,2,0,0,1,4,1,1,0,8,1,14,0,9,1,2,2,16,0,1,9,4,0,0,2,4,8,1,2,3,0,0,4,1,2,3,18,0,3,2,0,12,6,3,30,2,2,23,1,1,2,5,6,2,0,1,5,0,7,0,3,0,4,9,0,2,5,13,0,3,6,3,1,0,8,12,7,0,26,2,6,2,0,0,2,0,5,0,2,1,1,20,1,1,1,1,2,6,7,0,2,5,1,0,1,21,6,2,4,3,0,5,0,2,0,0,11,2,4,4,4,9,0,52,7,0,1,5,3,8,287,1,1,7,3,2,1,11,2,3,0,2,13,8,3,8,0,6,0,3,2,0,1,7,19,5,0,0,1,2,2,5,5,4,3,1,1,1,1,1,0,0,1,6,0,4,5,2,1,1,4,4,7,6,4,8,3,9,1,4,0,2,3,2,15,7,6,9,1,5,7,2,0,0,2,1,2,0,0,5,2,10,4,6,3,3,1,0,3,0,3,2,7,8,0,9,0,9,4,0,0,2,2,1,287,0,0,3,0,1,4,4,2,2,1,10,0,1,0,0,0,5,3,1,5,9,0,4,4,4,6,0,1,1,1,4,6,5,2,0,5,0,5,0,0,3,1,4,3,8,2,1,4,6,9,4,16,1,2,4,3,5,2,1,4,0,6,1,3,0,1,0,32,1,2,0,3,2,1,9,7,12,0,10,7,2,0,0,0,13,1,1,8,0,0,1,0,1,0,3,2,0,0,0,2,1,0,4,3,0,2,4,112,2,1,3,1,3,10,4,6,2,3,0,0,2,0,8,4,6,0,8,4,5,1,20,186,25,4,3,0,2,5,15,4,2,3,14,3,12,2,1,2,7,18,8,1,3,20,7,29,0,4,5,0,0,8,2,5,0,10,4,10,3,1,0,0,0,1,6,5,18,3,0,2,11,0,5,0,5,8,4,0,0,2,14,4,6,1,69,4,1,0,0,1,1,2,0,6,23,6,7,0,14,0,0,1,0,2,0,2,0,1,3,6,0,10,2,8,6,0,12,1,3,0,3,4,1,1,2,14,0,4,3,53,0,0,0,0,2,0,3,1,0,12,1,7,0,9,10,4,4,4,1,0,5,10,0,1,1,3,0,0,0,12,0,7,22,8,1,0,4,0,1,2,0,2,4,1,4,10,0,1,0,3,5,0,0,2,3,3,1,20,4,7,0,12,2,4,1,0,2,16,4,1,16,0,3,1,0,5,8,3,11,1,1,5,2,0,0,0,6,0,0,2,7,3,1,0,14,1,1,2,2,2,1,12,0,1,0,4,2,1,0,3,0,8,2,4,1,8,1,1,0,0,0,6,0,9,6,1,1,5,3,1,1,0,0,4,2,10,7,11,3,1,0,1,0,10,1,2,5,5,0,0,0,10,2,4,8,4,7,13,10,5,2,4,5,0,3,15,6,4,3,5,0,0,2,16,3,3,5,11,8,1,1,1,5,1,0,0,1,2,53,2,5,0,2,5,3,6,0,2,5,2,5,1,0,2,0,0,1,9,0,3,0,5,0,2,2,0,0,0,0,0,2,8,5,1,4,2,30,8,3,1,0,3,1,5,1,2,0,2,1,0,5,3,0,6,4,41,0,3,0,0,6,2,4,12,0,0,4,0,0,1,0,7,0,123,1,27,0,3,3,10,0,1,11,10,113,8,0,0,1,13,0,0,0,0,0,0,13,0,1,0,0,0,24,0,92,1,26,0,88,0,2,152,0,0,20,0,182,0,0,0,152,3,37,0,1,0,0,163,0,0,7,0,0,110,0,1,0,0,0,0,0,0,0,40,0,0,0,0,0,0,0,0
"1989 Walker, Alice, The Temple of My Familiar",high,6593,4608,3573,2857,3569,2523,1646,2270,2671,1785,996,885,1630,2030,1758,915,1159,915,983,677,766,882,1112,462,899,714,690,1128,374,828,581,366,469,525,674,485,861,560,589,571,374,442,630,345,520,457,559,574,436,243,254,588,370,269,309,439,326,301,260,301,154,141,503,190,208,330,543,264,407,337,106,76,321,246,85,222,150,181,203,82,169,68,185,80,225,175,138,148,315,186,148,98,280,96,226,230,110,265,105,173,314,231,70,174,246,344,147,76,86,146,141,220,309,99,155,71,123,160,255,450,119,141,97,140,73,93,176,129,207,99,133,132,49,98,68,192,366,99,118,128,189,119,124,19,253,65,115,70,56,50,141,261,51,60,105,24,119,73,67,110,89,155,103,99,44,115,214,96,115,92,76,141,165,8,39,167,200,66,76,56,231,78,67,83,52,90,99,73,38,113,63,50,93,90,292,69,190,84,199,159,39,137,80,115,132,126,70,180,80,79,347,78,165,44,69,134,56,19,131,65,93,108,77,22,35,49,52,69,28,139,33,122,33,52,95,138,130,24,55,160,36,36,37,79,66,65,27,39,82,39,32,49,51,14,43,40,53,32,53,120,33,56,56,27,146,175,51,100,15,53,103,83,59,41,54,55,58,36,62,63,46,31,35,95,98,31,72,69,51,23,13,157,2,92,41,105,59,36,23,32,12,79,7,25,71,23,36,18,36,14,41,84,68,84,94,25,15,43,20,11,96,34,42,25,109,26,48,44,79,11,42,42,13,31,12,24,41,170,31,39,19,70,21,9,36,79,21,3,39,12,78,23,42,47,33,45,14,23,25,37,9,4,45,228,22,23,47,39,22,53,46,8,7,28,16,32,36,26,132,17,21,21,15,8,15,1,0,43,16,53,17,27,40,1,21,30,36,68,40,20,66,18,15,55,32,44,45,34,11,50,27,33,28,13,30,61,24,18,20,38,37,1,161,6,12,21,34,25,34,18,19,21,31,50,24,22,29,39,3,16,18,29,2,39,14,13,38,54,20,52,11,28,56,19,21,17,21,29,18,23,16,17,0,11,59,20,33,34,29,15,24,23,10,3,11,53,16,8,0,14,58,20,12,2,69,21,7,21,12,20,27,25,26,56,23,12,27,13,27,35,9,21,9,10,18,15,61,31,9,15,60,18,38,18,41,42,0,10,68,9,8,69,21,19,21,24,8,26,24,25,13,38,43,13,30,78,31,59,14,45,21,28,59,16,8,17,0,14,4,12,15,19,20,2,19,61,4,24,66,10,7,13,38,4,13,11,22,52,40,30,17,5,11,13,69,5,27,21,27,46,33,45,14,15,7,7,37,39,48,68,45,2,11,29,11,14,59,3,82,31,30,17,22,39,64,0,0,51,11,37,16,7,30,17,29,31,21,15,27,22,14,6,126,11,14,21,11,11,59,2,7,24,13,17,20,0,6,7,32,14,15,64,15,14,1,25,10,52,4,15,0,38,29,14,13,31,12,17,8,40,6,28,14,11,5,29,16,21,14,10,44,19,21,23,17,37,5,31,28,22,4,42,28,15,14,10,34,28,25,11,14,21,6,6,19,6,52,0,10,13,12,8,42,38,8,25,20,11,14,72,2,19,18,20,23,2,12,18,12,20,0,7,21,10,33,14,15,58,64,15,32,12,4,17,0,6,12,35,8,14,31,38,8,10,1,0,1,16,7,6,3,35,26,19,12,14,4,59,8,9,10,9,6,7,10,9,13,20,18,45,10,14,1,4,0,17,47,9,10,17,19,37,18,14,10,7,11,12,8,9,4,36,0,8,22,28,0,15,0,18,8,16,25,19,28,45,14,11,6,7,10,76,8,4,16,9,28,0,7,15,18,22,7,21,4,6,8,10,4,5,42,2,3,5,0,12,31,9,0,13,20,15,7,26,6,28,9,0,9,9,20,17,9,54,8,48,34,0,24,10,16,27,1,16,10,1,28,0,13,20,6,2,39,9,0,17,0,9,38,6,24,11,12,5,18,3,12,9,7,19,4,23,11,2,48,16,19,1,49,26,15,6,13,4,15,3,25,7,8,4,19,0,23,0,28,10,18,15,39,1,18,8,16,6,35,35,32,50,5,9,3,8,12,0,8,22,6,10,29,2,6,10,3,34,9,7,3,6,10,8,19,12,9,0,8,5,19,8,22,4,0,15,22,1,6,22,8,9,4,5,4,10,39,6,58,11,30,18,9,0,0,8,7,4,2,6,16,0,1,7,8,2,6,15,15,10,11,23,24,0,2,3,4,0,15,31,0,0,2,8,10,5,9,4,0,9,19,9,9,16,3,12,0,1,3,0,32,19,3,6,11,7,31,12,12,7,11,52,3,22,10,10,2,4,12,20,3,5,3,4,25,10,40,21,24,0,4,30,6,2,5,11,0,5,4,3,15,8,0,0,0,0,4,11,4,9,9,0,12,22,8,50,5,10,5,30,0,25,1,0,6,0,11,4,7,10,11,9,5,11,4,19,9,3,5,11,12,19,11,25,4,14,2,21,0,30,13,1,14,10,23,13,0,4,32,33,11,12,3,0,1,6,13,2,14,15,5,3,19,7,15,26,5,11,10,22,13,10,11,16,0,2,19,7,2,5,10,43,16,11,18,5,7,11,0,0,64,16,5,3,0,10,12,19,5,21,3,49,0,0,8,6,13,10,13,3,0,2,6,0,4,1,0,6,23,14,25,32,0,12,2,0,10,24,12,15,1,17,13,3,0,7,7,10,22,0,0,5,3,9,9,3,0,9,7,5,3,8,35,2,18,20,4,7,2,0,8,24,4,5,7,25,1,0,1,2,1,7,3,7,1,26,4,1,1,12,3,10,0,2,9,0,2,4,0,0,6,40,6,12,42,1,0,20,0,17,2,14,0,1,0,13,39,5,14,10,1,15,10,32,0,9,5,29,3,15,11,9,0,1,10,22,11,8,4,6,3,12,5,36,18,5,35,22,3,4,5,31,29,3,8,5,5,0,3,3,21,10,7,14,0,16,16,10,0,10,9,0,46,17,10,6,29,0,7,24,5,6,8,9,15,38,14,6,14,15,4,7,7,0,11,32,4,1,28,3,3,5,5,10,10,14,4,2,13,0,0,4,0,0,6,0,3,13,5,11,31,4,23,6,6,13,1,5,1,2,16,1,19,38,0,0,0,12,0,16,24,0,9,10,18,17,3,3,0,11,9,3,6,27,15,2,7,9,3,1,2,10,5,35,1,25,0,0,2,13,1,0,7,8,10,5,4,5,3,9,5,4,22,24,11,8,0,9,2,0,3,5,20,1,2,1,10,0,3,5,17,0,3,7,13,5,21,11,0,0,7,9,15,2,4,11,5,7,0,7,22,6,6,10,6,2,2,13,6,24,0,0,7,0,13,0,4,0,30,11,0,3,4,1,2,4,12,11,16,3,6,0,3,11,6,16,13,1,17,20,8,3,1,3,4,10,6,6,10,0,12,23,14,14,7,3,10,7,4,5,4,0,6,5,5,2,5,2,9,11,8,25,3,13,1,2,36,0,23,38,3,1,9,2,8,8,20,0,9,29,13,3,8,2,10,4,4,9,10,1,3,8,50,9,0,2,2,2,13,7,0,0,27,0,0,0,1,4,7,5,8,3,11,8,6,6,4,25,13,9,0,2,0,9,2,0,2,0,10,17,14,16,16,6,20,0,4,5,5,0,23,8,11,5,0,5,2,5,0,0,4,6,3,2,0,28,11,9,15,6,3,2,2,5,1,12,35,21,5,12,5,0,4,2,0,13,1,8,20,2,0,26,0,8,10,10,9,11,19,6,1,9,3,2,8,0,4,3,1,5,5,2,3,6,4,34,2,8,3,8,7,14,9,6,0,9,0,3,4,8,3,3,0,7,4,13,38,2,8,1,2,6,7,11,4,3,5,0,25,16,3,5,8,0,0,18,3,9,0,14,9,11,6,4,2,2,22,2,25,11,0,4,12,6,9,7,9,3,5,9,5,1,3,0,3,1,0,12,6,0,4,6,0,8,2,3,3,3,6,1,4,3,9,15,12,7,1,15,4,0,3,25,0,2,13,20,6,11,11,2,16,4,11,10,2,4,1,5,7,1,2,0,4,8,10,6,0,0,3,20,0,20,0,0,3,1,5,2,5,2,2,14,0,8,13,2,0,1,9,5,2,0,9,6,2,4,3,1,1,7,5,9,4,8,9,3,6,12,13,12,2,6,7,12,8,2,5,4,4,15,9,1,5,0,0,8,4,1,10,3,4,7,5,2,12,2,0,3,1,0,4,2,7,9,0,1,7,5,0,7,7,4,0,6,0,1,14,0,2,12,5,2,13,3,16,0,0,5,7,4,7,0,5,8,2,1,0,5,4,0,1,2,0,4,3,7,0,7,0,7,0,15,5,0,5,2,2,8,10,6,0,14,8,2,2,2,3,4,4,17,0,0,4,14,3,5,0,0,13,1,7,7,5,2,0,7,7,3,0,3,1,4,1,5,1,2,10,5,1,2,7,2,5,9,9,2,8,10,9,4,3,2,4,1,5,8,5,2,2,1,3,9,12,5,3,2,5,4,2,0,36,19,5,20,7,16,4,5,0,4,0,3,15,5,1,16,1,0,1,1,2,2,4,2,3,2,1,3,3,12,3,2,17,2,0,0,9,2,3,3,5,12,4,7,1,1,2,4,0,2,1,11,4,8,2,2,0,3,6,2,104,0,0,10,2,4,1,3,14,14,0,1,5,5,1,22,2,4,3,5,0,1,7,4,0,3,0,2,15,27,15,4,0,0,1,0,8,5,0,0,3,2,12,1,7,10,2,4,0,6,3,4,6,5,9,1,7,2,8,7,2,5,0,1,0,7,1,0,2,0,2,5,3,1,0,3,17,0,0,2,10,2,15,1,1,4,0,1,7,0,0,19,3,0,11,0,1,10,10,5,0,3,8,6,2,4,6,10,3,11,1,2,6,9,0,6,11,10,1,0,0,0,5,3,11,0,12,9,2,0,2,15,3,2,15,5,7,5,8,1,7,4,6,4,5,2,7,6,0,2,5,0,15,0,3,0,9,1,4,5,4,3,2,4,2,2,1,4,0,6,4,5,0,1,23,0,23,0,1,9,6,9,3,1,1,0,2,6,0,1,6,6,13,3,0,4,0,0,5,1,5,1,2,4,6,1,2,5,5,0,5,7,1,7,4,0,4,7,42,7,7,1,3,18,6,7,4,10,4,5,12,5,5,3,4,6,0,1,5,8,2,1,4,4,1,2,7,0,0,1,1,5,0,4,14,9,1,0,3,0,19,10,20,0,7,18,0,4,0,1,2,3,19,2,3,7,3,6,0,2,4,0,7,2,21,0,1,0,3,0,0,1,4,2,0,6,0,8,0,0,18,2,2,5,14,1,4,5,0,3,7,2,1,1,8,6,4,0,1,0,9,6,6,1,0,2,4,11,1,0,5,0,0,0,6,4,3,4,1,0,3,8,9,5,6,7,1,0,1,13,2,7,6,5,0,0,0,0,8,0,0,14,1,7,7,14,8,0,0,2,2,6,4,4,3,2,8,0,10,0,0,0,6,1,0,1,7,13,5,2,328,5,8,2,1,2,0,4,0,3,5,0,5,7,7,0,2,5,12,3,2,6,2,13,22,1,3,1,0,0,1,0,3,0,6,5,0,2,0,0,1,1,2,4,8,16,4,0,3,5,0,7,3,6,1,6,0,3,2,12,0,3,8,0,3,0,4,1,18,6,0,2,4,3,5,1,0,2,9,5,5,3,0,3,3,10,5,1,15,3,1,1,3,1,1,0,332,1,0,0,4,1,0,3,4,2,7,7,0,8,6,11,0,3,0,3,1,4,8,0,0,16,9,0,5,2,3,8,0,1,4,15,6,1,1,1,4,1,8,1,0,0,4,0,11,10,4,3,0,1,12,2,1,4,0,7,13,0,14,2,0,4,4,0,1,0,1,2,11,0,4,2,0,0,0,1,6,2,3,8,11,10,4,0,1,7,4,3,4,0,3,6,0,0,1,9,2,0,1,1,1,3,11,0,5,2,8,2,0,3,0,14,4,7,5,0,4,3,5,0,4,1,8,7,8,1,0,5,27,13,1,5,1,4,9,0,2,1,4,15,11,10,8,6,3,6,2,10,7,15,10,1,3,0,6,0,4,3,1,0,0,2,1,4,3,12,0,3,2,0,0,1,2,5,0,0,2,3,1,0,5,0,3,7,1,14,1,5,3,1,9,9,8,5,3,4,0,1,1,0,4,9,1,3,7,0,4,4,1,16,2,4,8,0,7,3,0,8,4,1,7,1,18,4,14,1,3,4,0,1,6,2,0,1,0,1,22,1,5,8,1,0,7,1,0,4,5,15,9,2,3,2,4,3,10,0,6,5,9,1,6,0,1,0,4,8,1,1,67,4,8,4,1,0,0,0,2,1,2,4,5,3,4,0,0,1,1,9,0,2,0,2,3,18,9,0,4,2,5,8,1,0,0,4,2,2,6,3,4,1,1,0,0,0,4,15,8,0,8,4,1,0,3,2,5,2,0,0,8,0,0,0,9,1,2,3,10,12,1,2,3,1,3,0,0,7,7,9,180,2,0,1,4,5,0,4,1,9,27,4,5,7,4,1,0,0,5,9,3,2,3,6,3,0,7,2,5,11,0,2,3,2,3,0,2,3,3,0,3,1,0,4,3,0,0,3,1,29,6,15,5,2,0,2,0,0,0,2,9,3,4,0,0,1,4,0,32,1,2,1,3,1,0,5,0,0,0,4,1,0,4,0,2,1,1,2,8,1,0,4,0,6,4,2,2,0,1,10,0,4,5,4,4,3,0,7,0,0,4,4,3,1,3,5,0,2,6,0,4,1,7,3,1,6,0,4,2,6,0,1,3,7,0,1,1,1,0,5,3,1,3,13,0,1,3,0,1,2,1,3,1,3,1,4,1,0,0,2,0,6,0,0,0,0,0,0,1,6,5,3,0,3,1,6,2,2,7,7,1,7,1,2,8,1,5,0,0,1,0,2,2,0,2,1,3,5,2,0,0,0,2,4,1,1,0,3,0,4,9,0,9,0,0,2,0,0,2,3,0,1,3,4,2,6,3,3,13,0,12,0,0,4,0,3,0,5,0,2,8,0,3,1,2,3,2,2,0,2,7,0,5,0,5,3,1,0,1,2,1,6,1,0,24,2,8,1,1,0,7,1,0,7,2,0,1,0,0,1,3,2,0,0,8,6,6,3,5,0,4,4,0,0,20,9,6,3,13,1,2,15,1,5,2,2,0,0,8,5,7,0,3,0,15,0,10,1,2,7,8,3,3,0,1,1,0,5,0,0,0,3,0,1,3,7,1,2,7,1,3,0,2,0,2,16,4,1,4,2,0,5,0,3,0,0,5,1,0,3,8,1,7,1,1,2,2,0,2,0,3,4,1,14,1,2,2,2,2,4,1,0,1,0,0,2,0,2,0,0,4,8,3,0,2,0,5,3,1,6,4,0,0,4,0,3,5,1,4,0,1,3,3,3,1,2,0,12,3,2,2,6,135,0,2,2,2,7,0,2,11,3,3,3,1,4,2,0,3,3,5,2,0,4,0,2,0,2,0,0,1,5,1,3,0,2,0,4,10,1,3,0,24,0,4,2,0,3,0,0,2,6,2,2,3,2,0,8,2,11,6,1,4,4,1,0,8,1,0,2,6,2,0,2,3,4,0,0,5,0,3,0,0,1,2,0,5,3,10,0,6,2,7,5,3,0,0,0,2,1,3,0,10,6,6,1,0,0,10,6,9,3,1,0,0,4,0,0,2,0,3,11,4,3,6,3,0,5,2,0,0,4,8,2,0,3,2,3,4,2,7,1,3,1,0,3,6,11,0,3,2,0,0,2,0,1,3,0,0,1,0,4,14,0,2,0,0,3,0,1,3,3,0,3,3,0,4,2,7,2,0,7,4,1,2,9,6,1,5,8,13,1,2,5,1,17,0,2,1,3,2,0,1,222,6,2,0,0,1,8,0,1,1,6,0,0,4,0,1,4,10,1,1,6,0,3,3,1,4,4,5,18,6,0,3,0,1,0,8,12,1,4,0,1,2,0,4,11,2,5,0,4,3,3,1,3,10,0,0,1,1,1,0,2,0,0,2,0,5,8,10,0,0,3,0,0,0,3,1,8,1,3,2,1,1,0,1,2,1,5,6,1,2,2,0,2,3,0,5,8,1,8,0,1,1,7,0,0,3,2,10,0,2,2,5,1,1,2,5,5,0,16,4,0,0,0,1,0,6,3,8,2,3,0,0,9,0,5,3,0,0,5,1,0,0,1,2,0,0,4,0,5,4,1,2,3,6,5,1,5,0,2,1,5,0,3,2,0,3,2,2,2,2,1,0,3,1,2,1,2,8,0,4,0,1,3,3,0,6,0,1,2,2,3,0,0,5,21,4,1,5,5,0,0,0,2,14,7,0,2,4,2,0,4,12,0,2,4,2,14,0,4,0,0,0,1,1,1,2,0,2,4,1,0,2,5,0,0,0,2,2,25,0,3,6,0,2,8,5,0,12,0,3,0,1,0,1,0,1,0,3,2,2,0,0,0,0,2,0,5,27,1,6,1,4,1,17,1,1,4,0,4,8,1,1,1,6,1,3,1,0,0,14,1,9,5,4,3,1,3,4,4,12,1,7,0,3,2,1,6,0,8,8,0,2,1,1,4,6,1,1,2,13,0,1,6,0,1,1,7,0,4,3,0,0,1,0,1,3,0,4,8,8,1,0,0,3,2,1,4,0,0,0,3,2,1,2,0,4,0,0,2,8,0,0,0,6,10,0,1,0,3,1,3,2,6,2,5,5,2,1,1,3,5,9,0,1,0,2,2,3,0,0,1,1,0,0,0,1,1,0,0,2,0,4,4,4,3,4,3,0,2,2,2,1,0,4,3,0,2,0,0,0,0,4,2,2,0,3,0,1,3,0,3,1,0,1,0,24,2,1,11,0,4,2,0,2,1,4,2,4,1,2,0,4,0,0,3,0,4,1,2,3,15,1,1,3,0,2,0,2,10,8,1,2,0,1,3,2,0,0,0,2,0,6,1,0,4,8,1,3,0,4,0,0,0,3,0,3,1,4,6,0,0,3,2,3,0,2,1,2,5,0,0,0,0,4,0,0,0,0,0,2,1,1,0,5,4,0,2,4,2,2,0,3,2,1,3,0,1,4,0,3,2,1,0,0,0,3,2,1,4,3,1,1,2,3,0,1,2,0,9,4,7,6,0,1,0,1,0,1,0,2,1,0,9,4,2,4,4,4,0,3,2,0,0,0,1,0,2,1,6,0,8,4,2,0,1,6,0,2,13,3,1,4,1,4,2,1,5,0,0,1,1,1,2,0,8,2,3,1,5,2,6,0,0,0,2,0,1,0,0,11,0,2,0,1,1,0,0,7,3,1,1,0,0,0,5,2,4,0,0,5,7,0,2,2,3,1,1,3,0,0,4,6,4,4,2,2,0,2,3,3,4,1,2,0,10,3,13,2,1,2,0,3,4,0,3,0,1,4,2,0,8,0,5,1,3,0,5,0,1,6,0,1,2,2,0,0,0,1,4,0,1,2,2,0,1,1,2,2,13,0,12,0,9,1,7,1,1,0,3,2,0,5,1,7,1,0,5,3,4,0,2,1,2,1,5,1,1,4,0,1,0,0,1,4,0,0,2,0,0,1,5,1,2,2,0,1,0,0,4,2,0,0,0,4,0,0,0,3,3,3,0,1,1,1,8,0,1,4,2,1,2,4,1,4,2,0,1,6,1,2,0,2,0,2,3,2,0,0,0,1,0,2,4,2,0,3,3,2,0,0,2,4,0,1,0,2,2,0,3,7,1,24,0,2,0,0,4,0,4,0,3,0,1,1,0,3,0,3,0,3,1,4,3,0,3,0,1,1,2,3,0,1,0,3,4,0,0,1,1,4,0,0,0,15,0,3,4,4,0,2,0,1,0,1,0,1,4,4,0,1,2,1,3,6,0,4,5,0,2,0,0,4,2,26,0,2,0,1,2,0,3,2,1,1,0,0,3,0,11,1,1,3,2,6,3,1,0,3,2,0,4,3,25,0,4,2,2,0,1,2,0,2,1,3,5,3,5,10,0,1,2,0,4,0,0,12,5,0,0,1,0,0,3,1,0,1,3,0,3,0,1,0,0,4,2,2,14,1,0,3,0,0,0,4,1,6,2,3,1,0,0,5,0,4,7,1,2,9,30,1,1,2,0,0,2,4,4,2,1,1,0,0,1,0,6,0,0,1,4,1,2,4,6,1,0,1,0,1,2,7,0,1,1,3,0,4,2,1,1,1,3,0,0,0,0,6,6,2,3,0,1,12,9,1,0,1,3,3,0,0,0,3,3,1,0,1,0,1,0,0,1,0,2,0,2,0,3,3,1,3,0,0,0,0,2,0,0,0,3,2,2,3,3,0,0,0,3,0,3,1,1,1,1,0,1,2,4,2,4,1,1,0,0,15,0,2,0,1,2,0,2,0,2,1,12,1,0,1,0,3,0,4,2,0,0,0,3,0,6,0,0,2,2,0,1,5,0,7,0,5,1,0,3,0,3,0,9,2,3,1,2,0,1,2,1,1,2,0,5,2,0,0,0,3,4,2,146,1,3,2,2,4,0,1,0,0,2,0,0,0,1,19,1,0,0,0,1,4,0,0,2,1,3,1,0,2,1,4,5,0,1,2,3,6,4,0,6,2,0,2,0,0,4,0,2,2,4,2,2,0,0,0,6,0,4,2,2,4,3,1,3,0,5,0,0,8,0,0,2,3,1,2,0,1,5,0,2,0,4,0,0,0,2,14,1,3,0,2,4,1,1,0,0,1,2,6,0,0,7,1,2,2,2,0,1,1,8,0,3,0,3,0,5,0,1,0,6,0,2,0,0,0,1,2,13,9,4,7,0,5,4,0,3,0,0,1,4,1,2,4,1,2,3,0,1,2,2,0,0,4,0,6,1,0,7,5,3,1,3,2,3,0,0,0,0,0,2,3,1,5,0,0,0,0,6,7,2,0,0,0,0,1,0,0,0,0,0,0,0,0,0,3,2,0,4,0,1,0,0,2,5,0,0,3,0,0,0,2,0,1,1,0,0,0,0,0,0,2,16,3,0,1,0,0,0,0,0,0,0,0,0,0,0,0,0,0,0,0,0,0,0,0,2,10,0,0,0,0,0,0,1,0,0,0,0,0,0,0,0,0,0,0,0,0,6,0,0,0,0,0,0,0,0
"1990 Johnson_C, Charles R., Middle Passage",high,2919,1722,1560,1667,1487,1544,811,985,861,536,565,982,666,175,263,515,375,396,532,158,328,335,601,294,648,313,587,192,113,157,354,114,193,233,337,154,235,273,195,255,266,317,128,193,85,189,307,217,143,239,165,191,223,185,132,263,89,106,125,57,124,90,156,126,91,61,215,95,67,112,42,74,108,107,39,89,72,36,80,38,97,45,119,103,82,50,72,75,90,112,110,35,118,77,52,105,31,81,46,92,72,63,14,118,55,98,56,64,30,50,50,70,125,92,71,52,69,68,93,60,35,49,31,101,52,41,53,35,73,61,77,61,31,55,93,50,115,65,97,53,15,36,51,43,61,49,43,77,27,32,53,30,32,30,56,37,31,41,48,45,62,95,23,38,43,59,70,17,59,29,91,21,41,22,0,87,49,19,41,23,25,47,36,44,38,42,21,31,68,51,12,52,38,26,24,61,25,35,18,51,29,46,30,56,52,45,26,60,24,16,9,33,76,19,45,79,40,57,26,27,45,49,32,13,12,35,33,27,24,13,21,20,38,53,39,13,41,29,21,29,22,34,39,31,15,27,26,27,27,26,37,54,24,6,37,30,22,34,27,44,17,7,16,47,10,23,26,41,21,21,32,23,29,17,44,38,28,34,33,22,28,33,24,13,11,7,9,16,4,44,24,21,0,10,6,22,25,17,11,19,22,29,1,22,30,17,15,14,12,9,32,66,11,14,45,14,10,7,24,16,18,11,34,54,8,8,35,6,15,9,11,24,19,16,2,6,19,33,22,5,22,15,17,0,12,30,10,0,44,9,16,11,15,15,15,23,7,6,26,11,15,9,6,38,17,10,19,10,7,20,22,12,8,3,13,18,19,15,35,8,11,26,13,17,15,1,0,17,13,11,5,24,9,0,19,15,16,32,22,13,3,19,13,18,12,13,8,11,5,31,15,17,13,2,32,26,12,12,18,21,8,0,8,19,14,5,22,9,5,2,19,8,16,30,15,12,20,16,0,14,16,16,9,19,11,3,20,12,14,23,6,18,11,2,10,14,11,8,19,4,6,32,0,10,4,3,17,67,2,12,11,19,8,19,21,20,7,1,0,6,11,14,12,6,10,9,29,7,16,6,24,14,2,13,23,9,10,3,16,14,16,4,1,7,12,7,10,14,10,7,5,47,12,34,4,15,0,5,6,4,16,11,13,3,14,13,15,9,34,20,2,23,10,20,25,0,16,6,9,35,29,8,5,15,13,13,0,3,5,1,0,14,5,41,13,10,9,7,21,0,0,2,14,2,6,6,15,6,2,9,11,0,18,9,6,6,13,3,11,3,15,10,23,14,0,16,15,4,7,8,16,8,11,13,4,18,22,10,16,6,6,38,11,6,14,2,0,7,9,1,22,2,11,2,5,24,28,23,9,6,11,2,8,18,22,3,3,11,7,3,1,9,6,5,14,1,2,12,14,12,11,9,2,4,2,5,10,6,0,17,0,26,14,11,12,14,6,3,8,12,9,9,13,7,0,1,30,9,9,15,17,10,6,4,10,11,7,18,6,2,3,3,5,14,6,5,9,10,5,11,4,7,9,5,2,5,19,70,8,5,7,1,26,28,13,5,5,6,3,7,4,4,2,15,6,2,4,5,10,7,0,0,8,97,7,7,6,4,12,5,24,5,2,10,0,3,8,13,5,16,6,0,0,0,1,0,0,11,2,9,5,6,6,15,1,17,0,8,5,0,6,5,18,0,1,1,6,3,25,11,11,11,6,0,0,8,16,12,1,11,12,18,19,2,5,19,7,2,3,3,2,7,1,9,13,4,0,9,0,11,4,5,20,1,10,1,5,3,8,6,6,14,9,4,6,5,2,0,9,0,16,4,6,7,4,1,8,4,2,11,4,2,2,1,4,7,7,2,0,19,3,14,11,4,17,7,3,0,4,0,4,12,0,21,12,9,10,1,3,4,10,10,12,10,6,47,4,0,6,18,9,7,7,5,0,5,0,19,5,5,9,4,4,15,13,12,10,9,10,7,10,2,2,4,13,8,38,0,7,6,4,1,5,1,16,1,8,4,12,0,7,0,9,0,10,17,5,5,10,9,6,12,2,16,7,6,10,0,2,0,0,3,6,0,1,0,3,10,3,5,1,0,1,9,9,2,3,3,12,0,9,11,9,1,7,8,2,5,4,3,0,21,3,0,0,8,1,0,4,10,3,0,5,0,8,10,5,1,2,0,1,3,5,2,0,28,5,1,8,1,10,9,1,10,6,2,2,2,2,0,13,0,6,0,1,5,0,1,2,0,6,9,11,1,0,4,16,0,2,10,2,7,0,0,3,1,17,5,0,3,0,11,4,13,2,8,12,5,4,2,6,9,1,6,7,3,1,3,4,1,7,5,4,2,8,0,13,3,5,5,2,8,0,0,5,9,10,3,0,0,0,1,5,1,3,10,11,0,8,2,0,12,0,0,0,3,0,5,3,3,0,0,4,5,2,8,10,14,4,1,2,5,3,5,7,5,7,9,3,6,4,9,7,7,0,0,2,4,6,7,4,2,2,7,5,3,2,1,0,8,4,0,1,4,16,13,11,2,3,7,3,8,10,3,2,7,6,1,6,14,0,1,6,4,12,6,0,7,0,4,3,4,6,3,0,2,0,2,5,1,0,4,4,3,2,2,2,10,2,0,0,6,17,7,3,7,0,1,3,0,6,4,0,7,5,1,3,3,0,2,0,0,1,6,0,0,0,1,5,7,0,8,10,2,2,0,0,4,4,5,6,0,2,3,10,6,0,6,8,3,6,6,3,4,3,0,2,2,2,6,8,9,3,0,2,0,0,5,8,5,8,4,10,7,0,1,7,3,0,0,8,0,0,2,0,3,8,4,3,4,2,0,0,11,0,3,9,7,0,0,0,5,11,0,5,1,0,0,4,1,0,7,9,0,4,3,0,10,9,0,5,6,3,1,5,10,0,3,4,7,2,4,2,8,4,7,8,4,3,15,4,8,0,0,4,2,13,7,6,1,0,0,6,0,0,13,3,12,0,0,6,12,3,0,4,0,1,0,4,0,9,3,3,11,9,20,6,3,5,0,0,6,5,0,2,0,5,4,16,5,3,3,5,1,2,0,0,0,0,0,3,0,6,4,5,5,2,1,1,1,0,0,7,0,0,1,3,1,6,1,0,0,0,4,0,5,111,0,8,0,1,10,3,4,0,3,2,2,1,4,3,5,2,3,9,5,0,3,9,3,0,5,0,0,4,9,10,2,1,1,0,4,1,0,0,3,1,0,6,9,4,2,0,5,2,0,5,0,8,0,5,5,0,0,2,1,4,0,4,1,1,5,11,8,0,1,19,0,1,5,2,1,1,11,0,6,7,2,7,4,2,9,0,4,3,6,0,10,5,4,4,0,1,0,0,5,0,4,0,2,5,2,2,1,4,1,54,0,0,2,0,2,11,5,5,10,5,8,1,3,4,0,0,0,5,0,0,7,3,2,6,5,2,4,3,6,1,0,8,7,13,2,3,2,9,2,11,2,3,4,0,5,16,1,2,11,5,0,7,1,8,11,7,0,6,1,3,0,0,5,2,20,2,6,2,8,2,5,0,6,0,2,1,1,4,4,5,0,2,0,0,6,0,9,1,4,3,0,5,2,4,1,1,0,1,5,0,2,0,1,4,2,1,0,2,0,11,6,23,60,2,0,1,0,5,0,6,5,7,0,0,7,5,6,0,0,1,7,4,6,1,1,10,1,4,2,0,8,1,19,5,3,5,10,0,6,3,0,3,1,6,4,0,3,1,6,0,13,48,6,0,1,5,6,1,2,0,2,3,3,2,0,2,4,0,8,1,3,8,1,3,11,7,2,2,10,4,4,1,0,0,2,0,1,3,3,1,2,0,8,7,9,4,1,3,0,0,1,7,4,2,5,3,0,3,1,1,2,1,0,2,4,8,7,0,2,6,7,7,8,2,2,11,1,0,1,0,4,6,9,6,0,6,0,3,13,0,8,3,0,5,2,0,1,0,0,2,3,0,2,1,6,0,5,2,1,8,1,3,3,12,3,0,4,1,3,1,2,3,4,2,0,7,3,3,5,0,0,4,9,8,1,1,0,0,1,9,0,3,2,0,1,0,0,5,3,0,2,0,0,0,2,6,2,3,3,1,2,0,5,0,1,0,1,1,1,4,5,3,1,3,5,2,8,3,1,7,3,2,12,5,3,1,0,1,7,0,6,0,6,1,3,0,5,1,1,12,1,2,1,0,4,3,2,0,6,2,0,2,2,3,0,0,1,1,0,0,0,1,2,0,11,6,6,0,4,2,1,5,8,0,4,6,0,0,1,11,2,7,0,1,0,0,1,7,7,2,1,2,3,0,0,0,1,0,0,3,1,0,1,1,1,0,5,0,3,0,0,2,0,2,1,0,7,0,1,0,0,3,4,0,2,2,2,8,2,3,1,0,5,3,5,0,0,7,0,8,5,0,2,0,3,4,2,2,2,3,7,2,0,2,0,0,2,1,0,1,0,3,1,1,0,6,4,0,4,1,3,0,0,8,0,1,5,1,2,1,3,3,4,2,3,2,10,7,0,0,1,3,0,0,4,2,8,1,4,1,3,3,5,5,14,0,0,1,5,1,0,5,2,0,3,0,2,2,3,2,3,4,1,3,3,3,3,5,2,8,4,3,2,0,7,2,2,0,0,2,1,0,1,4,13,0,5,4,2,13,0,0,0,16,1,1,8,3,2,3,1,2,1,0,24,7,2,3,4,0,0,0,1,4,3,0,9,2,0,1,7,0,0,2,0,3,9,0,0,0,3,3,3,3,0,5,0,0,0,3,6,1,0,1,1,4,0,1,13,0,1,0,1,0,2,2,0,2,0,2,2,5,5,0,6,0,0,1,0,1,4,0,0,0,8,4,1,1,0,0,5,12,0,2,0,0,6,6,1,0,2,1,5,1,4,3,2,6,3,2,0,0,3,36,5,0,1,1,0,0,0,6,3,1,6,2,4,2,0,0,4,6,4,3,3,5,3,2,4,2,3,4,0,7,2,2,1,0,1,6,0,0,0,1,0,4,4,2,2,1,5,0,2,3,4,4,4,6,6,1,2,4,0,3,0,5,0,2,1,4,3,1,0,0,0,0,8,0,1,5,0,3,0,4,1,0,2,3,3,0,4,0,1,2,1,5,0,3,2,5,3,1,3,11,2,1,3,1,1,1,1,0,5,3,1,3,4,2,5,5,3,6,1,0,0,0,6,7,2,2,2,2,0,1,2,0,10,0,0,1,3,2,2,0,0,1,3,0,0,2,5,5,2,1,0,0,2,0,0,1,0,6,0,3,8,1,0,0,1,3,1,1,1,5,1,0,0,0,0,6,2,0,4,0,0,0,6,0,0,8,1,1,2,1,0,3,3,0,0,0,1,4,2,1,2,7,0,0,2,1,1,5,4,6,0,0,0,0,0,2,0,0,3,6,4,0,3,0,0,0,3,2,0,3,6,3,8,2,0,1,7,2,3,0,2,0,0,0,0,0,0,2,1,1,2,1,4,0,4,1,23,2,2,3,6,4,2,1,1,0,5,2,1,0,1,2,3,7,7,0,4,2,0,1,5,0,1,0,6,0,0,0,5,2,3,2,4,3,3,2,2,3,14,0,1,11,3,0,2,0,0,3,0,3,0,0,1,0,4,1,4,1,0,1,2,1,2,0,5,0,0,4,2,5,0,2,0,0,1,0,0,0,2,3,0,0,2,1,2,3,6,6,5,1,3,0,0,2,0,2,4,0,0,2,4,5,1,4,2,0,2,0,0,1,0,0,11,0,0,6,2,0,2,1,1,3,1,1,5,3,0,0,2,11,2,5,2,5,0,0,5,2,0,1,0,3,3,2,1,1,1,3,0,0,16,4,0,1,2,4,1,1,0,2,1,2,3,0,11,5,1,0,3,0,3,0,0,4,2,0,3,0,0,1,0,0,2,0,0,4,1,0,0,0,2,0,1,0,0,2,0,3,1,1,2,1,4,0,2,0,4,0,0,0,2,0,0,1,0,9,2,2,0,0,2,3,1,1,0,0,3,1,2,0,0,3,1,6,0,5,0,5,3,4,2,3,1,2,3,0,2,0,0,1,0,3,0,3,1,39,0,6,3,3,5,1,6,0,3,5,0,1,1,4,0,2,0,0,0,0,1,0,0,6,0,0,1,2,0,4,3,7,0,0,0,0,8,4,0,5,0,0,2,0,1,2,1,0,5,1,8,1,3,5,3,0,2,1,0,0,3,6,1,0,0,3,0,0,6,3,6,5,0,1,0,0,1,1,2,5,1,0,2,3,1,1,7,0,0,1,2,0,4,0,2,3,2,4,1,2,0,9,2,3,2,7,5,2,5,3,10,3,1,0,0,3,0,1,2,3,1,1,0,1,2,3,0,22,1,1,3,3,0,0,0,1,0,4,0,1,3,3,0,0,0,2,1,0,1,0,3,13,0,0,0,3,5,0,0,1,0,1,1,0,0,1,3,2,1,2,4,0,0,1,2,8,0,2,0,3,1,0,4,1,1,0,0,0,0,0,0,3,20,2,5,0,3,0,0,0,0,0,0,0,2,2,4,0,3,0,3,1,0,0,2,0,4,1,0,3,1,1,2,0,0,0,5,6,0,3,2,0,0,0,0,3,3,1,0,7,4,2,0,2,0,2,0,5,0,0,1,2,0,0,1,0,2,2,7,3,0,0,1,0,0,7,0,1,7,2,0,0,3,0,0,0,2,2,5,3,1,0,0,7,0,0,0,4,2,1,0,0,0,0,1,3,0,0,0,0,4,4,0,0,4,2,3,3,1,1,3,5,5,0,0,0,2,0,0,1,1,0,8,0,0,0,4,5,0,10,1,0,1,7,0,1,3,0,0,2,5,0,0,1,1,0,2,5,0,3,1,2,2,0,0,3,0,0,3,1,1,0,1,0,0,0,0,2,4,2,0,0,0,0,0,2,0,5,1,0,1,3,0,2,4,1,4,1,1,0,0,1,1,0,3,0,0,0,0,3,5,0,2,0,2,4,0,0,0,0,2,1,4,0,1,1,0,4,3,1,0,0,0,1,0,4,3,0,0,2,1,4,0,2,1,0,3,8,0,0,1,0,2,0,2,0,0,4,0,1,3,1,4,0,1,0,1,1,5,6,6,0,1,0,0,2,0,0,0,5,0,0,3,5,2,0,0,8,1,3,2,1,6,0,0,1,4,2,0,2,0,3,0,4,3,1,0,6,2,3,0,0,0,3,1,3,3,0,2,2,1,3,2,1,0,0,1,1,0,0,2,8,0,3,0,6,1,0,1,0,1,0,0,0,0,0,0,0,7,0,2,3,1,1,1,1,1,3,0,1,0,1,1,1,6,1,0,2,1,0,1,2,0,5,1,1,0,0,0,2,4,0,2,2,0,0,0,0,3,3,4,0,2,2,0,0,2,1,0,0,1,0,0,0,2,0,4,1,0,0,0,3,0,3,1,1,0,1,0,0,0,1,0,0,2,0,0,0,0,4,2,8,0,2,0,6,0,0,1,0,0,0,3,1,1,3,3,3,2,1,5,1,0,0,0,1,0,2,0,0,1,0,0,0,1,1,2,1,1,2,0,0,0,0,5,3,0,1,6,2,0,0,5,2,1,1,1,3,0,1,1,1,1,1,2,3,1,0,6,1,0,0,0,1,0,2,0,0,0,1,1,4,0,1,0,2,0,1,0,0,2,1,1,2,2,3,5,2,0,2,0,1,1,0,1,3,0,0,0,1,3,2,0,0,0,5,1,3,2,1,0,4,0,0,0,2,0,1,4,4,7,1,1,0,8,2,3,1,0,3,1,0,0,4,1,3,2,0,1,4,0,0,4,1,3,5,2,0,0,0,0,0,0,3,0,0,2,0,3,1,0,1,0,1,2,2,1,0,4,1,4,0,1,1,2,1,4,0,3,2,0,1,0,0,3,0,0,3,0,2,2,2,1,0,10,0,4,0,1,0,0,3,1,1,0,0,0,0,1,2,5,0,0,2,1,0,4,1,3,0,5,0,0,0,1,3,2,0,7,9,0,0,0,7,0,0,50,0,0,0,0,2,0,3,2,5,1,2,1,1,1,2,0,4,0,0,0,0,0,0,2,4,1,1,0,0,0,3,1,1,2,7,7,0,0,0,3,0,4,1,4,1,5,0,0,8,7,1,3,0,2,0,8,24,2,1,2,0,4,0,0,1,2,2,1,1,1,0,0,4,1,3,0,6,2,1,4,1,1,0,0,0,1,1,4,4,0,3,1,1,1,0,1,0,0,3,0,1,1,2,0,1,1,2,0,0,0,0,2,2,2,2,0,1,2,4,4,1,11,0,5,0,2,2,0,0,0,5,1,5,1,5,6,0,1,0,4,0,0,1,0,2,0,3,0,5,0,0,0,1,4,1,2,1,0,2,0,1,0,0,0,0,0,2,0,0,0,1,0,0,0,0,0,3,3,2,2,0,1,2,0,0,6,0,0,0,0,8,0,0,0,3,2,0,1,0,0,4,0,0,6,2,0,1,0,1,1,3,0,0,2,4,1,0,1,1,0,0,1,1,1,0,3,0,2,0,2,1,0,0,0,0,1,2,0,1,0,2,2,2,37,1,2,3,2,0,1,2,0,1,2,0,1,2,1,3,0,1,4,0,3,2,0,0,0,0,0,0,3,0,4,2,0,2,2,0,1,0,4,0,0,0,2,2,0,5,2,0,2,0,0,0,0,0,0,2,1,0,0,0,0,0,0,3,0,0,4,2,0,0,1,0,1,1,0,2,4,0,2,1,0,0,0,0,3,0,0,1,2,5,5,0,0,0,1,2,0,0,0,1,4,2,0,0,0,3,0,4,0,0,0,0,0,0,0,0,0,1,0,1,1,1,0,0,2,0,3,3,3,0,0,0,0,0,3,0,1,0,10,0,0,0,2,1,0,1,0,0,4,0,0,3,0,0,0,11,1,2,0,0,3,0,0,3,0,2,0,1,2,2,2,0,0,0,1,0,4,1,2,8,0,1,0,2,26,0,0,0,1,1,0,1,0,0,0,0,4,18,2,1,1,1,0,0,5,0,1,2,1,0,0,3,2,1,1,1,0,1,5,0,3,1,2,2,2,11,2,3,0,0,0,0,0,0,0,0,0,0,0,1,4,3,2,0,1,0,0,1,0,4,3,1,0,1,0,0,5,1,0,5,3,1,0,0,0,1,3,1,2,0,0,2,1,3,0,4,0,0,1,0,4,0,2,0,0,1,0,3,0,1,5,0,0,1,0,3,1,1,0,0,0,1,0,0,1,0,3,0,1,1,1,0,0,0,2,0,3,3,0,5,1,1,1,5,0,2,2,0,6,0,1,3,1,0,1,1,1,0,2,1,1,0,0,0,0,0,2,1,0,0,0,1,0,3,5,0,0,0,4,0,2,4,0,1,0,2,0,0,0,0,0,1,0,4,1,1,2,1,0,0,0,2,0,0,0,0,0,0,1,1,1,0,0,0,2,0,2,2,0,2,0,1,3,2,0,4,0,2,0,2,0,0,0,2,0,0,2,0,3,0,0,4,0,3,0,0,0,4,3,0,2,0,4,10,0,0,2,0,0,4,2,10,1,1,1,1,4,1,1,2,1,1,1,5,0,0,1,3,1,0,0,1,0,2,0,1,0,3,0,1,0,0,0,0,1,0,2,0,1,0,1,2,0,1,2,0,0,0,0,3,1,1,3,0,0,0,10,0,0,0,0,0,0,1,0,2,0,0,0,0,0,0,3,2,1,0,0,1,1,1,2,0,0,3,0,1,0,0,0,2,0,8,0,2,2,0,0,0,0,0,0,4,0,2,0,0,0,1,0,2,0,5,1,0,0,1,4,1,0,0,1,0,2,1,0,0,2,1,0,3,0,0,3,0,1,1,0,2,0,3,0,1,0,0,0,0,0,0,0,0,0,0,0,0,0,4,2,2,1,0,0,0,0,2,0,0,0,0,4,0,1,0,0,1,0,1,0,0,1,0,1,1,2,3,2,1,0,0,5,0,7,5,1,0,0,0,2,0,0,2,4,2,1,3,2,0,1,9,0,0,0,1,0,0,1,3,1,0,2,1,1,1,3,1,3,0,1,2,0,0,0,16,0,0,1,0,0,1,0,0,20,2,0,2,0,0,0,1,0,0,1,0,0,1,0,1,2,1,0,0,0,2,1,0,3,1,0,0,0,0,0,2,0,3,1,0,3,2,16,1,1,2,0,2,0,1,0,5,0,0,0,0,3,0,1,0,1,0,1,1,0,2,1,0,0,0,1,0,1,2,0,0,1,2,0,0,1,1,0,2,2,0,0,0,0,1,1,1,0,0,4,1,2,4,0,0,0,2,0,0,2,2,2,0,0,0,3,0,5,0,0,0,1,0,1,0,0,0,1,1,1,0,0,0,0,1,0,0,1,0,1,1,0,1,0,4,0,1,0,1,1,1,1,0,1,2,2,3,0,1,0,0,0,1,0,2,0,1,0,2,0,4,1,10,0,0,2,3,1,0,0,0,0,0,0,0,4,0,3,0,0,1,0,0,0,0,0,1,0,0,2,1,2,0,1,1,0,0,0,0,1,0,0,2,1,0,2,0,0,0,0,0,3,0,2,5,0,1,1,0,0,1,0,0,2,0,2,4,2,1,1,3,0,0,0,0,2,0,0,0,1,0,5,0,0,0,3,1,8,0,2,3,0,0,1,1,2,1,0,0,0,0,0,3,0,3,2,1,1,0,0,1,0,0,0,1,1,2,0,1,0,0,0,0,2,3,0,1,2,0,0,0,0,2,3,0,2,0,0,1,0,1,1,4,0,2,1,2,2,1,2,0,0,2,0,5,0,2,7,2,0,0,0,2,1,1,2,0,1,0,0,1,4,0,0,0,4,1,0,0,0,0,0,3,1,0,1,1,0,3,0,1,3,0,1,1,2,0,0,0,2,2,0,2,1,0,0,0,0,0,0,0,0,0,0,0,1,0,0,0,0,0,0,1,0,0,0,0,1,2,0,0,0,0,2,2,1,0,0,0,0,1,3,0,1,1,1,0,0,0,0,1,3,0,0,0,2,0,0,0,0,1,3,0,0,0,1,0,0,0,0,0,0,0,0,0,0,0,1,0,0,0,0,0,0,0,0,0,0,0,0,0,1,0,0,0,0,0,0,0,0,0,0,2,0,0,0,0,0,0,0,1,0,0,0,0,0,0,0,0,0,0,0,0,0,0,0,0,0,0,0,0,0
"1991 Johnson_D, Denis, Resuscitation of a Hanged Man",high,4197,2060,1636,2102,1691,882,1827,1195,1189,910,953,1001,651,480,454,614,386,523,433,743,411,463,392,525,140,218,238,267,361,278,262,311,350,288,443,244,270,314,106,279,203,273,221,164,260,147,211,161,118,158,173,197,106,189,200,254,164,242,188,237,229,200,130,197,145,128,138,203,131,109,149,275,100,92,139,101,141,155,118,146,119,145,216,191,97,100,107,62,86,79,87,113,118,98,86,83,168,96,54,100,75,87,111,87,96,79,80,71,68,107,67,46,24,58,67,75,80,71,81,115,83,24,64,67,105,119,66,66,49,57,43,79,95,64,75,67,32,73,74,83,36,46,193,125,101,75,61,56,42,56,45,85,76,67,92,43,22,45,53,128,62,99,93,70,69,60,45,88,85,50,28,17,46,49,52,116,59,73,66,28,21,76,35,63,52,43,64,57,34,43,42,46,22,37,53,65,31,41,78,21,26,85,34,36,34,26,48,40,94,54,5,60,30,44,44,46,32,39,37,48,33,28,33,59,36,52,32,41,23,78,21,49,54,25,38,25,34,49,29,30,41,51,48,50,18,15,23,33,15,47,23,44,42,36,29,38,70,26,50,45,33,45,56,27,30,48,25,26,29,29,43,77,14,15,26,13,15,27,43,23,25,27,32,17,29,51,40,35,21,40,12,11,52,30,31,21,29,30,30,48,17,36,64,25,24,31,17,8,25,12,16,16,30,31,28,23,33,20,21,23,24,26,20,12,13,51,53,33,23,24,56,16,17,34,36,49,21,10,32,22,37,16,13,44,44,20,22,35,15,22,12,23,36,11,17,10,16,37,30,17,21,5,13,24,18,15,15,9,22,40,35,9,20,19,11,20,28,15,25,17,23,12,14,10,14,16,0,26,10,46,6,42,8,65,24,11,23,6,13,7,8,17,25,28,14,25,30,13,30,37,18,21,30,60,16,13,13,15,14,23,32,0,9,20,8,14,10,30,18,31,37,12,31,38,801,12,17,22,2,32,14,27,15,16,20,34,31,14,24,10,24,12,13,31,30,26,12,15,27,11,9,8,0,9,62,18,22,23,10,12,19,8,19,4,24,8,8,18,0,18,13,6,11,26,9,20,13,7,22,19,11,16,21,12,23,8,9,12,3,8,11,10,43,16,15,30,30,16,13,21,16,16,25,25,18,6,0,21,12,8,18,12,22,16,28,13,17,3,8,11,15,16,9,18,11,2,14,18,10,5,12,14,26,13,19,26,0,1,7,17,12,13,9,1,14,21,19,20,6,9,7,25,9,21,17,15,15,8,14,13,12,14,8,30,19,15,10,4,8,14,12,10,12,3,0,7,13,36,6,6,12,11,14,11,10,17,25,19,11,18,11,12,8,7,4,0,0,9,15,13,9,5,10,5,31,8,9,10,20,0,9,19,3,16,14,30,7,12,21,25,12,8,13,8,8,0,14,15,7,11,8,11,12,1,15,15,10,7,12,11,0,10,37,25,12,3,11,44,17,7,6,8,22,12,20,11,18,17,20,14,4,23,13,17,13,21,4,16,12,10,10,15,7,5,17,14,7,3,13,7,4,13,22,3,12,11,13,1,29,13,7,39,3,12,10,12,1,17,1,2,0,21,1,13,13,7,7,17,7,11,29,2,5,27,10,10,5,6,17,12,10,7,9,2,0,19,9,12,12,5,9,13,5,14,1,0,26,9,12,6,10,8,12,4,20,15,13,4,12,4,14,6,7,22,22,4,7,11,12,7,7,7,28,18,4,4,6,8,8,2,9,18,12,8,7,4,16,15,8,1,5,14,1,8,8,11,0,15,0,22,1,7,3,12,11,1,7,7,6,15,8,4,7,13,11,9,20,1,8,18,13,6,6,13,5,3,9,11,10,4,3,0,7,5,13,7,16,6,0,1,20,15,15,22,17,19,7,0,16,14,0,15,14,2,1,10,7,11,5,9,8,7,14,6,3,7,10,0,8,17,12,3,1,3,13,21,8,11,3,3,13,7,6,16,1,5,3,5,2,9,2,9,21,6,5,12,4,8,16,1,4,1,10,14,4,6,10,10,6,11,3,0,7,1,10,5,4,8,10,3,3,0,8,14,18,3,3,0,9,4,33,7,4,0,12,17,7,6,2,12,17,30,7,14,11,7,13,15,4,8,8,7,5,15,0,3,0,9,3,1,0,7,13,0,4,1,3,19,6,5,10,0,9,10,10,7,5,8,7,1,2,7,4,8,3,0,18,0,10,3,3,9,12,6,6,7,0,6,9,0,9,0,9,0,5,5,0,0,1,4,19,1,4,23,6,5,12,0,28,16,0,5,12,18,2,10,1,10,21,3,12,2,7,8,0,5,0,3,2,11,5,2,0,3,6,1,2,4,15,14,8,3,1,23,7,0,9,5,9,6,5,4,0,6,8,2,5,8,0,0,0,5,12,4,5,9,8,0,8,12,12,3,3,6,13,3,2,8,10,7,8,0,9,7,2,5,8,1,6,6,6,6,4,7,7,17,18,8,5,6,5,4,6,3,0,0,11,7,7,4,6,6,5,1,12,5,7,7,11,1,3,2,6,3,6,5,3,5,3,9,12,17,8,13,8,7,8,4,20,5,3,0,4,4,8,7,2,3,2,4,3,3,7,13,0,2,0,22,3,6,3,7,8,9,2,10,4,1,0,0,5,8,1,1,6,6,0,4,3,0,6,4,0,2,4,12,7,10,62,7,21,0,9,2,9,2,0,10,7,2,1,8,8,9,2,0,0,4,4,2,4,8,5,2,4,7,2,3,5,18,4,3,1,7,3,0,6,4,4,4,4,4,8,0,3,4,0,8,9,4,8,5,9,4,0,8,4,4,0,1,4,0,6,1,0,4,5,4,2,8,0,11,7,1,0,30,13,5,0,1,8,6,7,3,1,8,7,6,3,2,0,3,4,3,1,2,7,5,0,16,0,4,5,2,12,1,3,5,4,1,1,11,9,1,3,9,8,8,8,3,2,5,2,0,7,12,10,9,2,9,0,5,0,3,4,6,4,6,3,6,4,5,0,0,15,8,9,7,6,16,14,3,6,5,5,2,4,3,4,2,3,2,7,0,7,2,4,2,2,0,2,2,10,1,9,2,0,6,0,4,0,0,6,5,4,2,5,5,5,1,0,9,5,0,3,0,8,2,24,1,0,0,0,1,0,5,4,0,5,3,3,0,20,10,0,5,6,3,17,9,4,3,3,2,7,6,12,2,2,1,5,4,0,0,0,2,4,10,5,4,1,1,11,0,1,5,6,4,8,7,4,4,0,8,4,0,13,3,7,12,7,2,10,0,2,7,2,0,5,5,13,6,2,5,0,0,11,7,6,1,3,5,3,5,1,2,6,9,0,6,3,3,5,4,3,5,0,0,3,4,3,0,0,0,0,3,0,10,18,7,12,0,10,8,6,7,1,0,7,1,9,4,2,8,3,2,4,1,6,5,6,2,7,3,2,0,6,1,3,2,9,6,1,2,4,3,6,3,6,4,7,2,3,0,1,5,2,3,5,5,11,5,3,5,4,3,1,0,4,5,3,5,2,0,7,3,5,1,1,3,4,1,2,12,6,5,7,8,0,7,0,3,2,2,7,6,1,0,4,3,0,0,0,5,6,4,9,5,5,3,2,2,9,0,3,3,0,10,0,12,6,6,9,0,1,1,7,5,0,2,8,5,62,1,5,3,3,0,3,4,0,3,2,2,0,1,0,3,2,2,9,4,10,12,9,4,4,6,5,1,4,2,1,4,9,4,3,0,6,2,7,0,2,5,6,0,2,4,3,4,4,2,0,1,0,29,4,4,2,1,9,0,6,1,6,2,2,0,5,3,7,3,13,1,12,0,7,3,6,4,3,2,1,0,6,8,3,2,0,3,6,2,1,3,3,2,2,1,8,4,1,10,4,0,5,6,8,4,5,5,0,4,10,0,0,0,0,7,6,0,5,2,0,8,0,6,0,3,0,5,5,2,1,0,0,0,14,2,0,0,2,0,0,4,0,0,3,3,13,2,2,0,7,2,4,5,4,4,2,5,6,1,0,7,8,0,4,2,6,10,4,1,10,0,2,3,3,5,1,4,2,2,11,2,7,2,4,2,3,1,6,2,0,0,7,9,160,7,0,0,3,1,2,3,0,5,6,3,0,5,0,0,0,0,3,5,4,6,4,4,0,5,4,9,2,1,1,4,5,7,6,0,3,0,0,3,0,3,0,5,1,3,23,4,2,3,0,1,3,12,0,2,5,6,0,0,3,3,0,6,6,3,0,2,1,0,3,0,0,1,0,1,2,1,0,4,0,0,0,1,0,1,1,1,3,0,4,2,3,1,8,0,0,0,13,4,4,2,4,2,0,6,0,1,3,0,0,3,0,9,8,2,0,5,0,2,5,5,4,0,9,1,2,0,1,3,0,3,0,10,1,2,4,4,4,6,2,12,0,7,0,10,4,0,3,3,1,6,0,1,1,2,4,1,2,4,2,8,3,2,3,1,2,2,14,6,5,0,4,3,3,0,0,2,3,2,0,0,2,2,3,9,0,5,8,3,4,4,3,1,2,0,5,1,4,0,5,3,4,0,5,7,0,3,2,1,7,3,4,13,4,2,2,0,2,1,1,1,3,5,1,1,14,4,2,5,5,0,6,5,0,1,0,5,2,0,1,1,2,1,0,1,0,4,0,0,8,4,3,0,11,0,3,4,5,13,2,0,1,5,3,3,1,3,4,3,11,0,1,1,0,1,2,0,1,2,0,7,1,3,7,3,0,1,2,1,0,0,0,11,1,0,0,3,0,0,3,3,0,1,5,2,2,0,0,1,3,1,2,1,1,0,2,3,13,1,5,3,0,2,5,2,0,0,5,0,3,9,3,0,0,4,0,0,5,5,3,1,5,9,2,4,0,0,4,0,0,4,4,0,0,0,0,2,0,9,0,4,3,8,4,7,0,1,9,0,1,7,4,3,3,12,1,16,6,0,0,0,4,6,3,2,2,2,3,0,0,1,0,3,2,1,2,0,5,2,3,2,1,2,5,1,1,1,0,7,2,0,10,0,1,1,4,4,6,6,1,4,4,1,2,3,2,2,1,0,2,2,3,1,2,0,0,1,1,4,1,4,4,2,0,0,7,2,0,7,1,10,4,2,5,4,9,5,5,1,0,0,0,2,3,2,0,11,2,0,5,3,1,4,2,8,4,3,1,0,1,2,2,2,3,4,3,1,1,1,1,0,2,5,0,6,0,6,4,2,2,3,3,2,2,4,5,5,4,1,11,1,2,0,5,2,0,0,3,0,4,0,3,1,0,2,1,10,0,4,9,11,1,2,1,2,5,3,3,3,0,38,2,0,6,12,0,4,0,0,1,0,1,2,0,2,1,1,1,0,4,4,2,6,1,1,2,1,0,3,1,1,1,0,4,2,2,0,0,4,7,6,3,1,3,1,3,4,8,1,2,1,0,0,1,2,5,0,1,0,0,2,8,0,2,1,8,2,3,4,0,0,1,2,0,0,3,20,1,23,1,0,2,7,0,1,3,4,0,0,3,0,0,3,2,4,5,0,1,0,26,15,1,1,0,1,3,1,0,3,0,3,2,1,1,0,1,2,0,0,4,0,1,2,1,0,2,3,1,0,3,1,3,1,7,4,0,2,2,4,0,0,0,0,8,2,0,1,0,7,3,4,11,1,6,1,5,5,3,2,0,1,3,3,3,5,3,2,0,0,1,3,0,1,1,0,1,3,2,2,0,1,0,1,1,3,0,5,1,4,1,3,0,3,6,1,2,1,0,1,1,0,2,1,2,0,0,1,0,0,3,1,0,3,2,4,5,3,0,3,3,1,3,3,6,5,1,1,0,1,2,5,1,0,1,3,0,1,2,0,0,4,4,0,1,1,2,0,1,1,2,1,3,0,4,1,17,3,0,2,5,3,3,2,2,3,0,4,2,11,0,1,3,0,1,0,0,4,2,0,3,3,0,0,1,1,2,2,2,0,1,2,0,0,0,1,0,0,8,2,2,3,1,2,3,2,3,0,0,2,1,3,5,10,3,1,2,2,1,9,0,1,4,0,0,0,2,1,4,0,3,4,4,0,2,0,2,0,3,2,0,2,0,3,4,4,0,3,0,1,0,3,2,6,3,1,12,2,0,0,6,9,3,0,0,0,3,2,1,0,4,1,1,8,1,0,6,1,2,0,2,1,0,0,0,0,0,0,2,1,0,0,1,3,0,1,0,1,1,1,0,1,2,1,0,0,0,0,2,0,7,8,3,2,1,0,3,2,1,2,1,3,1,7,3,1,0,1,3,1,0,3,1,1,1,0,1,2,0,0,0,5,1,0,1,1,1,0,1,3,5,0,6,3,2,1,1,4,1,5,7,0,0,2,1,0,2,0,4,2,1,2,4,0,2,2,3,7,0,9,0,1,3,5,1,0,1,5,0,6,2,5,1,1,2,2,1,1,0,0,0,0,0,4,1,0,1,2,2,4,0,0,4,0,2,2,0,4,4,4,2,6,1,0,3,0,0,6,0,3,3,0,3,0,2,2,4,0,2,0,0,0,3,1,0,0,1,1,0,5,0,2,4,0,0,4,4,4,0,5,0,4,8,3,0,4,1,0,15,3,0,5,3,1,0,1,2,4,2,3,2,0,9,0,5,0,0,1,16,0,2,0,1,0,2,1,1,0,2,10,0,2,0,0,0,2,5,1,1,2,3,0,0,4,0,0,4,2,1,3,5,3,2,1,0,0,0,2,0,1,1,0,0,4,2,0,0,1,0,0,5,0,1,3,1,2,0,2,0,3,0,0,2,1,5,3,2,1,0,5,0,4,0,1,0,0,6,0,3,1,2,0,4,1,0,0,1,0,1,1,2,2,4,1,2,2,3,1,2,3,2,0,1,2,0,0,0,4,3,7,3,10,6,0,4,0,4,7,0,1,4,3,10,6,1,2,2,1,2,1,0,0,1,0,5,0,1,3,4,1,2,3,3,0,1,2,0,1,1,0,0,1,2,1,1,2,0,0,0,1,1,2,0,0,0,1,0,1,10,0,0,1,2,2,0,1,0,0,3,1,3,0,0,2,1,0,4,1,1,1,2,0,1,1,1,0,0,0,1,0,0,1,0,1,0,6,6,0,0,0,2,7,1,1,8,1,0,0,2,2,6,1,0,0,3,0,2,1,1,3,1,0,2,2,0,1,1,7,1,0,2,3,2,1,1,0,0,1,0,0,2,2,8,0,2,3,2,8,0,1,3,0,2,0,2,0,13,0,4,1,2,2,0,1,1,0,0,2,1,2,0,4,1,0,2,0,3,0,1,4,0,0,7,1,0,2,0,0,0,0,3,4,0,2,1,2,4,0,2,0,1,0,1,1,2,1,2,1,0,0,0,0,2,3,0,4,0,1,0,0,5,3,7,0,0,1,1,4,1,1,3,1,0,3,0,0,0,3,0,1,1,0,0,0,0,1,0,0,8,1,0,5,0,0,1,1,0,4,0,2,0,13,1,0,1,1,0,0,0,0,2,2,0,2,3,1,4,1,1,0,0,0,0,1,1,3,3,2,3,0,5,5,4,0,0,0,6,0,4,1,3,0,1,0,3,0,1,1,0,1,0,3,7,2,0,1,6,0,1,1,1,1,2,6,0,0,0,0,2,2,0,3,2,6,0,2,7,0,1,4,0,1,0,1,4,0,1,0,2,0,1,0,1,2,1,0,2,0,4,0,0,3,1,0,0,0,2,0,0,2,2,8,0,0,0,0,0,0,0,0,1,3,2,7,0,0,3,1,3,1,2,0,6,0,0,5,0,0,4,0,2,0,0,3,2,0,4,2,4,0,3,2,0,1,2,0,1,0,0,5,1,1,3,2,3,1,1,0,0,2,1,5,0,0,0,0,0,4,0,1,2,0,1,0,3,1,6,1,0,0,1,2,0,2,2,0,1,0,0,2,0,0,1,0,1,3,1,2,0,1,0,0,3,1,0,0,2,2,1,0,1,0,0,0,0,0,0,3,5,2,3,2,1,1,4,0,0,0,1,0,0,7,0,1,5,3,5,0,2,0,0,0,6,0,1,2,0,0,0,0,1,0,0,0,3,2,2,4,0,1,1,2,0,1,1,7,2,0,1,0,0,0,2,1,0,0,0,27,0,0,0,1,5,0,0,2,0,1,0,5,3,0,5,3,0,0,5,0,8,1,0,0,1,3,0,0,2,1,0,2,3,1,3,1,2,1,1,2,0,3,1,1,3,1,1,2,8,1,2,1,1,0,1,0,2,5,0,0,0,0,5,2,4,1,4,0,2,0,3,2,0,0,1,1,2,0,0,0,0,2,1,0,0,4,0,1,1,0,0,0,3,0,3,2,0,0,0,0,1,1,3,4,0,1,3,2,0,2,1,0,0,5,0,1,0,0,1,1,1,1,0,3,0,1,1,5,1,0,2,1,2,7,1,6,0,2,2,5,1,0,0,1,0,0,9,2,1,2,0,1,1,0,1,1,1,0,0,0,0,0,2,0,0,0,0,0,1,2,1,0,0,2,1,0,1,1,2,0,1,1,0,2,0,1,1,1,0,0,2,2,1,2,0,1,5,1,0,1,0,2,0,0,2,0,0,1,3,0,0,1,2,1,1,2,0,1,0,0,1,1,1,0,7,5,3,1,0,0,4,2,5,0,0,2,0,0,0,2,0,1,1,0,24,1,2,3,0,3,0,0,3,0,0,1,0,0,0,0,0,1,1,3,0,0,1,1,0,1,0,2,0,5,0,0,1,0,2,2,0,1,0,2,1,0,0,0,3,3,0,0,0,3,0,0,9,0,0,1,2,0,1,3,2,1,0,3,0,1,0,0,2,0,4,0,0,2,1,1,0,2,0,1,11,0,0,0,1,1,5,5,0,1,1,1,0,3,9,1,0,4,1,1,2,0,1,0,0,0,3,0,2,2,0,1,4,0,4,0,0,0,2,1,0,0,0,3,0,1,0,1,0,4,0,3,0,35,0,0,1,0,3,0,0,3,0,0,0,1,3,3,0,0,0,1,2,0,1,0,0,4,3,2,6,0,1,2,1,0,0,0,0,0,0,0,2,2,0,3,1,7,2,2,3,0,0,1,0,4,2,0,0,0,4,1,2,3,2,2,1,1,3,0,0,0,3,2,5,1,0,0,1,1,2,0,1,4,0,3,0,0,2,0,1,1,0,0,2,1,1,4,1,2,0,0,3,0,0,4,2,0,4,2,0,0,2,4,3,3,1,1,8,1,4,1,0,0,1,6,1,0,1,5,0,18,0,2,1,1,1,0,3,0,1,0,3,5,0,1,0,2,1,38,0,0,1,0,0,0,0,5,0,2,2,1,3,0,0,0,0,3,4,1,1,2,0,0,1,0,1,1,3,1,0,0,2,0,1,5,1,0,3,0,2,0,2,2,0,8,0,1,0,3,0,0,4,1,0,6,0,0,1,5,0,1,0,0,0,1,1,0,1,2,2,0,1,0,0,0,1,2,0,0,0,1,0,0,1,0,1,2,1,8,0,0,0,0,0,0,0,1,0,4,0,1,0,0,0,2,0,0,0,3,4,0,4,0,1,1,0,1,0,2,5,2,0,0,0,1,0,0,11,0,5,2,0,1,0,0,0,1,1,6,1,0,1,0,0,1,0,1,7,0,3,3,0,1,0,0,0,0,1,0,1,1,12,0,0,4,1,0,1,3,0,0,1,2,0,0,1,1,0,0,1,1,3,1,1,0,0,1,4,7,4,1,0,6,5,1,0,0,3,0,3,0,2,1,1,0,0,1,2,3,0,0,0,1,0,0,0,4,0,9,3,0,4,1,0,0,2,0,0,1,1,0,0,0,7,3,0,2,0,1,0,1,0,1,0,5,1,1,0,1,0,1,3,0,2,1,2,5,1,0,0,0,0,3,0,0,2,0,0,0,2,0,2,2,0,0,1,0,0,0,0,0,0,0,7,3,1,2,0,0,1,0,0,0,6,4,1,3,1,0,0,1,2,0,0,1,0,2,5,1,1,1,0,4,3,0,4,4,2,0,0,0,2,1,0,0,0,1,1,1,1,0,0,0,0,0,9,0,1,1,0,0,0,0,1,5,0,2,4,0,0,0,8,0,2,4,1,0,2,3,1,1,0,4,1,3,1,2,0,0,1,0,2,0,1,2,0,1,13,0,0,0,0,0,0,2,3,1,1,1,1,0,0,1,0,0,0,4,0,0,0,0,3,1,3,1,1,0,1,2,2,0,5,4,0,0,0,1,1,1,2,0,0,0,0,2,0,1,0,0,3,2,1,4,0,0,0,7,3,0,0,0,6,4,1,3,0,1,2,2,0,4,0,1,2,0,0,6,0,0,0,0,0,0,2,0,2,2,0,0,1,1,2,5,3,1,0,0,0,2,0,2,0,0,0,3,2,3,0,2,0,1,0,1,2,3,0,0,2,1,2,5,4,0,0,1,1,0,3,1,0,2,0,1,0,2,1,3,4,0,0,0,1,0,1,4,0,1,0,3,1,2,0,1,1,2,2,0,2,0,0,1,0,0,2,1,0,0,2,1,3,2,0,3,2,3,1,0,0,0,1,0,0,2,0,0,3,0,5,1,0,4,1,0,0,2,0,1,2,2,3,1,3,0,2,0,2,6,0,2,8,0,5,0,0,0,4,0,0,1,0,0,0,0,0,0,3,0,0,1,1,0,0,0,1,4,0,0,0,1,1,0,0,2,0,0,1,0,0,0,1,1,0,1,0,1,0,0,1,0,0,0,1,1,4,2,3,1,0,2,0,0,0,1,1,1,0,0,0,0,0,0,0,0,0,1,1,3,4,0,2,2,0,3,4,0,0,2,0,0,0,0,1,4,1,0,0,0,1,3,2,0,2,1,0,4,0,1,0,2,0,1,0,0,0,1,0,2,0,2,0,2,0,2,0,0,0,0,1,0,2,0,0,3,0,2,0,0,3,1,1,2,0,5,3,3,16,0,0,0,1,0,0,0,1,3,0,3,1,0,0,0,0,0,1,0,0,1,1,0,0,1,2,2,2,0,0,0,0,0,0,0,1,0,1,4,0,0,0,0,0,0,0,0,0,1,0,1,0,0,0,0,0,1,0,0,1,0,0,0,0,0,0,0,0,0,1,0,2,0,1,0,0,1,0,14,0,0,10,0,0,0,0,0,0,0,0,0,0,0,0,0,1,0,0,0,0,0,0,0,0,0,0,0,0,0,0,0,0,0,0,0,0,0,0,0,0,0,0,0,0,0
"1994 O'Brien, Tim, In the Lake of the Woods",high,4074,2542,1438,2190,1360,627,1513,1048,1174,921,475,785,552,698,561,438,368,352,534,426,568,335,199,322,120,400,137,381,315,175,178,495,259,221,172,97,305,368,155,193,133,204,349,283,190,143,264,201,253,376,178,119,179,214,226,135,81,138,122,207,177,113,62,141,100,130,139,165,51,117,77,94,183,89,94,108,85,128,117,60,153,91,132,135,129,103,103,70,90,97,118,81,59,88,70,124,86,107,86,42,79,118,28,51,104,127,96,82,37,151,73,121,40,77,58,34,100,92,123,69,18,22,97,130,48,53,60,60,56,47,15,71,97,85,53,75,38,46,22,46,26,44,142,51,38,69,62,38,39,205,73,56,71,58,123,23,16,100,42,162,71,87,87,66,53,40,84,62,202,31,20,63,54,36,8,54,74,63,27,65,60,57,58,82,27,21,39,15,18,29,25,92,23,27,51,41,94,25,18,29,42,120,25,38,18,14,32,25,75,55,9,52,43,36,66,40,25,56,42,48,49,24,34,57,29,37,27,30,32,28,36,37,48,31,15,98,22,47,86,48,36,14,77,68,88,50,20,67,26,68,29,58,54,33,14,26,46,41,23,51,30,18,35,41,22,93,59,12,35,15,46,21,31,80,40,4,29,34,45,26,15,30,22,76,82,4,14,38,26,39,19,7,13,30,16,43,59,21,23,31,47,28,9,8,14,25,8,14,49,15,34,7,27,31,19,12,39,24,27,16,25,29,53,17,55,16,20,39,9,18,26,30,30,13,29,11,22,31,21,46,13,46,11,15,17,19,42,23,33,19,15,38,25,17,49,8,13,9,36,15,28,36,14,22,69,35,21,32,13,47,73,40,25,50,26,10,15,31,61,21,5,18,19,18,37,14,0,12,12,30,4,33,5,16,18,14,24,11,12,10,13,17,20,30,13,7,12,29,18,23,15,19,28,10,38,9,15,13,43,29,6,2,5,3,23,12,3,19,23,26,4,14,5,31,0,35,14,12,4,26,6,13,32,24,23,15,8,15,4,14,12,27,8,10,14,15,10,24,20,8,42,1,0,10,9,10,6,21,9,32,15,7,37,8,11,13,5,1,0,15,8,35,12,16,8,17,12,12,44,6,26,16,21,16,6,5,27,13,38,8,10,12,1,17,16,13,34,11,8,21,16,13,14,37,5,24,0,20,26,8,14,9,8,18,16,19,6,11,8,22,267,11,19,4,10,0,45,22,5,11,10,4,7,3,9,7,0,1,24,19,22,10,8,52,9,14,9,16,9,9,5,5,13,5,17,26,23,24,6,8,14,17,6,25,13,8,16,17,23,39,14,5,5,11,1,22,11,11,4,16,3,15,22,10,18,9,18,13,5,4,20,29,6,34,2,0,0,14,18,4,22,17,8,23,2,6,13,8,24,26,4,11,32,12,10,21,16,13,23,9,10,8,4,5,7,0,24,11,44,12,17,8,4,17,11,3,20,8,3,15,0,20,28,8,32,18,9,13,20,13,19,2,14,13,0,14,11,14,8,16,4,19,5,19,9,8,1,36,12,2,4,2,11,11,4,10,65,9,8,4,20,12,4,4,15,14,3,0,22,15,6,14,4,12,1,2,0,5,6,7,1,5,4,12,14,18,7,29,19,1,23,0,23,7,6,17,21,1,11,6,2,8,11,11,0,13,20,3,36,6,18,6,26,4,0,5,9,10,9,2,5,4,7,12,1,16,7,15,5,30,3,12,9,24,11,10,5,6,17,3,11,32,6,0,1,5,13,4,7,0,13,13,2,9,13,9,10,2,9,7,13,7,19,9,30,8,0,6,0,0,14,3,10,4,17,7,1,8,5,5,9,5,13,6,10,5,17,0,33,6,8,16,8,6,5,16,13,7,6,8,9,0,48,15,4,8,5,7,6,3,17,4,13,6,11,6,2,0,13,7,5,6,13,5,10,3,7,4,0,8,10,3,10,5,23,11,6,0,9,3,6,11,11,11,0,6,13,6,7,24,8,14,15,0,4,9,12,5,22,8,12,4,15,7,10,8,4,0,13,11,8,4,11,1,7,8,5,5,4,10,2,0,14,0,24,4,3,4,1,3,5,3,5,14,9,17,14,0,2,0,16,11,8,1,10,25,2,2,5,1,4,13,1,5,14,10,4,41,11,6,12,14,7,9,1,13,22,9,11,3,0,18,6,0,4,11,18,1,12,2,8,0,13,8,3,8,11,3,11,3,6,2,6,13,3,0,15,8,15,6,13,14,3,6,1,1,0,2,13,0,3,0,1,24,5,16,0,0,12,5,14,7,6,14,6,10,2,0,22,3,1,5,0,4,0,4,5,3,15,0,3,3,1,15,6,0,8,2,3,3,5,7,0,10,10,9,4,14,5,6,3,7,14,10,5,0,4,3,2,3,4,2,0,1,6,5,5,15,0,0,0,2,0,11,7,5,9,0,14,11,3,3,6,8,5,6,13,12,3,4,4,0,1,18,4,6,2,25,12,13,1,9,26,4,6,4,5,20,4,2,20,20,2,6,0,0,8,5,22,15,7,33,2,30,10,1,9,7,0,1,6,2,1,1,3,9,14,10,1,4,16,0,5,10,11,7,3,2,8,31,15,4,6,0,4,2,0,12,3,2,1,1,3,5,0,37,0,6,0,0,23,7,17,6,8,6,1,30,7,0,7,0,4,7,2,2,0,6,13,0,1,1,0,2,13,11,2,15,0,4,5,0,6,13,6,11,12,18,12,7,0,1,5,4,1,0,0,10,4,3,3,18,8,9,6,1,7,4,0,4,6,3,0,5,11,0,4,10,15,6,7,2,2,0,2,3,0,13,6,4,9,4,15,4,6,5,1,13,1,7,18,0,2,7,0,6,6,26,11,6,1,87,1,3,0,2,4,5,0,1,12,2,5,7,5,4,13,5,5,6,0,3,1,5,6,3,0,5,0,9,3,4,4,4,8,2,3,2,12,5,5,2,9,3,0,10,9,6,10,3,3,3,1,1,5,4,10,5,7,5,0,1,12,4,4,3,0,1,5,4,1,12,10,2,10,12,4,4,4,7,6,2,3,7,4,5,2,9,1,0,3,3,4,0,5,6,4,1,12,13,0,3,6,13,4,0,0,1,0,0,1,0,3,8,7,1,3,8,6,2,1,14,7,95,5,8,1,0,15,2,0,1,1,6,0,12,1,0,0,5,1,10,7,15,0,2,2,9,1,8,11,3,12,5,4,13,1,0,12,5,6,10,0,0,4,7,8,6,8,0,8,4,3,3,22,4,3,6,2,7,12,7,0,3,2,0,14,4,9,11,8,4,5,0,2,18,1,0,3,7,10,3,6,2,0,7,1,4,1,5,4,10,2,7,9,2,3,13,1,14,12,4,4,2,4,7,0,6,4,5,6,0,0,0,0,4,0,4,8,11,4,0,1,1,23,17,1,0,0,5,14,7,3,11,4,5,3,4,4,5,5,3,2,6,9,7,2,11,3,5,2,6,3,0,4,1,6,0,9,9,3,3,6,8,1,2,12,18,1,8,0,9,11,2,1,1,2,10,2,4,16,4,5,0,6,3,0,1,0,2,4,7,0,1,3,6,2,2,0,5,0,11,16,12,1,2,2,0,1,2,0,0,0,6,4,5,1,4,1,3,2,5,2,2,6,4,0,17,296,7,0,7,13,0,1,5,5,3,1,5,3,1,0,2,15,5,7,0,7,13,4,2,2,3,0,0,6,8,7,5,0,2,8,9,1,4,0,5,10,0,1,4,0,3,2,7,4,0,0,2,0,2,4,6,7,6,0,1,2,10,9,2,0,0,3,0,6,6,4,5,3,0,4,3,1,1,5,2,7,5,6,18,8,0,5,5,5,0,4,5,7,3,1,7,3,2,1,1,4,3,1,2,1,3,6,0,0,0,6,8,1,5,4,0,0,9,2,12,5,3,8,4,3,6,0,4,1,6,2,6,4,3,4,11,6,3,0,2,2,12,12,0,1,1,5,5,2,3,16,0,6,2,2,4,4,3,1,3,1,5,0,3,1,1,0,0,14,4,5,15,2,3,0,0,2,51,0,9,2,1,1,6,2,2,2,4,3,8,0,1,12,8,6,2,1,7,3,0,3,9,4,2,0,0,3,1,0,12,0,0,0,1,4,9,5,2,4,0,216,1,0,2,8,1,1,6,1,2,0,2,7,2,4,3,0,6,4,2,3,1,4,3,12,0,0,3,2,19,3,3,9,2,2,2,3,7,0,5,4,2,0,1,2,3,0,2,2,3,12,0,1,3,0,13,6,0,5,0,3,9,0,2,2,6,0,3,4,1,0,6,0,1,2,0,1,2,1,1,4,5,3,81,0,2,2,3,4,3,3,2,0,1,0,7,4,0,2,5,0,2,1,2,0,3,3,2,0,7,2,0,1,2,1,9,1,13,1,2,6,4,9,2,2,2,4,3,3,1,1,2,4,2,4,0,1,2,4,11,5,5,2,2,3,4,0,0,12,1,4,0,3,0,1,1,4,0,1,0,3,3,4,0,3,5,2,2,1,7,3,5,0,1,1,5,3,16,2,1,3,7,0,0,0,5,0,0,1,9,2,0,3,4,6,4,0,0,10,2,1,0,7,1,0,2,0,3,3,0,3,6,3,2,0,39,1,6,2,11,3,13,14,2,0,5,0,8,8,1,0,5,0,3,13,3,0,0,7,1,2,2,0,0,0,1,1,1,0,0,1,1,15,1,1,1,4,2,10,1,4,2,0,0,1,2,1,12,0,14,3,2,1,1,1,1,2,1,1,2,0,1,5,0,2,6,0,0,3,7,1,9,3,13,3,0,0,1,1,6,0,4,4,3,6,2,1,1,0,5,0,9,6,2,0,0,0,0,4,0,3,3,0,3,0,1,1,1,2,3,7,2,27,2,0,0,6,76,0,1,11,2,49,0,0,1,1,0,0,0,1,14,1,6,14,5,4,4,3,0,4,2,0,6,16,4,1,2,0,0,0,3,9,4,1,1,0,3,0,1,3,7,6,3,11,0,0,3,3,1,3,0,2,0,0,3,0,8,4,0,3,0,2,5,13,5,2,7,5,0,2,4,1,4,13,2,2,2,1,4,3,0,1,0,3,3,1,2,2,1,0,1,18,0,4,6,0,12,1,1,5,5,4,3,0,2,9,5,1,0,1,4,10,3,6,5,2,3,3,9,2,0,4,13,2,0,16,3,6,0,8,1,6,3,1,1,0,0,2,1,3,4,5,3,0,5,3,9,7,8,1,0,2,3,2,1,0,0,1,2,0,4,10,0,6,2,3,0,0,1,0,1,9,4,11,1,1,4,0,2,1,1,0,4,5,3,6,2,4,0,0,10,5,0,0,0,0,0,34,0,1,3,0,1,0,0,10,0,2,1,1,12,7,6,3,4,1,0,3,0,3,1,1,2,6,0,3,7,8,0,0,0,6,5,0,0,10,1,0,0,0,1,1,8,4,3,1,0,0,2,2,0,0,2,4,2,2,0,5,3,4,5,0,12,1,5,0,0,4,3,0,0,2,4,1,13,1,0,19,0,3,3,4,3,5,0,1,0,0,6,0,0,0,1,3,0,3,0,0,0,6,3,1,3,0,1,0,2,1,0,2,11,1,0,1,4,4,0,3,5,4,4,0,4,3,3,4,2,0,0,0,0,26,4,0,0,0,2,5,3,0,4,4,1,3,0,1,1,0,0,1,3,1,0,2,6,3,1,6,3,5,2,6,0,5,3,1,0,2,3,2,0,2,5,0,12,5,1,5,2,0,0,6,0,1,3,1,2,0,5,6,0,6,0,0,0,0,0,6,0,0,0,1,5,1,1,3,0,11,2,0,1,4,2,0,2,6,1,0,1,1,1,0,0,6,2,0,1,2,0,1,0,2,0,0,0,2,3,2,0,0,1,0,0,3,2,19,1,3,2,0,5,2,3,0,2,3,1,0,3,4,1,1,2,12,0,1,0,1,5,3,0,0,5,12,1,1,2,1,28,0,0,0,2,1,2,2,1,3,0,1,4,1,0,2,2,1,2,3,1,1,0,7,8,3,3,0,3,0,2,0,1,2,0,2,2,2,0,1,2,2,7,2,5,2,7,0,1,8,2,0,2,3,2,3,1,1,6,0,1,2,4,1,5,9,4,1,0,1,6,3,10,0,0,6,3,5,0,0,5,0,2,4,13,1,4,3,0,0,2,1,7,0,0,0,3,0,0,1,6,1,5,3,6,5,1,0,0,0,0,4,7,3,0,0,3,0,0,0,9,3,4,0,0,3,6,0,4,0,1,1,0,3,1,0,0,5,27,5,5,1,1,0,5,11,4,0,0,1,5,9,3,0,3,0,7,3,5,0,0,0,1,0,7,3,1,5,13,3,5,2,1,6,0,4,0,1,0,1,8,3,0,1,1,0,2,0,1,4,1,2,0,0,6,0,2,3,3,2,12,1,1,0,3,1,0,0,1,0,3,1,3,1,5,0,3,1,0,1,0,4,2,0,2,2,7,0,2,5,2,5,0,1,1,0,2,2,3,0,0,2,2,1,4,1,0,1,10,0,0,0,3,4,0,0,3,1,1,2,1,3,0,0,1,1,0,0,1,7,1,6,0,1,2,1,3,0,3,2,1,1,2,0,4,0,1,2,4,0,0,0,0,2,4,0,0,0,0,5,4,2,1,3,0,4,0,1,5,0,0,3,0,1,0,0,5,3,2,1,0,0,4,0,0,1,2,0,3,22,0,0,0,1,0,0,1,1,0,3,2,0,2,0,0,0,1,1,1,21,0,0,0,2,1,0,1,0,6,0,1,2,0,0,3,3,0,31,1,0,1,3,4,0,1,0,0,1,0,3,3,2,4,1,0,3,2,4,1,1,5,3,9,2,10,3,4,20,3,2,1,0,4,0,4,0,1,5,0,1,9,1,1,2,0,0,1,0,5,0,2,1,1,0,7,1,1,1,3,1,1,3,0,0,0,3,2,2,4,2,2,1,2,5,2,1,2,2,3,2,0,5,3,1,3,0,1,0,0,1,3,1,4,1,0,1,1,2,0,3,4,0,4,0,0,0,4,1,1,0,0,0,0,1,1,0,3,0,2,1,0,0,0,2,0,1,0,3,0,0,1,0,6,0,2,6,0,1,0,1,2,0,0,0,11,0,2,3,9,2,0,0,2,0,0,4,1,0,0,3,0,8,1,4,1,12,5,3,0,2,1,3,0,0,0,2,2,4,4,1,3,0,4,2,0,0,0,0,3,4,0,1,0,3,5,0,2,1,2,0,2,0,0,0,0,3,1,2,2,1,1,0,0,4,0,1,0,2,3,2,0,1,5,0,1,0,0,0,1,6,13,33,4,7,2,1,1,1,0,2,0,4,1,1,1,1,1,2,0,0,2,6,0,1,3,2,3,0,2,4,1,10,6,0,0,0,19,3,0,0,2,0,0,13,1,1,2,1,1,0,0,0,3,0,3,0,2,1,2,2,3,2,0,0,2,1,0,0,4,0,3,1,1,2,1,5,0,0,1,0,1,2,1,1,0,0,2,0,0,0,0,1,1,1,0,0,1,0,0,0,2,6,1,9,1,2,1,0,0,1,0,0,1,5,0,0,5,0,2,0,0,0,1,0,0,0,0,0,1,5,2,0,1,0,1,0,2,1,4,3,0,1,2,0,1,0,2,6,2,0,1,1,0,6,0,1,6,6,0,0,0,3,3,1,0,1,2,0,0,0,0,7,0,2,1,1,0,5,13,2,4,1,2,1,1,1,0,42,0,0,3,1,1,0,0,4,4,0,5,1,0,2,1,0,0,1,0,4,2,1,1,4,0,0,0,0,1,1,5,2,0,2,8,0,2,1,1,3,1,6,2,0,3,0,0,1,0,3,4,0,1,0,0,0,0,0,4,0,0,3,0,6,0,0,2,0,2,2,1,5,1,7,1,0,2,0,3,0,0,0,2,3,1,2,1,0,0,0,3,1,0,0,1,0,1,0,0,3,0,0,0,0,0,2,0,29,5,0,2,3,3,12,3,0,0,4,0,1,0,0,1,0,0,1,4,6,1,0,0,0,0,0,20,1,0,4,0,1,1,1,2,0,0,1,2,1,1,1,0,5,2,2,0,1,6,1,0,0,0,0,0,3,0,1,0,0,0,5,1,0,1,2,0,17,3,1,0,0,0,1,0,4,1,0,0,8,1,2,4,5,0,6,0,1,2,1,1,0,0,1,0,0,4,0,0,5,0,0,1,0,1,0,2,1,1,6,0,2,1,0,0,0,1,0,0,0,1,1,2,0,2,0,14,1,4,1,0,5,2,0,0,1,0,4,3,0,0,0,1,0,1,1,0,0,3,1,4,0,3,0,1,0,2,0,0,1,1,2,5,1,0,1,1,1,4,1,0,0,0,2,0,4,0,2,0,1,2,3,11,0,1,0,0,3,0,2,4,1,2,0,0,1,0,1,1,2,4,0,0,0,0,0,0,3,4,4,0,2,1,1,0,4,0,0,0,0,0,2,0,43,0,1,0,0,0,1,6,1,1,0,7,0,0,0,12,0,0,2,7,0,2,0,1,1,0,1,0,0,1,0,2,0,0,1,4,2,5,0,1,1,0,0,0,5,1,1,0,0,2,0,1,6,1,0,1,6,0,0,0,0,3,2,0,1,1,2,8,3,4,2,1,2,0,3,1,1,2,3,0,1,1,2,0,3,2,0,11,0,0,0,0,5,0,2,4,1,3,1,6,3,2,0,1,0,0,3,1,1,0,1,1,0,0,3,3,0,0,0,0,0,2,2,1,1,0,0,0,0,0,2,0,0,0,1,4,0,0,0,4,2,1,0,10,2,2,0,0,4,4,2,2,1,0,1,4,5,0,0,3,0,3,0,0,0,0,1,0,1,1,0,3,2,0,0,0,5,1,1,1,0,0,0,0,1,0,3,2,0,0,1,3,3,0,1,8,2,0,1,1,4,1,1,0,0,0,0,3,2,3,0,0,0,1,3,0,2,0,2,0,0,2,0,1,2,2,1,1,1,4,4,0,1,1,2,0,1,0,0,0,3,0,3,0,1,0,2,0,0,1,9,0,2,3,0,4,1,0,3,2,2,0,0,0,1,1,3,4,2,0,5,1,1,0,0,1,0,0,13,1,1,1,0,2,0,1,3,4,0,0,0,0,0,3,0,0,0,0,3,1,2,0,3,2,0,0,1,4,1,1,0,1,0,0,0,1,0,1,1,5,1,3,2,0,5,0,4,3,1,0,3,5,9,0,3,4,0,0,7,0,1,1,6,7,0,2,5,0,1,0,1,1,0,0,0,0,0,0,0,2,5,0,0,1,0,0,0,2,0,0,6,1,0,0,2,1,3,1,0,5,5,2,0,0,0,3,0,0,0,1,1,1,0,0,2,0,0,6,2,0,0,0,3,0,2,1,1,2,0,1,2,2,2,0,0,1,1,0,2,0,0,0,2,1,0,0,0,0,1,0,0,0,3,2,0,0,1,0,0,0,2,1,1,2,0,0,1,0,1,0,0,0,0,2,0,0,0,3,0,1,4,1,10,2,0,1,0,1,0,7,3,1,2,0,2,4,0,3,0,0,0,2,3,1,0,1,1,0,0,0,0,5,0,1,1,4,1,0,1,3,1,2,0,7,0,0,0,3,2,0,0,2,0,6,1,0,14,40,0,0,0,0,0,1,3,0,4,0,0,3,0,3,0,0,2,0,0,0,0,0,0,4,4,0,0,1,3,0,0,0,2,0,4,1,3,5,4,0,1,0,5,5,1,2,0,6,1,2,0,2,3,1,0,0,0,1,2,0,0,0,0,4,2,7,1,0,1,0,2,0,1,0,1,24,2,16,1,0,3,1,1,8,2,0,1,0,1,2,1,0,0,0,2,1,1,0,2,4,0,1,0,0,1,0,0,0,2,0,4,0,1,0,3,0,6,6,0,0,0,2,0,0,0,0,0,1,0,1,1,33,1,0,0,0,1,0,0,0,5,0,1,0,1,2,1,0,0,1,1,0,0,1,1,0,1,1,3,4,1,1,1,0,3,0,3,4,2,0,0,3,0,1,0,0,0,0,1,2,6,0,0,2,0,1,0,2,1,0,0,1,1,0,1,1,0,0,0,2,0,0,2,6,0,0,0,0,0,0,1,4,0,0,4,0,1,0,0,2,0,0,0,1,0,0,0,1,1,1,0,1,0,0,0,0,0,0,0,0,4,0,0,0,2,0,1,0,1,0,1,0,0,0,1,0,2,3,1,0,3,0,0,0,1,0,7,1,1,1,0,1,0,2,0,0,0,2,1,0,0,0,4,0,0,1,0,0,1,0,2,0,1,0,0,0,0,3,0,0,1,2,0,1,1,0,0,0,0,0,5,0,5,0,1,1,1,0,0,2,1,0,2,1,0,1,0,4,0,1,0,2,1,2,0,1,0,1,0,0,0,0,0,2,3,1,1,1,2,1,0,0,0,1,0,1,0,0,0,3,0,0,3,5,0,0,1,0,2,1,0,1,1,9,0,0,0,3,0,0,2,0,4,0,0,0,0,0,1,0,3,2,0,2,2,0,0,1,1,2,0,0,5,1,1,1,0,16,0,0,0,0,3,0,1,0,3,0,0,0,0,0,9,2,3,0,0,0,1,0,0,2,1,4,0,1,1,2,0,0,0,2,1,1,0,0,1,0,0,1,1,0,0,10,8,3,0,0,4,0,1,0,0,0,0,2,0,4,1,0,0,0,0,2,0,1,0,1,2,0,2,0,1,0,1,1,0,0,4,0,1,0,1,0,1,0,0,0,2,0,0,0,0,1,4,0,0,2,0,0,0,1,1,0,0,0,1,4,2,0,0,2,0,0,0,0,0,0,0,2,0,1,0,3,2,4,0,0,5,0,1,2,0,1,2,2,0,0,0,0,2,0,0,0,0,0,1,0,2,0,1,0,2,1,1,0,0,0,1,1,0,2,2,2,7,1,2,9,0,6,0,0,0,0,0,1,0,0,0,0,0,1,0,2,0,0,0,0,0,0,3,0,1,0,6,1,0,0,0,0,0,0,0,0,11,2,0,0,1,0,1,0,0,0,0,0,0,0,0,0,0,4,0,1,1,3,0,0,0,0,0,0,0,0,0,0,0,0,0,0,0,0,1,0,0,0,0,1,0,1,0,0,0,0,0,0,0,0,0,0,0,0,0,0,0,4,0,0,0,0,0,0,0,0,0,0,0,0,0,0,0,0,0,0,0,0,0,0,0,0,0,0,0,0,0,0
"1995 Dexter, Pete, The Paperboy",high,6426,3256,2535,2004,2001,2222,2353,1790,1716,1442,676,1325,1069,942,704,757,869,550,534,1636,977,359,676,550,1065,581,452,279,402,241,421,355,388,246,213,234,463,278,363,312,425,177,414,213,215,298,229,101,304,571,409,286,206,416,216,132,285,202,172,128,191,166,232,153,121,228,99,238,89,267,126,51,109,124,165,135,100,179,148,92,159,116,301,91,213,322,198,74,90,135,86,115,98,124,110,110,92,165,72,145,99,81,119,119,104,152,217,253,100,159,94,181,176,159,89,170,80,38,71,75,48,20,160,79,220,75,123,82,62,91,88,153,52,117,96,85,45,96,116,70,91,39,86,59,34,97,64,58,52,22,81,13,163,117,63,72,31,96,30,85,73,45,53,81,99,40,73,115,112,115,91,32,37,16,96,51,43,108,26,28,56,61,10,82,44,65,46,66,63,35,104,73,32,89,30,63,174,80,67,17,34,115,54,65,40,89,85,20,39,9,18,55,19,55,82,58,69,35,39,136,86,63,46,78,67,33,12,37,35,3,185,42,105,48,39,33,40,57,35,36,48,21,59,29,115,35,29,53,36,25,37,92,50,105,56,23,14,31,44,29,63,23,5,70,24,9,49,22,34,32,27,47,44,68,24,28,41,21,26,40,59,61,39,40,27,23,67,44,27,38,34,10,41,20,50,33,30,56,16,19,36,29,0,40,68,34,19,29,80,15,18,62,26,28,17,47,36,11,28,24,10,17,29,15,27,63,1,11,39,55,27,12,20,76,33,26,9,11,27,72,32,85,43,92,42,15,16,13,31,20,23,29,59,16,38,41,22,39,52,22,11,114,16,17,14,87,4,75,16,27,45,3,18,49,33,43,24,12,35,37,37,27,23,77,21,16,0,31,11,6,7,18,146,3,18,26,38,29,18,2,10,25,55,21,22,28,32,5,56,11,29,36,21,12,8,52,5,28,32,27,70,3,14,40,29,27,13,42,9,13,39,24,54,28,1,13,30,45,3,24,21,40,14,26,13,13,49,25,13,21,19,34,9,24,39,11,27,28,42,22,12,409,0,26,16,19,8,7,6,4,16,57,27,23,35,10,35,24,0,16,29,38,13,3,4,13,8,10,6,35,19,22,6,4,11,58,35,51,12,7,32,19,91,34,12,23,11,16,52,3,9,20,10,32,14,23,0,16,20,19,28,12,45,3,17,17,5,7,21,27,2,38,6,11,35,0,24,4,30,9,21,15,1,28,50,15,0,0,25,12,26,30,31,9,15,18,4,18,21,26,4,86,7,4,3,14,19,42,7,4,12,4,17,16,21,27,12,0,21,20,13,8,7,18,30,5,33,12,5,4,10,8,50,16,4,7,5,23,15,17,28,13,8,10,11,0,0,24,37,7,52,13,21,20,2,3,14,4,9,3,25,12,2,26,26,4,9,66,40,23,25,22,24,11,26,0,39,22,18,10,5,4,19,25,4,14,15,1,7,16,0,29,12,20,9,23,20,15,22,1,23,13,31,11,29,18,18,6,18,8,4,10,32,28,13,15,11,41,42,6,7,8,11,18,13,10,34,13,23,7,10,19,5,28,2,6,11,0,35,15,14,29,13,15,11,5,0,16,34,13,0,6,36,11,20,3,21,20,24,23,2,33,14,1,3,9,27,4,20,8,9,4,15,6,0,4,13,19,23,22,2,38,29,10,28,2,7,9,4,0,30,15,12,5,5,26,12,10,33,3,6,11,8,11,10,1,5,5,16,3,42,7,0,16,0,7,2,24,15,4,14,2,6,12,1,4,12,12,9,4,41,20,0,23,16,9,0,29,0,12,11,13,5,10,0,12,19,13,18,88,13,10,10,29,8,9,8,0,13,1,14,21,1,4,4,1,4,6,8,16,2,207,0,10,1,9,12,17,1,13,4,33,23,8,9,9,6,0,26,7,2,9,78,2,10,2,16,5,20,26,14,3,4,17,8,7,27,0,22,10,4,6,9,8,16,25,1,7,8,5,4,9,8,28,2,7,27,9,2,11,12,3,30,12,9,5,0,0,3,0,0,5,18,8,26,1,15,20,5,9,12,0,20,0,5,8,0,7,21,12,6,1,14,16,9,6,6,0,11,3,7,19,10,1,8,4,10,13,19,8,25,11,5,4,9,10,5,2,8,3,5,10,13,0,3,1,14,22,5,2,0,11,1,1,12,3,11,1,3,17,11,0,21,9,10,6,5,4,5,0,0,12,8,14,6,0,19,0,4,18,10,4,11,3,8,11,2,5,2,0,14,0,5,0,19,27,0,2,1,3,9,1,10,1,26,1,3,0,10,5,1,9,10,0,0,3,3,21,4,3,21,2,8,5,2,3,19,0,15,6,7,5,2,9,17,48,3,12,7,2,23,12,49,13,3,0,12,10,0,4,2,29,0,3,25,12,5,18,0,0,0,3,9,7,4,2,10,0,3,1,8,4,14,15,9,3,2,0,3,7,3,0,5,8,16,10,0,23,3,28,5,9,22,17,4,14,8,1,11,19,24,1,10,14,0,0,2,0,9,8,6,5,15,6,4,16,10,28,6,0,5,2,8,1,2,3,9,9,3,6,2,3,38,26,23,1,19,8,4,15,3,1,2,25,11,2,1,3,1,25,30,7,8,38,0,17,28,16,0,0,38,21,5,2,4,9,1,0,4,0,12,4,1,5,6,4,0,12,2,0,7,8,0,13,5,5,17,6,0,3,27,0,2,11,1,1,0,0,5,6,0,4,4,1,0,0,0,7,5,8,5,8,1,20,6,1,14,6,5,11,2,1,0,2,9,0,2,1,3,5,2,0,15,0,0,8,0,9,9,1,9,3,13,5,3,7,3,4,0,6,11,0,5,6,0,2,5,4,3,34,0,1,4,4,0,0,7,8,0,1,17,5,6,10,8,10,2,1,13,10,0,10,6,6,7,10,3,20,1,18,2,7,14,9,20,7,4,4,10,2,0,3,5,2,2,0,4,6,4,7,3,16,0,0,6,36,6,23,3,5,405,1,2,2,9,9,13,0,4,6,7,11,11,0,5,1,0,0,4,4,3,0,11,8,9,2,11,4,6,18,3,1,5,0,16,3,14,8,0,7,2,0,5,107,23,0,0,13,0,2,0,0,3,6,0,9,2,13,0,4,22,10,5,1,2,7,8,0,11,3,0,0,0,10,0,5,0,0,4,4,1,13,3,4,0,3,2,0,3,5,2,9,1,6,2,1,3,36,7,0,0,1,0,0,0,13,6,3,6,3,18,4,2,3,0,9,2,4,4,4,4,6,0,6,6,0,2,16,6,16,6,1,7,0,33,1,3,0,3,2,3,2,3,13,0,0,9,1,6,8,5,4,0,4,5,8,1,4,9,2,0,5,6,4,5,0,0,0,0,10,8,0,1,0,0,3,0,4,6,13,1,6,2,5,5,10,1,0,3,3,1,5,3,12,7,1,4,3,5,12,17,9,2,22,5,0,7,3,8,2,2,8,5,12,10,5,1,0,4,7,5,3,4,1,2,4,1,0,4,6,2,4,3,8,6,0,0,1,1,3,10,10,2,0,1,1,6,2,12,10,10,0,4,2,1,6,5,6,1,1,0,2,8,0,16,6,1,0,1,2,0,4,0,3,6,14,1,2,5,1,11,0,4,4,5,6,0,6,0,7,2,9,4,0,2,3,2,6,1,0,0,12,2,3,1,8,7,0,4,10,2,3,3,7,0,0,0,10,9,0,0,3,9,11,1,1,0,1,14,3,6,1,3,1,10,3,7,0,16,5,3,2,0,5,0,2,3,0,4,7,3,3,1,1,1,0,3,1,6,0,14,445,4,3,0,0,3,0,6,4,4,1,10,0,0,0,0,3,0,1,0,3,10,0,7,4,1,24,0,5,3,2,6,6,5,0,7,0,3,2,1,3,0,0,3,2,3,4,2,9,10,0,2,9,0,2,3,0,10,4,3,4,1,2,0,4,0,2,4,3,11,77,3,2,5,11,3,2,6,0,2,0,0,1,1,2,0,8,22,3,15,1,2,0,6,2,6,3,10,1,3,2,0,0,3,0,5,1,7,4,19,2,14,13,0,0,2,0,0,17,6,3,6,4,1,1,2,0,1,0,8,3,0,0,3,4,0,1,0,0,0,3,3,4,1,18,1,8,0,3,4,13,0,2,0,4,0,2,2,6,1,25,3,1,1,4,4,0,7,2,7,5,1,5,1,2,1,5,0,5,0,1,0,11,7,3,1,3,1,7,0,0,2,11,0,1,2,0,7,4,2,3,0,0,11,0,0,1,0,6,0,0,1,0,0,4,0,1,0,3,0,9,1,0,4,1,4,4,3,0,4,0,0,0,4,1,2,5,0,2,0,6,0,0,0,0,3,8,0,3,5,8,0,2,1,23,7,1,10,1,2,2,0,0,0,4,0,2,1,6,0,4,0,6,5,4,4,3,0,7,1,7,0,0,5,2,2,7,0,4,1,2,4,9,1,3,44,2,2,5,1,3,6,3,0,15,25,0,2,0,3,0,4,3,0,9,5,1,3,0,3,2,0,28,0,1,7,1,2,6,4,2,2,9,0,0,4,7,4,0,1,1,0,4,4,1,2,1,7,1,5,2,1,0,0,2,2,1,2,10,0,7,8,0,3,1,6,1,1,0,5,6,0,3,4,1,1,1,3,2,0,0,1,5,0,1,0,7,5,0,0,6,1,1,2,0,0,0,0,2,3,3,7,1,6,4,1,0,2,5,4,1,6,1,1,1,6,1,3,4,0,2,2,11,6,0,1,0,0,6,2,0,5,3,0,0,4,2,0,3,12,6,7,1,0,4,4,3,0,0,1,0,8,1,1,2,0,3,0,5,0,4,0,0,2,0,5,0,2,4,0,1,0,2,6,1,6,3,2,2,4,0,2,0,1,0,0,2,4,0,1,0,0,0,1,0,6,5,3,3,1,0,4,2,8,0,1,6,0,3,6,0,13,1,4,2,0,0,1,5,0,5,2,1,1,0,1,2,1,4,5,1,2,0,0,5,2,0,5,1,0,2,2,6,0,5,6,32,0,0,0,0,0,3,3,3,0,4,5,5,0,0,3,5,2,6,4,0,1,0,5,0,5,5,3,2,2,1,2,0,0,0,0,3,0,8,0,12,3,14,1,1,4,2,3,6,8,3,1,5,7,3,1,5,4,5,0,1,3,6,3,2,0,0,0,0,2,5,10,3,3,6,0,3,5,0,2,5,7,1,0,2,0,0,2,1,6,3,4,4,1,1,1,4,4,2,4,2,7,0,0,3,2,0,4,10,1,0,0,3,0,11,2,7,0,1,1,0,1,23,1,0,2,9,2,1,0,1,10,1,1,0,4,0,4,0,1,1,8,1,147,0,0,1,1,0,2,1,4,2,2,6,1,0,0,0,2,0,10,4,1,2,0,0,0,1,0,2,2,0,11,1,2,2,2,2,0,1,0,0,2,0,2,1,1,0,0,1,2,0,6,7,1,0,1,0,2,1,1,3,0,0,0,0,1,0,0,0,5,6,4,1,6,1,0,11,0,1,4,5,3,7,2,1,7,4,0,0,0,0,0,0,2,1,1,2,0,1,1,1,8,6,4,2,0,2,2,0,4,1,3,0,0,3,3,1,1,0,1,0,0,0,4,1,0,2,0,0,0,0,0,0,0,0,0,51,5,3,9,0,9,2,1,1,1,4,0,2,7,0,4,4,6,1,0,12,11,1,2,0,2,0,0,0,1,1,0,2,1,0,4,4,0,7,0,6,0,0,0,7,1,0,1,8,7,2,0,3,2,1,6,0,0,0,0,269,4,1,0,4,0,1,7,6,0,2,0,0,0,4,0,4,0,4,0,2,2,1,0,0,3,2,6,0,0,1,8,3,4,0,6,2,1,0,13,2,3,1,1,8,4,3,1,2,0,0,6,3,0,3,1,5,0,4,0,0,0,8,3,0,2,0,2,5,1,0,0,1,0,0,0,0,1,0,2,0,0,1,1,6,1,3,1,0,1,1,1,1,3,3,4,0,0,19,1,3,7,0,4,0,2,0,1,3,0,7,0,1,1,0,0,0,4,6,0,0,0,1,4,0,6,1,0,0,0,1,0,2,1,1,3,0,4,4,5,1,0,3,3,6,1,1,7,0,0,0,3,1,0,0,0,0,0,0,0,0,3,0,10,1,0,0,0,0,2,0,1,0,2,0,0,0,1,0,0,4,0,0,3,6,0,0,0,3,0,3,2,0,0,4,3,0,0,0,7,0,0,0,1,0,1,1,5,2,23,1,1,2,2,27,0,4,1,0,0,3,2,4,0,2,3,2,4,5,0,0,0,1,1,1,0,0,1,1,7,4,2,0,0,8,1,25,2,2,0,3,0,0,1,6,2,1,7,0,3,9,0,1,0,0,2,0,5,1,0,0,2,0,0,2,0,4,0,1,4,4,4,0,2,6,0,2,0,1,0,1,0,2,0,0,3,1,5,3,0,0,0,0,0,0,0,1,1,3,3,0,1,4,1,0,0,0,2,0,1,3,2,6,3,4,1,0,5,0,0,0,0,0,1,1,1,1,7,0,0,0,4,0,0,4,0,0,15,3,0,0,0,0,0,0,0,1,2,0,0,4,0,0,0,8,0,0,7,0,0,0,0,0,0,0,1,0,0,0,0,0,0,2,2,1,7,0,3,0,1,0,0,0,6,0,0,1,2,0,0,0,2,2,0,0,0,0,5,1,2,6,0,5,90,6,0,0,0,6,0,3,2,3,0,1,0,0,0,4,1,1,2,0,0,0,0,0,1,2,0,1,0,0,1,5,0,5,1,2,0,0,0,6,4,3,219,0,0,0,3,0,0,2,3,0,0,0,0,2,0,2,2,0,0,0,0,0,6,2,0,2,1,0,4,2,0,5,0,2,3,14,0,0,0,2,0,0,1,9,7,7,6,4,0,2,0,0,2,8,0,2,0,0,2,0,8,0,2,0,1,4,5,1,0,5,2,4,1,2,0,3,0,6,0,2,0,1,0,4,0,1,0,1,1,4,0,10,0,0,1,0,0,0,0,2,0,0,0,0,0,2,0,0,0,6,1,0,2,0,0,2,0,0,4,0,1,1,0,0,2,0,0,1,2,1,0,2,2,0,0,2,0,3,0,1,2,3,0,1,0,2,4,0,0,0,1,0,0,7,6,1,0,0,4,1,1,1,1,2,5,0,0,2,0,0,3,0,0,0,1,3,3,3,0,0,0,5,2,30,3,30,2,0,2,4,2,3,4,0,5,0,1,1,2,0,0,0,1,0,1,1,0,0,1,0,1,0,5,6,0,0,7,0,2,3,0,1,0,0,0,0,2,2,1,0,7,1,0,1,5,0,5,0,1,2,0,3,4,0,4,0,0,2,4,1,2,1,0,2,0,4,2,7,0,1,46,0,6,2,0,0,0,0,2,0,1,7,2,2,0,1,4,0,0,0,0,1,0,6,1,2,3,4,0,0,0,4,3,0,4,3,0,5,0,9,4,0,0,0,0,2,0,0,0,2,7,0,1,2,4,1,1,0,1,5,5,0,2,5,1,2,1,1,0,2,8,0,4,0,2,1,8,0,1,0,2,4,5,3,1,0,2,3,0,0,1,13,3,0,0,1,1,4,1,2,1,1,0,2,1,1,0,2,3,1,1,4,5,2,0,1,4,2,0,0,1,0,1,1,0,2,0,0,1,0,0,0,4,0,2,0,0,0,20,0,0,1,0,0,0,0,0,0,0,1,43,1,1,0,0,0,0,0,5,2,0,0,0,2,0,1,3,0,0,0,3,0,2,0,1,1,2,0,4,3,0,0,0,1,0,0,1,0,0,0,0,1,2,3,2,0,1,0,3,2,1,2,0,0,3,3,1,2,0,0,0,0,0,0,1,0,3,0,0,0,3,0,2,2,0,4,0,2,0,3,0,0,0,0,0,0,0,0,0,1,1,3,2,2,3,1,5,0,2,0,0,0,1,4,1,0,6,0,8,4,0,0,0,0,6,0,4,4,0,0,1,1,0,3,2,1,2,3,1,0,0,2,1,8,14,0,7,0,7,0,0,3,0,0,1,0,3,0,0,0,1,1,1,1,4,0,0,0,2,4,0,4,2,0,1,0,0,0,2,0,3,0,0,0,3,2,9,3,0,0,8,3,3,0,0,0,1,0,10,1,0,0,0,0,0,3,1,2,3,3,0,0,2,1,1,0,3,0,2,1,5,1,0,0,0,0,1,2,0,4,2,3,0,0,0,0,2,0,1,0,0,0,2,0,0,5,0,0,0,0,3,2,0,1,0,0,0,0,4,0,0,0,0,0,0,1,1,1,0,1,2,1,0,1,0,0,1,0,2,1,0,0,5,0,0,0,1,3,1,0,0,4,0,0,5,0,0,0,0,6,0,0,0,3,0,1,1,0,0,0,0,2,3,0,0,0,4,2,1,3,2,1,2,3,1,3,0,1,0,0,0,2,1,1,2,0,5,1,1,2,0,0,0,0,0,0,0,0,3,2,0,0,1,6,3,0,0,1,0,0,2,1,0,4,0,1,0,1,3,2,1,3,0,0,0,0,3,0,0,1,1,0,2,1,1,3,1,72,0,1,2,2,1,2,0,1,5,0,3,1,1,5,1,1,0,1,0,4,1,4,1,4,0,3,3,1,1,0,1,0,0,4,0,5,21,0,0,1,0,2,1,1,1,1,0,2,3,0,0,0,6,0,0,1,5,1,2,0,0,5,0,3,0,0,0,7,0,0,0,0,4,2,0,1,1,2,0,2,1,4,1,0,0,4,0,8,3,0,0,0,2,0,0,2,0,1,1,0,0,2,2,4,0,0,0,1,8,1,0,0,0,0,3,1,1,1,17,0,1,0,0,0,1,0,3,4,1,1,0,0,1,0,0,1,1,0,0,0,3,0,3,3,0,1,1,0,1,0,3,0,0,0,1,0,0,0,4,0,1,0,0,1,0,0,0,1,0,1,0,1,0,0,0,0,0,0,1,0,1,0,0,1,3,0,1,7,0,1,0,0,0,0,4,0,1,0,5,0,0,0,3,0,1,1,0,1,1,145,1,0,0,0,1,0,1,0,2,2,0,0,1,0,0,0,2,1,1,2,2,1,0,0,1,1,0,0,3,0,0,3,3,3,0,4,0,0,0,0,0,0,0,1,0,0,4,1,1,0,1,2,2,5,1,0,5,4,2,0,0,0,0,0,1,1,1,2,2,2,0,0,1,0,0,1,0,0,4,0,1,1,0,0,0,0,4,0,0,2,0,0,0,3,5,8,1,0,1,1,0,0,1,0,0,8,0,0,1,0,3,13,0,0,0,0,0,0,5,1,0,3,9,1,0,5,0,1,0,1,2,3,0,8,0,0,0,10,0,1,0,0,0,1,0,1,0,0,0,0,4,0,5,1,0,0,0,0,0,1,0,0,0,0,0,0,2,0,0,0,2,0,1,0,3,1,0,0,0,2,0,0,0,0,0,0,1,0,0,0,0,6,0,0,2,1,1,0,0,0,4,1,0,0,0,0,5,3,1,0,0,0,0,0,0,0,0,0,0,0,4,7,2,0,2,0,2,0,0,0,0,0,0,0,4,1,0,0,0,0,1,2,0,0,2,0,0,0,1,0,2,0,1,0,0,0,1,1,0,0,2,1,2,0,0,0,2,0,0,0,0,0,4,2,0,0,2,0,0,1,4,0,1,1,3,0,0,2,1,1,0,0,0,1,3,5,0,0,0,1,1,1,2,2,2,0,0,0,0,0,0,5,0,2,1,0,0,0,2,2,0,0,1,2,0,0,0,0,2,0,0,0,0,11,0,1,0,0,0,0,0,0,1,12,0,0,0,0,0,1,0,3,4,3,0,0,0,2,0,0,1,0,0,0,1,0,0,6,0,5,1,0,0,1,0,0,1,1,3,0,1,0,0,2,0,0,2,1,0,0,0,0,2,0,3,1,1,0,0,0,0,0,1,0,0,6,4,0,2,1,0,1,1,0,2,0,0,5,5,0,3,1,0,2,12,0,0,0,0,6,1,3,0,1,0,3,0,2,0,0,1,0,0,0,1,2,0,0,0,1,0,0,3,0,1,3,0,0,1,4,0,0,2,0,0,6,3,0,1,2,31,0,0,3,1,0,1,1,4,0,0,0,1,0,0,1,0,0,0,4,5,0,0,0,0,2,22,0,1,0,0,0,0,4,2,2,0,0,0,0,0,0,1,0,2,2,1,0,1,0,0,0,0,3,0,2,1,0,3,2,0,2,2,0,0,3,0,2,1,0,0,0,3,1,0,0,0,0,0,1,1,1,2,0,0,1,4,1,0,0,0,2,0,2,2,0,1,1,0,1,1,0,4,0,2,8,0,0,0,0,0,0,1,0,1,1,0,0,0,0,0,0,0,4,0,2,0,0,0,0,0,0,0,0,0,0,1,1,0,0,1,3,0,0,0,0,0,5,0,0,2,0,0,1,0,2,3,0,0,1,1,0,1,0,1,3,3,1,0,0,0,0,0,1,0,4,0,1,0,0,5,1,0,0,0,0,1,1,0,2,3,6,0,0,0,0,2,0,2,4,0,1,3,0,2,0,0,0,3,2,0,2,0,1,1,0,0,2,1,1,0,0,1,2,6,0,0,2,1,0,1,2,1,0,0,0,1,2,1,0,0,1,0,0,0,0,5,0,0,0,0,2,1,0,1,1,3,0,0,6,0,0,0,2,0,7,4,0,0,0,0,1,2,4,2,1,1,1,0,0,0,2,0,1,1,0,0,0,1,1,0,0,0,1,1,0,0,1,0,1,2,0,0,0,0,2,4,1,0,0,1,1,1,0,0,0,0,0,0,2,0,1,0,0,0,1,3,0,0,0,0,0,4,0,0,0,1,1,0,1,2,0,1,0,0,0,2,0,0,0,0,0,0,0,0,2,0,0,0,0,2,1,0,0,0,1,9,0,1,1,0,3,1,0,0,0,0,0,0,0,0,0,0,0,0,1,2,0,1,0,0,0,0,1,0,0,0,0,1,0,8,0,0,0,0,1,0,4,0,0,0,0,0,0,0,0,1,0,0,0,0,0,0,0,1,0,0,1,0,0,1,0,0,0,0,1,4,0,0,0,0,0,0,0,0,0,0,0,0,0,0,0,0,0,0,0,0,0,0,0,0,0,0,0,0,0,0,0,0,0,0,0,0,0,0,0,0,0,0,0,0,0,0,0,0,0,0,0,0,0,0,0,0,0,0,0,0,0,0,0,0,0
"1995 Powers, Richard, Galatea 2.2",high,5950,1633,3245,2744,2358,3289,559,1819,963,1324,1131,391,1405,962,1022,828,752,661,873,184,647,550,631,208,929,562,910,286,423,448,518,429,581,430,546,513,261,536,783,516,316,319,149,371,326,266,311,230,440,167,254,200,476,316,338,352,218,272,314,255,143,216,208,188,191,236,169,182,214,235,171,152,360,139,73,325,191,128,158,111,137,206,97,107,150,101,176,160,293,149,151,103,172,148,122,151,97,136,138,156,225,121,113,273,170,77,167,121,131,129,114,96,156,79,203,38,92,101,171,80,128,82,82,72,50,155,160,71,143,162,67,115,103,110,73,117,212,69,80,164,38,107,33,100,66,76,129,190,91,59,114,28,60,93,157,34,68,66,75,38,95,96,63,135,41,231,127,76,113,27,285,95,143,29,5,94,146,96,107,35,81,109,40,37,63,81,126,55,38,122,55,47,90,68,16,50,35,83,61,13,52,102,56,93,54,10,74,23,62,25,44,49,9,32,52,181,89,29,112,75,114,78,37,49,33,33,44,70,83,37,44,44,66,41,39,63,16,42,21,71,41,57,34,96,31,33,36,43,59,40,36,18,45,35,13,77,79,43,54,120,83,13,80,84,19,107,46,60,38,57,37,36,42,22,49,46,65,27,61,49,22,28,41,61,46,15,42,30,88,34,23,21,16,32,23,34,76,47,27,31,28,46,32,45,46,21,6,37,20,30,84,105,26,39,65,37,11,18,28,46,30,10,46,40,37,21,27,87,223,14,44,23,38,35,6,36,32,24,50,26,52,31,28,61,49,26,20,9,33,45,62,28,30,38,36,36,17,28,41,81,43,4,50,10,34,16,13,15,24,73,63,22,27,7,16,31,30,14,30,32,20,9,35,20,29,6,0,84,14,12,11,35,99,15,44,30,17,18,35,25,30,6,13,35,26,34,32,11,21,39,18,66,18,40,20,34,31,16,26,53,12,1,6,12,19,49,44,14,30,19,17,41,27,8,49,14,19,127,17,22,25,22,14,21,33,21,3,24,26,24,20,11,37,60,35,28,11,142,27,21,31,13,1,26,47,31,4,13,7,11,36,7,41,1,19,19,11,43,0,16,31,11,14,2,52,5,13,8,28,20,15,39,10,49,34,16,6,23,18,29,17,9,15,16,9,38,8,84,46,15,12,20,25,52,34,17,0,16,31,34,19,19,18,6,45,84,13,22,25,6,12,4,28,28,29,2,34,9,8,18,33,29,5,13,3,17,0,10,25,3,3,49,40,8,7,27,20,11,22,12,5,21,25,0,34,30,4,10,15,1,12,28,22,11,29,5,17,3,17,28,26,40,18,8,0,23,18,16,6,35,37,11,20,31,11,9,13,7,64,26,36,9,11,49,5,0,0,22,7,8,3,4,81,22,6,44,3,13,24,5,6,4,38,24,8,24,30,20,9,11,4,8,7,17,8,0,23,12,20,10,11,9,11,17,10,3,25,26,13,11,0,9,8,17,6,7,11,15,4,16,34,17,12,31,4,36,8,21,12,29,10,22,9,12,28,15,11,106,14,13,7,5,24,6,37,16,8,21,2,11,12,16,10,5,4,10,22,0,3,2,10,9,3,15,15,16,12,10,23,48,4,13,2,7,28,29,12,29,30,12,7,1,26,11,16,20,15,24,36,20,16,6,6,3,0,4,23,6,12,28,8,37,11,14,2,1,6,11,18,20,7,12,4,57,3,7,8,9,7,67,9,3,25,4,2,9,23,1,12,12,17,7,3,6,0,24,10,9,7,14,6,57,9,11,4,30,2,65,15,4,7,1,0,11,13,54,0,22,0,11,10,13,18,17,13,4,16,4,18,8,9,5,24,0,11,13,8,0,9,13,13,45,12,17,17,15,19,51,6,3,4,4,5,15,3,18,19,24,0,35,5,21,8,3,12,2,20,0,5,3,3,0,5,69,26,24,53,13,39,14,13,28,4,4,3,4,50,0,17,11,16,4,15,3,241,2,7,16,18,10,15,16,17,12,4,6,9,8,1,10,11,0,24,3,17,6,15,3,27,10,5,3,1,24,16,2,17,5,8,55,23,0,4,1,22,5,8,10,12,2,7,5,16,6,5,51,20,0,20,3,1,20,3,16,29,3,15,18,9,3,21,0,5,21,20,7,7,11,11,8,37,9,10,4,5,7,2,17,9,6,0,11,5,4,8,9,12,35,5,6,25,1,6,8,18,10,21,4,10,15,4,22,15,10,0,0,13,0,8,6,8,3,14,7,11,13,4,13,15,0,9,1,13,0,6,6,0,0,315,8,24,10,2,5,5,4,2,3,9,13,0,7,3,0,6,5,27,6,11,10,4,9,49,15,7,3,30,7,4,7,23,13,8,18,2,25,3,2,4,14,23,4,12,2,11,0,8,6,4,7,8,5,0,6,4,2,10,37,0,0,0,1,11,25,9,17,4,0,11,8,9,1,18,10,10,4,52,3,9,4,14,4,16,15,7,14,50,1,4,10,8,6,3,15,21,16,5,57,8,5,23,33,3,6,0,2,10,5,5,9,13,2,0,9,7,8,13,27,1,29,3,7,9,1,9,21,16,1,11,0,3,4,15,6,6,9,7,2,7,7,0,1,5,15,5,6,5,13,14,28,3,15,16,3,1,4,4,3,6,0,0,4,14,3,1,7,5,18,9,0,24,2,0,23,9,1,0,5,5,0,12,9,0,3,10,2,9,5,2,11,0,0,9,15,1,1,8,13,4,9,0,1,6,1,23,0,0,5,3,5,7,6,1,14,4,18,8,9,13,13,5,12,0,19,4,0,4,11,13,16,5,25,12,1,8,2,0,54,6,4,3,3,6,4,39,7,13,14,0,8,6,0,0,5,0,1,9,6,6,2,1,4,0,6,0,1,6,6,0,15,8,1,4,1,5,5,13,6,28,9,0,5,3,5,9,11,4,3,1,2,11,6,7,9,3,5,4,10,2,37,4,4,13,19,2,13,0,0,15,5,5,4,8,0,8,1,13,3,9,18,3,10,7,4,6,5,12,0,1,16,11,0,10,0,3,3,18,4,27,6,7,5,1,7,1,12,6,19,4,2,5,4,24,0,3,4,2,19,3,13,0,9,4,0,33,0,0,9,0,1,0,0,20,6,3,9,11,1,10,13,4,4,7,1,8,5,3,0,5,3,3,0,0,9,0,12,0,0,2,1,10,1,19,1,0,4,2,2,6,4,0,11,1,9,6,14,15,9,7,7,9,14,0,0,7,4,2,2,2,15,7,2,1,6,0,2,2,9,4,14,9,3,0,14,7,0,4,6,6,4,3,3,11,0,2,1,7,9,5,6,9,2,8,3,0,0,6,5,2,3,6,13,3,12,1,7,8,4,1,6,4,11,10,14,4,22,0,0,5,13,21,0,1,0,0,6,0,3,6,8,8,5,7,6,5,0,2,0,1,5,4,9,0,1,9,3,3,9,13,5,9,5,14,4,14,0,3,3,15,15,13,4,6,11,7,17,7,0,2,5,3,1,0,12,2,1,3,1,4,1,6,11,7,17,2,6,0,0,6,0,12,6,10,0,24,5,32,2,10,2,13,1,5,1,16,13,3,7,0,0,0,7,1,1,29,3,2,0,3,4,0,0,0,13,3,1,3,9,3,25,10,8,1,4,1,5,0,4,1,3,3,6,4,0,0,6,9,1,3,4,12,3,8,9,3,0,4,3,16,5,0,4,9,15,0,0,0,2,7,8,2,3,2,1,12,4,3,3,4,13,4,1,35,4,5,30,3,0,8,8,5,0,2,6,1,6,0,3,1,6,2,3,1,8,14,1,6,3,14,5,7,0,0,5,0,5,2,0,0,3,1,3,4,0,8,5,2,4,20,2,2,2,0,4,1,6,0,6,0,5,4,12,11,3,4,0,5,6,0,0,7,0,13,0,5,7,0,4,2,3,10,3,4,7,0,72,4,8,4,0,12,5,5,5,0,4,0,9,8,4,6,1,13,5,4,3,7,2,3,0,5,48,5,11,3,2,1,2,1,2,3,6,6,12,1,17,3,4,2,6,2,13,0,23,6,2,8,6,12,7,1,1,22,7,4,2,16,7,2,0,1,11,5,4,4,7,3,0,4,2,12,6,0,0,4,10,0,11,1,0,0,2,3,3,1,3,7,15,0,4,0,10,0,6,0,3,9,12,3,4,5,3,2,5,1,16,1,19,6,23,2,0,4,2,5,0,9,10,1,12,5,2,0,6,1,9,4,3,12,9,0,19,7,2,0,1,6,23,4,3,4,4,1,1,21,2,11,1,24,11,0,1,11,0,0,8,1,24,0,5,0,1,6,0,1,18,3,1,1,4,5,0,0,1,2,6,3,0,5,2,0,1,0,9,5,0,8,6,0,6,2,0,0,3,0,6,2,5,7,0,2,11,15,4,0,5,0,2,4,1,13,2,10,2,2,1,10,1,2,10,12,1,23,0,2,3,3,4,2,9,4,10,5,6,0,3,0,0,12,3,0,0,4,0,10,17,5,0,11,1,2,0,5,6,0,5,4,1,3,0,2,5,2,9,1,7,5,1,12,3,9,1,6,2,3,0,4,4,11,0,3,2,9,4,1,4,0,0,10,5,8,2,3,0,0,2,4,1,4,9,2,6,2,0,35,3,0,2,5,3,2,3,18,8,3,3,4,5,11,0,0,0,9,3,0,1,3,0,10,1,6,10,0,6,3,10,0,0,22,1,6,8,2,0,14,2,2,7,3,3,13,2,6,1,3,10,0,0,26,2,0,3,6,11,4,1,0,9,0,0,2,0,5,5,0,329,7,5,7,4,8,5,1,2,0,17,4,6,9,3,5,1,6,0,7,3,2,1,0,17,1,5,0,0,17,0,6,1,1,8,0,2,2,14,7,2,8,6,8,6,4,3,1,0,12,0,0,0,2,5,11,0,0,1,2,11,0,18,3,2,2,12,7,0,5,4,5,3,2,1,0,8,6,11,9,9,0,0,3,0,1,2,2,4,1,1,4,8,4,2,3,2,13,4,11,1,4,28,3,2,4,20,10,6,4,1,3,0,16,0,3,2,4,3,6,7,4,1,1,2,6,7,37,7,8,3,0,2,1,2,4,1,21,16,9,1,8,10,1,1,1,1,7,30,1,1,5,5,3,4,3,12,1,3,6,7,1,6,5,1,3,7,4,7,0,1,4,1,2,4,2,0,4,7,4,4,9,2,1,4,8,1,0,5,5,5,1,2,3,4,19,0,0,1,10,1,2,3,3,3,1,1,4,4,0,18,7,1,3,3,1,6,0,2,8,0,4,18,2,0,5,8,2,0,0,10,1,1,2,1,0,2,1,1,1,3,5,1,3,2,4,0,0,2,23,0,6,1,5,6,0,9,0,12,1,0,1,0,0,7,4,6,0,3,2,0,2,1,7,6,10,4,7,0,0,0,2,1,1,0,3,2,4,3,2,1,3,3,0,5,1,7,3,12,3,0,7,4,7,1,9,3,0,0,0,0,1,0,2,11,0,3,0,0,0,0,3,1,4,0,2,4,3,4,0,4,1,0,1,0,7,3,0,2,12,3,0,0,8,0,0,9,1,15,5,5,0,5,3,1,15,7,1,3,0,3,6,0,0,6,4,0,16,2,6,1,3,8,1,15,0,3,0,1,1,17,0,0,32,0,2,1,0,2,0,3,4,3,1,1,1,3,0,2,1,10,2,1,0,3,3,2,6,3,2,1,3,2,0,5,11,0,0,3,0,1,5,6,0,1,0,0,0,16,6,7,10,5,1,5,0,9,7,2,9,1,7,8,3,0,0,0,0,2,0,0,0,2,1,5,6,0,4,2,3,2,2,0,0,2,1,8,4,0,8,1,1,1,2,4,1,2,2,10,2,4,0,5,5,17,4,2,1,2,10,0,3,0,4,0,4,12,6,8,1,3,1,3,0,1,1,14,0,1,3,0,0,8,10,0,7,0,2,2,1,0,0,1,0,0,0,1,1,0,5,3,4,1,2,4,4,3,1,1,1,7,2,5,0,6,2,3,6,0,4,0,4,0,5,0,10,3,2,5,0,1,19,2,0,12,0,0,2,1,1,0,2,1,13,4,1,5,1,5,3,1,0,11,1,5,2,10,3,18,2,2,1,2,5,2,10,2,1,3,5,17,0,0,0,1,3,0,0,3,11,0,4,0,3,1,13,1,10,22,0,0,2,3,1,2,0,0,17,1,0,0,2,0,5,2,1,4,5,3,84,38,10,2,8,0,0,9,0,7,3,0,2,3,3,0,2,1,2,8,1,0,3,5,1,3,3,1,0,1,11,0,5,7,6,1,2,5,6,0,0,0,0,3,1,8,1,1,8,1,6,7,5,1,3,0,1,3,21,23,3,4,8,1,3,1,5,2,7,3,6,4,2,7,0,0,7,15,0,1,2,3,2,9,2,1,0,0,5,2,1,2,2,1,5,0,1,2,18,4,0,1,0,3,2,3,11,4,0,4,0,13,0,0,1,0,1,1,0,2,0,2,4,0,2,0,1,2,1,2,5,3,5,2,0,0,1,9,6,0,2,0,0,0,2,0,4,0,1,7,1,1,1,2,1,1,0,2,1,14,0,4,0,3,9,6,2,1,2,3,3,3,0,7,3,3,0,0,3,0,8,0,2,1,1,0,8,1,7,1,0,5,2,0,0,0,2,2,4,2,4,7,0,0,2,0,0,6,3,1,1,4,4,3,0,3,0,0,0,2,4,2,2,2,0,1,0,0,8,1,6,6,6,7,0,6,0,0,0,5,4,5,0,0,1,1,7,7,3,8,0,1,0,4,13,5,3,3,2,2,3,12,0,4,4,4,0,0,0,3,0,2,6,6,12,6,0,0,1,0,2,1,4,7,2,3,2,4,2,0,0,1,3,9,0,18,1,5,0,4,1,0,1,5,0,1,4,0,4,0,0,5,4,5,4,2,0,6,0,6,1,4,0,3,1,0,1,0,2,0,2,0,1,2,4,0,4,0,1,6,2,2,1,0,3,2,2,5,0,2,0,2,3,10,4,4,1,1,2,10,5,0,1,8,1,0,0,1,0,4,3,1,1,8,0,1,4,1,1,5,0,5,0,0,19,2,1,3,0,1,4,16,0,1,0,1,0,1,7,1,1,7,6,1,3,13,3,4,0,0,4,2,3,4,3,1,2,0,10,3,0,4,6,0,4,1,1,0,0,1,0,1,0,0,1,9,2,0,2,4,4,6,0,3,7,1,4,1,0,0,0,0,1,1,5,8,23,4,1,4,1,4,0,2,4,11,5,0,0,3,5,5,2,0,3,0,2,0,6,1,5,4,0,6,1,1,0,6,0,0,0,0,9,6,9,7,5,2,4,5,1,1,0,3,1,1,5,1,2,0,5,3,0,6,2,2,2,3,1,2,1,2,8,0,1,7,1,0,1,3,5,0,1,2,1,4,0,1,3,2,10,11,11,2,0,0,0,1,0,7,2,3,5,1,6,0,8,0,1,3,1,0,0,5,2,4,2,6,1,0,0,0,1,5,1,0,0,0,5,2,1,0,1,0,15,6,2,1,0,1,1,10,2,5,2,0,3,0,1,1,3,2,1,4,4,0,53,3,1,2,0,0,2,4,0,8,1,5,8,0,7,2,0,1,1,0,0,3,2,0,1,9,2,3,2,0,1,5,0,2,5,4,2,7,0,0,4,0,2,2,4,2,3,1,0,0,2,0,3,0,1,1,2,5,1,0,0,1,3,1,1,2,2,1,0,21,0,1,4,5,1,0,14,2,4,1,0,0,6,0,3,7,1,0,1,0,0,0,2,0,5,2,2,4,6,2,0,5,1,0,1,1,4,34,0,6,1,1,2,1,0,6,6,3,1,0,1,9,2,1,3,5,0,4,0,4,3,0,0,2,0,3,8,0,1,0,4,6,3,2,1,0,3,2,1,5,9,4,1,0,0,3,3,1,1,1,4,4,2,2,9,1,1,0,4,24,0,3,0,0,1,3,0,0,0,3,6,0,21,3,0,0,0,1,0,0,3,5,9,0,4,0,5,0,0,0,3,4,13,4,4,0,0,3,0,2,0,2,3,2,0,3,0,1,5,0,5,16,1,6,7,40,0,1,8,4,3,0,0,0,0,3,0,5,1,4,1,0,0,2,13,1,1,4,2,3,0,1,1,0,0,22,7,1,0,5,0,2,12,0,0,1,1,2,1,8,1,1,1,2,0,0,2,1,0,4,2,6,4,1,1,0,1,1,0,3,4,3,2,0,1,13,4,0,4,0,4,0,6,2,4,1,1,4,1,4,0,3,1,8,5,0,1,2,0,3,3,0,0,0,0,4,2,6,1,5,3,2,1,1,2,7,10,4,0,0,0,0,2,1,1,2,3,1,0,6,0,2,1,1,0,0,1,0,0,2,3,3,3,5,7,2,2,3,1,0,0,0,7,0,1,8,1,1,2,1,6,3,2,1,2,0,0,3,6,0,4,2,1,0,0,1,0,0,0,0,4,1,0,0,3,1,0,0,5,11,0,0,2,2,5,0,0,6,0,0,2,3,0,19,5,0,0,3,0,6,0,2,0,0,0,1,6,0,0,1,2,1,0,0,0,0,3,6,2,2,0,4,14,4,0,4,2,0,0,1,4,0,0,1,3,2,1,1,1,0,8,2,3,4,7,3,2,0,5,2,2,0,0,5,0,4,1,0,2,0,2,1,0,0,0,8,4,0,1,2,3,0,0,3,1,1,0,3,0,0,0,1,18,2,1,2,1,4,3,2,1,8,0,5,7,0,2,0,0,2,0,0,1,0,0,1,1,10,0,0,1,0,47,4,0,3,0,1,0,6,4,6,3,3,5,1,1,2,0,0,1,0,2,0,0,3,1,1,2,0,1,0,1,2,0,3,9,0,2,4,0,0,2,0,4,0,0,2,1,8,12,5,0,2,2,3,0,0,1,8,2,1,0,0,3,2,3,3,5,0,2,0,5,4,2,0,0,3,4,0,0,0,6,0,0,6,1,6,7,14,1,0,1,3,1,1,0,2,1,5,0,0,1,0,4,0,0,4,4,0,2,1,1,5,0,3,5,0,2,2,0,0,0,2,6,1,1,1,0,0,3,0,2,3,2,2,2,0,4,0,0,4,0,0,6,3,2,1,0,0,1,0,0,2,1,0,2,1,2,0,2,1,0,0,0,2,1,1,2,6,3,1,1,6,1,0,0,1,1,0,26,3,2,1,4,1,1,2,6,1,1,0,4,2,2,1,0,1,1,2,21,0,0,3,3,0,0,0,1,0,2,2,1,0,2,0,4,0,0,0,9,1,0,0,0,3,9,0,1,5,0,21,0,2,2,2,2,4,8,1,0,1,0,1,0,0,0,3,3,6,0,1,9,6,1,0,1,2,0,0,0,0,0,0,3,0,1,0,3,0,0,0,2,0,1,1,3,1,2,0,2,3,10,2,2,0,2,1,7,9,0,1,3,5,4,0,0,0,0,3,1,1,7,0,0,2,1,3,0,0,0,4,1,0,0,0,1,0,3,0,0,1,1,1,1,0,1,1,0,13,0,3,0,0,0,2,2,3,2,3,0,0,1,9,5,4,0,1,1,6,2,2,1,1,0,0,0,1,0,4,2,6,2,0,0,0,6,0,3,0,0,0,0,3,2,0,8,0,0,2,2,0,0,0,3,0,0,0,0,4,0,2,0,2,1,11,0,3,1,0,1,4,2,0,0,1,0,6,0,1,2,2,4,0,1,0,4,4,4,1,3,4,1,0,1,0,1,8,6,3,0,3,0,6,3,5,0,1,3,0,6,0,1,0,6,0,0,0,1,3,6,2,7,7,1,0,0,0,0,1,0,0,2,1,0,2,6,4,1,0,1,1,0,0,0,0,0,7,1,0,2,0,0,3,1,8,2,2,1,0,1,1,2,2,1,0,4,0,0,1,5,5,0,0,1,1,6,0,0,0,8,0,1,2,6,2,1,2,2,0,4,0,0,1,2,1,8,0,0,3,1,2,2,6,0,2,0,2,2,1,3,2,0,0,1,4,0,2,1,3,4,0,1,4,0,2,0,0,12,2,1,0,0,0,0,2,5,1,1,0,0,8,1,2,0,2,2,0,1,0,5,0,3,3,3,7,3,0,0,1,0,6,24,2,1,1,0,0,1,0,0,1,0,1,0,2,0,1,2,0,2,0,4,1,1,0,2,0,0,0,1,7,0,2,5,4,0,0,6,6,1,3,3,0,5,1,0,1,0,0,7,2,0,1,1,3,2,4,0,3,1,0,3,2,0,0,3,15,6,8,4,0,1,1,2,0,1,8,1,5,0,2,5,3,0,1,21,3,0,0,1,0,0,1,7,1,0,1,1,1,2,0,0,7,0,1,0,1,1,4,7,1,6,2,0,0,0,0,3,8,1,1,1,7,0,0,4,7,0,2,0,1,2,0,4,0,9,1,1,0,1,1,2,6,0,1,1,6,0,1,0,6,8,0,0,2,0,0,0,0,9,0,1,6,10,0,0,3,1,1,0,7,2,1,1,2,3,0,6,6,0,3,10,1,0,0,18,2,4,0,0,0,1,5,1,0,2,0,2,1,5,2,1,0,10,1,0,1,2,0,0,1,0,2,1,2,0,0,0,1,0,3,4,0,4,0,2,4,1,0,0,1,0,2,0,1,5,2,0,0,1,0,2,6,1,0,1,0,6,4,0,0,2,1,0,0,6,0,1,5,3,2,1,0,3,18,0,0,0,0,0,2,0,2,0,1,0,0,0,4,0,2,3,1,0,5,1,4,2,0,0,5,8,2,2,8,2,1,1,0,4,4,2,1,4,3,3,0,0,2,0,1,2,0,7,0,1,5,1,1,0,2,0,1,6,1,0,1,2,2,0,1,1,2,3,0,4,4,0,1,0,0,0,3,1,1,0,0,0,1,0,2,2,0,0,4,0,1,1,0,0,0,3,3,7,6,5,1,0,1,2,0,0,1,0,0,0,0,4,2,0,0,1,0,1,5,4,6,0,3,1,0,0,2,0,1,0,0,0,2,0,1,3,2,0,4,0,0,1,1,1,0,1,0,1,31,0,0,13,3,0,5,0,1,0,2,0,0,4,0,1,4,0,0,0,0,0,1,0,0,0,0,0,1,1,1,5,0,0,0,0,0,2,0,1,0,0,0,0,0,0,0,1,2,0,0,1,0,0,0,0,0,1,0,0,0,0,0,0,0,0,0,0,0,0,0,0,0,0,0,0,0,0,0,0,0,0,0,0,0
"1997 Frazier, Charles, Cold Mountain",high,10891,7188,4110,4579,4341,561,2738,2841,2027,2264,613,1898,1665,1744,1439,1427,1879,1260,1059,1052,1142,889,1243,672,131,864,162,1266,787,195,998,837,394,588,258,305,559,611,155,570,386,420,478,354,386,521,385,525,608,598,454,616,632,509,347,479,362,118,208,282,444,80,90,161,141,310,542,317,79,255,135,72,169,194,116,266,230,31,370,87,401,74,449,120,254,344,273,78,209,114,127,152,190,297,63,155,223,275,64,235,119,305,66,277,182,180,167,156,56,97,160,208,56,258,137,102,188,126,210,93,39,88,312,152,73,98,254,101,101,61,117,221,46,268,209,166,41,166,153,126,137,31,32,36,25,251,134,270,115,22,197,20,119,90,98,35,20,162,108,133,84,90,2,162,101,426,99,62,96,117,49,84,74,50,0,38,107,177,71,21,31,44,27,190,74,85,38,68,118,155,49,73,96,32,110,126,40,80,135,256,25,204,70,41,59,4,64,201,17,159,20,176,152,81,165,96,205,110,40,223,82,60,63,133,28,178,19,62,58,10,60,45,242,43,70,8,111,89,197,114,34,57,71,32,61,116,41,82,20,76,63,193,76,199,99,47,14,54,115,120,89,10,23,62,12,24,38,19,47,93,44,51,28,83,42,84,112,33,149,111,32,59,38,21,18,15,36,61,42,83,102,12,0,29,60,23,73,26,6,11,24,105,0,174,76,45,44,67,60,5,108,9,19,67,181,155,10,56,67,12,155,2,51,111,54,48,42,14,56,50,44,23,18,87,172,14,79,26,17,14,51,39,27,5,26,24,16,0,69,16,42,86,68,65,65,17,19,0,38,40,27,5,9,41,74,6,93,40,7,25,52,64,22,27,26,77,51,18,39,3,56,44,23,20,26,0,0,45,7,68,36,37,44,1,29,52,43,25,40,12,4,49,30,48,81,53,49,9,26,26,70,38,115,53,67,15,28,38,26,27,33,0,10,18,28,42,15,32,21,2,38,24,45,32,4,235,103,45,0,10,20,20,21,64,21,44,24,9,23,31,98,92,10,22,0,21,18,45,69,32,82,6,1,5,18,26,29,39,11,31,35,26,42,6,57,25,232,12,0,65,15,11,50,15,21,29,52,80,10,38,50,65,47,46,22,20,27,46,77,24,43,23,9,45,58,49,21,22,16,19,22,57,21,116,8,19,0,22,7,24,49,36,16,3,29,29,13,3,35,13,4,59,43,27,36,0,16,13,8,50,107,29,2,27,27,63,0,106,6,16,37,15,16,1,84,9,3,14,25,0,2,53,18,16,29,14,43,118,28,37,6,2,33,44,14,9,51,6,35,21,24,19,18,40,3,65,15,10,52,43,31,7,18,28,26,14,74,45,32,15,13,39,24,14,59,0,0,3,28,7,22,1,19,23,22,20,29,36,47,0,60,8,7,12,25,2,15,18,52,2,4,16,13,25,32,0,47,7,29,47,16,12,85,33,0,11,32,21,5,19,0,61,17,22,101,32,57,7,38,2,3,15,44,7,22,18,18,14,8,13,19,13,29,21,25,35,3,41,19,10,7,2,8,29,5,1,6,28,24,4,7,28,13,33,5,11,13,3,22,19,14,13,21,22,6,28,9,26,7,47,26,39,123,30,38,0,19,53,56,19,10,0,17,3,27,25,23,3,33,15,8,13,58,32,0,1,31,6,25,45,71,28,3,9,0,0,5,20,18,42,19,103,40,20,3,24,14,15,12,1,20,51,11,5,9,0,13,36,56,26,26,5,0,0,0,34,21,40,7,11,27,11,33,37,0,13,30,19,2,10,25,37,0,27,52,18,0,12,2,24,7,51,42,7,11,9,0,6,13,1,31,12,47,2,25,4,5,0,36,34,6,11,2,8,15,15,33,17,8,7,15,0,83,17,2,28,7,6,0,9,68,17,77,27,9,19,2,2,19,2,21,35,1,12,19,43,8,0,12,18,44,24,1,6,36,41,8,0,28,34,14,5,6,10,0,3,0,32,18,17,32,3,20,38,4,23,43,9,43,10,11,29,25,8,45,31,55,0,27,27,3,0,5,6,2,10,4,27,63,2,40,0,33,0,19,21,13,12,17,10,13,0,16,19,19,19,6,0,11,23,0,1,48,2,0,2,24,52,22,4,12,0,0,21,40,15,10,5,22,0,9,8,15,13,5,11,87,5,1,0,0,22,6,0,14,10,20,8,24,23,3,4,3,20,5,74,22,3,3,0,2,5,21,11,0,1,7,0,3,15,26,12,7,24,8,17,0,39,5,0,36,0,4,0,35,3,0,9,0,4,16,9,1,99,0,14,41,6,8,5,0,14,0,0,0,4,66,45,0,5,12,3,27,4,8,36,17,1,9,11,2,1,2,18,10,9,10,79,9,3,14,15,14,8,24,0,6,12,2,2,10,26,0,21,34,39,21,0,0,0,0,1,19,5,4,16,5,0,15,2,0,11,3,3,35,18,0,5,14,4,8,0,14,11,32,11,1,5,0,18,3,61,20,2,18,15,24,13,8,8,20,20,43,2,0,2,7,3,23,17,16,13,6,47,30,6,12,13,0,1,13,0,12,7,45,44,6,12,4,70,6,0,13,22,4,27,65,4,31,20,1,2,26,20,3,20,5,3,9,8,6,16,28,8,0,1,0,4,0,0,0,22,43,22,20,3,22,12,6,2,7,14,31,21,26,12,0,6,29,0,5,15,4,11,7,14,6,22,0,1,2,0,1,27,55,13,17,20,20,5,2,22,11,18,2,0,0,20,6,20,15,4,19,16,33,21,3,32,9,27,36,17,47,6,35,0,3,49,4,11,20,8,35,0,3,7,0,3,16,4,7,32,13,15,1,23,3,0,0,14,15,0,1,3,0,3,12,0,4,10,7,0,0,3,0,11,11,31,0,0,0,19,32,25,10,18,5,0,31,9,0,18,16,1,4,5,2,16,0,0,14,17,14,6,8,16,0,14,15,3,18,13,16,26,8,3,10,7,9,2,1,24,3,3,8,22,5,31,5,3,4,85,15,6,1,49,4,73,0,18,22,8,0,0,6,0,0,28,17,0,29,19,1,15,41,4,2,11,17,1,0,16,24,0,8,9,1,1,9,4,1,20,6,15,15,0,0,3,0,0,3,971,4,5,11,12,9,7,8,21,22,9,6,2,5,2,4,0,4,3,1,0,0,43,0,11,2,0,4,1,1,13,45,17,6,14,6,6,7,9,56,3,15,13,36,3,2,2,20,2,13,11,0,0,20,28,3,11,29,19,18,2,0,6,0,11,4,12,9,14,20,8,0,25,5,0,19,0,8,3,0,6,9,0,6,16,26,0,8,11,3,0,4,25,0,15,3,0,5,10,1,0,4,19,0,5,2,1,4,1,1,7,8,5,41,15,0,0,31,11,28,0,0,0,0,45,0,6,8,0,7,0,4,2,10,13,0,0,0,4,40,16,1,3,27,18,4,7,5,22,15,10,0,0,19,0,18,12,8,5,26,15,1,5,16,24,6,0,14,3,21,5,10,7,4,3,2,12,23,23,1,7,6,9,5,2,0,5,2,11,1,42,18,0,9,5,3,4,16,6,2,12,5,60,5,0,4,9,0,43,0,8,1,1,16,6,3,0,33,4,0,2,0,11,13,5,3,15,26,13,4,15,0,1,31,30,0,10,0,5,0,0,6,0,2,28,1,10,4,1,1,1,3,0,10,30,10,7,2,3,5,1,3,4,0,0,1,5,7,25,0,11,12,4,26,10,1,1,17,15,10,4,4,3,5,9,13,0,5,19,2,4,3,9,0,5,10,4,32,5,0,17,8,5,34,0,2,14,9,34,2,0,21,7,0,24,6,0,12,2,21,26,21,2,108,2,25,7,12,0,0,12,0,0,13,6,0,2,0,22,7,15,13,24,6,0,8,12,11,25,10,6,11,0,5,5,0,6,3,1,5,29,24,3,0,0,38,10,29,0,3,22,1,3,0,15,0,37,7,9,10,5,24,23,19,28,0,41,0,0,14,0,0,4,5,0,7,10,0,5,11,1,2,2,3,7,4,2,9,4,14,10,0,15,10,1,6,2,5,9,21,0,13,5,3,2,7,3,3,3,16,0,5,2,4,1,16,0,10,6,3,29,0,0,17,7,0,6,679,0,0,2,29,6,3,17,0,1,0,11,0,19,0,4,0,1,6,4,11,9,21,14,10,11,5,0,13,9,2,12,12,1,7,1,6,3,1,10,0,7,56,20,8,10,19,21,13,0,7,4,0,3,1,2,5,20,3,5,2,1,9,4,0,5,8,0,2,7,0,8,0,0,0,2,0,8,3,0,0,2,0,3,21,0,2,11,31,8,13,6,4,0,0,2,4,5,5,0,6,4,0,1,0,5,5,0,7,24,0,19,0,8,0,19,0,7,0,4,10,10,4,3,0,4,1,5,0,8,5,6,2,1,16,10,4,2,2,0,7,21,13,11,0,0,2,1,11,33,0,11,0,7,12,7,5,2,21,5,17,4,7,0,7,0,3,1,6,0,38,4,16,0,6,9,0,6,4,9,4,0,2,5,1,4,1,6,4,11,9,7,7,31,6,3,5,0,5,10,12,0,0,2,10,4,25,1,43,5,7,3,3,10,4,0,5,21,12,2,12,25,1,6,0,3,6,0,7,10,8,37,5,1,7,13,4,24,11,5,13,44,0,2,3,9,0,2,0,7,2,4,2,0,0,19,6,14,1,0,0,7,5,3,0,8,16,13,1,2,7,7,1,6,11,0,2,6,0,0,0,3,0,3,0,6,4,9,0,8,0,11,2,0,4,17,0,0,0,5,3,1,9,2,18,1,0,4,7,6,6,1,5,10,5,102,8,8,0,23,0,1,2,5,7,0,17,0,33,0,35,1,0,11,0,0,1,0,2,2,0,1,15,0,4,0,21,0,0,25,3,4,2,0,2,0,12,3,23,11,9,1,0,6,1,0,5,0,0,29,2,8,0,3,1,12,6,2,0,0,11,12,1,8,1,15,8,0,0,30,3,7,5,8,12,0,16,7,17,3,4,1,3,20,3,26,5,5,4,1,12,0,3,6,15,2,5,14,8,5,12,11,1,3,1,29,5,16,3,5,3,3,11,1,2,3,6,0,8,4,2,0,0,0,2,2,0,1,9,1,9,2,14,2,9,5,4,16,15,5,0,3,14,0,2,10,1,10,7,1,5,9,2,0,7,3,5,6,13,0,0,4,3,22,3,19,2,3,1,4,32,9,0,3,0,1,2,38,0,14,4,4,2,8,3,6,0,0,0,8,0,3,2,1,2,5,0,0,3,16,5,0,2,8,0,8,5,6,0,8,5,2,2,0,1,21,0,5,1,0,11,6,15,1,2,0,1,0,3,5,8,13,0,9,0,18,3,0,4,0,0,6,7,1,1,18,1,3,7,4,7,8,11,5,2,0,0,20,4,11,8,3,10,0,0,13,0,2,20,0,0,0,3,0,3,3,0,0,0,2,14,0,9,7,19,7,2,5,17,0,1,2,0,9,0,0,2,0,6,2,3,0,5,8,1,5,0,16,2,1,2,0,4,1,10,6,0,8,0,0,2,0,0,2,26,2,3,28,0,3,7,2,3,18,2,16,0,6,5,0,16,4,2,394,10,4,9,3,4,7,0,8,30,3,4,36,5,6,0,0,0,0,27,5,0,4,0,8,2,12,4,3,4,6,1,3,0,6,0,2,35,0,4,1,5,5,1,11,0,13,1,0,2,0,6,0,1,0,1,5,2,7,0,0,0,1,3,0,2,12,0,3,1,11,6,5,5,13,14,11,1,0,0,0,0,6,0,0,26,6,0,30,6,28,6,2,0,6,3,3,0,14,31,10,0,6,9,6,4,0,1,1,4,3,20,19,0,13,7,5,0,0,2,9,7,1,1,2,2,1,1,0,3,6,5,2,0,10,1,10,1,12,0,0,0,0,0,3,0,3,7,0,2,0,0,2,0,0,4,22,0,0,0,2,29,0,3,0,1,7,0,4,6,20,18,3,13,4,12,0,2,1,0,2,3,0,5,0,2,2,27,1,5,0,8,18,0,1,0,3,21,4,0,0,4,1,7,0,1,1,4,4,14,0,1,0,7,16,0,6,0,18,3,0,10,4,10,2,9,4,5,7,2,2,0,5,0,2,27,0,3,2,0,0,9,3,2,0,0,4,0,0,21,0,0,3,3,0,7,3,3,18,0,0,0,7,2,0,16,0,0,8,0,0,4,11,0,7,0,14,1,3,3,2,0,3,3,0,0,5,4,2,3,0,9,5,1,11,0,6,8,0,7,3,0,6,0,3,6,8,2,19,3,6,0,4,0,0,9,21,0,4,0,7,11,3,9,4,4,0,11,5,1,3,5,11,14,3,9,2,0,7,3,10,5,0,0,2,4,1,1,0,20,11,5,2,0,5,1,1,0,1,0,0,1,2,5,11,7,0,8,0,1,6,3,2,0,18,0,2,10,30,7,3,2,5,10,3,2,0,3,0,0,2,30,1,3,1,7,3,0,0,5,0,1,1,6,7,20,1,11,5,5,3,1,0,0,0,0,0,1,0,4,0,0,2,0,0,3,1,0,34,0,0,10,5,0,10,0,0,1,3,33,2,0,11,2,1,7,0,4,1,0,0,7,1,2,0,11,0,0,2,0,0,1,35,0,2,0,5,0,0,1,0,16,0,4,0,0,7,0,0,0,4,11,0,1,6,1,0,0,1,0,0,6,0,7,3,1,13,0,2,0,0,0,6,4,3,19,0,0,1,11,0,0,2,3,0,3,0,0,2,4,0,4,0,0,1,0,11,5,3,0,0,5,15,7,2,19,5,0,3,0,1,8,0,6,4,6,2,2,12,0,0,1,0,2,16,3,2,11,0,24,2,8,3,1,4,0,2,1,10,1,6,0,11,11,0,14,5,2,7,0,0,1,11,0,2,0,6,0,6,0,0,0,1,13,0,0,2,0,0,0,0,7,2,0,0,0,0,1,1,15,9,0,8,2,1,0,0,2,1,0,7,0,0,0,1,5,5,1,2,2,16,9,0,0,0,7,2,1,1,0,12,0,0,0,0,3,0,0,0,12,11,1,1,0,7,14,2,29,1,2,1,11,0,3,0,0,4,4,0,0,3,7,0,14,3,18,4,11,5,1,5,0,1,3,5,6,4,7,6,0,0,2,0,0,23,9,0,1,5,2,4,0,4,3,3,0,3,3,0,0,0,7,11,8,3,32,3,0,2,3,7,5,0,9,2,2,0,3,0,5,4,5,11,5,6,1,1,5,12,0,0,1,1,4,51,1,3,0,0,9,1,5,1,61,3,9,0,5,9,0,13,0,0,0,19,2,9,1,5,13,18,2,7,5,0,12,0,3,5,0,6,8,3,0,1,0,0,2,2,4,13,3,1,0,5,2,33,5,1,0,0,0,1,11,4,1,2,1,3,2,2,0,3,7,0,7,0,0,0,0,6,0,9,10,1,2,1,2,0,4,1,5,4,4,0,3,0,2,11,1,19,5,0,0,22,6,9,3,0,2,1,5,5,0,31,0,0,9,4,1,10,5,9,0,5,1,6,9,1,2,0,2,1,2,0,11,6,1,0,0,8,5,2,4,1,8,13,0,5,0,5,0,0,2,1,11,2,8,8,10,6,5,0,0,0,4,1,1,5,1,5,2,2,0,1,1,3,0,5,10,0,2,0,0,2,2,1,22,6,0,0,0,0,1,0,0,1,2,0,0,14,0,4,1,1,4,2,1,0,0,2,7,0,1,0,4,1,5,0,0,0,2,20,5,3,3,0,4,0,0,0,9,0,3,0,4,8,2,7,0,3,2,12,2,0,0,5,0,0,1,8,1,15,20,4,3,0,2,1,11,2,4,1,2,0,0,4,0,0,0,0,0,0,0,0,4,0,1,0,0,1,0,4,7,6,0,0,5,0,10,1,7,4,0,4,8,2,4,7,1,7,0,3,1,3,0,4,1,5,4,1,0,3,3,1,4,0,3,1,2,0,0,3,0,4,1,0,9,10,7,2,15,4,2,3,2,10,0,0,0,11,2,2,0,0,1,0,7,1,4,0,4,0,0,1,0,0,3,0,10,6,8,1,0,0,6,5,1,0,1,0,0,0,8,2,0,1,0,6,1,0,0,0,1,9,0,0,0,0,27,2,15,4,0,3,0,0,11,3,0,1,0,3,0,2,3,1,0,12,5,1,3,1,0,11,0,0,2,3,2,1,4,0,1,2,0,2,0,16,8,2,4,3,22,2,0,0,0,4,11,0,3,4,1,5,2,2,0,1,0,1,4,0,18,9,17,2,4,0,3,0,0,0,0,5,4,0,0,0,2,4,6,1,0,0,18,6,0,0,2,1,1,0,2,2,5,4,4,5,0,0,1,2,2,0,0,0,3,3,3,0,5,1,1,4,2,4,0,8,0,3,10,0,2,3,0,1,0,16,1,3,0,5,1,1,0,1,0,0,5,3,3,14,0,0,5,6,2,2,0,4,0,0,14,1,0,0,1,1,0,1,0,3,5,0,0,3,1,1,2,0,0,2,1,0,0,0,15,8,0,1,3,0,5,1,1,1,0,6,6,11,2,1,14,2,1,0,4,0,1,2,6,2,0,1,2,1,0,1,1,6,7,1,10,1,7,3,5,0,4,3,12,10,4,2,2,15,9,0,3,6,0,5,0,1,1,20,0,0,14,4,1,16,0,1,0,0,3,3,0,0,0,9,4,4,0,0,0,0,2,2,31,2,13,2,3,6,0,0,0,1,1,4,0,0,3,0,1,3,6,0,0,6,0,5,3,2,0,0,0,8,0,3,2,1,9,1,48,0,0,4,22,3,2,7,0,5,10,0,8,1,2,1,0,0,0,1,0,0,0,0,0,0,4,0,9,0,6,14,6,10,7,3,4,1,1,9,7,0,0,0,0,0,0,1,1,1,3,3,0,8,1,0,21,5,5,1,12,0,12,1,5,2,0,0,0,3,1,15,2,0,2,1,0,9,7,3,4,0,0,0,0,4,3,2,14,0,1,4,4,0,1,0,1,0,3,2,5,0,1,0,8,3,0,8,6,0,2,0,2,5,0,18,5,1,0,0,0,5,1,1,2,3,1,1,1,0,1,1,1,6,24,2,2,17,4,0,0,3,4,0,0,6,10,0,2,6,2,6,3,0,1,0,13,4,4,0,1,0,2,0,0,5,0,1,22,4,1,0,2,4,3,1,3,1,5,2,7,0,4,0,2,0,1,0,3,0,0,9,4,1,13,28,0,0,0,3,0,0,1,5,2,1,10,0,11,0,0,0,0,8,0,6,1,4,4,3,2,3,0,3,0,0,1,1,2,2,0,13,2,9,1,0,1,1,0,0,1,9,0,7,2,1,0,12,5,4,0,0,2,0,0,0,0,0,3,0,3,0,4,0,0,0,1,0,1,4,2,5,4,1,2,1,1,0,0,0,1,2,0,1,1,2,1,0,1,0,7,8,7,3,9,0,0,0,1,6,0,0,0,0,0,12,2,1,11,0,2,1,15,4,0,1,15,2,0,3,0,0,5,0,0,3,0,12,0,0,1,3,0,1,0,0,5,2,0,1,1,5,13,13,2,0,0,0,0,2,5,1,0,2,0,49,1,5,6,1,2,1,17,2,0,0,4,0,3,0,4,0,23,3,7,0,1,0,2,0,0,0,0,3,16,3,0,0,0,1,0,2,3,1,0,0,0,20,1,8,1,6,2,4,2,0,24,0,6,0,4,0,3,1,0,0,2,2,1,0,1,5,1,3,2,16,0,0,4,10,0,0,3,10,3,2,1,7,3,0,0,10,0,0,2,3,0,0,1,1,4,0,1,0,0,0,0,9,1,1,6,1,1,1,0,0,1,7,0,4,1,6,5,226,10,2,0,0,5,2,1,4,0,2,2,2,0,1,6,0,7,0,2,1,0,0,10,1,2,0,0,0,0,0,7,3,2,0,2,5,1,0,5,0,96,0,1,1,0,3,3,0,6,0,4,0,0,3,0,2,4,0,0,0,0,0,0,6,2,2,0,0,1,2,8,4,0,2,10,0,2,0,0,5,14,0,1,0,0,4,5,2,0,0,8,0,0,0,2,8,0,0,1,0,2,2,7,0,3,5,1,0,0,0,2,0,10,3,1,0,0,0,4,0,0,1,0,1,0,5,0,0,2,0,4,0,0,1,6,0,3,3,0,3,6,2,0,4,0,0,8,0,5,2,3,2,0,1,6,13,0,0,3,0,7,4,0,0,9,2,1,3,3,0,1,0,0,0,3,0,4,4,1,0,2,0,1,0,1,9,1,2,0,4,6,0,2,2,0,4,0,2,0,0,4,4,3,0,0,13,4,3,1,0,0,3,0,0,0,2,1,2,3,0,1,1,1,1,1,0,1,7,10,0,122,6,0,10,0,2,0,2,0,5,6,1,0,0,1,2,18,7,1,6,3,2,4,2,3,2,2,5,2,5,2,3,6,7,5,1,0,11,0,1,3,4,3,3,1,3,6,1,0,0,2,2,3,0,2,0,2,1,0,0,0,2,0,0,0,3,16,2,0,4,7,0,11,0,0,3,1,1,0,4,7,0,1,3,3,0,1,3,0,4,0,0,0,0,3,0,0,12,0,1,0,0,0,3,0,1,5,3,1,4,0,3,2,3,2,4,0,8,0,0,0,0,0,0,0,3,6,3,0,0,9,8,7,0,0,2,0,2,2,3,9,3,4,0,0,3,0,0,0,1,0,0,0,0,0,0,9,2,0,0,3,4,2,0,0,5,0,0,0,9,2,2,1,3,2,1,2,0,17,1,9,0,4,1,0,0,1,0,4,0,12,1,2,0,2,4,0,0,1,0,2,1,8,3,3,0,2,0,0,4,3,1,1,1,1,0,2,2,0,1,0,0,7,2,0,0,0,1,5,2,3,0,2,1,2,0,0,2,0,1,0,1,2,3,1,0,3,1,1,1,0,0,0,0,0,0,0,3,2,0,8,0,1,2,0,0,0,0,0,0,4,0,0,0,0,0,0,0,0,1,5,1,0,2,0,0,0,4,0,0,2,0,2,0,0,0,2,0,0,0,1,0,0,3,1,0,1,3,0,0,0,0,10,0,1,0,0,0,0,0,0,0,4,3,7,0,0,0,0,0,0,0,0,0,0,0,0,1,0,0,0,0,0,0,0,0,0,2,0,0,0,0,0,0,0,2,5,0,0,1,0,0,0,0,0,0,0,0,0,0,0,0,0,0,0,0,0,0
"1998 McDermott, Alice, Charming Billy",high,4502,2409,2000,1940,1784,573,1569,1222,1428,1022,528,1122,929,827,1109,611,904,565,592,743,499,419,655,568,404,313,162,358,332,79,327,243,225,265,244,310,262,364,148,274,273,169,337,175,189,314,369,216,403,267,241,270,191,206,196,190,244,131,84,210,144,61,167,180,139,111,263,185,42,110,85,60,103,109,64,143,126,61,138,113,83,87,143,89,130,62,77,49,149,134,134,102,150,87,96,130,74,99,116,127,92,122,77,103,106,71,127,149,27,124,83,123,100,99,119,93,51,111,97,30,87,44,95,98,107,137,154,54,105,70,71,90,47,68,135,90,90,73,46,71,129,26,138,39,89,89,50,104,81,49,100,52,80,138,32,38,24,93,68,102,53,35,51,62,54,50,123,60,48,49,23,96,79,23,65,33,107,105,43,57,79,28,12,44,45,83,31,42,33,71,49,37,102,67,54,55,316,31,52,13,21,91,42,81,43,64,49,30,41,22,127,53,23,30,45,48,46,48,49,60,46,30,67,52,27,39,45,39,25,23,43,35,19,38,14,62,46,30,61,38,21,17,19,24,24,13,19,58,37,20,27,36,43,24,22,38,23,28,40,38,53,19,33,28,21,52,33,39,26,45,13,45,48,75,26,49,58,22,19,31,23,85,26,42,11,44,20,38,52,31,35,7,16,61,45,25,8,17,28,32,12,30,2,27,40,28,56,111,21,4,43,8,8,32,33,43,21,21,20,16,26,11,10,23,39,28,25,19,9,19,9,22,28,19,26,33,16,70,27,12,22,18,14,23,30,5,10,12,33,13,23,16,25,17,24,34,3,51,14,41,19,47,15,27,24,27,20,23,19,13,25,7,13,64,20,18,25,45,11,6,16,22,4,36,13,3,0,23,15,40,26,41,36,1,24,26,30,31,23,11,20,9,14,48,30,25,25,20,20,44,11,28,21,7,13,40,27,19,28,19,20,0,14,13,4,16,25,45,3,19,22,11,25,14,0,7,9,23,0,7,4,22,8,12,11,18,16,9,6,33,21,12,28,13,25,22,19,2,23,17,29,9,0,26,4,21,40,8,45,3,1,16,19,0,18,23,2,11,0,19,12,23,30,0,38,5,15,7,8,14,7,10,22,10,19,1,19,8,49,40,11,7,15,15,17,11,38,27,2,22,6,15,15,2,19,23,0,8,13,4,18,41,20,19,36,20,18,4,13,10,13,20,16,8,16,57,8,15,17,17,3,39,8,28,25,25,0,3,17,0,21,9,24,1,10,26,9,4,15,22,9,18,8,14,16,7,17,9,18,40,20,8,24,29,16,24,14,51,5,12,18,11,14,17,3,8,6,26,24,4,22,11,9,11,4,17,13,19,26,16,5,8,14,0,7,0,0,6,31,6,7,15,14,22,24,8,13,17,8,23,13,18,28,17,12,4,13,8,16,24,14,4,21,19,10,0,26,11,14,14,18,15,11,25,2,7,8,3,0,1,1,13,20,26,10,13,17,0,7,7,6,13,10,7,12,13,22,18,12,17,13,5,5,24,18,10,2,21,18,15,10,24,5,5,6,6,7,17,24,4,5,23,6,13,20,12,15,1,50,1,8,2,12,8,23,8,11,4,17,14,5,33,3,12,24,5,12,8,10,9,3,1,0,12,1,15,2,21,22,12,14,7,19,1,0,2,20,7,1,11,12,6,12,10,0,0,17,21,1,4,7,6,15,15,3,9,8,49,1,5,11,18,21,10,2,17,6,12,14,10,6,12,0,25,1,11,39,19,36,22,11,12,3,28,24,6,6,4,3,1,17,19,0,4,15,5,0,16,499,5,3,14,2,7,6,9,68,0,3,17,12,26,10,0,12,11,4,0,30,54,2,9,2,6,6,6,1,3,7,7,11,0,0,7,3,7,6,1,0,5,13,6,32,30,16,4,2,0,8,0,3,9,25,9,15,3,12,10,6,7,1,7,8,2,19,2,7,0,6,10,5,8,15,5,2,37,7,6,22,12,5,4,1,12,3,4,12,2,2,9,3,8,23,0,8,15,5,1,8,11,3,8,8,4,26,0,10,10,19,3,10,20,3,0,24,0,4,7,10,10,4,0,7,23,4,8,5,0,17,1,0,11,35,0,1,30,11,2,8,14,4,0,5,11,5,15,11,1,6,9,3,6,12,10,2,10,5,5,1,1,0,19,11,2,22,26,4,19,2,12,15,1,13,6,12,14,3,5,4,0,0,5,11,0,7,0,10,1,6,48,12,11,9,4,11,12,2,3,5,0,2,0,4,0,15,24,0,0,4,1,3,2,0,1,4,6,10,0,4,13,1,6,4,2,1,2,2,12,4,19,12,4,6,6,8,13,3,31,1,20,3,1,0,2,18,6,5,6,5,0,3,6,41,4,2,0,1,22,3,10,14,6,0,0,0,0,9,2,0,0,0,0,1,7,14,4,2,0,5,7,1,12,14,28,1,7,2,6,3,0,2,0,6,6,1,5,0,6,0,4,3,1,9,10,5,2,4,4,0,8,12,10,5,4,0,14,6,6,11,6,29,17,13,15,4,8,3,13,3,5,0,1,17,17,11,14,8,5,2,16,16,6,4,9,1,2,4,12,20,2,11,4,6,7,17,4,1,3,5,14,4,7,8,11,84,1,30,2,6,1,0,4,7,8,0,18,1,9,0,0,8,3,7,4,2,4,0,9,3,0,0,14,0,11,0,10,18,4,0,10,5,0,2,6,2,4,0,18,10,8,0,8,3,5,4,0,0,18,0,7,2,18,0,4,8,3,5,0,6,10,4,5,0,8,15,0,1,3,1,8,6,5,11,0,1,1,0,9,11,5,1,2,0,10,1,8,3,2,0,5,9,0,2,6,0,1,2,62,10,10,1,1,4,19,0,25,6,11,0,15,5,2,2,5,11,11,1,15,4,0,0,11,0,1,2,4,1,10,1,7,6,6,5,2,5,20,2,3,15,1,2,6,13,16,0,2,0,7,2,8,9,13,0,0,4,12,1,7,3,0,1,4,5,0,2,5,0,1,6,5,10,7,9,269,7,3,4,5,0,11,1,1,3,14,6,0,4,13,3,0,0,5,10,0,5,1,2,1,6,2,0,2,5,2,5,0,0,12,0,0,1,0,1,7,1,5,7,3,2,2,1,6,7,0,3,3,8,0,1,0,0,0,0,4,0,14,0,0,4,11,3,3,10,12,0,3,31,1,4,2,3,4,1,6,7,4,4,0,9,0,15,3,0,0,3,1,3,0,3,4,3,0,0,9,0,7,1,1,8,4,1,0,0,10,8,0,3,0,7,14,4,0,8,0,22,10,5,0,3,2,2,4,2,3,3,0,7,4,12,3,2,0,13,20,5,5,5,4,15,1,3,2,5,4,4,11,0,2,3,1,5,0,0,0,0,0,0,4,2,14,3,18,10,0,9,6,0,0,2,1,0,5,7,10,8,5,6,6,4,15,3,3,4,3,3,10,3,17,1,3,6,19,12,11,3,5,13,26,3,0,5,1,4,2,1,1,0,0,5,2,9,1,3,2,6,1,0,0,8,1,4,2,3,0,4,5,6,0,14,1,3,2,11,1,2,3,1,3,9,0,0,5,7,0,10,19,6,0,7,1,107,1,0,0,3,4,1,1,5,6,7,2,6,0,0,5,0,5,0,3,3,0,1,1,0,5,6,6,0,1,1,0,4,15,8,2,1,7,4,4,0,2,2,9,2,0,0,4,5,16,0,2,10,15,3,1,0,2,5,1,1,3,5,11,14,1,0,0,3,4,0,12,0,1,0,1,0,3,0,1,0,5,1,1,0,28,12,8,1,0,2,0,2,1,0,1,8,0,2,6,3,0,7,0,0,1,6,1,3,3,0,13,16,0,4,6,0,4,0,0,0,0,5,5,3,0,4,2,13,2,2,13,3,0,7,2,1,3,2,4,2,11,7,2,0,1,2,3,3,5,4,4,1,3,0,9,0,1,13,11,6,7,3,2,8,7,5,2,4,0,1,2,0,0,5,4,15,3,1,4,0,16,3,5,0,4,3,3,6,0,5,3,0,2,1,1,5,1,1,1,1,2,0,3,20,3,7,1,1,13,1,13,2,2,1,3,7,0,11,2,12,0,0,0,1,0,0,0,0,0,18,1,1,4,1,2,0,3,0,1,0,8,1,1,1,2,2,2,4,23,6,3,3,1,3,1,13,1,1,4,11,10,0,1,0,3,5,1,1,2,1,8,1,2,16,2,2,7,3,2,0,2,4,3,0,9,2,2,11,5,11,8,0,2,3,0,7,0,0,3,0,0,1,3,0,6,3,0,6,4,0,2,4,0,2,1,5,3,2,0,0,1,0,2,2,1,1,0,6,1,0,1,0,3,3,0,12,2,0,8,0,1,0,5,0,4,1,13,3,4,7,1,2,1,3,0,0,5,14,1,0,0,16,2,5,22,7,0,4,5,0,7,0,0,7,3,3,5,1,3,0,1,5,7,0,7,0,6,6,0,0,1,0,0,14,1,3,0,7,2,10,0,1,1,1,1,0,5,0,11,5,0,3,1,2,3,8,6,3,2,3,0,4,1,0,0,9,0,3,0,0,6,2,3,0,4,4,0,2,5,1,2,0,1,0,13,0,1,0,7,0,3,2,11,0,8,1,5,3,2,9,1,0,3,4,3,4,3,4,3,0,1,0,2,0,0,1,3,4,17,0,2,1,8,2,0,0,0,0,14,2,1,1,9,6,2,0,1,10,1,2,0,2,4,1,2,0,0,5,0,1,7,1,4,4,3,1,3,0,0,0,0,7,7,0,0,2,0,1,3,2,1,6,13,0,3,0,0,2,0,0,0,4,0,3,2,0,1,0,1,0,3,0,0,0,0,3,0,2,6,0,5,1,0,2,0,6,0,4,0,0,2,0,0,1,0,0,7,10,0,0,0,1,1,9,3,1,0,3,0,0,2,8,2,6,0,1,3,0,5,0,1,1,19,0,1,0,0,0,2,0,1,2,4,3,0,0,6,0,0,0,6,6,2,5,3,0,1,1,4,26,3,1,3,9,2,2,1,0,0,1,2,3,0,32,6,1,0,2,0,1,1,0,7,0,3,2,2,7,1,15,0,6,0,2,0,3,10,2,1,0,0,1,2,1,14,4,2,4,6,7,1,4,0,0,2,2,3,2,3,5,2,5,6,1,2,0,3,0,1,4,0,2,7,5,6,0,0,7,1,1,11,4,1,1,3,1,0,6,0,0,1,0,3,4,2,0,5,3,3,3,0,5,1,0,2,1,0,0,1,0,1,1,1,1,1,0,3,3,2,0,7,3,9,0,1,0,2,0,0,3,2,1,7,5,0,1,0,0,0,1,5,8,0,0,0,1,0,2,4,0,0,0,1,0,0,1,3,0,1,1,2,4,2,0,0,2,52,6,5,2,3,0,0,0,6,2,1,6,7,2,1,4,2,0,0,0,1,0,0,0,0,1,1,0,0,2,2,3,0,2,6,0,1,1,1,2,2,4,0,0,0,1,0,2,0,0,4,1,0,3,1,2,3,0,2,0,0,6,0,1,2,1,2,2,0,0,1,0,1,0,0,0,0,2,3,0,2,5,5,0,1,2,0,0,1,0,0,4,6,3,0,7,3,2,9,3,2,3,0,2,1,1,1,0,2,0,0,0,0,0,3,0,6,0,0,4,1,2,2,3,6,2,2,1,0,2,1,2,2,1,3,1,1,6,1,3,4,3,3,6,0,0,1,0,2,0,3,2,1,0,0,0,0,4,10,0,1,1,1,0,16,2,0,1,0,0,0,11,0,0,0,0,2,0,0,0,8,0,0,3,13,1,5,0,0,4,0,0,0,2,2,2,1,1,1,0,2,5,0,5,1,2,2,0,3,0,1,0,21,4,4,1,0,3,3,2,0,0,2,0,0,9,0,2,0,1,8,0,3,1,2,0,1,0,1,0,8,1,0,2,0,4,2,0,0,2,6,0,0,0,5,8,0,1,0,1,0,0,1,1,3,1,0,1,0,3,4,0,0,0,3,1,0,0,0,2,4,1,0,0,4,0,5,0,3,0,1,2,3,0,0,1,2,6,0,0,0,9,4,4,3,0,2,1,3,0,4,1,4,2,0,0,1,3,3,0,8,1,4,2,3,2,8,0,0,9,1,1,3,0,0,4,2,3,0,0,0,0,0,0,0,2,1,1,0,1,0,1,1,0,184,0,5,0,1,2,0,1,1,0,0,1,5,0,4,2,0,7,3,0,1,0,4,0,0,6,5,0,3,0,0,1,5,2,0,2,9,0,0,2,5,1,1,0,2,1,1,0,4,3,0,0,9,0,0,1,1,1,4,0,2,2,1,3,3,2,0,0,4,5,4,4,1,3,0,0,1,8,3,0,0,5,0,1,2,0,1,0,0,0,5,0,5,0,0,1,0,1,3,0,0,2,1,3,3,1,0,2,0,0,7,3,0,0,2,0,2,1,0,1,1,5,0,1,1,1,0,0,0,2,0,1,0,4,2,0,1,10,0,4,1,2,0,0,4,1,0,4,1,0,1,4,0,0,0,0,0,2,1,1,1,0,2,1,0,3,0,0,0,0,0,3,0,0,0,0,0,1,2,5,2,4,1,1,3,0,0,0,10,0,1,1,0,1,0,3,7,8,0,1,2,0,0,0,1,0,0,0,1,5,0,6,1,2,6,0,10,2,0,0,5,2,5,2,2,6,3,0,4,0,0,3,2,5,2,0,3,0,1,2,0,12,2,0,0,0,0,0,0,5,0,0,1,0,2,0,0,0,4,3,0,0,0,1,1,0,2,0,1,0,7,1,4,0,0,1,3,1,2,0,0,0,0,7,5,1,4,1,2,1,0,0,2,4,0,1,0,0,2,1,3,1,2,1,0,4,1,0,0,2,1,0,0,4,0,2,0,4,2,0,0,0,2,0,1,6,0,0,0,0,0,0,5,0,0,0,0,5,3,0,0,1,5,5,1,0,1,1,0,0,0,1,0,2,0,0,0,3,0,0,0,0,4,0,0,4,0,2,2,0,4,3,0,0,0,7,5,0,0,0,0,0,1,0,1,1,0,0,3,10,0,3,1,0,5,7,7,14,0,3,1,1,0,3,0,0,1,0,0,0,1,1,3,1,2,0,2,2,1,0,2,21,2,13,0,1,1,1,0,2,4,0,0,4,1,0,0,8,0,0,0,0,0,1,0,5,8,1,1,1,0,3,0,2,1,0,0,1,0,4,2,2,0,0,2,6,0,1,0,2,0,0,0,7,2,3,1,1,2,4,0,4,0,2,0,4,0,1,0,4,0,0,0,1,0,0,0,2,1,0,6,1,0,0,1,1,1,1,2,0,0,0,1,5,0,1,0,7,0,0,7,1,8,0,0,0,0,3,0,1,3,6,2,0,1,3,1,10,1,1,0,0,1,5,1,1,2,0,4,4,1,1,0,2,0,1,0,0,0,0,0,0,0,0,6,1,1,1,0,0,2,0,6,1,8,0,4,1,0,4,0,0,1,112,0,3,8,0,3,4,0,0,4,0,2,0,0,1,2,3,1,0,1,0,0,0,2,6,0,3,0,5,0,1,3,0,4,0,0,0,1,3,11,2,0,0,0,0,0,0,8,3,0,1,1,0,2,1,7,3,7,1,0,1,1,0,5,2,3,1,1,0,0,1,1,0,0,0,1,1,0,0,1,2,1,0,2,1,4,1,0,1,0,0,0,0,0,9,0,0,0,0,8,6,9,1,1,2,0,0,2,2,2,3,0,1,0,2,2,0,14,0,0,0,0,0,0,2,1,0,0,0,0,0,2,1,1,0,1,0,0,1,2,0,1,2,0,0,1,0,0,0,3,1,2,4,0,0,1,2,1,4,1,5,0,0,0,0,5,1,0,0,0,1,1,3,0,0,92,6,1,1,3,0,2,1,3,0,0,1,0,8,5,0,0,3,1,2,2,0,5,1,0,1,4,0,0,0,2,0,0,0,1,0,1,1,0,4,1,0,0,0,4,1,0,0,1,0,1,1,0,0,4,2,1,0,0,0,0,0,1,4,2,0,0,1,0,1,2,0,2,0,2,0,0,0,0,4,0,3,3,4,1,0,0,1,3,9,0,2,2,9,0,4,4,0,0,1,3,0,109,0,1,3,2,0,1,0,0,0,3,1,3,3,0,3,0,5,0,0,3,1,7,1,1,2,0,0,0,0,1,1,6,0,2,0,1,4,2,0,0,6,1,0,0,0,2,2,0,2,1,0,5,0,0,0,0,1,1,2,0,4,1,3,2,0,2,0,4,3,0,0,0,2,1,0,0,0,2,1,0,0,0,0,0,1,0,1,0,4,1,0,1,0,0,0,4,1,2,2,0,1,0,2,1,0,2,0,6,0,0,0,3,0,0,1,0,1,0,2,2,3,2,0,1,0,1,0,0,0,1,3,0,0,0,0,0,16,1,0,2,0,0,0,0,0,0,0,0,0,2,2,0,0,0,1,0,0,6,1,0,0,0,1,0,0,0,2,0,0,2,3,3,2,0,0,0,0,0,1,0,1,3,0,0,0,1,0,0,5,0,0,0,1,2,4,0,0,0,0,3,0,1,0,4,2,0,1,0,0,1,0,1,0,0,5,0,1,6,0,0,1,0,7,0,0,0,0,0,0,1,0,0,1,5,8,0,2,0,0,7,8,1,0,0,2,3,1,2,0,1,1,2,0,0,1,0,0,1,2,0,0,1,5,2,4,0,0,0,0,1,2,0,0,0,0,0,0,1,1,1,2,4,0,0,0,0,5,0,1,0,1,0,0,5,0,1,0,0,2,1,0,1,5,1,7,2,0,2,0,3,0,0,0,2,3,0,0,1,0,1,1,2,1,0,1,1,0,0,4,0,6,1,0,11,2,1,4,2,0,2,0,0,0,1,0,0,0,1,1,1,0,0,0,0,0,0,1,1,0,3,2,0,6,0,4,0,4,0,2,5,0,1,1,0,0,2,6,0,4,0,0,0,1,5,3,0,1,2,0,2,0,0,0,1,0,0,1,2,0,0,1,0,0,0,1,0,0,0,1,2,2,0,0,0,1,1,8,1,1,3,2,1,1,0,0,2,1,0,6,1,2,1,0,0,0,1,1,1,1,0,0,0,0,0,1,0,0,4,0,0,0,0,1,0,1,1,2,0,2,0,0,2,3,0,1,0,1,4,0,0,2,0,1,2,2,4,0,0,0,0,1,0,1,0,1,1,1,2,1,0,1,0,0,0,2,0,0,0,1,1,0,0,4,0,0,9,0,0,0,0,1,2,2,0,0,0,0,0,0,0,0,1,0,0,3,0,0,0,0,1,6,0,6,2,3,1,0,1,1,0,0,0,0,0,0,1,0,0,0,1,3,0,0,0,1,0,0,0,0,0,0,0,0,0,5,0,0,0,0,0,0,0,0,1,1,1,0,0,0,1,4,1,3,0,0,1,0,0,1,0,1,1,2,0,0,7,0,4,1,0,1,0,0,1,0,0,2,0,0,1,0,1,0,3,0,1,2,0,1,0,0,0,4,5,1,1,0,0,1,0,0,2,0,0,0,1,0,5,2,0,2,2,1,1,0,3,2,2,0,0,0,0,1,0,0,3,2,0,0,0,0,1,0,0,1,0,0,2,2,0,0,0,3,1,1,6,0,0,0,5,0,0,4,0,2,0,0,8,0,0,1,0,0,0,1,4,0,0,4,3,0,0,3,1,0,1,0,0,0,1,1,0,0,0,1,0,0,1,1,2,8,0,1,5,1,0,1,0,0,1,0,1,6,0,0,1,1,0,2,2,0,0,0,2,0,0,0,0,0,0,3,0,2,0,4,1,0,0,1,0,1,0,0,3,0,1,1,1,2,0,0,1,0,1,4,4,1,0,2,0,3,0,0,2,4,0,1,0,0,1,2,0,1,1,1,0,0,0,9,4,0,0,2,1,1,0,0,0,6,0,1,1,0,0,0,0,0,0,0,0,1,2,1,0,0,1,3,0,2,0,3,0,0,2,0,0,1,0,0,0,1,1,0,1,0,1,0,2,0,1,1,3,0,7,2,0,0,0,2,0,1,2,0,0,1,4,1,2,0,2,0,0,0,2,0,0,0,0,0,0,1,1,1,0,3,0,2,0,0,0,0,3,4,1,0,0,1,1,3,0,0,0,0,0,0,2,2,0,0,1,0,0,6,1,1,0,0,0,1,1,2,2,8,10,0,0,2,0,2,0,2,2,1,0,4,0,2,0,1,0,4,1,0,0,0,0,1,2,0,0,0,1,0,1,0,0,1,2,0,0,0,2,1,7,1,0,0,1,2,1,0,1,1,2,0,2,0,0,0,3,3,0,0,0,0,2,0,0,1,0,0,1,0,0,0,0,2,0,8,0,1,1,0,0,0,0,0,3,0,0,0,0,0,0,1,1,0,0,0,0,0,0,0,0,1,3,1,0,1,5,0,0,1,0,1,0,3,0,0,0,0,1,3,0,4,0,0,0,0,0,0,1,3,6,0,0,0,0,0,0,0,1,0,0,1,0,0,3,0,1,0,1,1,0,0,2,0,0,2,1,1,0,1,0,1,2,0,1,2,0,1,6,3,0,0,0,0,1,0,0,1,0,2,1,0,1,0,0,2,0,1,0,1,0,0,0,1,1,0,2,0,0,2,0,0,0,10,3,2,0,0,0,0,0,0,1,0,0,0,0,0,0,2,0,0,0,0,1,4,0,0,0,1,0,0,1,0,0,0,0,0,0,0,0,0,0,0,3,0,0,0,2,1,1,2,1,0,1,0,0,1,1,1,1,0,3,2,0,0,0,0,1,0,0,0,0,0,1,3,0,0,0,0,1,1,0,0,0,2,0,3,0,2,0,0,0,0,1,0,1,1,0,0,1,2,0,0,0,0,1,0,0,1,1,1,1,0,0,0,0,1,1,1,0,0,1,0,2,0,0,0,0,1,0,0,0,0,1,2,0,0,0,0,0,0,0,0,1,1,2,1,0,2,0,1,1,0,2,0,0,0,0,0,0,0,0,1,0,0,1,0,0,0,1,0,0,3,0,3,0,0,0,1,0,0,0,0,0,0,0,0,1,0,0,0,0,1,0,0,0,0,0,0,0,0,0,0,0,0,0,0,11,1,0,0,0,1,0,0,0,0,0,0,0,0,0,0,0,0,0,2,0,0,0,0,0,0,0,7,0,0,0,0,0,0,0,0,0,0,0,0,0,0,0,0,0,0,0,0,1,1,0,0,0,1,0,0,0
"1998 Stone, Robert, Damascus Gate",high,10640,3934,4035,3951,4119,1759,2893,2751,2274,2045,1975,1360,1340,1428,1035,1094,1756,1097,1070,2156,1019,744,771,1034,252,790,478,1072,549,718,761,457,678,876,385,612,812,521,500,604,389,490,651,395,523,351,439,471,431,299,242,588,366,269,514,431,500,361,379,193,237,367,445,187,259,218,398,279,387,239,218,314,199,259,189,224,148,74,336,307,156,316,377,237,276,208,251,193,103,161,146,226,196,195,334,156,180,175,176,176,155,163,171,133,388,199,134,146,161,216,261,245,197,56,118,77,107,251,181,241,461,232,211,103,79,332,101,127,125,133,155,142,136,151,119,112,125,70,88,96,82,130,15,201,161,111,118,254,97,131,130,133,128,88,79,121,78,116,47,210,94,77,32,98,89,209,129,103,145,84,44,54,72,102,95,75,106,193,75,80,130,66,159,115,111,70,59,108,106,83,37,155,56,106,73,57,57,68,87,120,80,203,120,116,92,54,87,77,16,30,43,111,131,64,109,81,69,105,51,69,88,74,91,78,67,131,116,63,37,106,84,51,123,77,80,4,28,45,80,94,51,96,54,80,30,62,22,64,76,37,79,60,105,68,44,62,129,79,67,147,100,52,87,62,111,68,44,82,22,81,45,70,86,53,59,48,46,61,56,40,35,43,88,61,31,133,66,30,21,28,27,36,11,194,58,57,60,64,55,35,51,43,0,60,101,62,35,38,27,58,41,23,52,61,78,35,9,48,57,105,98,53,52,35,44,23,95,26,47,35,31,133,59,50,119,46,41,44,70,30,36,28,33,26,28,11,43,35,46,64,46,50,29,45,48,16,39,7,67,28,13,16,52,59,50,29,37,25,104,33,57,14,13,5,19,17,54,23,79,40,84,17,25,24,20,53,0,37,45,38,2,33,107,13,43,30,29,65,30,23,36,23,47,26,52,32,23,19,40,47,36,38,27,73,22,36,14,34,19,40,22,0,16,30,18,50,53,29,34,23,24,27,15,19,76,47,21,39,107,44,33,39,57,24,43,31,31,67,36,40,24,60,96,27,30,23,48,63,48,32,12,18,0,143,33,25,105,44,13,34,36,10,29,2,20,31,17,38,0,34,38,48,24,10,30,17,19,95,47,51,25,33,27,30,44,27,34,28,56,27,18,29,15,35,12,18,6,37,35,26,16,11,32,32,47,41,0,40,60,18,28,21,12,22,33,17,66,32,22,54,14,6,29,32,43,5,25,27,6,47,22,22,33,28,24,45,0,2,8,35,18,44,21,18,15,66,24,15,35,48,11,15,32,12,44,21,16,18,20,24,28,15,29,18,35,26,20,18,14,17,18,36,32,10,3,16,24,39,14,55,27,3,17,10,7,28,80,17,35,30,18,17,19,60,5,0,0,32,19,13,15,12,24,21,85,32,13,15,17,13,17,25,14,32,12,29,12,3,20,18,41,25,12,16,24,0,24,4,18,24,17,25,23,15,20,35,30,19,47,6,1,21,26,20,46,25,26,5,24,136,25,13,17,12,15,35,9,25,44,22,12,20,73,39,13,5,25,37,30,26,48,19,34,13,50,12,3,33,23,13,30,3,29,12,8,11,46,7,37,12,30,7,11,11,13,28,4,25,15,27,5,39,18,8,18,18,15,46,15,29,21,5,16,34,24,13,28,19,49,24,22,22,16,48,1638,24,26,19,25,9,20,20,28,15,6,5,10,18,20,29,3,10,7,19,34,16,13,8,7,19,16,5,18,63,20,32,21,18,32,28,15,21,13,13,5,17,20,7,13,18,7,35,23,24,10,9,38,16,11,7,19,46,2,4,22,26,1,12,1,21,4,13,39,19,32,15,45,12,29,18,40,17,25,27,20,20,13,0,12,8,22,17,23,11,21,10,24,21,8,4,19,47,2,15,35,11,8,16,52,14,8,20,6,22,8,41,17,0,7,19,19,10,22,24,17,55,13,1,22,15,8,26,16,19,22,29,35,0,4,15,16,5,9,8,25,10,3,12,27,18,20,20,19,6,12,11,5,15,9,30,2,15,10,7,10,56,24,0,23,14,25,17,4,12,36,6,21,20,11,18,33,0,11,0,19,2,14,18,21,16,21,316,23,6,10,10,38,1,17,82,18,22,23,1,10,5,39,12,13,13,16,31,11,19,18,31,21,19,19,10,22,6,6,13,31,14,0,2,17,8,0,3,7,1,12,20,29,4,7,9,23,0,20,10,27,20,21,15,14,1,48,51,6,7,14,2,14,3,10,2,8,57,20,6,30,3,3,15,33,0,10,1,15,0,10,19,0,0,6,6,16,8,12,3,2,36,20,35,2,10,22,12,8,1,16,8,36,2,16,11,18,9,22,12,26,13,4,3,3,10,6,15,0,28,10,12,3,4,8,25,12,24,12,4,15,0,24,20,17,11,15,2,0,6,17,3,10,12,0,0,0,3,21,4,8,3,9,0,8,14,5,10,2,15,9,5,20,17,12,4,14,0,13,7,7,4,2,9,2,16,7,6,10,21,10,3,8,8,14,18,9,11,24,21,0,0,54,72,8,3,28,7,3,7,16,5,5,21,25,2,2,5,2,25,7,12,2,18,11,13,16,2,11,33,14,3,13,25,9,23,18,1,8,18,2,7,4,11,41,28,9,6,13,2,0,11,3,9,8,2,0,12,6,3,4,18,63,15,5,1,13,19,10,9,15,10,0,6,3,0,7,22,0,7,2,1,10,2,3,9,4,0,8,9,12,59,0,7,10,4,0,6,15,6,11,0,0,16,6,9,20,6,3,14,10,1,9,5,19,22,11,13,1,7,5,0,22,12,11,11,13,13,14,2,16,2,2,2,9,7,10,20,10,8,1,13,63,9,6,6,2,0,6,16,0,5,3,3,5,15,0,1,2,6,0,23,19,3,0,2,5,14,7,17,18,10,25,14,1,13,0,21,7,9,7,9,3,14,1,14,5,15,8,11,8,8,5,2,6,24,32,1,14,11,3,4,9,15,18,2,6,17,6,1,6,13,15,7,16,16,3,4,24,6,3,8,14,0,8,10,17,8,9,0,18,0,4,17,10,33,19,2,13,11,6,6,13,14,14,6,15,8,22,0,19,13,12,3,2,13,3,14,21,2,3,0,0,6,0,4,79,0,14,17,5,8,16,3,6,11,14,11,16,13,2,1,8,1,7,13,0,0,0,5,10,11,0,0,13,1,21,4,9,13,0,17,10,6,16,10,8,4,1,9,10,8,6,5,17,3,11,23,0,0,5,11,8,7,6,16,11,0,3,4,8,5,2,3,5,6,15,14,0,13,8,0,15,4,3,7,16,17,10,0,8,7,5,0,3,9,12,8,7,4,0,15,2,11,6,35,20,12,83,5,3,13,12,48,0,12,3,11,9,16,4,34,0,0,15,18,8,0,15,0,0,2,0,6,10,26,4,8,37,1,9,8,3,0,4,5,3,6,9,3,8,17,10,9,3,2,15,10,3,1,4,0,8,3,13,9,13,12,6,11,6,9,9,0,19,9,5,1,13,12,1,10,17,8,5,5,11,7,0,5,7,21,14,1,2,4,16,14,13,0,6,10,12,0,8,13,4,3,6,3,7,15,5,4,1,3,0,5,2,13,9,5,1,1,22,0,5,8,0,6,13,9,13,41,9,4,9,1,6,7,7,17,0,9,1,4,16,4,7,0,8,12,17,4,11,1,11,3,11,7,2,0,0,8,11,21,0,28,3,4,6,4,8,7,8,4,5,3,6,8,28,15,7,1,5,27,3,6,3,3,1,5,3,0,0,11,6,15,4,7,16,1,0,9,1,3,3,15,9,5,2,20,1,7,5,3,17,0,2,7,22,1,8,21,5,3,18,19,6,7,25,3,7,17,28,9,1,16,4,2,5,12,9,11,0,5,9,10,42,0,9,17,5,4,6,2,15,11,7,3,8,14,1,15,7,8,48,12,10,1,666,8,12,10,4,4,10,8,21,3,4,17,0,7,7,0,7,6,5,8,9,3,4,8,5,0,18,1,2,9,4,1,5,3,7,7,33,0,16,7,1,25,6,6,1,7,9,7,0,3,9,0,0,4,11,3,7,5,1,8,10,5,3,4,15,12,9,12,2,8,17,13,13,3,1,8,11,6,0,0,8,11,1,18,0,0,2,10,4,3,40,4,11,8,0,9,11,6,0,3,39,7,8,8,5,0,12,8,18,13,6,2,4,2,5,24,1,11,7,0,3,12,34,2,2,13,21,1,1,10,2,16,1,5,6,6,0,38,6,0,5,7,2,15,7,5,6,9,0,2,18,4,0,5,8,9,48,6,1,1,0,7,9,8,2,2,0,0,11,0,7,1,2,4,9,4,1,0,0,6,5,3,2,1,6,5,1,23,0,9,7,0,10,4,0,2,4,8,0,12,6,11,1,0,4,2,9,4,1,23,1,8,1,11,0,27,2,9,4,2,3,0,0,3,3,4,9,3,1,0,3,7,8,2,2,3,2,9,10,2,2,7,1,1,7,2,1,4,13,4,16,7,2,0,14,11,7,8,8,2,27,8,6,2,9,4,11,4,13,5,3,3,6,22,7,6,7,0,8,8,5,0,5,1,6,0,10,10,5,4,0,9,10,25,3,12,40,4,10,0,0,4,3,1,1,5,4,5,0,5,2,11,3,3,1,21,10,8,4,7,5,4,4,8,0,1,5,1,0,1,0,0,7,2,1,2,10,4,5,6,9,2,9,0,0,4,3,6,1,7,15,9,0,5,0,8,12,2,0,4,9,2,0,4,7,10,4,6,1,3,9,3,2,1,0,12,7,0,3,0,0,0,7,8,9,2,1,11,4,3,0,3,3,10,1,3,7,2,3,0,6,2,13,3,0,3,1,16,0,0,0,0,7,5,19,6,0,6,7,5,5,1,3,3,6,9,5,4,8,0,6,0,0,10,11,5,4,206,0,14,4,9,2,28,11,3,4,2,5,18,6,5,9,12,8,12,4,14,19,40,11,0,0,0,6,5,2,5,6,8,6,0,7,9,7,0,3,6,11,34,4,2,4,0,3,7,13,2,2,1,7,0,7,0,22,0,7,0,17,3,1,9,4,0,3,8,3,3,0,4,10,6,6,2,7,5,1,0,4,2,1,12,5,13,4,44,3,0,0,4,0,2,12,1,3,7,12,6,2,6,10,1,7,4,42,5,6,1,10,17,4,3,12,4,6,10,0,12,4,4,5,10,5,1,1,6,3,6,2,6,2,10,7,5,0,2,7,6,0,2,10,9,7,6,5,4,3,3,1,6,0,1,3,60,0,3,2,4,5,14,6,0,6,4,3,0,6,15,3,5,0,4,0,1,3,1,3,3,8,3,15,1,2,3,1,12,6,1,0,0,3,1,2,0,2,6,1,13,3,5,11,0,0,1,5,14,12,7,2,2,8,4,23,17,6,0,5,7,4,0,0,0,4,3,4,1,2,1,2,8,1,10,6,5,0,6,5,11,7,5,0,0,2,3,4,4,16,3,1,5,2,12,4,10,11,16,0,2,4,2,12,0,0,7,3,4,7,2,5,2,1,3,5,1,2,3,5,12,12,3,8,2,3,5,9,1,0,2,8,4,1,0,1,9,3,8,0,0,4,5,0,3,0,0,5,7,3,0,5,6,6,6,3,2,3,3,17,4,2,1,6,7,0,0,0,0,2,5,0,5,0,7,3,3,3,1,1,9,1,1,4,8,5,2,8,4,11,4,2,5,2,0,4,14,4,14,2,0,3,15,0,1,2,5,5,3,6,4,0,0,12,4,1,4,0,4,5,3,0,0,6,0,26,10,1,1,2,0,0,13,0,0,0,6,0,13,8,4,7,3,2,9,3,6,1,2,3,4,1,8,3,11,4,15,2,0,4,0,4,7,3,11,0,7,3,2,1,1,4,2,3,3,3,0,10,5,11,8,19,8,1,4,11,13,5,7,0,8,0,3,8,2,0,3,4,0,5,2,11,5,1,0,1,1,108,0,0,3,3,1,5,4,9,1,0,5,3,5,6,0,1,2,6,4,4,1,0,5,10,0,4,0,2,2,4,0,1,3,2,2,0,3,0,4,3,4,1,0,10,0,6,0,8,7,7,1,0,2,5,6,4,1,1,3,7,4,3,1,1,5,2,2,3,0,11,10,10,10,3,10,26,1,0,4,0,0,2,1,1,6,20,2,0,3,2,7,12,3,6,13,11,0,1,2,2,0,0,0,0,4,14,0,4,0,1,4,1,3,7,3,0,1,6,1,2,1,3,4,0,5,4,0,10,4,2,1,0,1,6,3,3,2,0,43,10,3,3,8,0,1,1,0,5,0,5,3,10,3,9,0,0,0,10,10,4,7,2,2,10,2,4,1,5,0,7,4,17,1,2,3,2,3,0,6,4,9,2,2,5,3,2,12,7,2,3,0,4,10,2,5,14,2,8,13,7,2,0,0,1,4,2,2,5,3,6,2,15,5,5,0,367,0,0,1,5,25,5,23,4,3,3,7,6,0,1,1,1,1,4,7,2,3,3,3,1,0,2,5,1,1,4,3,9,3,7,0,6,7,5,0,0,1,0,0,10,0,2,82,2,5,4,0,2,0,8,0,0,11,8,14,0,17,6,1,3,6,32,2,0,6,6,6,3,4,2,0,0,4,5,5,11,0,12,2,27,0,9,0,2,2,0,24,24,5,0,0,4,1,2,0,2,7,0,1,1,3,0,5,2,1,6,4,12,4,4,3,0,0,3,5,7,1,6,5,0,1,2,0,2,2,0,1,0,6,0,6,0,0,0,3,2,0,14,0,6,3,14,1,3,11,0,0,0,3,10,4,2,4,6,4,1,2,3,1,4,2,0,9,0,13,7,2,6,5,1,8,1,9,0,3,4,4,10,3,4,2,1,10,3,13,7,6,9,3,4,1,0,3,0,7,2,0,9,8,5,0,6,0,4,0,0,5,0,13,4,0,5,1,13,7,0,14,3,1,0,0,5,0,4,0,1,11,5,6,3,1,4,3,0,22,5,6,2,2,4,2,2,1,0,5,0,9,18,3,1,1,1,4,3,1,0,0,2,6,2,0,0,1,0,4,90,0,6,1,0,2,1,4,3,4,1,2,0,0,4,2,6,8,0,3,2,1,0,4,6,1,0,1,6,1,3,2,3,3,7,5,2,0,0,4,7,3,6,7,7,1,1,2,3,4,2,3,2,0,0,2,9,1,2,10,0,0,9,11,2,8,0,0,4,7,3,7,4,0,7,3,3,0,5,27,0,4,1,0,21,0,4,3,1,18,2,5,5,5,8,1,4,0,1,2,5,6,5,3,7,0,1,0,0,20,2,20,6,1,3,4,0,9,2,0,7,1,4,8,5,18,1,4,0,0,6,0,1,2,7,2,4,2,1,0,6,4,0,18,0,0,2,5,0,2,2,3,0,1,6,1,0,0,3,3,9,85,0,46,2,2,8,1,7,2,17,4,0,0,1,5,0,3,59,2,2,5,3,3,1,0,8,2,12,6,2,0,0,4,1,3,9,2,3,0,0,8,2,2,2,6,0,0,5,0,6,1,13,0,2,1,1,4,1,2,5,7,1,7,1,3,1,19,6,1,9,5,13,4,0,0,3,5,5,4,0,7,5,2,4,42,3,0,1,0,1,8,3,2,6,1,0,3,1,0,0,5,3,2,2,3,0,2,0,3,6,1,0,21,0,0,21,2,2,2,0,2,6,1,3,7,1,0,8,2,0,0,0,3,3,0,3,11,3,5,1,0,2,1,3,2,6,2,1,1,2,0,1,4,7,0,0,1,24,6,10,3,4,0,0,137,7,8,4,0,11,1,2,0,1,0,0,1,3,7,0,0,2,9,0,2,5,6,5,0,0,5,4,1,1,2,2,2,0,4,3,0,1,1,0,1,3,0,0,5,0,2,7,284,0,0,1,5,1,3,1,1,1,0,2,0,2,1,3,0,0,2,9,1,19,4,3,5,1,3,9,3,3,2,0,3,0,2,5,0,2,1,5,0,6,2,3,0,3,2,4,7,3,2,12,2,1,3,7,4,5,1,1,3,1,0,4,2,1,7,11,0,1,0,0,0,1,4,2,2,0,4,10,0,5,0,2,11,5,3,4,1,2,3,1,12,8,0,0,0,4,0,0,0,0,0,38,0,1,1,3,1,1,4,2,3,2,3,2,3,0,0,3,2,6,23,112,2,3,2,5,0,6,1,1,1,0,2,2,3,0,4,1,13,2,2,2,1,2,5,6,7,3,6,16,0,4,5,1,4,4,7,2,0,3,11,4,0,18,1,3,7,8,4,0,3,1,2,0,0,4,0,0,2,1,0,1,2,0,0,0,0,3,5,1,1,5,1,1,5,2,3,13,2,1,4,1,0,3,2,2,2,0,3,0,6,2,8,4,2,1,0,2,5,3,2,8,1,3,1,0,1,10,7,21,0,2,7,7,0,1,2,0,4,0,10,0,7,4,0,1,0,0,1,9,0,6,1,3,0,0,3,1,0,2,0,7,4,9,0,1,2,0,0,3,1,0,1,3,6,2,1,257,1,0,0,2,0,0,3,0,0,0,3,0,2,1,2,2,3,0,2,9,3,0,1,1,6,3,4,0,8,4,2,1,0,1,4,10,6,0,8,1,1,1,4,1,1,1,1,3,2,7,6,4,13,4,6,10,0,1,2,4,2,5,0,1,0,15,9,0,2,1,5,4,0,1,0,3,3,0,3,5,0,12,7,2,1,0,4,1,27,0,0,0,2,4,1,2,5,0,1,0,9,0,0,0,2,3,2,1,6,0,5,1,3,1,0,2,7,0,0,1,6,0,0,4,4,0,2,3,12,1,1,10,7,6,1,0,4,2,4,7,1,16,0,2,6,2,11,3,4,1,0,1,0,0,0,1,3,2,5,3,2,4,4,1,6,5,4,2,4,9,1,0,1,1,6,3,0,0,0,3,1,3,7,1,3,0,0,3,3,3,0,8,0,0,1,3,1,2,0,0,2,1,2,1,0,0,0,2,3,7,0,5,1,0,0,1,0,1,0,4,0,8,2,8,0,2,0,1,4,5,3,5,0,1,3,0,0,1,0,3,0,0,3,4,0,3,5,1,2,3,0,1,1,2,1,1,0,0,4,1,6,3,8,1,2,6,1,3,1,3,1,0,2,4,0,0,0,19,0,10,3,1,0,2,2,0,12,1,9,1,1,1,1,2,0,1,4,6,3,4,10,1,1,8,8,2,2,4,1,2,1,0,2,3,0,2,9,3,1,4,7,2,1,5,4,3,2,3,0,1,1,0,3,1,2,0,1,3,0,9,0,2,0,0,6,0,8,0,6,1,3,1,1,1,1,0,3,7,0,13,1,8,8,1,1,7,3,0,2,2,2,3,5,0,3,1,1,0,1,2,1,0,0,2,3,1,1,1,0,2,0,5,0,0,2,0,2,1,0,0,1,1,5,3,0,1,7,4,0,0,2,1,5,2,4,2,0,2,0,2,0,2,1,4,3,0,6,1,0,0,5,3,8,0,1,8,4,11,0,0,2,5,3,1,57,9,0,7,1,1,3,0,6,4,0,0,3,0,1,2,3,1,7,1,3,0,2,3,0,0,4,3,18,3,8,1,9,0,1,1,6,3,1,0,3,1,1,0,4,6,0,6,1,3,0,0,2,1,7,0,4,2,10,5,5,6,2,2,0,1,0,20,9,4,2,2,8,0,0,4,3,4,0,1,1,2,0,1,2,1,0,0,2,3,1,2,0,2,6,2,3,1,0,0,3,11,3,1,0,0,0,0,0,3,3,1,3,2,0,8,6,6,0,5,0,3,0,0,1,10,0,3,0,0,2,2,1,7,2,0,1,3,0,1,6,6,0,3,7,2,10,0,7,2,4,1,3,5,0,0,11,1,2,1,0,7,0,5,4,4,2,1,1,0,2,1,1,3,2,0,1,8,0,2,1,0,207,3,6,1,0,0,0,0,0,0,20,2,1,1,2,1,0,8,0,0,3,1,1,0,1,0,0,1,5,2,2,1,1,1,1,4,3,1,6,2,0,2,0,0,1,0,1,2,5,3,0,1,0,12,4,2,6,1,1,0,1,6,0,1,0,0,4,3,5,1,2,0,0,3,2,3,0,0,3,6,6,6,1,2,3,1,0,0,25,2,1,4,6,0,1,3,3,2,0,1,4,0,1,0,0,9,0,1,2,0,0,5,2,0,0,3,1,3,1,2,5,7,2,0,0,3,0,2,6,0,1,3,2,3,5,5,33,0,2,7,0,1,2,2,1,1,2,0,2,3,1,0,1,2,7,0,2,1,19,7,0,5,2,15,4,13,9,0,10,0,1,1,7,8,0,0,3,0,2,0,2,8,1,0,4,3,16,1,0,1,3,1,0,0,2,5,2,6,1,1,3,8,1,0,0,0,5,0,6,0,1,4,2,0,0,0,0,0,4,0,1,0,0,3,9,1,0,0,2,5,0,0,0,1,3,1,0,1,4,0,3,1,7,6,4,0,3,2,0,0,11,12,2,1,1,0,1,1,5,0,2,1,0,1,188,4,2,0,12,0,6,2,0,1,5,2,0,0,1,4,3,2,0,0,0,7,7,7,1,2,17,5,1,1,3,0,5,2,0,0,7,0,1,0,3,1,2,1,5,0,0,1,4,1,1,9,1,0,1,0,4,3,6,4,3,4,3,3,0,1,1,3,0,0,0,7,3,0,0,5,1,1,4,1,1,3,2,6,1,0,2,3,4,0,3,2,2,12,4,2,9,3,0,0,0,0,1,3,2,7,5,0,1,0,0,1,5,0,0,3,3,1,3,2,0,1,2,4,0,2,1,5,4,0,177,0,4,7,2,0,19,1,5,8,1,4,0,5,0,1,4,11,1,0,6,13,0,0,2,3,14,3,1,5,2,3,1,2,4,0,2,2,3,0,1,3,1,0,15,2,81,1,0,6,1,6,6,0,2,5,3,1,0,0,1,0,1,2,2,8,12,3,0,2,0,6,2,0,2,1,1,3,1,12,5,0,4,4,3,0,3,11,2,4,0,2,1,0,2,2,4,0,0,0,0,3,3,3,9,1,0,1,1,0,0,0,3,0,0,2,21,0,12,0,3,1,9,0,2,0,5,1,2,1,2,10,0,0,0,0,0,3,1,0,0,14,0,0,0,0,0,3,0,0,0,3,1,0,0,2,1,0,0,0,0,0,2,1,0,0,0,0,0,0,0,1,1,0,0,0,1,0,0,0,0,0,0,0,0,0,0,0,0,0,0,0,0
"1999 Gordon, Jaimy, Bogeywoman",high,3593,2586,1862,2163,1937,3356,459,1553,1381,1026,1592,326,942,1197,1253,792,624,647,731,456,614,632,471,143,922,406,866,300,464,492,336,455,476,365,414,278,249,437,349,327,298,687,262,299,171,200,380,395,188,241,242,152,267,185,144,193,106,249,166,234,277,226,190,266,226,114,121,187,199,124,207,145,200,220,218,118,126,146,193,170,150,90,36,148,155,120,175,122,279,142,172,114,139,117,165,84,158,89,145,74,216,208,80,114,96,96,95,76,111,16,119,176,141,110,109,70,105,121,73,33,73,85,86,104,41,28,89,99,105,116,111,76,105,45,80,54,94,110,53,96,15,116,9,80,49,64,66,63,72,147,80,47,52,47,100,25,55,38,42,26,47,32,97,97,72,94,72,29,19,75,90,33,96,56,4,59,75,68,43,57,62,38,50,40,61,34,46,33,31,85,51,22,39,63,88,45,17,28,59,57,40,27,16,69,31,21,50,91,61,124,27,89,14,53,29,42,28,3,69,40,45,25,21,36,27,37,49,46,30,61,18,47,31,32,28,23,90,40,43,27,60,8,33,34,23,37,67,37,11,43,103,49,42,12,53,43,142,30,62,67,60,8,4,57,17,117,39,72,28,49,16,48,67,21,38,41,24,28,41,29,46,13,42,15,32,28,35,27,56,38,19,36,16,41,22,31,25,41,39,64,34,49,30,27,15,12,26,71,3,21,32,96,70,23,18,15,24,77,11,11,39,55,11,13,54,22,25,27,13,24,22,19,18,18,9,47,28,3,54,35,11,17,30,8,27,31,26,8,25,28,42,11,41,31,10,12,40,32,9,13,12,11,20,5,14,30,53,40,16,54,63,9,14,6,37,47,37,4,24,20,20,19,25,21,4,5,0,29,34,41,13,14,8,21,19,33,34,9,31,8,21,26,21,11,12,16,4,31,14,28,23,23,16,2,19,17,12,48,11,35,10,0,74,8,9,24,11,14,19,7,10,26,24,21,5,18,23,15,59,30,18,9,4,20,18,20,46,17,16,18,5,10,7,27,19,14,14,20,12,19,9,5,0,17,32,19,5,5,2,12,0,10,19,81,13,18,11,2,0,10,12,21,13,6,13,32,1,13,26,8,5,7,58,30,12,45,8,17,11,26,16,7,16,8,17,16,4,20,23,1,7,26,25,29,10,34,0,15,14,5,50,13,14,12,11,16,14,27,23,29,0,31,13,4,0,17,21,26,0,5,35,9,9,15,14,20,0,54,8,3,5,32,18,4,37,4,23,36,4,1,31,8,14,20,23,9,31,3,24,0,2,11,25,12,28,5,13,19,16,8,8,5,8,30,1,22,15,38,26,20,11,7,5,16,20,13,15,8,12,22,17,8,18,11,25,0,0,10,16,24,12,3,8,0,0,12,59,35,9,28,22,5,35,7,6,50,8,8,6,13,0,12,7,8,13,0,8,15,19,9,30,56,13,1,12,9,9,24,120,21,0,12,14,12,12,11,17,38,6,12,9,10,12,10,48,20,29,27,20,10,1,13,4,20,7,73,14,13,5,4,7,20,4,7,7,17,13,6,1,22,7,8,6,15,0,23,16,0,6,11,24,46,37,15,26,38,29,11,4,5,1,6,3,9,0,3,9,16,15,5,42,3,16,5,9,13,5,5,6,18,15,16,5,7,0,26,11,10,5,8,2,9,4,12,0,4,9,13,6,5,8,11,9,21,1,2,2,7,22,6,22,7,9,6,21,3,7,11,3,13,1,0,36,7,1,2,15,13,64,14,16,25,0,3,52,13,35,2,17,8,5,9,1,29,5,1,2,5,1,11,7,23,11,5,4,3,10,5,2,0,7,3,11,2,10,15,46,0,15,9,0,6,0,13,9,10,11,8,13,7,14,1,14,10,1,9,23,3,0,38,20,4,23,11,24,6,5,0,13,1,16,16,3,2,6,16,8,6,5,16,13,11,11,5,9,4,10,0,46,15,7,9,8,1,0,15,6,7,3,5,8,20,3,21,32,7,34,12,11,20,14,3,8,2,7,4,4,0,6,11,8,12,7,4,8,7,19,5,9,1,7,0,4,0,10,3,14,7,6,3,13,3,2,5,4,3,3,0,5,16,1,12,13,0,30,15,10,18,3,5,2,0,1,9,4,27,2,13,12,13,11,8,15,9,5,10,4,8,0,255,0,14,24,1,14,7,5,2,3,4,5,10,6,8,8,10,9,5,15,0,2,8,5,0,0,54,3,0,8,1,13,7,5,32,7,15,6,7,38,0,10,0,7,0,8,6,0,0,4,23,3,8,7,4,11,2,22,0,4,2,2,4,2,0,15,4,2,4,6,7,2,13,8,15,7,2,8,2,11,6,10,1,1,6,0,6,4,10,12,2,6,9,3,17,5,0,5,7,14,33,14,4,0,1,3,9,9,4,0,0,0,3,2,11,7,2,6,0,3,7,1,5,12,11,10,1,2,6,25,1,5,0,2,1,4,3,6,1,3,11,3,28,13,7,16,12,13,8,2,7,8,2,6,1,0,8,15,1,6,7,6,5,10,14,5,2,10,2,1,0,14,2,0,2,46,5,2,6,15,3,13,9,8,3,7,8,4,0,2,3,16,5,17,13,4,0,2,2,2,3,3,3,1,15,0,6,2,3,3,0,0,5,3,22,0,15,94,3,1,0,2,7,2,2,10,2,0,1,8,0,7,6,0,4,3,51,5,19,2,7,9,0,7,6,20,7,0,2,2,11,0,8,9,10,0,0,0,2,7,0,9,3,5,3,13,22,3,26,9,6,12,2,10,6,7,0,0,9,2,2,19,7,13,0,1,2,0,1,1,7,3,1,5,7,133,1,7,3,15,7,9,0,8,2,0,0,7,5,6,3,3,15,2,1,0,3,1,16,0,0,3,1,20,8,11,4,9,5,8,4,0,3,4,10,5,7,7,0,13,8,18,0,8,10,3,9,7,6,5,1,3,15,3,10,0,9,10,4,8,4,20,17,1,0,4,0,10,7,1,2,8,6,4,1,4,5,0,2,11,4,6,23,3,0,2,10,13,7,5,17,7,3,5,5,0,5,4,5,8,0,1,11,2,0,2,3,2,3,5,5,1,1,3,4,5,0,0,2,0,5,1,0,1,1,5,24,6,1,3,5,3,2,8,28,1,3,2,0,30,1,0,2,0,4,0,11,3,0,2,3,4,4,4,2,0,10,5,2,3,6,13,18,1,5,3,1,2,3,0,21,6,3,0,0,11,3,2,3,10,4,5,4,9,4,5,3,1,12,3,4,4,11,0,11,5,0,5,5,14,0,8,5,1,0,3,11,9,0,5,4,0,5,0,6,0,0,2,11,3,11,4,15,4,2,1,8,0,0,2,12,1,4,7,2,6,1,0,0,1,2,4,0,2,0,0,2,0,4,2,3,9,2,2,9,2,3,0,0,3,2,10,2,1,10,1,2,1,2,2,6,1,0,18,0,8,0,1,0,1,6,1,1,1,2,2,3,2,0,7,2,9,1,24,3,2,8,1,4,3,10,3,0,7,5,13,4,1,4,2,5,2,11,0,0,1,21,2,0,1,5,46,18,5,21,10,6,0,7,2,8,0,3,1,0,7,1,12,0,0,7,0,0,0,3,2,4,10,2,1,4,9,11,1,1,0,2,0,7,0,4,5,5,2,0,0,1,1,2,1,4,2,0,0,2,9,8,4,9,5,1,5,5,9,9,0,1,0,2,3,2,32,2,6,16,35,10,1,8,1,8,4,4,3,7,0,0,11,0,4,9,25,5,2,1,3,6,0,0,5,3,0,9,9,3,11,0,3,3,3,2,8,0,2,4,0,4,6,2,4,1,0,1,1,3,4,3,6,1,3,0,5,6,0,1,5,6,0,2,0,9,4,4,9,17,5,0,7,1,4,9,2,2,1,2,2,1,24,3,0,6,3,3,4,14,0,7,1,3,7,0,7,5,8,4,0,11,0,5,20,1,4,1,1,2,1,7,1,9,1,3,0,1,0,12,5,12,1,3,2,0,2,2,10,5,6,4,2,40,4,3,1,3,3,7,14,0,1,5,7,4,12,0,1,0,5,3,6,0,3,1,13,6,0,0,0,3,0,0,6,55,7,0,0,0,4,9,0,2,0,0,0,4,2,0,1,10,22,0,0,0,0,5,0,6,18,2,10,1,6,16,5,1,0,2,4,5,8,4,3,0,6,4,12,1,0,2,1,3,17,1,1,1,0,1,0,3,3,1,1,1,0,11,18,0,1,6,15,0,4,4,4,0,0,2,3,0,5,19,1,1,0,0,6,1,0,3,1,0,2,0,0,5,1,0,7,0,2,0,4,3,12,0,0,5,3,1,1,0,3,1,0,2,0,2,1,0,1,3,0,1,1,0,0,5,1,0,0,2,15,48,1,8,0,0,1,0,0,2,0,3,84,1,5,2,2,7,2,7,0,11,3,5,0,0,1,0,4,2,0,4,0,0,3,2,1,2,1,4,2,3,0,14,0,0,1,0,5,1,1,7,3,0,3,8,1,1,0,4,0,4,2,2,10,3,4,3,3,4,1,2,2,15,4,3,4,0,8,2,0,0,11,5,4,3,23,2,4,0,6,1,1,6,3,0,0,5,0,1,22,2,7,2,2,5,1,9,6,3,3,2,0,0,5,4,1,4,0,1,6,3,8,1,3,0,0,2,8,12,3,5,9,11,0,0,8,2,1,0,1,11,4,1,17,2,3,1,0,1,7,2,2,8,14,5,11,8,0,2,0,0,22,3,0,1,2,10,1,19,0,0,0,0,2,14,0,0,5,0,0,4,3,2,0,3,0,3,4,0,2,7,0,8,2,3,3,8,0,5,0,3,2,1,3,0,2,0,2,4,8,1,0,2,0,0,2,6,1,13,0,2,3,1,1,16,1,0,262,1,5,3,4,0,0,0,2,1,2,1,3,1,0,6,1,5,7,10,1,8,10,6,0,4,2,2,0,4,0,0,1,2,1,4,0,2,6,0,1,2,5,8,2,1,3,0,0,3,0,0,9,2,3,0,3,1,5,6,0,0,9,0,6,0,12,3,1,0,2,1,2,7,2,2,0,3,10,3,1,10,2,0,3,0,11,4,1,1,1,5,0,3,3,1,8,4,1,0,4,2,5,1,2,4,0,2,0,2,1,1,7,3,4,0,2,0,0,7,1,8,6,3,3,2,0,2,1,1,0,4,3,2,2,2,7,1,1,0,0,0,5,0,3,1,0,1,2,1,5,2,0,0,1,9,2,10,16,0,7,2,1,7,6,1,0,0,2,0,2,6,0,0,2,1,6,7,2,0,1,5,0,0,0,2,0,6,1,11,1,0,0,3,3,9,0,1,2,0,4,10,1,1,0,2,0,1,2,0,0,0,0,0,3,0,1,2,1,1,1,0,3,6,1,1,7,0,0,2,8,6,1,0,4,0,2,0,0,1,4,1,0,0,2,1,2,1,2,0,5,1,1,0,0,5,1,0,2,4,1,1,1,7,0,8,2,0,2,0,3,0,11,3,2,1,4,2,0,2,5,3,3,4,6,2,2,2,2,1,0,0,0,0,0,13,4,1,1,2,0,1,0,1,0,12,1,2,0,6,2,0,9,5,9,4,2,1,5,2,3,3,1,1,0,0,6,2,1,1,0,1,13,0,2,0,0,1,0,4,0,6,8,2,3,3,1,0,0,0,7,0,2,2,1,0,3,6,2,4,3,4,0,2,4,0,0,0,3,9,4,4,2,12,4,0,0,0,3,2,4,1,0,0,6,2,3,6,1,2,0,2,0,2,4,0,0,5,0,0,3,2,1,0,1,1,1,2,2,6,3,0,0,0,4,2,0,6,10,12,9,2,1,124,3,5,2,2,7,2,1,0,3,0,4,1,3,29,0,0,0,0,3,3,3,1,1,4,1,1,0,1,1,3,0,1,0,1,0,1,0,2,4,3,0,0,3,2,1,0,0,3,0,191,0,2,2,19,0,3,2,5,2,2,1,2,0,3,13,0,1,0,0,2,3,3,7,0,3,2,1,2,2,1,2,0,2,1,0,9,0,3,4,2,3,0,0,0,2,0,0,6,0,3,6,3,2,1,0,3,0,0,2,0,2,4,8,3,4,0,0,0,1,1,1,6,1,1,0,0,3,7,0,0,0,0,2,2,6,1,0,2,0,0,0,47,0,0,0,0,4,2,14,3,0,0,0,2,0,1,7,0,4,1,2,0,2,0,0,1,3,18,1,3,1,0,0,4,1,0,4,1,15,0,1,1,3,0,0,10,2,0,1,2,3,3,0,1,0,4,4,3,1,2,2,0,1,0,0,0,10,0,0,3,1,3,1,3,5,1,2,0,1,2,1,0,4,1,3,1,2,5,1,0,2,4,0,0,0,0,0,1,0,0,0,0,0,1,0,2,4,1,2,0,0,0,2,0,6,5,8,0,3,1,6,3,2,0,0,0,0,1,1,0,1,6,0,13,11,0,3,0,0,2,1,2,1,0,3,5,0,2,1,0,11,1,2,0,1,2,0,1,0,5,2,7,0,0,2,1,0,0,3,2,3,2,1,0,4,3,1,0,0,0,0,2,2,1,0,1,1,1,0,3,1,3,2,0,0,4,0,6,1,0,0,0,0,1,3,4,0,1,0,0,1,9,0,4,0,3,0,1,1,0,2,1,3,0,3,0,0,1,2,0,0,2,2,4,0,6,0,1,0,4,0,0,0,0,1,6,0,0,0,2,0,0,2,0,9,3,1,1,0,1,0,1,0,0,0,0,0,0,1,0,4,1,9,1,0,11,0,0,2,0,1,1,0,4,8,3,1,5,0,5,0,2,2,0,1,3,1,2,4,1,0,5,14,0,2,5,2,3,1,7,4,2,3,0,0,5,3,0,0,1,5,2,0,0,2,0,2,2,2,1,0,0,1,0,0,1,1,0,1,0,0,1,1,0,1,0,0,1,0,0,3,0,2,2,1,0,0,4,3,1,1,0,2,1,1,1,0,2,0,3,3,12,0,7,0,3,0,3,4,3,0,0,1,8,2,0,2,0,3,11,0,0,0,1,0,2,0,0,0,6,4,0,3,1,0,1,4,1,2,2,1,4,12,1,0,1,0,1,10,1,0,2,0,10,4,5,4,6,6,2,20,0,0,1,2,1,0,0,3,2,0,0,11,1,1,8,2,0,6,1,1,6,6,1,3,0,4,2,4,1,1,0,10,0,3,0,1,11,2,16,1,1,0,1,4,8,17,150,0,0,2,0,4,1,0,1,1,6,2,2,5,0,1,0,0,1,1,0,0,0,0,0,0,0,8,0,3,0,3,3,0,0,0,0,0,1,3,4,3,3,1,0,0,2,8,0,0,0,6,1,0,2,25,0,0,2,0,7,3,0,5,0,1,0,0,2,0,9,1,1,0,0,5,0,2,1,0,1,0,0,1,1,1,2,5,1,0,0,0,5,0,9,0,3,0,0,0,3,2,0,0,2,3,1,1,1,0,0,5,0,2,5,0,1,0,5,3,0,2,0,0,0,1,1,0,3,0,0,1,3,1,4,7,4,1,1,5,1,1,0,8,1,8,0,0,1,0,1,0,0,15,0,4,1,1,0,0,5,0,2,1,7,2,0,2,5,1,1,0,4,7,1,0,0,3,3,3,0,5,2,0,0,1,0,1,0,0,0,0,0,3,0,2,1,0,4,6,0,0,3,1,0,2,1,0,0,1,6,3,0,1,2,0,0,1,1,1,0,0,0,0,0,5,0,2,0,0,7,3,2,0,0,1,0,0,1,1,0,0,4,3,2,1,0,1,1,4,4,1,0,0,1,1,4,8,3,0,0,0,4,0,2,0,3,5,0,0,0,1,2,0,0,2,0,3,0,7,0,0,0,2,0,0,20,0,0,5,0,0,0,0,1,0,3,0,0,1,0,5,1,3,4,1,4,1,0,0,7,0,0,0,1,1,0,3,3,0,0,5,2,0,0,2,5,0,1,0,0,1,3,0,0,0,1,0,0,4,2,0,2,6,2,0,1,0,1,6,1,0,0,1,0,0,0,0,0,0,0,3,0,0,0,5,0,0,0,3,1,5,0,0,0,2,6,3,3,1,2,8,2,1,0,9,0,1,2,0,0,5,2,0,0,0,0,1,0,0,1,2,0,0,0,1,1,0,0,0,2,1,0,0,4,2,3,0,0,0,3,3,2,0,0,2,2,0,0,1,1,1,1,0,0,2,0,0,0,0,1,0,4,3,2,2,2,2,1,0,0,0,1,7,14,2,4,3,1,9,4,0,0,11,4,6,0,1,0,11,2,1,0,2,1,0,0,0,5,0,1,0,1,0,0,4,0,1,4,0,1,2,6,5,0,2,3,5,0,4,6,1,0,16,2,0,3,0,0,0,1,3,2,1,5,1,6,0,4,5,1,0,5,2,3,1,0,5,1,0,1,0,0,0,1,1,11,0,11,1,3,0,0,0,6,2,0,3,0,2,0,0,1,2,16,0,0,0,0,1,0,0,2,0,0,2,0,0,0,0,0,0,0,0,0,0,0,1,1,0,0,1,3,4,2,6,0,1,1,2,5,0,0,1,6,3,0,3,0,1,0,0,1,1,0,3,4,0,0,0,0,0,0,1,0,0,4,0,0,1,3,3,0,0,0,4,2,2,3,0,1,1,2,1,3,1,2,0,0,0,2,0,23,0,4,1,0,0,1,0,0,1,0,0,3,47,0,1,4,2,2,0,0,0,0,4,1,0,1,0,8,0,8,12,1,4,1,1,0,0,3,5,7,3,0,2,7,0,0,1,0,0,0,5,0,0,2,2,0,3,1,0,2,3,2,2,2,0,0,1,4,0,3,2,1,13,1,0,0,1,1,0,0,1,0,1,1,3,0,1,0,1,1,0,6,0,2,1,0,0,4,1,0,2,2,0,0,0,0,0,0,0,0,10,3,1,0,3,3,0,0,0,0,1,3,3,2,26,0,0,1,2,5,8,0,1,0,3,2,13,8,0,0,0,3,3,0,5,11,0,1,0,6,0,0,1,0,0,2,2,9,0,0,7,0,7,5,0,2,0,0,1,1,0,2,0,0,0,1,0,1,7,3,0,9,2,1,0,1,1,2,0,1,0,1,3,0,2,0,0,2,0,4,4,85,0,2,1,0,0,9,2,6,1,0,60,1,13,0,9,1,1,1,0,0,0,1,0,0,2,0,4,0,0,3,1,2,3,10,7,1,1,0,1,4,1,2,11,0,1,2,1,5,2,0,2,4,0,0,1,1,2,0,0,0,1,5,0,0,1,1,0,1,0,1,0,0,13,1,0,2,2,3,2,3,0,1,1,6,1,0,0,4,0,1,0,0,0,0,0,0,2,0,0,0,0,3,1,1,2,2,0,0,1,5,0,2,0,0,3,0,2,0,9,0,0,0,0,24,1,0,0,1,3,4,2,0,3,0,0,3,0,0,1,3,2,3,0,0,0,2,0,1,0,1,7,0,0,0,2,2,0,0,0,0,0,3,0,1,2,0,0,1,1,1,6,2,4,2,5,1,0,0,1,11,0,4,0,0,2,1,1,0,0,2,0,1,0,1,0,0,4,1,0,2,2,0,16,12,0,2,1,0,0,0,0,2,1,0,4,0,0,1,0,0,0,3,2,1,0,1,6,1,5,2,1,3,1,0,1,0,0,1,0,0,0,3,0,1,1,0,1,1,0,0,1,0,1,3,1,2,3,0,1,2,0,0,2,3,0,2,1,0,0,0,0,0,0,5,0,0,3,3,2,3,1,0,1,0,2,0,1,0,7,1,1,1,0,6,0,0,0,0,4,21,0,1,0,1,1,0,0,0,3,1,1,0,2,2,0,0,1,2,2,2,5,3,0,7,0,0,1,1,1,0,1,0,0,0,0,0,0,0,0,11,3,1,0,0,1,0,1,0,0,1,0,0,0,0,0,0,0,0,0,0,2,1,6,0,8,6,1,0,0,0,0,0,1,0,2,0,1,0,3,0,3,2,0,2,2,6,0,3,4,1,0,1,2,0,2,1,1,3,0,2,1,1,0,1,2,0,1,0,1,4,7,2,1,0,0,3,2,0,0,0,1,0,0,4,0,1,2,1,9,0,1,0,1,0,1,1,1,5,0,0,0,1,0,1,8,0,0,1,4,0,0,1,0,1,1,10,0,0,0,0,5,1,0,1,0,6,0,2,0,5,0,3,2,1,0,0,2,0,4,1,0,0,2,0,0,0,1,0,0,0,0,5,1,2,0,0,0,2,0,1,0,0,0,0,1,1,4,9,2,0,0,1,0,0,0,0,3,0,2,1,1,1,6,0,1,6,0,1,0,1,0,0,1,0,0,4,0,3,1,0,0,0,1,0,0,4,1,3,0,1,1,0,0,5,0,7,0,0,4,2,0,3,2,0,0,2,0,0,0,17,1,0,0,3,0,2,0,2,4,0,0,1,0,1,4,1,4,2,0,0,0,0,0,1,0,1,0,0,0,0,5,0,0,0,1,0,1,0,1,1,0,0,2,1,1,0,2,0,0,5,0,2,1,0,1,1,1,5,0,0,0,0,1,0,2,1,0,2,0,1,1,1,1,1,0,1,0,2,1,0,0,0,1,0,0,0,0,3,2,1,0,0,1,1,0,2,0,1,2,7,0,4,0,0,0,3,0,1,1,0,0,0,0,0,0,3,1,2,5,0,0,1,2,1,5,0,2,0,0,0,2,1,0,0,1,0,1,0,0,1,1,0,0,0,0,0,0,0,3,0,1,1,0,0,1,1,0,0,0,0,2,1,4,0,1,3,1,3,0,0,2,1,0,1,0,0,0,0,0,1,0,1,2,1,1,0,0,2,0,2,0,2,0,0,0,0,2,0,0,0,0,2,2,0,0,0,0,0,0,0,0,0,0,0,0,0,1,1,0,0,1,3,0,0,0,0,1,2,0,0,1,0,1,0,0,0,0,1,5,2,0,0,3,0,3,0,0,2,3,1,1,1,0,1,0,0,0,0,0,0,0,0,0,2,1,0,1,0,0,0,5,0,0,0,0,0,0,1,5,0,0,1,2,0,0,0,0,0,0,0,6,3,0,0,0,0,1,2,0,0,0,0,0,5,1,0,0,0,0,0,0,1,1,0,0,0,0,0,0,0,0,0,1,0,0,0,0,0,0,0,0,0,0,0,1,0,0,0,0,0,0,0,0,0,0,0,1,0,0,1,0,0,0,0,0,0,0,0,0,0,0,0,0,0,0,0,0,0
"2002 Glass, Julia, Three Junes",high,6556,3120,3376,3712,2965,3549,2054,1957,1228,1097,1171,1183,1460,1649,1400,1065,901,905,1008,463,970,1062,1049,546,1241,884,840,466,480,737,616,470,392,523,711,606,360,419,359,518,567,527,325,379,421,557,516,557,590,303,368,319,306,245,462,398,308,277,265,349,192,186,222,291,245,234,344,199,322,305,101,296,277,216,51,241,206,67,157,185,140,230,113,156,176,129,176,148,210,199,200,144,148,169,191,240,130,156,115,199,273,159,69,195,165,234,150,167,84,104,85,136,157,98,177,114,139,252,159,91,81,224,86,101,155,150,142,161,110,111,104,107,114,87,99,168,203,126,122,88,158,75,91,113,194,73,139,150,151,40,127,115,71,113,71,117,180,103,117,74,134,105,70,90,94,160,97,94,98,77,157,88,136,57,43,131,160,119,114,73,101,67,101,56,104,106,63,82,63,99,71,135,67,62,82,83,103,65,67,174,69,64,72,118,51,6,77,38,45,17,153,65,55,86,73,103,63,109,65,57,113,121,83,89,58,56,68,62,53,38,69,108,56,83,60,47,57,67,59,64,54,114,38,57,51,36,35,55,72,33,31,50,71,38,31,60,77,37,61,33,63,24,129,72,31,105,39,100,56,50,83,77,75,58,46,72,62,53,75,22,42,105,72,43,56,50,28,111,44,49,35,340,42,64,19,58,22,39,98,57,26,60,3,50,52,48,29,50,29,61,95,95,116,44,95,53,32,36,62,28,24,49,61,62,58,61,37,28,51,29,17,38,44,41,13,26,31,72,56,20,55,56,56,12,19,44,44,14,40,18,51,26,52,24,39,83,13,26,36,65,21,3,82,29,28,15,17,23,29,15,28,8,40,113,33,25,41,32,62,49,47,38,6,15,46,7,0,38,35,50,58,26,12,1,44,18,38,27,36,19,42,20,32,58,27,65,34,18,37,33,19,54,32,21,19,83,51,29,53,36,34,0,27,32,18,17,42,54,16,14,26,36,25,26,13,25,16,38,7,17,31,36,17,16,52,20,27,15,21,40,17,20,47,24,62,35,31,41,16,16,34,52,1,29,6,26,52,22,21,9,37,19,43,1,42,32,21,25,0,24,33,56,45,0,39,7,12,17,14,22,43,20,41,45,33,11,23,10,22,39,22,4,29,20,32,26,16,26,26,18,60,13,28,31,49,30,0,38,69,3,30,32,27,11,28,20,18,44,30,37,6,32,25,40,31,3,22,60,24,14,17,50,20,20,42,29,0,14,12,1,10,11,57,4,22,49,45,34,50,30,15,39,16,14,25,26,30,28,30,37,38,18,6,23,41,13,37,28,40,47,16,11,19,14,89,12,21,13,9,15,26,11,11,62,14,38,27,13,20,17,10,15,16,12,31,2,0,18,27,111,10,2,31,28,24,26,15,24,18,26,11,19,59,27,24,14,53,13,35,16,12,21,37,46,13,0,29,10,13,35,20,26,14,33,3,12,17,32,18,9,0,23,14,19,32,22,20,4,19,30,4,13,20,9,19,16,13,25,7,29,13,36,7,33,23,13,12,32,33,44,20,15,10,15,18,3,15,30,7,7,6,74,25,24,33,16,35,4,15,2,26,3,11,19,37,21,12,17,29,27,5,18,9,6,24,1,34,27,11,30,4,2,9,36,23,15,16,65,14,11,30,18,24,17,0,1,37,26,18,13,21,31,37,14,2,0,11,31,17,16,18,18,19,31,1,15,11,28,6,4,12,6,28,1,10,1,42,18,14,26,20,24,0,24,1,14,22,18,56,8,14,37,22,9,9,14,6,35,12,12,14,22,335,3,16,48,0,17,0,24,1,20,15,21,7,12,4,13,15,13,18,33,12,11,19,26,5,1,11,51,11,13,15,17,22,6,11,19,5,2,16,4,6,17,2,1,6,13,0,44,20,18,21,37,10,15,31,0,18,1,10,14,14,13,34,15,29,7,7,9,52,24,16,4,4,38,13,0,7,10,16,14,47,16,3,16,1,7,33,4,14,12,23,9,4,29,9,12,9,29,8,10,22,2,21,10,11,0,7,13,6,8,13,14,38,6,21,3,8,16,11,0,19,1,24,55,15,13,13,11,19,7,8,6,11,20,11,4,0,8,6,7,15,2,9,3,8,6,26,21,14,12,15,14,25,1,14,13,38,14,18,19,25,9,27,10,15,9,40,10,0,15,23,0,12,17,22,5,1,9,26,0,4,16,25,16,16,5,7,5,2,27,13,0,4,5,13,1,7,7,8,3,12,17,20,14,23,28,13,0,11,1,21,4,15,17,0,4,0,1,19,11,0,12,10,12,43,0,8,19,2,10,2,5,3,4,10,0,2,11,10,10,18,7,20,15,23,50,10,10,7,6,4,9,3,18,0,5,1,11,22,11,52,0,4,0,11,14,17,25,17,2,0,4,15,6,11,7,0,0,0,3,14,27,15,20,10,0,10,5,8,11,18,10,7,14,1,22,4,2,12,0,22,21,6,19,9,37,3,12,8,10,10,17,6,11,7,6,7,11,6,20,4,15,0,3,8,5,14,14,12,12,2,22,19,31,12,28,4,1,3,16,22,8,8,6,8,7,38,19,11,18,8,16,12,5,4,10,20,20,2,9,16,12,9,9,5,17,14,8,34,15,3,9,0,12,6,6,1,2,0,9,4,13,19,20,6,10,2,0,27,2,2,12,3,8,0,6,15,0,4,9,0,26,10,17,7,4,9,4,6,0,7,22,5,2,6,9,17,7,0,5,11,5,8,0,0,11,2,10,1,11,3,2,11,7,31,6,12,11,13,10,2,17,19,0,5,7,7,19,12,11,10,2,6,1,0,12,11,10,0,10,8,10,4,10,5,3,0,4,4,0,12,11,0,4,12,33,9,6,0,1,0,10,0,50,20,3,0,86,1,14,11,10,12,14,17,59,14,50,0,12,10,39,6,17,6,8,1,11,9,19,1,12,12,18,7,6,8,11,47,30,19,17,2,3,4,8,20,8,0,7,14,1,4,10,14,12,4,13,0,23,19,2,3,9,16,0,15,13,11,3,8,194,13,1,0,5,5,13,4,14,1,6,14,16,8,12,16,1,3,13,6,0,0,8,5,3,1,13,2,7,6,3,10,1,0,29,0,0,5,0,7,13,7,8,9,2,1,8,21,16,14,15,30,9,13,0,15,0,0,0,0,5,1,16,2,0,7,25,2,20,11,8,0,16,3,3,11,13,8,7,4,7,10,15,12,1,3,8,6,11,0,0,6,10,13,2,13,9,10,3,9,10,0,21,0,12,11,5,18,10,0,18,16,0,16,2,7,2,15,1,9,0,11,12,5,0,9,35,1,3,9,7,0,0,5,2,22,2,6,5,1,11,9,8,12,9,15,15,4,8,3,4,5,14,0,0,14,9,9,1,0,0,0,27,0,4,2,2,7,41,11,4,9,8,4,0,0,2,1,3,14,27,4,9,7,10,5,18,9,14,3,5,6,0,4,15,4,22,15,4,13,16,8,8,15,0,2,9,2,6,1,16,9,3,2,14,7,11,23,12,5,2,17,7,0,2,13,0,4,15,4,0,12,5,11,0,16,4,6,8,10,14,20,10,20,2,6,18,0,14,8,2,8,12,2,0,4,3,0,2,0,6,11,4,7,4,4,16,7,7,15,7,18,4,0,9,0,7,3,5,7,0,29,13,17,26,8,4,21,4,8,10,5,9,4,11,7,3,4,0,4,3,1,0,177,9,8,13,0,11,6,14,4,5,7,3,13,17,1,21,8,13,36,4,2,0,9,0,0,6,9,9,3,2,1,17,4,1,3,2,3,1,21,0,7,14,10,2,8,0,7,22,0,23,20,7,15,12,8,8,2,8,2,10,3,11,7,4,2,17,6,3,7,11,10,12,0,7,0,5,5,13,2,0,1,7,6,6,4,2,6,0,8,12,6,8,0,7,4,7,8,10,0,2,3,15,6,2,7,12,11,7,2,11,0,1,17,3,14,13,10,1,12,9,23,3,0,0,13,9,3,10,12,2,13,3,1,7,0,5,16,12,0,1,5,10,4,7,5,7,0,6,13,1,16,29,8,9,1,14,8,5,16,13,21,15,4,19,5,15,12,2,4,2,7,0,16,4,13,13,0,0,5,6,0,21,0,0,1,0,8,11,2,0,1,10,0,6,1,3,0,9,1,6,4,7,7,4,11,5,4,5,8,10,4,9,5,5,9,11,8,0,1,3,1,9,5,3,1,13,0,9,10,9,8,1,11,10,1,10,9,4,0,10,10,7,10,22,9,12,0,4,5,0,6,1,5,6,0,4,6,3,0,5,5,1,2,9,0,8,4,0,1,6,1,1,4,1,5,214,0,11,3,4,1,1,8,1,0,0,0,7,2,0,16,6,0,3,5,1,0,14,0,8,1,13,0,4,7,3,0,15,6,3,4,3,6,2,3,1,7,4,4,1,1,0,6,13,7,8,0,0,12,3,8,2,2,14,1,4,4,15,1,8,1,3,9,1,1,5,14,1,3,2,12,0,8,3,11,0,5,2,12,11,7,5,2,5,3,7,9,8,4,9,7,3,22,10,6,6,10,3,1,0,4,3,4,0,2,2,11,5,2,12,12,1,16,13,2,4,5,0,1,3,3,4,2,3,2,5,11,4,7,18,2,0,9,12,23,6,11,0,2,2,1,11,2,5,0,3,3,9,0,2,0,5,0,7,1,8,3,13,4,2,5,3,2,2,18,5,5,0,3,1,0,0,5,5,2,1,4,26,6,6,0,0,0,13,3,17,1,5,5,1,11,5,0,78,0,0,9,3,0,0,3,6,7,10,5,5,7,4,0,3,5,3,0,20,13,7,2,1,4,7,1,5,0,6,0,10,1,0,2,0,6,2,5,9,0,4,14,7,3,11,2,11,6,4,7,9,3,4,15,1,0,2,1,2,3,0,366,1,2,11,2,2,4,7,0,7,2,2,11,1,0,1,8,3,1,4,8,1,5,0,1,0,20,2,19,10,10,9,8,1,3,7,1,1,3,14,12,5,2,0,6,0,2,13,10,5,3,5,7,3,8,0,2,0,23,2,11,11,5,8,18,2,2,5,3,3,3,10,2,11,48,17,9,7,11,1,6,4,4,1,9,9,15,3,2,0,0,4,0,11,3,10,4,4,10,9,7,2,10,5,4,2,1,4,5,0,8,9,1,4,1,11,0,2,4,3,8,2,16,7,8,0,4,10,10,10,1,3,18,10,7,1,6,3,2,6,0,15,4,2,7,6,9,3,3,3,10,3,1,1,7,2,1,12,1,2,1,0,4,0,4,6,0,1,2,1,3,11,3,1,3,6,3,8,12,8,5,3,2,3,0,1,5,0,4,5,0,2,7,0,1,2,0,3,0,4,0,7,4,0,5,1,1,6,4,9,4,1,2,4,8,2,3,0,7,12,22,0,0,4,5,4,9,1,9,1,8,11,2,2,0,0,0,2,9,3,2,2,11,0,5,8,11,0,3,15,9,1,8,6,1,8,9,7,0,2,4,0,2,0,0,16,2,9,4,8,1,0,0,9,14,0,10,5,7,2,5,23,2,0,1,3,6,3,0,4,7,3,4,15,0,1,5,10,1,0,0,4,1,1,0,0,2,7,0,0,4,2,4,11,7,6,8,7,3,4,8,0,3,10,0,0,1,3,3,2,0,1,0,0,11,8,12,8,3,11,4,2,7,5,0,9,7,7,5,17,5,7,8,1,6,3,3,3,1,0,9,4,15,3,1,5,9,3,2,2,0,4,8,2,10,1,295,10,1,14,3,1,5,5,3,0,8,5,1,0,0,7,0,0,0,10,0,6,2,7,12,3,4,9,5,0,1,12,1,1,4,4,7,6,3,0,12,1,9,11,7,3,3,8,15,0,8,0,7,6,3,0,2,8,7,0,2,2,0,3,3,2,0,1,0,2,0,1,0,3,0,1,1,10,0,4,0,0,1,0,0,11,25,1,3,2,0,0,0,1,6,1,0,0,4,0,1,2,1,1,5,1,5,1,8,11,5,3,0,5,7,1,1,0,4,3,2,1,7,10,7,3,1,1,0,4,1,12,7,0,5,8,4,0,2,6,18,10,2,5,2,6,8,7,4,10,2,5,3,2,3,3,4,14,0,11,2,2,3,3,2,10,5,5,3,17,5,7,4,0,11,6,10,0,0,6,0,2,2,1,1,5,3,0,1,1,0,0,0,0,0,6,3,0,2,0,1,5,4,1,4,2,1,1,12,0,6,1,6,4,0,4,4,1,1,6,5,5,10,0,3,10,1,0,1,1,6,0,21,2,2,14,10,1,0,0,6,2,15,4,6,1,0,0,2,4,0,6,3,3,9,6,2,0,6,0,3,2,2,3,2,7,2,1,8,3,8,5,1,3,8,1,4,4,1,10,0,0,6,2,0,4,0,4,4,0,8,0,0,0,1,1,1,2,4,4,0,1,0,2,3,11,0,1,0,4,2,5,1,2,18,0,2,0,7,0,1,0,1,1,1,7,12,8,2,5,0,10,5,8,0,0,6,4,5,7,1,5,4,10,5,0,0,2,0,0,9,0,3,0,1,6,0,3,4,3,0,0,0,17,2,7,0,3,2,1,1,7,1,4,1,1,8,2,6,5,3,2,0,1,4,6,4,1,4,2,5,0,6,5,2,2,2,4,4,6,7,0,8,1,3,0,2,1,0,2,7,0,0,0,1,12,7,3,4,1,0,1,0,0,3,2,18,2,3,3,0,3,0,0,2,7,2,1,1,0,0,2,0,0,0,4,2,2,1,0,8,1,2,2,1,2,0,4,0,2,2,7,1,6,3,4,2,3,6,2,4,1,0,3,1,0,4,5,10,6,3,2,0,4,0,3,3,1,1,1,1,2,2,3,2,9,3,0,7,1,0,4,1,4,0,3,3,1,2,1,6,3,3,0,2,3,2,5,7,3,4,0,2,1,1,1,0,2,1,2,4,0,0,1,6,6,12,4,0,1,2,22,4,0,13,0,1,26,0,0,2,3,4,2,0,4,0,8,0,2,1,3,3,2,2,1,0,0,5,3,1,2,0,0,0,5,0,0,4,1,0,2,4,1,1,3,0,10,3,5,4,5,2,5,2,2,11,2,1,6,1,2,10,5,6,0,2,3,3,4,4,2,0,2,0,5,3,3,3,2,4,2,4,0,0,7,0,3,2,0,2,4,3,3,3,4,1,0,12,7,1,5,0,0,1,1,6,3,0,6,4,1,17,1,6,1,3,4,2,2,1,0,3,7,1,4,2,3,1,2,2,6,2,0,2,0,12,4,7,5,2,0,8,2,5,2,9,1,8,0,6,3,235,6,1,0,0,6,1,1,7,1,0,0,3,9,2,0,2,1,4,8,3,4,0,1,3,0,0,0,7,4,2,7,1,1,4,5,1,3,0,7,17,0,6,0,10,4,0,1,1,2,8,0,7,1,6,0,2,0,3,2,0,5,0,2,4,3,7,5,2,0,4,2,2,7,4,1,0,6,6,8,0,6,4,1,1,2,7,2,0,1,1,2,2,5,2,0,0,0,0,1,2,0,5,1,3,1,5,6,9,4,3,2,4,7,1,5,8,1,3,1,1,3,0,1,2,1,1,0,0,3,1,14,12,0,6,2,0,8,0,4,1,4,6,2,3,9,11,11,4,3,0,0,3,0,6,2,2,2,0,6,12,2,2,6,7,0,0,0,0,0,2,0,1,0,12,31,0,1,2,0,4,3,0,4,4,6,8,1,2,5,0,0,2,6,3,0,2,2,9,3,0,0,1,5,8,4,15,0,0,0,5,7,2,0,7,7,5,2,1,2,0,9,4,0,1,2,6,5,0,7,0,3,3,1,7,10,2,0,2,3,5,1,3,1,3,2,1,3,0,10,1,2,0,3,0,0,5,0,4,0,5,3,2,1,2,8,0,4,0,1,1,0,1,1,1,4,5,3,2,2,5,2,3,3,2,7,1,1,2,7,2,0,8,2,1,2,0,0,0,0,3,0,49,12,0,2,1,4,3,3,1,3,4,3,5,4,2,2,0,0,0,0,5,2,7,0,2,0,6,1,3,0,6,5,5,6,2,2,4,0,8,3,3,5,3,1,6,7,5,2,6,2,1,1,0,0,0,5,2,0,2,0,14,1,4,6,9,5,1,1,0,6,2,7,0,0,4,1,3,2,0,0,2,4,2,2,4,2,0,2,3,0,15,4,0,7,0,10,1,8,2,0,5,7,0,1,1,4,1,0,1,0,4,14,3,3,2,1,2,1,0,0,0,0,15,3,0,0,1,4,0,1,1,1,0,1,1,5,0,0,0,0,0,2,0,1,2,0,3,2,4,3,3,0,1,0,3,6,1,2,2,0,5,2,0,1,2,9,7,0,1,2,0,0,8,0,1,2,1,5,5,1,1,3,4,3,0,6,2,0,4,10,4,1,3,5,1,1,8,1,2,14,0,3,1,6,0,6,0,0,1,3,1,0,0,1,2,0,2,3,2,1,0,0,1,5,4,0,8,2,0,1,0,6,5,0,0,11,0,0,1,0,4,3,4,0,0,2,1,0,5,1,1,0,18,5,2,0,0,6,2,0,0,1,4,3,3,4,2,1,2,3,2,4,0,1,2,0,5,5,18,0,3,0,1,1,3,2,7,6,5,4,1,7,2,0,2,0,3,1,24,2,3,2,0,3,2,5,2,2,4,2,2,4,0,0,1,0,1,4,1,1,0,8,2,5,5,3,1,5,1,1,2,0,0,5,3,3,4,5,0,3,17,1,0,8,2,3,3,1,0,0,1,3,0,5,6,0,0,0,1,1,0,1,3,0,2,0,1,3,1,10,1,2,0,2,4,2,3,0,1,3,1,2,3,1,2,0,2,0,2,0,1,0,2,0,2,0,9,3,2,21,5,1,3,8,0,6,12,0,2,6,0,8,6,0,1,0,2,1,0,3,8,0,6,6,13,10,1,0,4,0,7,0,1,2,0,1,4,0,1,0,3,0,5,3,0,3,1,1,0,5,1,8,0,1,1,37,1,1,0,0,2,0,2,6,9,1,10,0,4,4,4,1,1,7,1,0,4,2,3,0,2,0,6,3,3,2,0,1,2,0,0,3,4,1,0,4,3,0,3,4,2,1,3,4,0,1,0,5,1,0,0,5,1,0,0,2,6,2,3,4,1,4,1,2,0,4,3,1,1,0,0,1,0,1,6,0,2,1,1,4,1,1,2,2,0,0,1,0,8,0,5,0,0,1,2,15,6,2,1,0,3,4,3,0,0,7,0,6,5,3,1,6,5,0,2,0,0,0,0,1,0,0,0,2,1,0,7,3,1,2,3,7,3,6,1,1,8,0,3,3,2,1,0,2,0,0,5,8,0,5,4,2,1,33,3,1,2,0,3,5,0,0,0,0,6,0,4,0,3,1,1,1,2,4,0,2,0,7,3,2,1,6,2,0,1,6,8,0,1,2,2,1,1,0,1,19,2,2,7,0,2,0,4,6,0,3,1,1,0,3,2,2,4,5,1,0,6,10,0,2,0,2,2,5,0,4,1,2,15,1,0,1,0,3,0,2,2,0,10,1,7,3,4,4,0,9,3,2,0,5,0,0,1,0,0,3,3,7,0,3,2,3,12,2,1,1,0,1,1,2,0,0,1,3,4,12,5,2,3,1,0,0,12,0,1,0,1,6,2,4,1,6,1,2,1,12,1,1,2,2,2,0,3,0,3,0,1,1,6,1,1,0,1,1,4,2,1,3,8,2,6,4,15,0,2,0,3,0,2,2,1,4,4,3,1,0,3,0,3,4,6,0,0,1,1,0,1,3,4,1,0,2,6,0,9,5,1,0,4,2,1,1,1,3,1,1,1,4,4,0,0,3,3,0,1,2,3,0,2,0,2,2,4,3,10,0,2,6,0,0,1,0,1,2,3,0,6,0,11,4,0,0,2,1,4,0,0,0,1,0,3,1,2,1,1,0,2,0,2,0,1,7,0,2,0,0,1,0,3,0,6,5,0,0,0,3,2,1,2,0,0,3,1,3,1,1,2,0,2,5,1,3,0,2,0,4,2,2,1,1,1,6,5,1,2,1,0,3,0,2,1,2,0,1,2,0,2,3,0,0,0,2,2,2,1,1,0,17,0,3,2,6,4,9,2,1,2,0,0,0,0,4,0,18,0,0,2,0,0,3,0,2,2,4,0,0,2,1,3,2,1,0,3,5,0,0,1,2,0,4,1,2,3,1,2,2,0,0,6,0,3,2,0,3,0,1,2,9,1,3,1,7,2,3,4,0,1,3,4,0,4,2,0,2,3,3,1,4,1,2,1,1,4,2,4,0,0,0,0,0,1,2,3,5,0,2,2,20,2,0,1,16,2,0,0,12,4,14,2,3,2,2,0,1,1,2,4,0,4,4,0,1,0,2,5,2,0,3,0,0,0,0,0,9,2,1,1,0,4,5,6,1,3,1,0,1,0,0,5,1,1,0,3,4,4,0,0,0,2,0,2,6,5,0,2,3,1,0,0,0,3,0,0,0,0,0,3,1,0,0,0,0,1,9,2,3,2,1,0,2,9,0,2,0,2,0,0,1,7,3,1,1,0,6,3,1,4,1,1,0,2,0,1,3,3,3,3,2,3,3,0,0,1,2,8,2,2,1,2,1,0,6,1,0,3,0,0,2,2,0,0,0,1,0,0,0,5,1,0,0,0,0,2,0,4,2,0,6,4,3,7,3,7,0,0,6,1,1,2,6,0,2,2,3,0,0,0,0,8,0,1,4,0,3,4,5,0,0,1,4,2,3,8,4,8,2,2,1,1,1,4,0,3,5,0,0,1,2,3,4,0,2,3,1,0,2,0,0,1,3,3,0,2,1,2,1,0,1,0,7,0,0,5,2,1,2,6,0,2,1,0,2,6,2,0,0,0,1,1,0,3,0,1,3,0,3,0,3,0,1,1,2,1,0,2,6,7,0,0,0,4,3,0,0,1,0,0,1,0,4,3,9,2,3,0,0,0,1,0,1,0,2,3,1,0,0,0,1,0,3,0,2,0,2,0,0,5,2,0,1,1,2,1,1,0,0,1,0,0,1,0,0,0,1,1,1,5,0,5,1,0,1,0,1,2,4,1,0,0,0,0,0,4,0,1,0,1,0,0,1,1,0,0,0,1,0,0,0,2,0,0,1,0,0,0,0,0,1,2,0,0,0,0,0,0,1,0,0,0,0,0,0,0,0,0,0,0,0,0,0,0,0,0,0,0,0,0,0
"2004 Tuck, Lily, The News from Paraguay",high,4781,2738,2281,1728,1799,748,1229,1290,1385,427,321,1038,592,775,980,609,932,611,452,161,392,287,452,382,268,511,179,233,247,319,351,283,130,192,108,251,358,176,76,309,136,129,139,201,129,268,254,193,175,140,161,127,251,125,152,260,139,53,88,53,134,32,254,50,121,199,214,99,111,201,40,7,169,80,73,159,129,9,57,41,81,7,85,58,78,78,75,34,54,128,42,76,133,74,39,115,61,89,73,85,100,96,28,87,41,128,75,89,26,47,44,65,27,118,75,38,68,88,133,50,58,103,79,56,50,93,64,41,43,38,61,39,3,64,81,57,35,54,89,42,83,15,0,2,19,59,63,26,35,3,121,56,44,68,29,1,94,59,55,84,56,39,1,24,24,47,39,63,7,39,1,38,27,11,5,18,37,12,67,20,66,32,19,38,28,55,17,57,37,49,34,74,46,47,43,40,62,13,80,2,3,18,55,55,37,66,106,37,3,34,45,55,61,26,40,72,37,16,25,43,52,91,51,29,16,21,38,37,10,3,27,30,30,16,40,0,60,22,29,36,11,12,58,18,38,40,28,36,15,22,21,72,45,34,37,31,10,30,33,7,24,10,22,38,159,18,20,50,26,36,23,22,24,41,39,53,46,28,24,12,29,25,38,22,23,15,21,45,35,12,14,14,0,31,8,25,71,12,1,1,21,21,0,27,36,1,17,28,12,34,14,13,68,22,42,27,14,34,13,0,36,8,37,33,54,17,23,5,32,19,31,28,17,35,22,15,20,57,24,8,16,33,30,8,11,20,24,0,42,2,16,39,16,15,18,29,15,2,23,27,14,4,12,44,11,14,27,35,0,15,32,24,21,3,20,38,34,68,13,2,9,42,21,20,17,4,0,29,4,50,38,12,5,0,23,29,58,38,24,1,4,36,11,6,24,21,30,21,24,23,23,18,13,14,10,32,13,23,6,15,31,0,7,4,19,18,12,15,14,2,21,19,18,10,27,17,25,20,121,4,15,16,2,17,7,21,13,10,7,25,30,11,19,5,3,17,14,12,5,9,11,54,0,25,22,0,2,4,23,7,75,11,24,0,7,16,31,13,0,15,24,5,12,7,19,34,15,7,1,4,21,6,35,8,17,3,10,22,45,22,20,20,1,10,5,3,0,4,15,1,52,11,7,28,25,16,0,15,12,21,18,37,21,2,3,9,8,6,18,11,2,29,14,1,26,10,20,38,18,39,41,16,4,9,5,9,0,74,8,2,7,9,25,8,28,5,22,16,31,1,3,14,23,53,16,9,9,31,43,60,29,3,11,8,27,6,19,24,18,8,12,31,21,22,0,5,33,7,10,52,20,12,3,21,11,1,14,7,22,10,5,15,50,4,39,0,0,27,12,3,6,0,38,7,17,9,10,5,9,23,25,2,4,12,13,1,11,9,23,1,5,6,6,14,1,0,25,7,14,36,6,26,15,23,0,17,9,20,10,22,0,22,12,9,13,12,2,0,8,27,0,30,7,6,14,0,13,8,9,9,15,10,8,25,9,23,0,3,2,6,2,7,0,6,3,0,3,17,20,20,5,17,12,11,20,6,33,34,14,20,4,0,8,8,16,6,10,12,23,16,2,6,84,17,21,0,14,3,10,12,0,0,15,15,4,12,16,1,13,6,5,16,13,6,0,1,26,20,11,5,12,12,1,12,8,0,1,9,7,14,1,23,10,10,1,2,0,13,4,26,9,15,19,1,4,0,2,16,3,10,19,5,0,2,0,12,33,6,4,10,12,5,5,1,7,30,11,13,0,7,7,16,0,7,14,13,0,12,0,17,3,28,14,9,3,32,59,12,0,1,5,1,9,17,5,0,0,0,13,3,20,23,2,5,12,13,4,5,12,5,17,1,13,6,16,7,20,4,0,6,21,15,31,3,9,3,4,0,28,6,12,39,1,10,16,10,1,0,6,21,9,7,8,5,2,10,17,0,16,13,5,6,9,10,0,13,8,11,13,8,15,13,8,6,5,6,2,8,4,8,9,14,45,0,16,0,5,0,3,21,7,2,5,40,3,5,1,1,3,1,15,0,9,0,2,8,36,7,4,2,20,113,20,1,24,1,3,0,6,0,0,7,14,0,6,15,6,10,3,3,6,0,0,3,11,0,3,4,16,0,10,9,6,2,35,1,0,18,7,2,0,5,0,0,1,19,4,8,100,20,7,0,10,6,27,5,25,5,2,0,0,7,10,1,0,0,6,85,6,1,1,3,11,11,9,5,32,6,1,0,2,0,0,45,7,9,0,0,0,1,14,8,3,2,0,4,39,0,5,8,1,5,0,0,7,1,23,0,0,11,2,4,12,8,6,8,4,8,3,15,0,4,6,3,14,4,10,2,1,1,31,1,11,1,8,0,0,3,6,30,5,30,0,3,9,5,10,3,0,0,0,0,7,3,6,10,16,531,8,11,0,4,1,11,19,10,4,5,3,2,0,0,2,11,4,7,0,4,7,8,0,18,9,1,6,10,3,0,1,18,16,4,4,2,0,0,5,5,8,6,15,7,2,2,5,10,4,14,0,1,4,0,9,11,7,11,7,17,4,29,11,0,6,3,6,18,5,2,4,3,0,2,17,9,7,3,12,10,8,9,10,13,4,5,0,4,0,9,2,0,0,9,4,27,8,11,12,26,0,1,14,6,15,16,3,0,0,1,7,0,3,5,0,1,2,11,7,19,1,14,0,0,1,2,3,31,0,2,8,13,0,11,8,2,2,0,0,4,1,9,1,0,3,2,4,14,3,2,9,5,8,1,40,7,11,0,2,8,2,2,5,10,6,0,29,0,0,2,3,6,8,3,3,5,0,7,30,3,0,0,23,0,1,6,0,0,5,1,5,12,0,5,0,7,0,21,1,7,460,0,1,5,18,5,9,4,0,0,6,0,0,14,12,0,0,8,3,6,2,0,4,3,3,10,0,3,3,9,3,9,20,1,4,8,3,3,7,9,0,22,5,2,0,0,2,19,8,3,13,0,3,9,5,6,2,9,6,2,0,10,12,8,3,0,23,0,1,5,1,0,7,15,2,12,12,22,1,0,1,2,0,7,8,0,5,4,6,5,3,8,3,7,6,1,6,0,0,3,0,0,70,0,1,8,7,6,9,7,0,7,0,3,18,12,4,0,5,0,11,10,0,0,0,8,0,3,28,0,18,0,1,21,2,1,0,9,5,1,7,7,10,1,0,2,8,3,6,15,1,3,9,7,0,0,0,3,1,11,14,5,7,6,4,4,0,4,0,4,6,1,7,0,0,4,6,0,2,0,10,0,0,5,6,0,4,7,1,0,3,1,1,19,18,2,0,3,4,0,2,1,0,3,2,4,0,5,3,1,1,6,0,4,1,11,14,2,0,0,16,7,2,0,4,0,0,15,0,3,2,1,3,33,14,18,7,1,6,0,39,2,1,1,5,2,5,5,4,1,0,4,1,7,0,0,2,0,2,3,5,22,5,2,6,6,10,4,3,0,4,17,4,0,5,3,1,20,2,4,1,13,0,2,1,6,10,12,16,5,1,8,1,7,3,0,0,12,8,0,12,6,3,7,2,12,1,14,0,3,0,3,0,1,4,3,3,5,0,0,4,2,0,11,0,5,2,1,2,1,9,9,4,2,0,1,6,3,0,1,1,27,1,8,12,0,3,12,1,11,2,20,4,0,3,1,9,4,4,3,8,8,0,1,4,2,0,0,0,1,6,17,0,5,9,7,0,4,1,0,1,6,1,9,7,1,2,3,10,0,2,2,0,3,1,1,0,0,1,3,14,2,0,18,5,0,11,5,0,4,10,6,1,0,13,3,0,0,5,9,5,4,0,0,1,6,2,7,3,0,7,0,0,3,0,1,1,3,0,4,0,10,9,2,0,3,3,0,3,0,5,9,0,7,1,58,4,0,2,6,11,0,1,5,4,5,0,0,9,8,4,6,4,6,8,4,18,1,0,5,3,4,8,5,4,50,6,9,0,1,1,0,4,1,12,3,2,0,4,2,0,8,0,3,1,4,1,11,3,4,5,13,1,3,0,3,4,2,4,1,4,0,27,0,2,3,12,5,5,1,4,4,0,3,0,3,8,0,6,0,0,9,0,3,0,0,5,3,0,2,0,0,0,22,2,1,37,7,2,8,0,3,0,0,0,3,1,1,3,5,6,6,1,6,4,3,2,3,4,4,0,1,8,20,0,13,0,2,4,4,0,10,1,1,0,1,1,3,6,0,2,1,0,10,2,3,6,5,11,2,3,1,4,8,0,14,1,0,0,1,0,3,0,1,2,5,0,1,1,0,0,3,0,5,8,0,3,0,2,41,5,4,9,0,0,0,2,6,4,0,2,5,0,0,0,3,7,0,3,1,0,5,1,1,0,3,3,7,0,0,0,3,2,0,0,6,2,15,0,3,6,7,0,0,1,0,4,1,9,0,1,7,4,0,0,0,8,2,3,1,3,2,1,12,1,0,3,3,1,0,0,3,1,1,2,0,4,1,2,0,1,6,2,0,3,9,1,2,0,0,1,1,0,0,45,1,0,1,2,4,7,5,1,0,6,0,0,0,1,5,1,0,0,1,1,5,0,7,2,2,13,1,1,1,1,0,1,2,2,0,6,1,1,2,0,2,2,3,6,0,7,2,5,0,7,7,4,3,22,6,0,1,0,3,0,1,0,0,0,9,2,5,0,2,0,1,8,0,0,0,0,11,4,4,4,2,2,2,1,7,3,0,1,1,0,2,0,0,0,0,1,0,9,5,0,7,4,14,0,4,0,0,5,0,3,9,0,0,2,11,7,0,2,3,2,1,0,1,2,4,0,1,2,5,4,0,3,11,0,4,0,1,0,2,0,0,3,0,0,3,2,0,0,1,6,0,15,3,2,3,1,0,1,1,0,111,2,0,0,9,14,5,1,10,0,34,6,12,4,0,3,3,3,2,1,5,8,3,2,2,1,1,0,2,0,2,1,9,0,0,15,2,11,8,6,6,5,0,8,12,3,6,5,3,3,2,5,3,1,4,0,1,8,1,0,11,6,1,21,0,3,0,1,2,5,3,16,4,1,1,0,1,4,0,12,8,1,4,3,3,6,5,5,0,2,0,0,7,2,2,0,37,3,0,2,1,0,1,0,2,4,0,1,0,0,5,5,2,6,3,0,2,6,3,0,0,2,3,0,3,5,13,4,0,6,3,0,5,10,0,0,1,5,4,6,8,4,4,4,2,7,9,1,0,0,5,1,0,1,0,6,3,1,5,1,10,0,0,0,0,0,17,2,1,0,4,0,0,7,3,11,0,0,2,0,6,0,0,0,5,2,3,1,1,5,8,0,0,4,0,0,18,5,4,0,0,0,0,1,0,4,1,0,7,0,1,3,0,2,0,1,0,3,2,0,3,6,0,5,8,1,0,2,4,2,0,3,17,1,1,2,0,17,0,0,5,0,8,19,9,0,0,6,3,8,4,0,0,0,3,9,0,6,8,12,1,3,2,2,2,2,15,0,2,0,0,7,0,2,6,6,2,0,6,1,0,0,2,0,6,3,5,5,1,7,3,0,1,0,0,1,3,0,0,16,5,0,13,0,3,4,4,3,4,3,1,0,8,8,0,12,1,7,1,0,1,1,11,0,0,1,1,0,3,0,1,5,3,0,0,0,0,0,6,0,0,0,6,1,1,1,1,4,22,1,3,2,2,0,0,3,1,1,3,0,2,4,8,0,4,1,0,5,1,0,1,11,2,1,1,1,1,4,1,0,0,5,2,3,1,0,0,0,20,5,0,0,0,2,4,0,0,0,0,0,3,0,0,2,3,0,1,5,1,2,0,3,3,4,0,0,4,7,6,4,0,2,8,15,3,3,0,1,0,3,3,2,17,8,7,1,0,5,0,2,0,1,3,4,3,2,1,1,4,1,6,0,3,7,0,2,0,0,7,0,0,5,1,0,0,4,0,3,0,0,0,0,0,10,11,0,0,0,0,0,0,2,0,1,9,2,0,1,5,0,4,3,0,0,1,6,3,0,4,3,0,14,6,1,2,12,0,1,3,9,10,0,0,0,2,2,2,1,0,3,2,2,0,6,0,1,2,4,6,3,1,2,2,2,2,0,1,2,0,4,1,2,2,1,2,7,5,1,5,2,3,0,1,9,0,0,3,1,1,3,3,1,0,0,6,6,0,1,1,0,2,1,0,1,2,6,3,0,0,1,2,11,0,3,0,0,1,0,0,0,1,0,0,0,1,1,5,0,1,0,0,1,0,0,0,0,7,5,0,1,3,0,2,0,2,0,0,3,0,1,29,1,0,4,0,2,1,0,1,1,2,0,3,0,3,0,2,1,3,2,1,4,1,3,0,1,0,13,1,3,3,3,2,2,6,6,2,3,11,1,6,2,3,3,0,4,0,3,2,8,0,0,1,3,1,2,1,0,4,1,0,6,0,1,0,1,0,2,11,0,0,0,4,0,0,11,5,1,3,13,0,4,3,0,0,0,2,4,1,1,3,6,5,0,10,0,0,3,2,7,0,2,10,0,1,6,4,3,0,0,0,4,1,0,0,1,3,3,2,11,6,0,2,5,0,0,0,0,7,3,2,0,0,0,1,0,1,0,9,2,8,5,1,13,0,2,1,0,0,7,2,0,0,1,4,0,0,4,2,3,0,0,2,10,4,1,0,1,4,3,0,1,0,0,8,1,0,0,2,1,1,0,1,0,2,0,0,0,0,0,0,2,4,0,4,0,4,4,0,0,3,1,5,0,0,0,1,0,0,0,0,5,5,1,0,3,0,6,0,3,0,0,0,0,6,6,2,0,3,0,1,0,1,1,4,5,4,0,1,0,0,12,2,0,3,2,2,0,0,0,6,3,1,1,2,0,3,4,3,1,1,0,0,1,0,0,1,0,0,160,1,3,0,1,0,2,2,0,0,2,1,0,5,0,0,0,1,2,0,4,0,0,2,1,1,3,0,0,0,1,2,0,2,0,4,5,5,0,3,0,0,0,1,1,0,0,3,1,0,0,3,0,0,3,0,1,0,0,4,12,0,0,1,0,0,0,3,0,0,0,5,0,31,0,0,0,0,0,5,0,6,0,0,1,1,0,7,2,1,14,0,7,1,0,5,8,1,0,2,3,0,0,0,1,2,1,0,2,2,0,1,5,4,0,3,2,5,1,0,0,0,0,0,0,0,6,0,0,9,0,2,4,0,6,2,3,2,0,0,3,1,7,0,1,0,2,1,1,4,1,0,2,11,3,5,3,0,2,0,4,0,0,0,3,2,3,0,1,0,0,2,7,0,0,2,2,0,0,1,0,10,5,0,10,1,1,2,0,2,0,0,0,1,0,0,4,4,0,3,2,0,1,19,1,0,2,2,1,2,3,3,3,4,0,0,3,2,2,1,0,6,2,2,2,0,0,11,1,0,2,0,0,0,0,1,2,0,6,3,0,3,0,1,3,1,10,1,0,3,0,0,4,3,5,0,1,0,0,0,1,5,4,0,0,2,4,3,1,4,2,1,21,3,3,1,1,0,3,1,2,1,1,0,0,0,0,3,0,0,2,1,3,0,0,2,0,4,1,13,1,0,0,0,10,3,0,1,4,1,3,0,1,2,33,2,1,1,2,0,0,1,3,1,12,2,1,1,0,1,1,0,2,2,2,1,1,0,0,1,0,1,0,1,0,7,10,0,0,2,1,1,0,8,2,1,3,2,1,139,2,2,2,0,0,0,13,0,0,1,0,6,2,7,2,0,4,0,0,0,5,0,1,0,2,0,5,0,0,0,0,6,2,0,3,0,0,0,0,4,0,0,4,5,2,1,0,3,46,4,0,2,0,1,1,0,0,1,0,4,5,3,5,4,0,1,1,1,11,0,1,13,0,0,0,0,0,6,8,0,0,1,0,2,1,0,0,0,0,0,0,3,0,0,1,2,1,0,0,0,4,0,0,3,1,2,12,7,2,6,7,3,1,6,4,9,6,0,0,1,0,4,1,1,1,0,4,4,1,0,0,3,0,1,8,0,1,4,2,0,0,1,10,2,0,1,0,0,4,2,6,0,3,1,3,0,0,0,10,0,2,2,0,0,0,84,1,0,2,5,0,0,3,0,1,2,1,2,2,0,3,6,3,0,0,4,0,1,0,0,1,1,2,0,0,2,0,1,1,3,0,6,0,2,0,0,0,0,0,0,1,6,5,2,1,1,0,4,0,0,3,14,1,0,0,0,3,6,3,0,1,0,5,2,3,1,10,1,3,3,1,0,5,9,0,0,0,0,2,0,0,0,3,2,7,2,0,5,1,1,0,0,1,0,1,12,5,1,2,2,0,0,0,1,2,1,1,5,0,3,7,26,0,2,2,3,0,0,0,0,0,0,0,1,0,3,1,0,0,2,0,7,11,0,0,0,1,2,4,0,3,0,0,0,6,4,54,0,1,0,2,0,0,1,0,0,4,5,0,2,3,0,10,6,0,1,3,0,1,4,5,0,0,0,0,0,0,0,1,0,1,0,0,0,0,0,1,0,0,1,0,2,1,20,0,1,0,0,8,0,3,1,0,0,0,0,8,1,1,2,2,0,4,1,1,0,0,0,1,2,3,0,14,0,1,2,1,1,0,6,0,1,0,1,5,0,5,1,1,10,1,0,5,0,2,1,1,0,1,5,0,1,3,0,3,0,5,0,0,0,6,6,0,4,1,11,1,1,1,2,1,1,0,0,0,0,13,5,1,0,0,0,1,8,0,0,0,2,0,1,9,1,0,4,0,0,0,2,1,0,6,0,5,0,0,2,4,2,0,0,0,1,0,0,0,0,0,0,0,5,27,1,7,0,0,6,0,0,1,1,11,10,0,4,2,13,3,0,1,0,8,4,0,2,0,0,1,0,2,0,3,7,3,0,2,2,1,1,0,3,1,3,6,2,0,9,0,0,0,2,0,0,4,12,1,0,0,2,1,0,3,0,4,2,3,0,1,0,1,0,0,1,2,0,0,12,1,3,0,0,4,0,0,2,5,0,4,4,0,8,0,4,0,3,2,2,0,1,0,0,2,0,1,0,1,1,0,0,2,0,1,1,1,0,3,0,2,3,2,5,3,3,0,4,2,3,0,4,0,0,1,6,0,7,0,0,1,1,0,0,0,1,2,2,1,0,0,0,0,0,0,0,0,0,4,1,4,2,0,3,0,0,2,0,1,1,1,0,1,0,4,3,1,0,5,0,1,4,0,1,3,1,7,2,1,0,0,0,0,0,0,1,0,0,1,0,0,3,0,0,0,0,1,0,0,0,0,0,2,0,3,1,0,0,0,0,0,0,0,2,0,5,0,1,1,5,0,0,0,0,0,1,1,0,0,0,0,0,0,2,0,1,0,0,0,0,0,1,0,2,1,0,7,0,2,5,0,0,3,0,0,0,0,0,21,0,0,0,5,0,0,0,0,3,5,3,1,0,1,1,0,0,5,0,0,0,1,0,0,17,1,2,0,0,0,0,3,1,2,1,2,0,0,0,1,1,2,0,0,0,3,4,2,0,0,0,2,0,3,2,0,0,2,0,0,0,0,0,3,3,0,6,0,0,0,3,1,1,2,0,1,2,1,1,0,2,5,0,0,1,0,1,0,1,0,4,0,5,0,2,1,0,1,1,0,5,1,0,1,10,0,1,1,0,5,0,2,1,0,1,3,0,2,0,0,0,0,2,1,0,2,0,3,0,0,4,1,0,1,0,1,0,0,0,4,2,0,1,6,0,0,0,0,0,0,0,0,1,2,0,1,0,0,4,5,0,0,1,1,2,1,0,0,0,2,0,2,0,1,2,0,46,0,1,6,0,4,3,2,2,3,4,3,1,0,1,3,2,1,0,3,0,0,0,0,1,2,1,0,13,1,0,1,0,6,3,0,2,0,0,0,1,1,0,1,0,5,4,0,3,2,2,0,3,1,0,2,1,4,0,0,0,0,4,2,0,0,0,2,0,9,0,1,0,0,1,1,0,0,0,0,2,2,0,0,5,2,0,3,1,1,0,0,0,0,0,0,1,1,0,2,3,0,1,0,0,2,0,2,3,1,3,0,0,2,1,1,1,3,7,0,3,2,1,1,1,0,1,0,0,1,0,0,7,0,2,0,2,3,0,2,1,3,0,0,0,3,1,0,0,1,0,0,2,0,0,0,2,1,0,0,3,0,1,0,0,0,0,0,10,2,0,4,0,0,2,1,0,0,3,3,0,1,2,0,0,4,0,1,0,0,1,6,0,0,0,2,0,1,0,0,2,0,0,2,0,0,7,7,5,0,1,0,0,3,0,5,0,0,0,1,0,0,0,0,0,1,0,0,3,0,1,0,0,0,1,0,0,0,0,0,2,5,2,0,2,3,0,5,0,0,0,5,0,0,3,1,5,1,0,0,0,0,0,0,1,0,1,11,7,0,3,1,0,0,0,0,0,0,2,1,0,0,0,3,0,0,1,0,6,1,0,1,1,0,0,0,1,0,0,2,0,1,1,0,0,0,1,5,0,1,1,2,0,1,1,0,0,0,1,1,1,1,0,1,0,4,2,0,0,0,2,2,3,6,3,2,5,0,2,1,0,4,0,0,0,0,0,1,2,1,4,0,13,2,1,0,4,0,1,0,1,0,0,0,3,0,2,2,4,3,0,1,0,2,0,4,0,1,2,0,0,0,0,2,0,1,4,1,0,0,0,1,0,0,0,0,3,0,0,4,1,0,19,1,2,2,2,6,3,0,0,1,0,0,3,0,0,1,4,0,1,6,0,0,0,2,1,0,0,0,1,1,1,0,2,0,0,0,0,1,2,0,2,0,1,1,0,0,0,0,1,1,0,0,0,0,1,0,0,0,0,3,0,6,2,24,3,0,0,1,0,0,0,1,2,1,0,1,1,0,5,0,0,2,2,0,0,3,0,0,0,0,0,0,9,0,5,1,1,2,0,3,0,0,1,0,3,0,10,0,1,2,0,6,3,2,0,1,2,0,0,0,0,0,0,0,0,0,0,2,0,2,0,2,0,0,0,0,0,0,0,0,1,2,0,8,0,0,0,5,2,0,0,0,0,0,3,1,0,1,1,0,0,0,0,0,4,0,0,0,0,0,1,0,0,0,3,0,0,0,0,0,4,0,3,0,0,0,0,0,1,0,0,2,0,0,0,0,0,0,0,3,0,0,0,0,1,0,0,0,0,0,0,2,0,0,3,1,0,0,0,0,0,0,0,0,0,0,0,0,0,0,0,0,0,0,0,0,0,0,0,0,0,0,0,0,0
"2006 Powers, Richard, The Echo Maker",high,8132,2772,4081,3512,3119,1258,3108,2332,1231,1314,1900,2112,1512,2449,2242,1174,789,1042,1216,316,1027,965,838,1493,323,638,606,831,835,676,695,699,832,587,836,573,401,715,337,579,462,650,281,532,480,452,372,399,408,280,608,491,491,464,359,389,345,460,405,617,297,0,360,381,281,278,344,307,292,252,233,0,364,239,160,352,272,0,350,240,247,0,240,271,195,157,201,302,441,226,190,163,307,264,201,219,199,202,169,269,232,238,150,318,147,97,318,263,164,417,170,171,104,251,199,71,186,170,134,183,155,132,89,170,144,157,228,190,120,188,101,156,0,115,141,158,58,206,163,190,92,130,0,0,59,89,149,268,123,115,129,40,114,113,284,0,201,152,149,165,169,134,0,189,73,407,158,111,171,67,0,198,131,0,90,118,193,125,189,88,138,100,53,81,92,117,217,66,66,194,107,99,87,97,36,99,58,108,158,17,0,58,141,124,71,26,132,36,0,73,46,89,29,70,85,140,103,90,127,129,104,98,98,81,78,64,115,68,130,120,60,64,85,82,79,0,56,68,54,61,103,0,60,136,54,44,63,67,101,56,78,86,56,54,53,76,136,55,75,105,54,58,43,111,16,56,106,70,68,50,82,114,59,42,65,83,122,101,71,57,29,48,53,95,109,30,73,75,120,94,39,135,69,43,68,68,93,87,0,0,37,89,53,38,45,0,24,42,37,38,91,35,69,72,55,55,43,37,49,0,61,43,59,45,133,53,57,118,102,23,73,74,56,64,101,46,61,20,93,81,64,62,36,22,76,87,47,49,55,0,66,37,59,40,64,50,49,0,41,120,50,33,84,23,32,32,40,31,0,137,67,33,53,23,30,50,28,43,30,0,12,72,51,62,55,27,0,53,0,33,45,94,83,8,30,24,41,37,66,56,38,27,26,61,31,37,36,52,36,14,29,53,35,86,41,27,83,22,54,61,26,0,24,19,32,59,85,20,47,26,19,54,27,43,1,21,37,129,91,75,43,30,0,36,53,29,13,30,37,23,38,41,53,59,0,58,33,86,38,31,20,131,1,18,78,55,10,32,14,28,24,10,37,0,37,35,30,15,0,28,49,28,55,3,24,24,34,21,24,33,27,43,36,43,41,27,27,38,24,33,33,15,20,30,23,39,0,54,43,24,27,50,58,44,40,30,0,37,35,37,36,25,34,18,50,73,0,62,29,4,1,24,24,0,37,3,55,27,13,11,37,33,34,13,22,44,0,2,33,40,25,57,31,5,36,65,26,67,26,12,14,26,26,0,34,44,26,13,18,5,3,0,80,34,13,20,21,130,48,22,8,25,37,21,2,27,15,25,14,57,45,31,15,66,29,0,6,10,25,44,33,21,19,51,16,0,1,24,28,56,7,16,66,36,4,39,17,10,37,28,10,21,32,44,25,36,27,22,18,14,25,10,9,13,2,0,32,19,29,29,23,16,33,30,25,6,10,35,43,17,0,25,26,49,27,7,12,36,18,16,26,6,31,34,70,43,22,36,13,26,30,56,17,20,72,16,53,50,26,20,12,13,42,18,52,0,4,34,19,23,27,18,17,17,16,18,23,0,8,47,43,29,6,28,8,21,25,14,26,21,916,25,86,9,24,9,15,29,15,24,49,70,17,6,17,22,33,28,25,32,46,14,8,11,0,23,40,16,33,21,10,37,17,15,0,4,20,33,14,50,10,18,11,41,7,12,26,15,14,21,26,11,26,33,11,12,28,3,0,12,15,13,8,2,0,18,6,18,16,7,14,85,15,17,13,75,8,46,41,9,5,8,0,26,7,53,1,39,3,26,39,22,24,24,18,4,21,9,0,14,22,23,23,17,19,22,22,0,24,21,8,27,20,31,31,42,30,29,21,21,11,0,4,8,3,30,20,43,5,17,6,18,7,20,16,6,0,0,21,13,3,10,2,15,35,28,0,19,31,21,16,23,20,6,16,10,18,11,18,22,22,13,25,8,0,11,28,23,19,8,31,14,29,27,10,15,9,16,11,11,24,3,12,21,21,11,18,0,36,14,7,6,4,17,22,11,25,12,20,20,24,0,4,0,12,4,7,10,45,0,25,2,8,25,11,66,31,1,32,6,16,13,5,6,23,3,16,24,12,11,24,16,19,21,24,18,16,25,26,13,15,22,17,11,3,19,7,19,24,16,0,17,7,0,13,11,5,6,5,11,13,1,12,81,12,17,15,2,13,12,1,36,16,31,4,1,22,0,15,13,34,6,33,17,23,14,0,3,15,0,18,1,0,0,7,12,0,0,1,18,14,13,1,14,16,13,5,0,18,14,10,15,13,2,3,10,8,14,19,11,9,8,25,23,33,21,23,0,8,14,24,32,26,20,2,38,19,8,16,11,16,9,0,17,11,0,0,9,20,6,13,3,0,16,11,4,9,50,0,0,0,9,24,21,20,18,19,0,20,9,11,6,10,7,5,10,3,9,8,1,9,0,9,30,15,19,145,1,20,25,12,9,20,0,20,13,9,37,18,14,10,32,3,8,0,1,14,14,16,4,10,17,3,22,15,13,15,29,11,2,11,12,6,2,6,16,25,16,24,2,1,0,10,22,10,11,14,16,7,29,12,7,19,13,27,6,3,12,16,22,0,15,22,2,0,10,6,20,2,12,0,7,21,8,2,12,6,4,16,0,10,14,4,8,16,14,1,15,9,0,7,13,0,13,6,2,32,7,1,15,5,0,17,13,4,7,11,19,8,16,1,5,3,3,10,0,0,5,6,12,6,6,7,38,5,10,30,11,10,11,12,7,2,3,14,0,13,15,6,22,11,33,6,0,6,7,0,18,16,4,10,14,11,11,20,14,11,104,11,12,2,0,2,6,0,2,23,15,9,4,0,5,4,8,0,4,9,17,0,7,9,10,3,8,7,10,3,11,17,15,0,19,2,29,6,10,15,4,4,7,8,3,10,6,8,13,5,32,15,10,4,0,17,19,16,9,2,6,7,5,5,9,17,0,11,4,15,4,2,27,4,10,5,14,20,20,19,1,7,8,18,13,22,0,6,13,23,2,19,0,7,24,9,21,7,1,8,10,1,5,35,6,15,0,18,16,7,11,18,18,10,4,11,10,11,0,0,5,0,1,3,0,17,14,9,26,6,10,4,7,4,6,10,7,8,8,4,0,13,19,0,0,0,9,0,11,1,0,3,7,11,11,18,21,0,8,0,6,12,4,12,9,6,33,6,16,7,4,9,6,32,15,0,0,10,6,16,5,8,7,8,14,32,12,0,9,6,15,8,18,15,8,0,22,16,0,11,4,13,4,0,5,8,0,10,0,11,0,25,27,17,6,9,7,0,0,5,6,8,9,12,7,6,23,4,25,12,8,4,5,10,27,11,18,3,10,1,16,31,11,13,1,0,0,0,104,0,5,21,3,8,29,10,16,4,14,2,0,7,14,4,9,6,9,26,3,9,7,15,6,18,10,2,4,11,0,15,5,6,16,12,5,9,11,8,13,8,23,6,8,10,9,7,18,2,1,5,2,21,13,11,8,9,16,3,16,0,3,7,3,13,11,16,0,18,3,31,8,7,8,23,7,4,4,14,18,2,12,0,2,0,12,0,3,4,6,3,0,6,6,0,3,0,13,7,7,9,21,5,17,7,5,8,15,13,12,7,11,0,6,1,4,13,0,30,5,2,2,5,5,15,2,6,3,3,3,16,4,18,6,17,5,15,28,0,6,7,7,13,14,10,5,12,3,7,13,21,5,24,5,12,6,11,1,7,12,7,0,10,17,4,16,4,15,9,10,0,5,4,7,12,8,13,18,43,5,2,4,12,1,12,0,6,7,0,15,10,1,15,17,2,3,2,11,2,18,17,0,4,10,2,5,4,3,6,3,8,7,539,10,11,7,23,4,8,1,13,205,4,4,5,18,8,0,7,3,5,8,4,0,8,3,3,11,0,7,13,16,7,2,14,2,2,10,1,2,0,7,7,13,6,3,29,6,2,6,1,19,15,0,12,9,1,28,0,0,1,4,7,5,5,1,5,20,0,8,18,20,10,4,6,9,0,11,2,0,9,14,16,19,7,5,12,4,1,4,18,17,1,4,8,11,11,15,5,0,4,0,4,4,7,7,0,0,8,10,0,10,0,0,270,2,9,2,1,20,3,26,0,13,7,17,0,7,8,17,11,6,4,1,21,6,7,0,3,7,9,16,10,30,8,1,4,0,3,5,1,9,2,5,3,13,0,2,9,12,3,3,11,10,0,5,10,1,2,6,10,18,12,2,5,7,1,10,18,17,0,0,9,5,0,0,7,14,0,6,6,7,7,9,0,5,7,0,5,15,15,5,1,15,8,0,1,4,5,9,5,0,9,9,3,0,0,7,1,0,4,6,22,9,1,1,0,2,3,9,4,2,6,2,4,6,13,13,0,11,0,3,1,8,18,7,5,6,2,9,7,8,3,25,8,7,12,0,3,13,8,7,18,5,3,7,15,1,8,7,1,2,5,7,2,9,2,0,11,10,4,0,6,3,2,0,7,12,14,6,4,3,7,2,3,23,2,11,4,7,9,1,21,6,12,5,11,4,2,0,5,0,2,0,4,18,7,3,7,5,6,2,22,7,9,10,1,1,0,6,3,1,4,9,3,8,5,4,13,12,3,12,6,11,8,0,5,14,10,4,4,9,15,1,0,0,5,7,0,4,16,8,10,5,9,14,0,11,6,25,1,0,15,0,17,4,4,3,5,2,1,11,4,6,15,0,16,31,15,21,0,0,12,3,6,5,6,17,2,2,33,7,0,0,6,0,5,1,0,0,39,6,1,5,3,10,12,1,446,7,6,13,26,11,6,3,5,1,10,7,13,2,0,11,1,6,0,0,18,0,9,4,3,7,0,5,0,31,11,9,8,1,4,7,5,4,8,0,19,0,0,5,2,2,7,0,0,1,3,17,2,7,13,0,4,9,12,1,10,7,8,2,2,6,0,16,6,13,12,5,0,0,63,9,21,9,5,10,8,0,3,16,0,4,6,4,10,3,25,1,1,19,1,2,11,1,7,17,5,3,1,0,5,0,2,3,10,27,3,10,4,6,164,7,6,13,0,5,10,11,20,8,18,3,2,7,6,2,12,9,21,5,0,3,5,1,8,17,2,4,9,7,1,7,2,8,10,2,6,11,4,13,4,2,7,7,3,7,1,6,7,18,7,2,8,10,5,12,4,1,21,10,13,11,11,2,7,12,2,4,9,5,7,2,21,7,0,14,7,2,4,4,6,5,1,4,10,3,3,10,8,16,6,10,17,10,1,2,9,2,18,11,2,0,7,7,3,7,4,11,15,9,5,2,0,4,3,8,0,7,3,3,2,2,10,4,6,7,1,0,20,6,2,2,0,12,6,3,10,0,3,1,6,15,1,3,2,4,3,0,7,2,9,6,18,8,10,0,8,0,5,6,5,0,4,3,6,11,1,1,1,2,0,1,6,1,4,4,1,0,1,4,10,0,3,9,9,1,1,4,2,4,12,11,1,9,4,0,8,0,10,9,6,3,4,5,4,1,0,3,4,0,2,3,3,0,6,5,11,33,0,0,4,5,0,3,19,7,18,3,0,2,4,7,9,2,9,4,2,6,18,0,0,8,6,1,12,2,9,0,3,5,13,24,0,13,3,1,5,22,0,0,38,1,4,5,0,3,0,1,10,2,18,12,9,3,3,1,2,7,6,4,4,3,0,2,9,10,3,17,7,6,0,2,8,0,6,3,0,1,9,7,3,0,6,7,0,24,12,20,8,20,0,2,3,10,2,8,9,11,4,2,8,0,0,0,0,7,0,0,0,3,0,13,5,2,11,4,7,3,5,3,1,3,2,4,5,5,3,7,1,21,9,4,6,1,5,7,7,13,3,17,2,0,4,2,27,0,14,3,9,0,5,2,1,2,5,9,14,20,0,16,1,1,1,4,0,10,8,0,0,11,2,0,4,0,1,5,26,321,0,4,1,0,0,8,2,2,11,30,10,5,1,4,5,3,3,4,4,7,6,4,1,1,8,0,6,0,3,3,6,0,6,1,8,9,4,5,0,6,0,8,3,6,6,0,0,5,5,0,1,3,21,7,7,10,15,9,4,2,8,3,9,5,5,5,3,6,2,15,1,8,14,1,9,1,1,1,0,3,2,4,4,9,1,0,2,13,16,1,9,4,2,4,5,0,0,8,5,0,1,6,3,5,0,0,34,10,2,2,6,0,1,7,3,7,11,10,0,8,9,4,11,10,2,5,0,9,12,0,5,1,3,0,0,8,2,13,1,1,8,3,7,2,8,1,0,0,24,3,11,5,4,5,3,8,18,0,0,0,3,10,1,7,14,2,0,1,7,5,3,0,6,5,7,2,15,5,1,2,28,2,3,7,7,5,6,4,7,4,1,9,2,0,11,9,3,7,0,7,11,5,1,0,1,0,7,3,4,6,6,2,0,7,2,6,11,4,0,2,0,8,0,6,9,8,2,6,4,6,2,0,3,0,3,3,4,4,2,4,11,1,1,0,0,1,3,1,3,6,7,8,8,1,5,3,16,0,3,20,0,0,0,0,3,5,4,3,0,2,1,5,2,5,0,4,9,9,0,7,5,1,15,1,0,0,2,6,1,5,3,7,15,5,0,1,1,2,3,2,4,3,2,0,3,4,4,0,0,0,1,2,2,0,5,1,2,0,14,6,0,1,2,54,0,1,2,13,4,6,7,4,0,4,0,0,2,7,3,7,6,5,0,7,1,0,0,7,7,20,5,8,0,9,2,0,0,8,5,7,2,292,1,5,6,9,1,10,0,10,0,2,13,1,2,0,4,4,16,11,1,2,15,3,0,1,1,1,1,9,3,7,6,5,6,6,1,3,1,1,5,6,1,7,3,10,8,2,1,3,6,5,3,13,9,3,0,4,4,2,6,2,0,0,1,0,9,3,4,6,4,9,1,7,3,4,0,4,3,5,1,2,0,0,2,0,7,2,2,6,2,2,2,2,11,8,2,3,3,6,1,2,5,8,1,6,0,2,0,6,2,15,4,4,2,2,1,1,5,0,4,14,3,2,276,5,0,1,11,0,10,6,0,4,0,4,3,2,0,0,1,6,2,8,4,3,0,3,2,0,0,15,2,4,0,6,2,2,1,3,3,11,1,13,29,10,0,4,3,8,1,7,6,1,5,1,3,9,9,4,2,0,0,12,4,2,6,6,10,3,8,7,4,3,1,0,6,9,5,10,1,4,7,1,7,4,1,2,1,2,1,0,7,1,20,2,3,11,1,5,1,3,15,3,5,0,2,5,4,6,3,9,4,0,1,0,0,0,12,10,0,7,3,3,0,3,0,0,0,1,9,5,4,4,1,1,0,5,1,0,0,4,3,0,10,7,3,0,8,4,15,2,7,10,2,4,1,2,2,7,10,9,3,7,0,0,3,2,4,1,1,9,1,10,3,4,5,12,2,5,4,0,0,0,0,3,0,6,4,2,8,2,7,0,7,1,7,8,2,4,0,2,8,2,7,8,3,0,0,3,5,7,1,0,3,0,5,0,6,3,0,0,3,13,6,7,2,4,2,7,3,8,4,3,4,0,6,0,2,4,2,14,2,0,13,2,4,5,1,5,0,3,0,15,1,3,11,1,14,2,1,6,1,4,3,2,4,0,2,8,3,1,2,1,3,3,2,2,9,0,2,1,0,0,4,2,2,0,5,1,4,2,0,4,6,0,1,0,7,0,0,6,1,0,2,6,4,1,1,5,9,0,1,10,0,11,8,3,1,0,15,0,4,7,0,0,5,3,17,9,5,0,2,0,4,4,3,0,14,6,2,13,10,5,0,9,5,1,2,4,7,0,0,5,1,4,7,4,3,6,11,0,7,0,5,8,1,0,4,1,0,6,0,8,11,1,0,10,0,5,0,0,0,0,3,3,6,7,4,3,13,3,2,4,5,25,11,2,0,6,5,5,8,0,3,2,6,1,1,1,0,0,6,5,1,0,3,6,1,0,6,0,2,16,8,0,0,2,2,2,0,3,3,2,6,19,9,1,2,3,12,4,3,0,6,8,5,10,5,0,7,0,2,42,2,4,4,11,4,5,0,0,6,0,9,27,1,14,4,2,2,4,3,6,3,22,4,0,6,2,0,36,8,11,4,0,10,2,9,0,7,5,0,1,3,8,2,4,0,6,0,0,2,2,0,3,7,1,1,3,1,6,2,6,12,3,5,0,0,0,0,2,2,3,4,4,7,1,1,5,0,3,0,4,0,1,0,1,5,9,13,0,4,1,7,0,2,2,3,3,5,3,2,1,0,3,5,3,7,8,3,1,0,2,8,2,0,0,0,9,3,2,13,12,1,1,4,1,12,2,10,6,4,1,2,0,4,1,4,2,5,0,1,14,4,1,1,6,2,0,3,0,5,1,2,0,4,3,9,5,1,0,1,5,4,0,4,1,3,3,1,1,2,1,4,2,1,0,2,2,4,10,0,0,5,2,5,0,0,7,3,0,0,4,7,1,0,0,0,1,0,220,0,11,1,4,5,8,5,0,0,7,0,0,4,6,5,9,8,1,0,3,0,8,1,8,15,0,0,3,6,0,1,3,5,1,2,5,3,0,6,10,5,3,1,7,4,1,0,5,0,1,0,3,9,1,6,11,4,5,1,6,1,1,8,0,2,3,5,5,0,0,3,5,18,2,1,6,0,2,6,1,0,20,4,1,0,2,0,14,6,0,1,3,2,0,2,12,2,2,1,6,152,6,0,1,4,3,5,3,7,2,1,2,2,3,1,6,2,1,0,6,6,4,6,0,1,0,0,3,4,1,0,0,0,1,0,8,1,4,3,1,1,8,3,2,1,4,7,1,2,3,1,0,1,0,2,5,3,1,0,0,6,0,2,0,0,0,3,0,1,0,1,3,2,2,0,4,7,1,7,1,2,6,5,0,0,12,4,0,3,7,2,15,15,2,2,0,3,9,5,9,5,0,3,0,2,0,3,2,0,11,9,4,7,50,7,0,0,6,4,3,1,1,1,2,1,1,6,10,0,11,3,0,0,0,5,203,2,3,7,1,1,0,0,8,8,4,2,9,6,0,2,6,0,2,0,3,13,0,2,0,6,2,3,0,0,1,5,1,3,1,7,4,1,6,0,4,3,7,3,3,0,5,3,0,1,2,1,0,0,6,1,1,7,6,0,2,0,9,9,5,3,4,1,1,3,3,2,5,1,3,3,0,4,1,0,6,0,2,2,4,12,0,3,1,10,3,6,3,3,0,4,3,7,2,7,1,9,0,3,0,3,3,5,7,1,1,1,0,0,0,0,0,4,4,0,2,0,6,9,2,6,1,0,0,0,6,5,1,10,2,6,3,0,3,4,0,190,3,1,0,6,0,0,7,8,6,4,2,2,1,0,0,8,0,1,7,6,0,0,0,7,0,0,1,5,0,3,1,5,8,9,1,3,1,7,2,9,0,8,7,17,5,0,0,9,13,2,0,1,0,4,2,2,4,5,0,8,2,0,3,2,0,188,4,2,2,0,0,2,0,0,0,1,0,0,6,2,0,4,4,0,8,0,8,1,2,0,1,3,0,3,11,1,1,0,4,1,2,0,2,7,5,0,1,2,7,2,0,0,2,1,2,2,1,3,10,11,5,10,1,2,1,3,2,0,15,4,0,1,3,4,0,6,4,0,0,4,0,3,0,0,4,3,2,2,7,3,10,2,2,0,16,3,3,1,0,6,3,3,9,0,0,3,2,0,0,2,0,4,4,4,0,2,5,0,0,13,2,1,5,4,1,9,8,3,4,3,5,0,4,1,0,8,1,0,0,4,2,0,2,1,1,6,0,0,5,2,2,0,4,1,0,0,0,1,0,1,3,2,7,1,1,1,0,4,4,1,8,0,3,3,4,2,0,0,6,8,4,5,7,1,3,6,4,6,0,14,4,1,6,3,12,2,0,0,0,4,2,3,0,0,0,9,1,5,4,1,4,1,3,0,1,5,0,0,1,2,0,3,0,2,0,0,4,0,4,0,2,4,3,5,2,1,0,1,3,4,3,7,2,0,4,1,1,1,4,0,1,3,1,16,2,5,6,3,1,5,0,3,0,0,0,12,5,3,1,0,4,3,8,5,2,3,4,2,4,2,7,0,2,1,4,0,2,17,0,5,0,0,0,7,3,2,0,1,2,1,6,1,1,13,0,2,2,16,2,3,1,0,1,0,1,3,9,0,12,1,5,1,0,7,2,2,13,2,0,1,2,0,5,2,0,0,6,1,6,0,5,4,5,3,0,14,1,5,5,3,2,1,3,6,7,2,0,2,0,0,4,1,4,1,2,2,4,1,7,5,6,6,3,164,1,0,4,3,0,7,1,0,3,0,4,1,0,13,6,1,12,0,3,0,1,2,3,2,1,1,0,0,1,32,4,0,0,0,9,1,6,2,3,0,2,0,3,6,0,3,35,4,3,3,3,4,2,1,9,0,3,2,6,4,4,0,2,2,0,1,1,0,0,0,0,3,0,3,2,3,7,3,4,3,5,0,3,5,0,3,3,8,0,2,4,0,1,0,1,0,6,0,6,6,1,1,0,5,15,10,159,2,2,1,7,9,3,2,0,14,3,5,2,0,2,5,1,0,4,0,1,3,1,3,7,2,3,11,0,1,0,5,6,1,3,5,5,0,0,2,2,0,2,0,0,1,0,1,5,2,0,0,3,7,2,1,0,2,2,0,0,7,0,2,13,0,2,28,2,5,9,0,2,0,18,1,3,0,4,1,6,0,0,3,1,3,2,3,0,4,3,1,2,1,3,0,3,9,6,9,5,1,7,2,0,0,4,3,2,5,4,0,0,1,3,1,6,1,1,2,5,1,8,0,7,1,5,0,0,1,11,18,2,1,10,0,0,3,2,0,10,2,11,1,1,0,1,0,3,1,0,0,4,0,3,8,2,3,0,1,4,2,3,1,0,0,2,1,2,22,2,0,8,6,3,0,3,3,3,0,0,0,0,0,0,0,0,1,2,1,8,5,2,0,4,8,2,0,1,5,2,1,0,0,1,3,2,1,1,0,14,0,0,2,4,2,1,6,2,2,0,136,0,2,6,0,1,1,0,0,2,0,0,5,0,2,0,0,1,1,0,4,1,0,0,0,0,0,0,0,0,3,0,2,0,0,0,1,0,2,0,0,1,7,0,15,0,0,3,0,0,0,0,0,0,0,0,0,0,1,0,0,0,1,0,0,0,0,0,0,0,0,0,0,0,0,0,0,0,0,0,0,0,0,0
"2007 Johnson_D, Denis, Tree of Smoke",high,12691,5924,4357,5570,4168,2761,3394,3496,1481,2199,2861,2883,1231,755,741,1650,1215,1574,1331,1466,1187,1158,1036,1208,542,709,743,1035,863,885,998,750,851,602,1084,709,322,850,661,815,533,658,491,800,569,374,556,449,260,350,522,605,245,427,511,624,423,546,548,574,560,662,392,441,547,247,465,417,479,263,442,639,258,303,364,308,446,379,405,517,261,574,610,400,216,180,305,347,181,245,264,367,321,246,299,227,323,218,246,235,231,256,193,210,155,214,160,193,289,208,276,246,206,175,183,129,206,217,218,206,142,262,242,112,125,192,179,153,98,192,118,352,275,230,187,160,183,208,208,238,143,157,478,265,193,151,131,130,156,120,178,238,145,147,223,222,98,169,240,282,124,128,104,134,130,309,160,233,142,110,92,126,117,168,54,253,114,163,187,141,97,83,267,119,131,133,80,152,165,134,108,110,81,111,83,150,65,87,117,61,134,174,131,97,53,139,113,172,135,100,94,142,127,89,119,128,112,91,90,244,160,62,110,102,86,117,76,155,111,107,60,184,156,37,121,99,43,104,79,139,106,144,107,71,63,64,86,86,34,117,94,95,143,88,123,100,163,91,86,108,90,78,98,98,81,61,95,106,112,107,65,152,59,90,68,77,105,52,83,83,88,120,89,92,105,111,50,68,76,114,41,54,23,136,105,54,64,80,26,75,72,91,102,58,50,93,69,63,64,51,70,35,101,51,82,95,67,66,66,154,42,87,87,111,32,62,98,60,78,57,43,95,64,101,50,69,70,80,80,41,59,66,62,23,70,34,61,93,73,104,45,61,50,56,53,102,29,106,69,84,88,12,51,66,80,32,65,19,92,71,58,44,60,54,70,54,73,55,41,52,59,57,61,27,52,5,0,62,50,50,46,92,28,180,53,43,53,68,34,51,70,58,36,44,40,59,53,48,47,67,55,58,24,63,29,78,74,39,33,64,45,7,13,49,34,36,27,50,19,82,34,45,71,30,101,55,55,40,29,41,46,62,70,35,76,38,44,72,57,46,53,46,25,45,65,65,82,34,55,50,62,82,1,67,31,22,89,85,35,37,76,24,36,102,51,44,45,33,0,29,50,17,29,66,50,62,54,32,61,32,25,43,51,35,33,44,22,21,157,44,28,44,34,47,43,52,104,48,43,60,62,51,41,76,87,56,2,48,36,30,23,63,37,19,42,20,56,25,32,37,29,50,53,58,90,5,28,72,34,35,40,44,51,34,89,76,0,7,49,149,41,48,43,95,35,42,79,35,37,5,18,42,25,70,60,32,35,36,18,45,52,99,34,44,27,29,35,31,60,51,51,19,45,36,3,40,50,51,47,57,22,59,69,51,21,32,94,44,62,43,35,22,34,31,34,0,1,14,24,14,32,3,37,32,31,31,20,23,51,21,19,20,14,27,35,51,19,32,46,63,29,22,22,44,22,0,59,10,34,20,14,38,36,53,74,25,11,27,29,49,0,20,56,37,30,15,28,67,54,174,25,43,24,19,9,50,40,37,45,47,7,31,28,44,64,47,44,61,42,35,22,71,35,21,17,17,15,27,33,29,23,14,38,34,16,38,23,37,63,22,40,74,30,41,33,44,9,34,46,12,6,55,85,9,55,26,14,42,17,22,50,21,48,19,26,33,35,9,61,17,20,19,53,13,0,38,26,17,63,25,17,8,0,16,401,7,18,24,33,32,24,49,12,15,17,31,14,18,28,45,30,27,37,67,12,24,24,29,42,37,28,11,67,25,6,53,17,23,46,7,16,18,23,22,5,9,86,31,29,20,33,47,10,24,41,19,0,23,0,22,8,21,42,13,28,24,14,20,46,84,31,20,22,37,20,27,47,6,23,16,28,14,14,36,33,34,15,17,37,34,9,23,3,9,25,21,22,46,0,14,24,48,27,57,21,39,44,0,30,27,28,44,22,18,16,29,12,11,10,20,31,28,43,18,28,30,15,0,23,23,27,23,16,11,0,32,55,25,8,17,17,8,19,33,13,15,21,11,23,14,19,25,44,8,15,34,11,69,43,39,16,9,19,16,21,47,9,46,10,34,25,0,24,0,20,18,10,30,40,19,18,34,38,17,19,13,17,0,9,15,129,10,21,3,34,17,29,18,26,27,18,49,5,12,23,32,32,13,12,23,41,18,19,6,63,10,13,18,14,3,0,30,24,10,8,26,16,14,26,23,19,14,41,20,24,24,26,12,11,0,5,16,16,7,6,8,13,487,27,12,11,39,27,20,19,16,0,23,17,0,19,1,29,21,20,12,0,0,8,16,10,21,9,2,15,39,43,1,11,9,8,18,3,1,6,7,19,19,29,37,13,14,12,10,12,3,4,17,12,18,14,16,8,17,11,20,5,35,16,38,23,21,15,26,28,0,17,16,16,22,8,25,0,7,10,22,17,13,0,0,0,20,19,5,18,12,8,0,11,8,18,7,47,11,8,11,44,23,10,9,24,0,20,17,15,39,6,7,28,7,22,27,8,27,9,41,17,5,15,19,16,12,14,22,0,8,29,5,10,16,8,23,68,16,22,37,25,40,32,1,14,27,9,23,11,20,13,24,16,12,28,40,17,22,23,17,19,18,17,19,13,10,26,20,6,34,6,20,15,16,8,13,14,28,0,18,127,40,4,1,0,16,31,13,15,32,25,57,11,0,18,12,12,8,22,14,0,11,5,0,15,13,2,8,7,13,9,24,5,6,86,0,17,9,15,50,1,22,8,12,1,10,27,16,10,0,0,23,7,12,17,10,34,13,16,18,10,40,9,14,23,6,5,10,12,0,3,4,2,13,24,15,39,0,44,14,6,4,29,5,27,39,17,13,10,45,25,5,5,43,12,0,20,14,0,13,6,18,31,27,2,25,0,33,0,60,25,25,1,12,9,13,19,29,16,12,19,20,4,2,0,22,15,15,2,8,2,44,6,8,12,13,13,16,9,15,25,11,12,42,8,28,6,23,10,48,28,25,36,9,11,13,12,0,10,52,13,18,8,27,4,19,7,16,17,8,27,17,27,18,7,7,8,0,44,4,3,32,24,39,25,13,16,22,33,14,25,14,16,11,3,7,17,0,14,16,22,10,6,17,5,18,10,5,24,1,0,23,0,5,9,0,10,12,17,11,26,22,28,6,0,9,8,0,14,18,11,1,24,21,0,0,0,20,0,12,17,0,15,3,5,7,6,19,0,6,11,15,10,8,10,10,3,12,12,5,13,37,19,3,20,7,0,0,5,15,9,13,26,17,7,3,11,35,8,3,8,20,10,15,10,9,0,3,8,0,19,3,16,11,5,7,13,0,14,12,14,1,18,12,11,20,15,11,0,16,284,11,14,8,11,10,15,15,0,9,7,35,6,5,7,11,6,17,18,38,0,4,7,13,11,0,1,0,0,8,0,14,6,8,12,9,16,13,22,11,15,0,14,18,28,13,11,19,6,9,9,3,17,26,13,16,8,5,11,5,6,3,14,8,6,29,19,12,10,13,12,0,29,21,9,12,32,6,7,5,21,10,11,14,11,8,7,4,6,22,12,5,10,17,10,18,1,0,2,9,11,2,10,6,9,18,7,16,17,23,9,29,25,21,0,16,4,4,9,6,0,0,13,4,1,17,0,6,12,18,18,11,1,5,13,11,18,3,16,14,0,11,0,12,18,19,26,0,8,22,14,8,31,7,25,38,13,12,10,3,7,1,40,4,1,6,10,8,0,5,4,7,12,6,29,9,22,18,17,10,17,6,3,13,6,7,5,8,2,6,16,0,19,5,6,12,2,4,8,10,0,10,4,5,9,5,23,6,10,98,10,4,9,12,7,0,9,2,20,6,5,36,12,19,13,20,19,2,75,12,10,18,14,11,4,9,3,11,7,19,1,17,0,9,6,4,2,7,17,21,24,10,19,21,38,7,10,0,9,18,1,6,5,38,3,24,24,17,0,6,30,4,13,6,17,8,7,24,25,16,2,11,2,6,8,5,8,15,6,11,12,9,9,0,19,29,1,11,1,0,7,11,13,11,9,8,20,5,10,8,11,7,21,6,9,13,0,8,11,2,11,9,13,5,26,10,17,2,5,11,2,7,7,7,8,3,6,3,12,6,29,0,16,13,7,14,0,0,14,15,307,5,0,2,1,5,8,8,28,7,9,5,137,20,6,12,0,14,20,13,7,17,12,11,13,20,20,13,3,6,8,14,14,20,15,0,13,9,9,6,45,5,0,8,18,3,1,5,9,19,8,6,2,16,0,6,17,14,5,6,4,9,1,25,14,8,0,8,22,0,29,24,1,10,0,3,2,11,0,11,8,55,1,9,0,10,11,0,4,7,7,8,7,4,12,0,0,3,16,22,9,5,24,14,0,9,0,1,21,0,7,9,0,9,2,4,0,9,97,11,1,5,5,0,5,8,11,1,42,21,1,2,2,17,5,6,22,8,36,12,3,1,3,8,6,16,16,0,6,5,2,9,7,11,485,7,14,6,7,12,1,7,8,15,39,12,18,5,8,6,4,0,7,4,10,21,12,22,7,7,11,3,6,5,4,6,20,4,32,5,8,9,3,6,9,5,13,7,10,0,10,10,8,0,28,6,22,7,0,5,17,12,16,22,12,9,34,0,7,3,10,4,22,18,3,3,7,4,5,5,20,0,8,18,7,16,14,7,10,6,12,9,15,7,0,0,12,9,0,0,2,2,12,5,18,4,3,8,16,2,1,3,0,5,7,4,13,11,6,5,42,30,4,13,12,4,2,6,19,6,0,83,4,11,8,8,8,6,7,10,4,4,0,0,2,0,13,5,0,0,1,6,19,3,2,7,7,0,0,5,3,3,1,11,2,1,6,26,4,10,16,2,0,8,8,20,1,0,2,0,6,10,3,5,0,14,1,2,1,1,10,24,3,8,4,42,9,0,2,15,0,8,17,29,3,0,0,3,1,16,11,22,6,7,1,8,8,31,11,6,33,4,6,11,1,13,11,11,12,0,0,0,6,6,9,5,14,12,4,7,12,12,5,7,5,6,7,52,5,7,15,3,10,15,10,4,11,13,2,20,9,0,13,0,3,8,6,8,7,4,19,6,3,4,9,7,27,21,6,7,6,41,5,5,2,16,13,2,1,17,7,11,10,10,3,10,7,18,6,7,4,6,10,11,13,7,5,3,8,5,3,1,5,7,14,8,2,3,10,13,20,6,2,7,2,1,4,3,6,3,12,3,12,6,14,20,6,10,6,2,13,5,6,7,2,17,0,11,13,5,7,22,6,4,8,13,3,13,1,2,1,3,1,6,2,3,5,10,16,2,6,11,3,1,2,4,2,8,0,6,2,21,12,5,2,6,4,12,15,1,4,7,7,39,4,13,2,5,2,0,5,11,11,10,10,2,0,5,0,0,4,2,1,10,7,2,7,5,5,1,2,25,2,7,6,0,3,0,5,15,7,7,6,9,4,2,6,7,34,5,1,2,0,6,9,7,13,0,3,0,5,0,4,1,7,4,10,1,4,9,1,8,7,17,0,5,13,1,2,0,6,8,9,1,2,2,3,13,1,3,12,3,8,2,6,4,7,4,0,5,102,21,9,1,0,9,2,4,4,24,0,15,7,1,2,8,7,9,0,2,15,0,25,5,2,1,4,9,4,13,0,3,7,4,16,1,6,5,9,7,0,0,3,2,5,4,0,19,0,12,0,7,3,4,4,21,4,6,5,9,0,2,14,4,17,4,7,5,5,7,4,8,2,1,17,0,1,5,4,1,2,6,4,9,6,5,0,13,0,4,6,18,0,2,2,3,0,6,2,2,19,4,6,2,5,0,0,15,6,0,6,5,0,9,3,6,9,1,9,5,8,2,0,1,10,9,5,3,5,7,8,9,6,12,5,2,5,6,2,2,6,4,12,4,9,0,9,3,1,4,8,1,3,5,3,4,13,5,1,2,1,9,7,9,5,3,0,4,7,21,0,13,4,0,10,0,17,3,2,0,6,11,0,0,1,8,9,0,8,5,0,7,6,6,5,6,16,8,7,1,5,9,4,1,7,3,10,0,9,4,5,2,4,1,11,2,4,6,1,30,21,3,6,6,5,0,1,6,6,0,6,17,14,1,6,10,6,8,4,5,1,4,14,7,9,9,11,3,5,2,2,6,4,1,1,4,12,9,2,2,7,4,3,3,5,33,2,8,18,0,8,6,3,39,5,7,1,8,5,0,8,21,8,12,0,0,3,1,26,0,2,0,5,2,6,6,2,6,0,10,4,5,3,6,8,6,0,1,5,0,3,9,2,14,2,7,8,7,2,13,4,12,4,0,8,3,7,2,3,0,3,1,2,9,0,8,3,7,0,0,3,7,20,6,2,12,6,5,5,5,4,0,6,12,7,3,2,4,21,7,7,2,1,12,1,5,12,0,6,2,4,2,4,0,8,3,2,10,0,6,1,9,5,1,0,1,1,1,4,3,11,5,5,8,12,6,1,2,0,1,0,3,7,7,4,7,3,13,22,4,3,0,5,4,10,3,1,4,6,15,3,2,2,0,7,3,2,20,23,6,7,3,10,6,2,5,7,0,12,4,0,0,7,14,9,10,8,1,0,1,6,8,9,1,0,2,7,6,0,5,1,3,10,5,0,7,6,9,3,5,4,9,7,2,0,8,4,5,5,5,8,12,32,0,6,3,4,10,0,4,8,5,1,15,1,1,3,0,2,13,0,3,6,3,0,1,3,3,8,5,2,3,0,2,0,0,8,1,9,10,3,11,1,7,0,0,8,7,17,4,4,3,4,7,2,0,0,2,3,9,0,0,7,3,2,5,0,3,0,4,0,2,2,5,11,9,0,6,5,9,4,0,5,9,0,3,3,11,12,6,0,2,4,5,13,3,15,3,2,16,10,3,7,1,6,5,7,61,8,13,3,5,9,4,2,1,0,8,2,0,4,3,8,6,10,0,8,9,7,9,3,10,11,14,2,3,2,4,9,0,3,2,1,0,3,0,4,3,7,5,8,10,10,2,2,4,1,9,6,4,0,7,6,3,2,6,0,11,0,6,2,7,1,6,4,15,4,10,2,0,0,7,1,1,2,7,51,1,7,12,6,6,0,3,2,3,10,6,3,3,6,0,9,8,3,14,2,0,2,3,0,1,7,3,0,0,8,1,17,4,8,4,6,8,2,3,0,4,4,9,3,1,2,5,9,8,9,6,1,2,4,0,13,4,3,3,3,12,10,0,13,6,5,1,16,1,3,6,5,13,11,3,12,1,1,7,3,1,6,10,3,0,6,0,5,0,2,3,13,0,2,4,2,5,3,0,11,5,5,13,3,19,4,0,7,0,11,0,0,7,2,6,9,5,0,17,2,0,25,1,3,4,2,12,6,3,16,3,6,0,8,4,3,2,0,3,7,4,6,6,0,5,4,3,2,6,2,8,4,1,8,9,7,6,3,0,9,7,2,30,2,6,14,1,3,4,9,7,10,7,3,0,8,4,0,2,0,8,11,6,0,6,4,0,7,5,2,14,1,1,0,1,18,7,3,1,5,0,0,8,13,10,1,4,2,5,4,4,2,2,0,0,1,1,4,8,3,11,7,8,1,3,8,1,1,2,5,2,5,5,5,7,2,0,1,1,1,4,2,10,1,8,0,4,11,5,1,2,3,4,5,12,7,9,5,1,0,6,2,1,3,3,13,3,1,0,5,4,2,2,1,1,4,25,5,0,2,4,7,8,6,8,3,3,3,0,5,11,3,0,11,1,3,0,3,1,5,11,3,4,4,3,7,2,1,3,2,1,0,0,4,7,13,4,0,0,9,6,7,8,25,0,14,0,3,8,3,0,1,4,3,11,3,5,17,1,5,4,4,0,8,0,1,3,6,1,8,4,9,12,3,17,4,3,24,7,1,2,3,19,3,4,0,0,0,0,0,6,122,15,2,0,1,0,4,4,3,5,3,7,12,2,2,3,7,5,19,0,0,9,0,0,14,0,2,7,3,2,12,7,8,2,6,7,0,9,10,11,4,5,5,0,9,2,2,0,2,4,5,1,3,4,3,8,7,2,3,1,4,13,16,17,6,0,13,5,2,7,4,0,4,4,5,1,9,4,1,1,0,3,7,0,3,0,3,5,13,1,0,10,7,0,5,4,12,5,6,1,0,0,0,1,2,6,2,0,0,1,3,0,4,6,3,6,5,1,7,2,0,2,5,1,4,14,3,1,9,6,2,3,4,6,7,6,1,14,0,3,0,21,5,11,3,6,1,3,3,2,5,14,6,5,0,5,10,3,5,3,5,14,15,0,1,6,7,6,2,1,4,8,20,2,3,7,5,10,3,1,10,6,6,2,4,2,1,3,0,0,0,2,3,2,3,2,1,3,1,2,0,5,10,1,1,16,3,1,7,0,4,6,11,7,2,6,4,2,1,5,4,0,2,20,3,1,2,6,11,1,2,3,10,7,0,5,3,3,3,7,1,2,4,0,4,10,0,6,4,9,4,1,1,4,9,0,7,2,7,1,0,8,5,0,6,0,3,8,0,0,5,3,3,0,3,2,1,1,2,2,2,4,0,0,2,0,1,1,4,4,9,32,0,5,3,7,1,3,4,0,1,4,5,2,0,3,4,7,1,0,5,1,6,0,0,3,1,0,11,1,0,3,5,1,8,3,4,10,3,2,8,5,13,1,1,0,0,0,0,0,8,1,10,0,2,2,1,0,1,4,1,1,1,6,0,3,6,6,1,4,0,3,3,0,2,14,2,0,0,5,4,5,2,4,2,0,4,1,2,2,3,2,0,2,0,4,17,6,3,8,0,0,1,4,4,8,3,0,2,1,0,1,0,4,0,0,14,3,1,1,0,0,7,2,6,5,2,8,2,3,0,5,4,4,10,0,0,9,13,3,1,1,10,1,3,0,5,0,6,5,5,7,2,1,3,4,3,1,6,2,2,0,8,5,5,10,2,5,10,2,5,3,5,0,5,4,3,4,1,0,1,2,10,1,3,290,15,2,0,8,13,3,0,4,3,4,5,0,3,0,3,1,4,2,4,17,5,1,2,1,11,3,2,1,24,3,2,14,3,0,1,0,3,5,1,0,1,2,8,4,5,2,17,0,5,0,3,3,1,8,5,1,4,4,7,2,2,19,3,8,2,8,1,3,17,2,8,4,6,1,1,2,5,0,0,15,4,0,3,1,3,0,2,9,1,3,1,5,0,5,14,5,2,0,1,2,7,0,5,2,7,5,4,5,1,3,3,2,2,11,8,4,11,5,1,31,3,1,8,2,1,3,5,1,6,3,5,6,2,8,0,0,2,7,0,0,2,2,4,4,3,0,8,55,0,0,3,6,0,3,0,2,2,2,4,1,10,3,1,1,6,3,1,1,0,1,10,2,1,2,0,0,50,2,1,11,0,3,1,1,18,7,6,5,1,0,5,16,0,5,10,0,0,0,6,0,1,1,0,3,9,1,16,1,11,4,3,1,2,3,5,1,2,3,0,9,2,1,3,1,8,0,2,3,7,3,10,0,4,1,3,0,10,1,4,12,0,9,6,5,7,3,1,0,1,5,1,1,4,2,5,4,1,1,18,1,1,1,0,5,0,4,3,0,6,4,5,39,5,7,7,5,0,1,1,5,15,1,3,1,2,0,2,13,9,3,1,1,1,13,0,3,2,16,3,0,3,3,1,3,5,1,0,2,3,3,1,3,1,0,3,0,0,0,2,12,4,1,6,3,1,0,2,2,3,2,1,7,2,0,0,3,2,2,0,3,1,1,4,0,13,3,3,2,5,0,3,10,5,1,3,6,5,2,3,2,6,8,2,1,3,1,2,3,4,0,2,3,2,0,12,1,7,1,2,0,2,3,2,1,1,5,0,3,4,0,3,1,4,0,1,9,0,2,2,16,3,34,3,3,1,10,3,2,2,5,1,0,4,2,2,6,1,3,6,0,0,7,2,3,3,0,2,0,4,8,3,2,0,0,8,1,1,0,0,0,0,3,14,10,1,2,2,0,0,0,2,0,0,1,1,2,3,4,5,2,10,6,0,3,1,1,0,5,1,4,2,7,5,2,12,2,4,4,0,5,4,1,5,7,0,1,8,8,3,0,5,2,2,2,5,8,2,4,4,1,10,4,0,4,0,9,3,1,2,4,3,3,1,6,4,0,5,3,7,1,0,27,3,14,1,0,0,0,34,0,8,0,1,3,11,0,13,0,4,0,2,5,0,1,2,3,7,49,1,0,3,2,1,1,0,5,5,0,8,7,4,7,9,1,3,1,2,3,1,1,13,4,2,3,4,6,8,0,1,4,8,0,1,6,0,5,2,8,8,0,4,7,0,0,2,8,2,1,4,0,2,3,6,3,8,2,1,1,0,3,1,2,1,3,0,1,0,5,4,2,1,0,3,0,3,2,13,3,2,0,0,0,9,3,20,4,0,1,6,4,2,7,0,2,3,6,6,3,0,10,0,3,7,0,0,1,1,4,4,5,6,1,5,0,2,1,1,4,5,0,3,5,2,0,0,2,4,14,1,0,3,5,3,11,4,2,8,6,2,7,0,1,5,0,8,1,5,0,4,2,0,0,1,9,2,0,1,3,0,1,0,7,4,2,1,0,3,3,10,3,2,2,3,10,10,0,7,4,8,2,7,0,2,2,0,3,3,4,5,6,2,0,0,0,3,15,0,2,5,1,9,3,0,4,4,4,4,2,2,3,4,0,0,4,5,2,0,0,2,2,2,0,3,23,5,13,0,2,1,1,3,3,1,4,3,5,1,3,61,3,0,5,1,5,10,3,0,0,7,3,1,1,0,6,1,1,4,1,2,1,0,9,4,1,3,6,7,3,0,0,4,2,1,4,2,2,1,0,2,10,2,4,7,0,1,3,3,3,26,1,6,2,0,12,1,26,1,3,3,3,0,1,4,4,6,2,2,1,1,2,2,1,0,0,1,0,0,8,86,3,1,13,2,3,7,0,3,2,1,1,0,2,2,3,2,5,3,3,4,2,9,2,9,1,1,0,1,0,8,7,0,1,3,0,2,7,2,0,0,2,6,0,1,0,0,3,3,0,3,1,0,1,2,2,0,1,0,0,1,2,4,6,2,0,2,0,0,0,7,5,0,1,1,4,0,2,0,1,1,0,6,13,0,2,2,1,0,0,0,0,0,0,0,1,7,0,1,0,3,0,0,2,0,109,0,0,0,0,0,0,2,159,4,1,0,0,0,0,0,2,5,0,0,0,0,0,0,1,0,0,0,0,0,2,7,0,0,0,0,0,0,0,0,0,0,0,2,0,0,0
"2008 Erdrich, Louise, The Plague of Doves",high,6051,3542,2441,2361,2327,2590,1456,1746,1650,1034,504,1143,1215,895,915,693,884,867,608,542,583,601,702,444,1058,463,653,530,513,345,452,427,278,263,248,275,465,386,542,351,186,275,408,226,185,355,306,382,334,345,303,266,246,361,215,280,142,144,149,215,325,107,192,212,95,204,331,240,175,182,105,87,145,127,153,105,153,119,152,89,193,53,76,89,157,134,144,66,160,135,75,109,154,149,113,165,127,140,87,142,126,118,100,74,109,158,134,96,51,105,101,165,221,90,122,117,130,72,150,89,64,103,124,178,101,115,107,98,107,63,100,132,44,135,117,73,284,124,96,40,129,54,85,46,98,126,67,57,84,55,126,88,95,65,81,27,70,101,53,83,58,51,36,73,72,126,68,81,81,68,140,61,77,44,61,50,65,65,71,39,93,63,38,59,87,69,20,66,74,61,38,49,53,57,103,108,216,43,54,124,19,74,47,71,29,1,88,90,48,51,130,49,120,28,42,93,114,41,43,77,38,45,52,66,25,74,43,61,36,53,51,64,53,74,44,41,71,52,62,41,40,42,61,43,44,61,22,45,23,41,24,63,66,89,44,37,16,55,58,36,51,16,32,42,68,85,35,39,25,16,32,34,62,46,58,25,43,32,41,38,23,39,35,24,31,13,23,65,43,69,31,31,15,40,20,56,80,23,26,18,20,42,8,72,83,13,52,28,32,16,60,67,86,32,34,64,8,36,38,20,70,21,64,80,32,25,26,25,24,49,53,24,10,30,32,22,28,65,21,35,25,46,38,23,27,35,26,0,45,14,25,45,24,24,31,55,28,35,46,32,16,25,23,33,16,26,44,30,11,36,46,27,14,30,24,67,28,29,62,10,27,46,15,31,21,9,0,20,16,44,14,17,31,5,24,29,49,39,18,22,42,53,30,26,29,24,16,23,26,39,26,31,47,75,45,47,17,17,11,36,31,1,9,6,21,30,16,43,18,16,23,22,33,15,19,24,35,35,0,22,19,20,15,19,17,13,35,17,17,23,26,22,25,13,9,16,23,19,34,15,13,70,0,3,29,21,36,41,15,15,17,36,15,4,35,31,22,8,0,42,16,17,11,31,7,39,33,17,5,15,30,25,35,37,10,25,27,24,16,37,35,16,11,14,23,5,16,22,20,44,17,29,4,21,15,22,0,8,19,14,19,38,28,12,13,18,20,11,29,19,32,29,15,15,31,58,21,21,22,12,40,14,22,13,20,5,0,26,6,6,18,11,24,0,23,12,8,17,27,1,16,35,22,20,8,16,28,19,48,21,21,11,13,27,25,13,25,73,34,18,30,5,13,13,1,36,23,33,41,7,25,10,24,13,14,7,20,18,32,17,11,28,25,13,43,27,0,12,23,14,28,8,11,20,48,11,30,13,20,21,36,13,37,19,25,11,22,29,25,9,25,23,21,17,5,0,24,21,11,39,9,23,22,17,0,27,42,29,22,43,0,34,27,18,29,10,20,19,8,6,9,17,22,9,25,19,28,8,12,24,21,10,10,17,12,28,2,15,14,7,12,6,6,17,17,3,7,22,18,15,10,11,21,17,12,5,22,0,16,12,14,1,36,6,4,24,4,22,4,42,8,30,8,32,14,2,6,8,26,13,5,1,8,2,23,23,12,38,19,15,15,12,28,15,0,10,11,13,15,21,11,31,1,8,0,1,4,17,5,21,19,28,27,17,7,36,3,20,18,11,8,20,8,2,13,23,6,14,18,7,20,7,6,6,0,21,13,21,15,4,30,11,11,16,11,16,15,11,10,8,26,25,2,20,14,12,0,16,193,17,9,17,42,20,23,16,41,7,7,2,6,9,15,2,10,19,7,2,15,34,17,14,12,7,8,4,11,10,6,2,4,1,10,6,2,18,21,10,0,18,18,27,14,21,24,10,6,0,7,9,14,7,1,13,21,51,24,4,11,3,13,17,7,9,15,3,9,0,18,10,10,9,13,16,0,16,4,14,8,14,28,4,15,6,3,7,14,7,15,11,2,9,24,4,13,18,37,0,31,13,10,3,28,15,9,3,12,3,27,6,4,0,11,1,11,7,15,4,19,4,30,1,12,15,14,3,24,0,11,2,7,12,11,0,2,6,12,19,18,4,8,3,2,16,9,7,4,15,8,16,6,20,24,9,27,15,7,13,12,1,0,6,6,0,9,7,15,6,9,8,8,0,28,8,13,21,23,9,7,0,0,5,14,2,7,1,17,12,0,10,11,11,4,16,16,5,16,4,0,0,8,0,0,0,33,11,0,0,40,6,15,10,7,35,13,8,20,0,7,8,2,11,0,0,1,2,8,37,5,12,8,6,30,5,16,21,18,22,7,13,10,4,0,9,9,6,16,13,5,2,9,14,21,5,7,0,7,14,9,6,15,9,0,2,11,17,12,2,0,0,0,5,1,7,5,8,4,0,13,17,1,6,4,4,21,8,1,6,44,26,4,0,5,7,0,12,12,15,4,6,1,24,4,3,7,14,11,9,12,6,10,3,5,9,0,2,3,4,13,21,12,3,14,12,10,28,6,1,0,0,14,6,18,11,12,13,11,10,5,8,10,11,6,7,8,6,23,4,19,5,6,2,23,6,8,21,3,22,4,15,14,10,6,13,0,5,55,8,4,0,20,7,25,9,6,7,13,0,3,0,21,8,29,14,13,1,0,8,15,0,1,12,0,2,7,18,6,8,0,10,11,0,2,15,19,8,1,13,22,3,0,15,14,19,9,0,0,8,5,1,6,2,2,6,21,15,3,5,6,4,8,2,28,7,4,0,5,15,1,9,9,3,5,0,1,2,0,8,8,4,3,5,8,5,1,5,5,3,0,5,10,0,0,13,0,4,15,2,2,11,59,1,1,11,0,21,8,5,0,35,2,16,14,2,12,5,1,4,13,13,0,3,2,4,1,9,13,15,0,6,8,3,10,24,4,6,5,8,20,8,14,2,8,17,9,9,14,30,13,6,13,11,0,0,10,13,4,9,2,6,7,19,12,1,16,4,9,0,3,11,12,13,9,0,9,3,9,14,8,1,8,5,10,7,17,11,5,13,4,7,17,13,12,0,11,1,6,5,8,5,8,4,7,2,4,0,0,2,0,2,1,0,1,7,3,5,74,3,3,3,0,10,22,11,1,3,5,1,7,11,0,0,0,10,0,9,1,0,4,19,5,7,17,6,0,4,4,1,5,15,5,3,6,7,12,3,3,2,6,13,7,5,0,0,3,9,14,2,7,8,7,5,3,4,1,4,9,4,3,8,13,2,0,20,3,0,7,1,8,5,0,4,7,0,4,4,11,0,14,5,6,1,9,11,0,4,10,5,4,4,7,2,72,8,8,5,0,5,11,4,4,8,7,6,18,11,2,0,13,2,12,0,1,0,0,27,0,9,8,10,3,34,3,8,6,2,4,0,6,3,8,7,12,9,6,3,0,5,4,10,13,6,3,3,19,1,4,7,2,13,2,8,8,11,8,6,3,0,8,10,4,3,4,5,2,9,6,1,11,7,1,7,10,1,7,0,1,4,9,3,5,18,10,0,1,15,6,4,4,4,4,5,3,20,2,9,6,1,35,8,0,2,4,0,9,1,4,0,5,1,0,0,0,5,5,4,5,4,9,7,22,4,6,6,9,6,0,8,0,10,2,4,16,0,4,5,14,14,4,1,5,4,6,2,10,6,5,5,4,13,8,6,7,2,0,0,0,8,7,0,1,8,12,4,12,4,2,4,3,6,3,7,9,9,7,13,5,0,3,9,2,7,1,4,0,8,2,7,12,3,8,4,4,1,11,42,10,3,3,7,8,0,4,8,0,24,8,2,6,8,6,35,6,4,1,4,2,1,9,0,1,5,3,9,5,4,6,7,0,12,5,8,6,8,4,0,3,6,6,13,8,10,8,0,6,4,5,4,3,1,2,23,7,2,0,10,1,5,13,10,1,7,7,8,0,6,0,6,7,4,8,3,6,13,1,4,9,13,1,0,0,1,0,5,4,0,4,7,6,3,5,0,3,7,3,4,11,15,2,9,5,11,2,6,2,2,3,1,8,4,8,1,4,5,5,5,8,7,2,0,7,3,2,3,7,1,2,0,8,4,5,3,0,283,2,2,0,4,0,0,0,5,6,11,1,5,9,3,0,4,1,11,1,0,1,4,5,3,14,13,21,6,5,5,3,6,15,2,1,6,7,7,3,0,3,1,12,5,3,1,3,3,0,3,14,6,6,2,11,3,0,4,0,3,0,2,4,2,4,3,38,4,0,1,3,0,4,3,2,1,0,3,4,1,0,9,1,1,0,1,0,2,10,2,0,1,4,4,10,7,4,0,0,5,3,0,8,1,5,3,0,2,0,5,7,0,2,6,0,4,3,7,0,4,0,8,2,5,5,1,3,3,1,5,0,11,0,2,6,3,7,2,9,7,3,0,2,1,2,4,9,10,0,0,1,0,10,5,5,7,2,4,1,2,6,1,5,12,6,4,0,0,0,8,18,3,12,0,0,4,7,0,9,10,2,4,1,5,2,0,1,3,6,1,1,3,9,1,3,10,0,7,5,5,7,0,6,4,5,0,4,4,4,12,25,0,18,1,8,2,2,3,1,0,8,10,3,1,7,5,1,1,0,2,5,5,7,5,0,4,2,4,5,2,4,6,3,9,7,3,0,0,1,3,0,0,1,4,0,1,0,5,1,1,13,11,0,0,0,2,2,4,1,11,3,4,1,0,9,3,1,1,10,7,4,17,0,0,2,2,1,1,1,4,5,20,1,8,0,0,1,0,6,10,0,0,0,12,1,5,5,5,5,9,0,1,4,2,1,3,8,1,3,0,6,10,0,12,0,0,2,1,0,0,6,0,17,2,7,1,0,9,2,1,6,5,2,11,5,7,3,4,2,0,4,0,0,11,4,0,2,0,0,3,3,14,3,2,7,0,2,4,3,2,9,4,2,11,7,2,0,8,4,9,4,4,0,0,4,3,3,12,3,12,1,0,6,4,1,1,9,2,1,0,4,6,3,3,5,1,6,3,8,2,3,4,2,0,5,0,0,0,7,2,2,8,5,5,6,1,3,8,5,2,3,7,9,8,2,0,11,0,8,1,5,4,3,3,2,1,15,0,1,4,0,3,3,3,3,0,5,3,0,2,5,5,4,0,0,11,6,1,0,16,2,1,1,11,2,2,5,3,5,1,9,3,2,0,4,0,3,4,1,8,3,7,4,0,15,2,0,11,0,3,2,7,4,6,1,3,0,10,2,1,3,0,4,2,7,2,2,6,4,0,5,1,5,11,0,4,6,4,1,1,9,5,5,6,6,1,1,5,0,5,1,6,4,0,1,0,4,0,1,0,3,0,8,11,6,7,0,4,0,1,0,0,12,0,0,2,1,4,9,14,1,6,7,0,3,8,2,5,2,0,4,5,13,14,4,9,1,0,3,5,0,9,2,2,0,1,9,1,4,11,2,0,0,7,3,0,4,9,3,0,9,3,6,9,4,5,0,14,1,0,1,0,2,11,3,3,6,5,5,3,0,3,3,0,10,5,5,0,4,8,1,2,0,0,1,130,0,3,13,2,2,5,0,2,3,1,3,2,3,3,0,2,8,0,3,6,0,0,2,2,6,4,3,4,2,8,5,4,2,8,1,9,0,0,8,0,2,0,0,2,0,2,2,2,3,3,6,4,0,5,3,5,2,2,2,3,2,1,2,2,3,37,3,12,7,0,0,0,3,1,4,2,1,4,7,6,0,1,0,4,2,3,4,2,0,2,0,1,4,4,2,5,3,0,4,0,2,0,0,2,0,0,0,5,0,1,3,2,2,6,2,0,6,6,0,2,17,3,2,14,4,3,2,5,5,1,1,5,4,6,6,4,9,2,6,0,4,5,2,1,1,1,5,0,6,3,3,2,7,0,0,5,2,4,0,0,2,8,0,14,6,5,0,6,6,0,1,0,5,4,5,0,2,7,0,0,0,1,7,2,11,4,1,5,0,3,1,7,6,9,3,7,2,1,5,1,1,1,2,0,5,1,5,6,6,3,2,4,0,3,0,2,0,15,3,2,0,0,2,4,2,0,3,1,3,1,3,1,1,4,2,4,0,5,0,0,1,0,4,6,7,2,0,1,3,4,0,2,4,4,1,3,8,2,2,0,0,0,11,6,0,0,0,2,1,0,3,1,0,3,1,0,6,2,9,5,0,0,0,3,14,3,10,1,0,3,0,3,8,2,0,3,3,1,1,2,6,2,0,4,0,0,2,4,4,1,2,0,3,6,3,4,1,10,7,1,5,1,0,2,4,0,3,4,1,2,4,5,4,6,0,0,6,9,0,5,0,1,6,3,4,1,0,0,2,4,1,4,13,3,10,9,5,1,5,4,1,1,18,0,3,1,2,2,1,0,1,5,3,4,0,3,2,0,3,17,0,0,1,0,2,4,3,3,7,1,3,2,2,13,0,3,0,0,4,7,3,5,2,5,4,6,1,0,2,0,0,1,6,1,0,1,0,4,8,0,3,1,0,0,6,9,9,0,5,2,3,1,0,0,0,0,0,0,1,0,6,0,1,3,0,1,5,1,2,2,0,4,10,7,0,2,2,1,2,18,0,6,2,2,0,4,5,5,3,4,0,7,5,7,6,0,6,2,11,0,1,4,4,0,0,0,1,11,0,0,1,1,12,0,3,1,0,15,0,0,7,0,1,2,1,7,1,4,0,10,0,0,1,1,4,5,8,2,0,0,1,0,2,4,3,4,8,3,0,4,2,0,0,3,3,3,3,0,2,6,2,1,5,2,0,10,0,2,0,1,1,4,4,5,5,1,4,2,3,1,0,9,1,0,6,1,0,1,3,9,0,0,2,3,6,2,5,4,3,4,9,2,5,3,9,0,1,2,1,2,3,0,0,5,2,2,6,6,3,7,1,0,2,2,3,3,2,1,0,1,1,1,0,0,1,3,0,1,4,0,4,0,8,5,1,1,1,2,3,4,4,8,3,4,2,5,0,1,7,0,1,3,3,1,0,2,1,1,1,3,1,2,4,0,0,0,1,2,0,3,0,2,0,2,6,1,7,1,0,3,1,2,3,0,0,7,7,2,1,1,7,3,3,5,3,0,0,2,14,1,0,9,3,1,11,0,12,2,2,1,19,5,0,0,3,3,6,4,8,2,3,0,1,4,2,4,0,0,9,3,5,0,1,3,1,0,9,7,0,1,0,0,2,8,0,4,4,1,3,4,6,3,1,0,3,4,4,0,3,0,1,2,2,2,5,0,0,1,3,2,2,0,6,4,3,0,1,5,1,0,6,0,12,8,6,3,0,0,3,3,0,3,26,0,0,6,6,1,0,3,1,2,1,2,5,0,4,0,2,6,2,4,5,6,2,5,0,0,3,6,3,1,2,6,4,2,5,2,7,2,5,1,2,1,0,1,0,9,1,0,1,1,2,4,2,3,1,0,1,1,0,4,0,10,0,0,3,0,2,0,2,1,2,2,3,4,0,1,6,2,0,10,4,0,0,11,3,3,4,0,5,0,5,7,2,8,0,0,0,5,5,3,3,3,4,2,3,2,9,1,3,0,4,2,1,3,3,4,2,0,0,4,2,4,0,4,1,9,0,2,1,3,0,0,0,1,21,3,3,5,0,4,1,0,6,4,0,7,6,1,0,1,4,2,0,0,7,1,0,0,2,0,10,3,0,3,2,0,0,3,0,0,3,0,3,0,0,3,2,0,1,4,2,2,6,5,5,0,2,1,0,2,3,0,1,0,1,3,2,1,0,34,5,1,6,2,4,0,7,0,5,0,6,0,0,1,1,0,9,6,1,4,0,3,4,0,1,1,0,2,0,0,4,6,2,1,2,0,8,5,2,1,1,0,2,1,4,3,0,4,1,0,0,0,0,9,7,0,2,0,9,8,4,1,2,2,1,3,0,2,7,1,3,1,0,1,1,3,0,3,5,1,5,3,0,6,2,2,2,4,0,3,0,4,4,1,0,0,8,1,0,0,0,5,1,2,0,4,0,3,3,3,2,0,2,1,1,3,1,4,5,3,1,3,0,0,3,0,1,1,8,0,1,0,0,4,1,0,2,0,1,7,2,2,7,1,1,3,2,1,6,1,0,1,0,1,0,2,1,3,3,20,1,5,1,1,1,0,0,0,7,2,4,1,0,0,2,0,7,1,0,0,1,6,2,0,1,1,1,3,0,3,2,6,0,3,0,0,1,1,0,0,1,0,2,2,1,1,0,2,1,3,5,1,0,1,1,35,1,0,0,0,5,0,2,4,0,5,0,7,7,2,2,0,1,2,38,2,5,0,8,0,0,0,0,0,4,3,2,1,0,6,5,2,1,0,3,3,3,7,3,5,4,0,6,3,8,2,1,3,1,4,0,0,1,0,7,4,2,2,4,0,2,2,0,4,0,2,0,0,0,3,6,0,2,2,1,1,2,2,0,2,0,0,2,0,0,4,2,0,3,5,2,0,3,0,1,0,2,1,0,0,0,0,5,0,0,0,4,0,0,1,0,3,3,0,0,5,0,0,0,0,1,4,2,2,1,2,7,3,1,2,1,0,3,1,0,0,0,2,0,2,3,5,4,2,5,0,0,7,3,2,3,1,0,2,2,0,5,5,4,0,1,0,0,0,7,1,3,0,1,3,0,1,5,0,4,0,2,0,0,4,7,4,3,3,1,2,5,7,1,3,3,4,0,6,4,0,1,1,1,1,0,4,1,4,2,0,0,1,0,5,3,2,0,1,0,1,3,2,0,1,2,1,0,0,0,4,2,5,1,0,7,4,0,0,2,3,0,0,0,8,0,0,1,0,1,0,0,9,2,5,3,1,1,2,4,1,2,0,1,3,2,3,4,1,0,1,1,0,1,0,0,0,8,0,2,1,1,2,0,0,2,0,10,3,0,2,4,1,0,2,0,1,1,0,0,0,2,0,3,1,0,0,5,7,3,1,0,0,3,4,0,2,2,0,0,5,1,1,1,0,2,2,5,1,1,1,1,1,0,0,1,0,3,1,3,1,0,1,9,0,3,0,0,1,1,0,1,0,0,1,5,2,0,3,3,0,0,3,7,9,10,2,0,0,6,1,3,3,2,0,0,2,2,1,0,3,0,10,3,3,2,3,3,2,0,0,0,1,2,0,2,1,0,0,2,0,2,0,1,1,2,2,8,1,2,3,1,0,2,0,0,3,3,0,4,3,2,0,0,0,0,3,4,1,3,0,0,1,2,1,2,4,2,0,1,0,0,1,3,0,1,0,3,25,0,2,1,0,0,2,2,2,1,0,3,0,0,0,0,0,0,8,0,1,4,3,2,4,0,0,0,2,2,1,2,0,0,2,1,9,0,0,0,1,0,3,1,1,0,7,1,1,1,0,2,6,0,0,3,6,0,4,0,0,5,0,0,0,1,1,0,7,5,2,12,4,6,0,0,0,2,1,3,0,1,1,0,0,1,0,3,4,6,0,0,1,1,1,0,2,3,0,1,1,0,1,3,1,0,0,0,5,0,1,0,0,1,1,7,1,4,2,6,1,3,1,0,0,1,1,0,1,0,1,2,0,1,3,5,4,1,4,1,4,0,1,4,1,1,16,0,1,2,0,0,7,0,1,0,3,0,4,1,1,3,2,1,0,0,1,0,3,8,1,0,1,5,0,2,4,0,0,2,0,0,0,0,0,0,2,1,8,1,1,4,8,1,0,2,11,0,0,0,1,2,5,0,2,1,1,0,0,8,0,1,3,4,1,4,2,0,6,1,0,1,4,0,2,0,1,0,0,1,0,0,5,6,0,4,4,1,1,0,4,1,0,1,3,7,1,2,1,1,1,6,1,3,0,0,0,3,0,0,6,0,2,6,1,0,0,0,1,1,1,1,4,3,2,5,0,0,0,3,1,6,0,0,1,0,1,3,2,0,1,0,0,1,1,2,1,0,0,0,1,0,0,0,0,1,36,3,4,1,1,5,3,0,0,4,0,0,0,2,0,0,7,1,0,0,4,4,1,0,3,1,1,2,0,2,1,1,0,0,3,2,3,1,1,4,1,0,1,0,2,2,2,1,2,3,0,6,1,2,0,3,3,0,1,0,4,1,1,0,4,2,0,0,1,7,1,1,1,2,0,2,0,0,2,0,0,1,1,1,0,6,0,1,6,2,0,1,3,0,1,0,2,0,0,2,0,4,3,2,3,4,0,1,7,1,4,1,1,0,5,0,0,2,0,1,1,0,4,1,5,2,5,1,0,1,1,2,1,0,1,3,1,0,5,1,2,1,1,0,1,2,3,3,2,1,0,2,0,2,1,4,3,0,0,1,3,1,0,2,0,2,2,0,0,0,4,1,2,0,1,0,0,1,0,2,0,0,1,1,1,0,2,2,3,1,0,0,0,1,0,0,2,0,2,8,8,0,5,5,1,0,2,0,1,0,5,3,0,0,2,4,1,2,5,1,1,4,4,5,1,4,2,0,1,2,1,0,0,0,0,2,3,0,0,0,0,2,5,1,0,1,2,0,5,0,0,3,4,1,5,3,0,2,2,0,3,0,7,0,2,0,0,1,2,0,3,1,0,4,0,3,3,0,1,4,1,0,5,0,1,2,1,0,0,0,0,1,3,0,1,0,1,0,0,2,11,1,0,1,2,4,1,3,0,4,3,0,3,4,2,0,1,10,6,0,0,0,1,2,0,0,0,0,2,1,0,0,3,4,1,0,5,1,0,2,1,2,3,3,0,0,0,0,0,0,1,1,3,0,0,0,0,2,1,0,2,8,2,8,2,2,8,2,0,0,0,4,2,2,1,0,1,1,0,0,4,13,2,2,2,0,0,0,2,0,2,0,3,0,2,0,1,0,0,1,3,0,1,0,0,2,0,5,5,1,1,4,0,1,1,2,1,1,1,0,1,0,0,1,1,0,0,0,0,0,2,2,1,2,0,3,0,0,2,0,0,0,1,1,5,0,3,7,2,1,4,1,0,0,0,0,0,3,0,0,0,2,3,1,3,0,1,0,1,0,1,3,0,0,1,0,0,0,0,0,3,3,1,0,2,0,0,0,3,5,0,2,0,1,0,0,0,0,2,0,0,0,0,0,3,1,0,4,0,1,0,0,0,0,0,2,2,0,0,0,0,0,0,2,0,3,0,0,0,0,0,0,0,0,0,1,0,0,0,0,0,3,1,0,0,1,0,0,0,5,0,0,0,0,0,0,0,3,0,0,0,0,0,0,0,0,0,0,0,0,0,0,0,0,0,0,0,0,0
"2008 Glass, Julia, I See You Everywhere",high,4815,2081,2399,2914,2016,3552,1221,1464,782,861,997,676,1050,987,821,855,309,668,780,364,643,780,618,385,1161,479,915,306,434,780,442,374,486,394,506,419,193,402,472,382,407,519,193,333,376,433,352,435,207,209,253,202,177,186,291,269,160,260,274,312,198,200,226,209,232,204,171,183,375,122,145,338,301,214,83,152,174,90,102,186,164,337,72,178,193,63,121,181,150,180,303,145,118,129,169,145,129,112,116,125,200,109,93,138,79,145,115,108,100,101,72,59,160,91,116,75,89,148,114,106,57,166,49,62,97,96,107,149,58,136,64,49,161,56,76,118,233,105,71,68,65,75,33,105,156,67,102,68,98,81,85,64,31,63,59,194,136,57,77,14,106,44,34,87,64,64,51,73,93,53,138,76,79,60,52,91,136,74,100,73,95,43,51,31,79,61,54,54,49,60,41,49,48,59,48,61,53,93,33,97,100,25,61,74,43,6,61,32,44,61,110,51,30,42,56,48,33,59,71,22,63,64,63,66,73,37,37,49,76,65,37,41,28,47,35,73,54,50,46,46,68,123,33,57,38,37,33,27,45,21,43,60,43,22,29,46,64,48,42,68,44,52,80,33,32,79,41,36,40,37,85,56,32,26,39,38,49,45,48,14,21,62,53,61,34,19,28,68,33,37,18,333,54,38,18,31,15,26,121,43,34,55,40,30,13,63,19,30,14,40,55,94,117,36,49,26,18,29,48,64,50,26,20,22,33,36,26,23,30,12,16,46,36,19,24,17,34,31,63,16,21,20,35,10,47,29,39,83,22,36,22,20,43,15,27,56,10,17,27,46,20,3,63,16,33,10,18,22,48,30,26,8,24,53,24,12,22,10,61,61,14,32,4,9,31,12,0,42,36,54,19,36,25,22,48,10,22,18,30,19,30,27,16,43,17,50,26,12,29,28,9,34,27,17,25,17,41,30,23,14,19,3,24,18,7,21,29,43,31,15,20,27,18,15,0,8,16,25,41,19,34,24,19,43,54,17,18,13,20,24,9,20,41,18,41,46,35,24,15,15,38,13,0,22,13,51,39,16,24,10,22,16,27,6,25,9,14,14,0,14,19,34,20,3,20,22,9,14,44,14,36,14,31,44,32,5,15,9,9,13,13,10,11,13,25,30,6,17,20,17,36,13,25,14,17,29,0,23,38,8,23,28,21,19,29,10,21,27,30,28,5,14,18,17,6,7,22,25,14,15,11,40,17,12,31,23,0,5,15,8,10,18,30,0,19,40,45,20,22,6,30,21,16,11,22,15,25,22,31,27,11,10,11,11,37,9,30,84,28,35,12,7,14,17,6,9,10,7,22,19,11,12,11,26,17,37,14,5,18,26,6,9,11,14,16,0,0,19,14,69,9,2,25,15,8,23,19,4,26,7,9,33,21,23,13,19,34,5,32,15,11,11,7,32,8,0,11,8,10,14,23,19,8,7,28,18,16,21,14,9,0,28,9,22,40,21,25,9,15,4,7,7,12,9,18,15,5,14,5,17,14,31,0,15,18,23,21,9,26,20,11,28,6,15,12,6,13,17,9,3,15,36,13,8,19,11,25,3,14,6,38,8,15,17,22,15,16,9,27,9,5,8,15,7,15,7,14,20,16,11,37,26,5,18,16,19,18,68,11,10,13,12,4,5,0,22,11,10,17,8,14,18,24,6,2,0,22,27,21,18,35,11,13,12,2,11,9,22,15,14,8,6,14,11,10,9,69,21,6,12,10,5,3,7,0,14,20,13,10,1,17,29,7,10,10,12,0,24,32,14,14,14,0,5,8,18,1,8,0,21,10,27,5,11,8,0,0,10,32,14,9,15,20,17,11,33,4,0,13,56,9,17,6,9,9,24,17,13,8,7,9,7,12,22,3,8,12,16,0,43,4,17,6,24,12,11,15,0,5,2,16,8,22,10,20,18,21,4,7,5,3,15,20,5,7,15,11,0,10,15,15,12,34,9,3,9,1,10,24,3,15,11,21,7,2,16,7,11,17,34,5,0,19,6,19,3,7,0,12,10,10,7,14,5,13,6,13,4,8,12,7,0,7,3,24,43,15,12,30,9,6,4,15,5,5,12,8,2,1,4,9,4,4,1,9,6,18,3,14,9,8,7,5,15,13,9,4,19,24,14,19,11,15,6,11,13,15,19,35,4,0,14,26,38,13,8,21,15,7,4,21,2,6,9,11,14,7,4,5,2,0,11,7,3,3,4,11,0,7,7,5,0,17,11,17,11,2,21,17,0,10,0,31,1,12,12,0,6,6,2,11,20,1,13,15,4,16,1,12,9,0,7,9,2,0,1,10,7,10,7,13,2,9,7,8,16,7,30,4,14,8,10,1,9,2,10,0,4,3,16,14,17,23,6,6,3,11,10,7,15,12,7,0,4,7,7,10,6,3,0,6,3,5,15,6,21,8,2,11,11,11,3,19,8,6,3,3,10,7,1,7,1,11,10,3,25,11,16,18,4,5,6,19,14,5,6,6,9,8,12,7,5,2,16,0,7,5,6,5,9,15,20,2,23,6,14,5,16,2,2,1,99,19,2,2,6,4,14,31,5,6,13,6,18,6,24,3,12,9,18,6,4,20,1,6,3,3,7,12,9,32,8,9,3,0,1,2,13,2,16,1,7,2,14,1,16,7,2,9,0,29,2,6,5,6,12,0,9,10,0,9,6,0,16,3,17,7,6,102,6,1,0,17,8,19,4,0,17,15,10,0,10,8,11,8,0,0,9,2,4,4,20,9,2,5,8,30,6,13,4,12,3,18,2,9,0,3,41,5,4,8,3,2,0,6,17,0,9,9,10,3,3,6,9,4,7,4,15,0,12,2,0,5,10,0,1,7,13,3,9,1,0,3,2,0,9,8,7,0,58,2,10,13,12,3,8,12,12,8,2,0,6,3,17,14,18,6,5,0,4,10,4,0,3,11,9,8,24,5,5,12,31,9,20,5,6,10,11,17,4,4,4,0,0,5,7,13,3,4,6,0,19,8,0,4,9,12,1,18,7,3,2,24,0,10,11,9,5,0,1,3,35,0,4,5,13,6,3,10,1,2,6,6,0,2,5,3,3,0,18,4,5,2,2,2,0,1,10,0,1,1,0,15,13,10,15,2,0,1,10,6,8,8,11,6,9,1,1,11,2,0,1,0,4,0,4,3,0,9,6,3,7,13,9,53,2,5,3,8,5,4,1,3,11,7,9,2,0,2,5,3,4,0,0,9,4,9,3,8,4,5,1,3,18,0,12,0,8,3,4,10,8,0,10,15,0,6,1,5,2,13,1,5,0,2,9,8,0,14,28,1,8,4,11,0,0,5,11,8,7,7,14,4,7,15,9,4,6,15,3,9,12,8,2,3,14,0,0,6,2,6,0,1,0,0,23,0,3,2,0,7,4,1,4,11,6,6,0,3,1,7,7,18,17,6,1,7,5,5,10,4,5,4,8,4,0,7,20,8,27,10,7,7,7,3,3,6,26,2,6,3,1,3,12,15,9,1,6,7,6,11,15,2,4,9,2,3,2,13,8,2,7,3,0,10,7,8,2,4,4,6,8,2,4,21,1,3,8,27,4,0,7,6,0,7,8,10,0,1,0,0,0,0,12,10,13,8,2,2,12,11,10,8,5,3,2,0,13,2,8,4,2,3,0,48,7,13,13,9,3,25,1,3,2,1,9,7,6,3,0,7,1,2,3,0,1,2,7,13,7,1,2,7,3,10,6,4,1,8,2,2,11,10,25,10,3,1,0,5,4,2,3,14,16,2,3,2,18,0,6,6,7,5,10,10,2,3,8,9,6,8,0,5,15,4,4,12,2,9,8,2,1,4,2,6,0,4,10,6,6,5,7,13,5,2,2,3,13,0,2,2,13,5,12,3,1,7,3,6,6,2,3,2,0,4,6,6,1,0,4,7,16,2,3,0,62,1,14,2,3,8,4,2,2,2,5,0,4,5,5,4,4,6,6,6,5,5,5,3,0,7,2,0,10,8,5,2,0,2,1,12,7,12,14,0,1,6,10,7,8,5,5,0,9,4,2,7,26,5,3,2,3,6,5,5,6,14,8,11,20,1,11,8,0,1,2,0,0,9,3,8,4,2,0,6,10,0,30,0,0,0,1,5,10,0,4,4,6,0,4,8,4,1,9,1,2,3,13,6,7,4,5,0,5,6,2,0,5,2,1,5,9,6,0,3,11,0,5,5,0,7,5,1,4,2,8,1,6,11,10,0,5,5,3,1,2,5,5,7,4,1,3,0,2,1,0,6,3,4,3,0,1,15,2,0,6,1,2,2,6,0,7,3,1,3,1,0,10,1,3,5,0,0,6,4,7,2,0,4,0,4,1,0,10,5,0,13,5,0,5,2,4,0,4,1,2,1,5,1,5,3,6,4,12,6,4,0,1,3,1,4,2,0,1,4,8,2,13,6,6,6,4,0,0,4,3,4,2,2,16,2,2,7,3,0,8,5,1,4,0,0,0,6,0,2,3,15,1,4,5,8,0,2,2,7,10,1,2,1,3,2,4,4,3,7,2,4,1,11,6,3,15,5,4,5,240,4,7,4,0,7,0,6,5,3,2,6,1,6,1,1,6,2,0,1,2,3,1,5,1,0,0,10,3,3,5,3,2,5,8,7,2,2,5,6,4,3,7,4,5,1,1,6,3,0,0,10,4,1,4,0,8,1,7,5,3,6,0,10,2,7,1,3,0,0,4,1,4,9,1,2,4,2,8,1,14,0,4,3,8,2,5,2,1,1,3,32,10,0,101,0,0,5,4,0,0,1,2,7,7,3,10,5,4,0,1,3,1,4,14,4,4,1,1,4,4,0,5,0,1,1,5,0,0,5,0,8,3,3,4,0,2,1,4,5,4,3,3,4,4,0,6,3,0,11,0,0,1,2,0,1,0,0,3,2,7,10,1,11,4,3,2,1,2,5,1,2,4,2,5,5,6,0,3,2,1,0,0,4,1,7,0,5,3,4,1,5,2,1,1,3,2,2,0,3,2,3,1,4,10,5,1,3,7,2,3,2,0,3,0,16,1,9,12,6,7,7,2,1,5,5,6,0,5,7,2,25,11,4,1,3,1,9,3,4,1,7,6,6,3,4,0,3,5,1,8,2,4,2,14,6,8,0,1,4,1,4,5,2,3,4,1,7,0,2,2,3,5,1,1,3,2,8,4,13,1,3,0,16,3,8,3,4,2,14,3,2,2,5,3,1,6,0,13,5,5,10,1,4,3,2,2,5,2,2,4,1,3,2,6,7,2,0,2,9,0,3,5,10,3,0,2,58,3,1,3,3,8,2,0,4,4,2,0,4,10,5,0,0,0,7,2,0,4,2,0,2,1,3,1,1,5,3,2,2,0,6,3,1,10,3,4,3,2,0,5,0,1,7,4,3,2,4,0,2,0,9,18,7,0,4,3,9,6,3,2,4,1,0,1,8,5,6,5,3,0,2,3,7,0,2,9,1,0,5,1,2,1,5,4,0,2,4,0,9,0,0,10,5,2,2,1,2,4,0,3,6,1,3,10,1,0,14,16,2,2,3,10,5,0,0,4,6,4,2,6,0,2,4,5,1,1,0,4,0,1,3,0,2,2,2,0,7,1,3,5,12,4,3,11,0,4,0,1,2,6,0,0,6,4,3,2,1,2,0,8,5,2,14,10,12,4,0,2,3,1,15,4,1,5,1,6,13,7,5,3,2,1,2,4,2,0,4,2,16,1,1,3,8,2,0,1,0,0,4,3,8,2,0,4,2,4,5,0,1,8,1,0,10,0,7,0,0,1,0,0,0,5,1,1,2,4,5,4,3,4,7,3,0,2,2,1,4,4,8,4,1,0,10,2,4,2,0,4,3,2,8,4,2,13,1,2,9,0,6,5,8,1,1,2,1,3,1,4,1,2,0,1,0,1,1,2,0,2,0,19,0,0,9,0,1,2,1,5,22,0,2,7,3,0,2,4,5,5,0,1,0,6,2,1,2,4,0,4,2,1,6,3,1,1,2,3,1,0,4,0,1,6,2,1,4,2,2,1,0,0,0,3,1,6,2,0,1,1,0,0,2,3,6,11,2,1,4,3,1,1,4,7,3,4,1,4,1,2,1,2,0,6,0,6,7,1,4,3,1,3,3,2,4,11,11,0,9,7,8,0,1,0,0,2,1,0,10,0,1,0,3,4,3,0,0,0,1,1,0,0,5,0,1,2,7,2,4,6,0,2,8,1,1,6,1,1,0,1,1,0,3,3,4,2,4,1,1,2,8,0,0,1,5,0,12,2,1,5,9,5,1,3,7,4,11,2,6,1,0,0,1,4,2,2,1,1,6,5,1,3,1,0,0,6,1,2,4,3,2,3,1,5,1,2,8,1,0,0,2,2,3,9,0,0,3,0,0,1,1,3,3,0,2,0,0,1,3,1,0,3,8,1,0,3,0,3,3,5,0,0,0,3,1,1,1,1,6,0,2,2,3,0,2,0,2,1,1,9,1,11,0,3,6,0,3,6,0,0,1,3,3,2,2,5,1,7,2,0,1,1,0,0,3,1,1,0,0,3,5,2,2,7,0,1,1,4,3,0,0,0,56,4,3,6,0,3,1,1,8,3,3,5,1,3,0,0,3,1,10,1,4,0,5,0,2,13,1,2,1,0,0,3,6,0,7,2,1,0,3,1,1,4,1,1,0,1,4,3,5,3,8,0,0,1,0,0,2,2,7,1,3,2,1,1,1,0,9,2,5,3,1,0,0,4,1,0,0,5,1,6,5,0,4,0,2,3,3,2,0,1,0,0,0,2,2,2,0,1,0,0,4,0,1,2,0,3,0,2,14,3,5,5,1,3,0,1,3,1,2,3,2,1,2,6,2,2,5,3,4,1,5,0,0,3,0,0,0,0,6,2,1,3,5,3,2,0,3,2,3,5,10,2,1,1,3,2,0,3,1,3,0,4,5,0,0,0,2,0,5,2,0,0,5,6,3,5,15,1,1,19,1,3,1,1,0,4,180,3,0,4,0,1,1,3,4,6,3,4,0,0,5,1,2,1,0,7,0,6,2,1,3,5,0,0,0,1,1,1,2,4,5,9,2,2,1,2,0,0,3,2,0,3,1,4,0,6,4,1,1,4,1,1,0,1,2,1,0,4,3,3,6,1,1,2,3,0,3,2,1,0,1,0,3,6,3,3,0,0,2,1,8,3,3,0,1,0,4,3,3,3,0,4,2,0,6,1,5,0,2,8,2,0,6,0,1,0,5,3,1,1,1,6,3,1,1,0,1,4,3,1,3,1,1,0,1,2,1,3,0,1,9,0,2,0,0,5,0,0,0,1,4,1,6,5,1,0,0,1,3,0,2,0,1,1,2,3,1,1,2,2,0,1,10,1,4,4,2,3,7,5,1,2,1,4,0,0,7,1,0,0,2,0,1,0,2,0,3,2,2,4,1,0,0,2,0,5,0,2,2,1,3,1,0,0,0,0,2,6,11,1,0,1,2,3,1,2,0,0,0,1,3,0,0,1,3,1,1,5,1,0,0,0,3,0,2,6,1,1,0,0,1,1,3,4,0,0,6,5,1,6,3,2,2,0,2,3,1,5,0,1,4,0,0,1,0,1,2,0,4,2,0,6,0,1,1,1,1,1,4,5,3,19,0,1,2,6,2,2,3,0,1,3,0,0,7,0,0,4,5,0,2,2,1,0,2,0,7,3,17,0,0,1,8,0,4,2,2,2,2,1,4,0,1,0,4,0,5,4,0,0,0,1,4,3,0,4,2,3,12,4,3,0,1,0,0,0,4,0,7,4,4,3,1,1,2,4,4,0,0,0,4,1,0,4,1,0,4,6,1,4,1,0,1,1,0,0,1,0,2,1,4,6,0,12,2,0,0,1,0,2,0,0,0,8,16,4,0,3,11,8,0,3,5,0,1,1,1,0,1,1,1,4,1,6,1,3,0,0,10,4,0,0,1,3,0,1,1,0,3,1,2,0,0,2,1,1,1,4,1,4,0,4,1,0,2,1,3,8,2,0,3,0,4,0,0,4,2,1,2,0,0,14,1,1,2,2,5,3,1,0,1,0,0,0,1,1,1,4,1,0,1,6,5,1,13,3,2,0,2,1,0,8,4,0,3,0,2,0,8,1,20,0,3,3,0,3,1,1,7,1,1,2,1,0,0,3,3,0,1,0,2,4,0,1,0,0,5,3,1,5,3,3,1,3,0,1,4,1,0,2,2,5,0,3,1,4,2,6,0,3,0,47,5,2,0,0,3,1,4,1,2,0,1,3,1,2,1,1,3,3,3,0,0,3,4,2,0,0,0,1,1,4,2,0,0,1,0,0,3,2,2,1,0,3,3,0,4,2,2,3,0,3,3,0,2,1,0,0,8,0,2,1,0,9,3,0,0,4,3,3,0,1,0,2,0,1,1,61,2,6,1,0,1,2,2,6,0,1,0,3,0,9,2,0,0,1,1,1,0,0,2,0,0,1,2,3,0,0,0,3,1,0,4,5,0,2,1,0,1,1,0,2,0,0,0,0,2,0,4,0,0,3,0,0,0,0,1,0,7,1,2,1,0,7,1,2,1,0,5,0,5,7,1,1,0,4,2,5,0,1,1,10,2,3,21,0,2,1,0,10,0,5,5,1,8,2,1,6,1,2,3,0,0,2,16,0,3,1,0,1,1,2,3,2,1,1,3,1,0,3,1,0,0,3,0,1,0,1,0,4,2,0,2,1,0,0,1,2,2,7,4,3,0,3,0,7,7,0,1,2,1,7,3,1,3,0,0,3,0,5,6,1,1,0,0,0,0,3,3,0,1,2,1,2,4,1,3,0,0,0,1,2,2,3,2,0,2,6,3,0,6,5,1,0,6,0,1,0,5,1,3,0,2,0,0,1,3,1,4,5,2,6,1,3,0,0,2,0,2,0,1,4,3,1,6,3,7,0,3,2,2,12,1,0,3,0,1,2,2,0,0,3,2,2,1,1,7,0,4,3,4,4,1,0,0,3,0,2,1,2,1,14,3,0,0,2,1,0,3,10,4,3,5,0,0,0,5,3,0,10,2,0,2,1,3,0,3,0,8,1,2,0,0,4,2,1,0,0,0,0,5,1,2,1,1,1,1,4,4,3,0,6,0,5,1,0,1,2,0,0,1,1,4,0,5,6,0,2,1,1,0,5,3,6,1,0,0,1,1,0,0,0,0,0,1,2,0,4,2,0,2,2,1,2,2,1,0,1,0,1,3,3,0,1,0,4,0,1,3,1,0,2,2,5,0,2,2,1,6,0,1,1,1,0,0,1,0,2,0,0,4,2,3,1,0,4,2,6,3,4,0,0,1,1,0,1,0,1,0,1,0,2,3,2,0,1,2,2,1,6,2,1,0,0,1,1,0,1,0,0,4,0,0,0,9,0,1,1,2,2,0,0,3,2,4,1,0,2,4,0,0,12,1,0,2,0,3,11,1,0,0,5,1,3,6,0,0,0,10,1,0,1,0,3,0,0,2,3,5,1,0,0,0,0,6,2,0,1,0,9,0,0,0,6,5,0,0,5,0,5,1,2,2,1,3,0,0,2,5,3,0,4,2,2,1,0,0,3,1,0,1,3,1,5,2,5,0,4,6,0,5,1,2,2,0,1,0,0,2,5,0,2,1,1,2,3,2,0,1,0,5,0,0,2,6,1,3,2,0,0,0,7,1,0,4,1,1,0,2,1,1,3,0,0,3,2,5,0,3,2,2,2,2,0,2,3,2,3,8,2,0,2,1,1,1,0,2,7,4,0,0,0,3,1,1,1,1,0,0,2,3,0,2,0,1,0,0,0,4,4,7,1,0,0,4,6,1,2,1,1,2,0,0,0,2,0,0,5,1,3,0,3,6,4,0,0,2,0,1,2,5,1,1,14,0,3,1,3,0,0,1,0,0,0,4,2,0,0,2,3,0,0,0,0,5,0,0,4,2,0,0,2,5,0,3,0,0,5,2,1,4,1,2,0,3,1,5,0,0,0,2,2,0,3,3,4,4,0,14,1,0,2,3,0,2,5,1,6,0,0,0,3,0,0,2,1,2,3,2,0,2,1,0,1,2,0,5,1,0,0,2,13,1,2,1,0,0,2,1,4,1,4,0,11,0,1,0,1,1,1,0,2,3,0,0,0,1,1,0,0,0,1,0,0,0,2,1,2,1,2,1,1,0,0,1,2,2,0,3,2,0,0,3,0,1,3,0,4,2,0,0,0,5,0,0,0,3,1,1,1,0,0,5,1,1,1,1,4,1,2,2,1,1,2,0,0,2,8,1,6,0,0,0,1,0,1,0,2,1,1,2,1,0,1,0,0,2,0,1,4,1,2,0,1,0,1,1,2,4,2,0,6,5,12,1,3,1,0,0,0,0,4,7,0,4,0,0,1,0,0,5,0,0,1,0,0,0,2,0,7,1,1,2,1,8,7,4,0,0,3,1,0,0,0,6,1,0,1,2,0,1,2,0,0,0,0,1,1,2,1,4,0,0,0,0,1,3,0,1,4,2,0,1,1,0,0,0,1,0,5,0,0,1,2,1,1,2,1,3,0,0,4,1,1,1,0,3,0,2,1,0,1,7,1,0,1,5,5,0,2,0,0,1,0,2,1,2,0,3,1,0,2,2,4,2,0,0,4,1,4,2,3,0,0,7,0,0,0,3,0,0,1,1,0,1,0,0,1,1,0,3,2,0,0,2,0,7,2,3,0,0,2,1,1,0,0,0,1,1,1,0,0,0,0,7,0,1,1,1,3,1,6,0,0,1,0,2,6,1,0,7,2,1,1,0,1,1,1,0,2,0,0,0,1,2,3,0,0,0,2,1,0,0,0,2,1,6,2,2,1,0,1,1,3,0,1,2,1,2,3,2,2,2,0,1,2,0,0,3,0,0,0,0,3,4,1,2,0,1,0,0,2,3,0,0,0,2,1,3,1,1,6,0,2,0,0,0,0,33,0,1,0,1,1,0,0,2,6,1,1,0,1,0,1,1,0,0,0,1,1,0,0,0,1,0,0,0,1,0,1,0,0,2,1,1,0,1,0,2,0,0,0,0,0,0,0,0,0,0,0,0,3,0,0,4,0,0,0,2,0,2,2,0,0,0,0,0,1,0,1,0,0,2,0,0,0,0,0,1,0,2,1,0,1,0,0,0,1,0,0,2,0,0,0,0,0,0,0,0,0,0,0,1,1,0,0,0,0,0,0,0,0,0,0,0,0,0,0,0,0,0,0,0,0
"2010 Casey, John, Compass Rose",high,5441,3265,3317,3096,2472,1728,1244,1709,2081,1658,1492,872,1515,2924,2473,1115,649,764,841,1408,778,1013,713,461,254,535,345,359,626,479,355,818,599,676,441,492,323,537,258,470,526,407,454,316,476,575,355,535,307,451,422,278,360,309,308,288,287,357,267,552,301,292,166,307,364,257,168,257,193,161,347,423,309,268,456,284,172,317,260,199,279,375,73,295,258,202,135,215,138,166,233,259,115,138,235,179,213,165,257,104,73,228,254,181,291,53,177,156,162,226,188,143,52,163,142,115,138,127,175,138,76,76,157,102,97,113,113,138,103,119,157,169,167,172,223,131,58,109,68,72,186,82,135,221,80,253,133,141,121,133,93,68,133,204,66,171,85,67,63,56,71,186,187,139,53,50,116,111,158,59,71,64,58,164,63,50,73,76,75,119,49,53,144,41,161,69,109,117,102,50,100,55,143,51,61,97,56,92,43,37,71,49,84,53,117,139,49,22,108,72,34,46,49,50,51,49,60,65,48,99,53,32,57,60,79,56,121,46,36,75,47,47,61,65,52,455,42,40,40,26,87,131,52,69,22,68,23,52,77,13,89,61,70,38,65,69,124,67,53,17,60,69,143,58,35,59,63,39,25,49,64,46,109,36,73,42,44,77,123,70,34,33,50,54,32,1,57,59,25,49,93,47,51,13,60,81,44,88,103,77,55,45,109,65,55,102,49,44,57,695,29,19,41,112,18,95,12,52,36,46,55,35,53,46,232,52,50,22,31,51,58,13,50,63,19,76,32,3,41,27,15,26,31,33,60,31,38,33,30,39,49,36,68,37,39,50,16,77,32,28,23,30,44,26,52,11,30,24,57,37,22,24,18,70,24,68,5,24,35,48,22,65,8,18,10,0,0,43,46,25,7,87,32,22,43,42,33,31,21,17,65,17,48,12,34,39,63,71,26,5,28,40,44,11,17,42,27,42,15,29,22,436,432,18,31,20,28,19,14,27,28,37,34,40,6,25,31,27,0,45,15,66,48,34,65,15,15,25,24,22,27,18,65,42,20,43,39,26,3,19,52,17,0,7,20,31,24,8,7,5,10,14,25,1,54,16,20,17,0,12,30,11,38,5,20,19,35,857,49,27,20,20,28,33,25,18,11,44,3,107,35,6,31,12,21,39,28,41,17,19,10,30,36,40,27,16,0,55,97,28,38,6,28,46,35,22,55,45,37,60,0,38,23,56,4,467,12,27,6,21,14,14,18,28,20,11,976,3,12,10,25,18,16,1,12,13,15,17,24,3,26,14,24,17,30,33,24,32,48,2,26,27,21,12,44,41,20,29,22,29,75,15,38,26,336,15,8,26,6,3,19,11,14,7,18,28,6,15,4,42,30,22,4,5,14,0,0,43,35,22,10,0,18,16,9,25,11,19,42,21,20,22,25,23,27,26,6,19,19,10,16,8,10,59,48,0,21,22,28,13,22,12,22,1,16,18,11,49,43,23,2,17,8,22,21,15,32,13,21,3,24,23,22,8,28,11,10,14,20,15,17,13,9,8,2,24,29,12,16,16,8,13,4,4,16,16,79,14,15,5,16,11,15,10,12,14,2,104,13,2,20,8,8,5,29,5,39,9,11,10,1,29,10,13,15,10,26,9,27,8,15,25,36,65,11,16,16,6,8,16,24,19,5,16,0,12,12,19,6,25,11,20,2,14,2,6,8,25,13,32,21,25,21,10,2,1,6,9,16,13,24,17,19,10,2,18,23,12,9,18,8,12,0,20,0,13,24,49,24,23,12,12,2,23,8,20,5,8,32,8,28,2,0,23,14,28,0,16,0,15,19,42,31,37,8,2,11,1,8,10,8,10,28,0,16,15,6,1,14,17,2,9,2,6,8,24,15,6,12,14,6,4,37,32,4,31,6,8,0,10,2,8,13,12,15,3,24,0,8,2,11,43,8,13,9,14,9,6,7,9,12,17,12,20,3,13,9,0,31,11,7,17,38,16,0,11,0,8,24,17,5,10,9,16,5,20,21,28,17,20,5,8,9,3,6,1,1,228,24,20,2,1,5,3,19,18,14,7,10,17,3,0,12,0,9,4,3,8,14,26,10,0,5,45,4,16,3,0,0,12,9,4,9,91,9,11,6,9,7,7,21,5,5,12,7,6,4,9,17,5,19,8,29,10,10,7,20,19,10,4,0,8,57,0,39,3,21,3,21,14,9,0,9,30,10,8,9,20,7,0,1,21,16,0,2,6,12,0,4,9,11,3,11,3,14,9,0,13,37,0,15,0,16,0,15,1,0,20,0,2,11,13,0,43,11,2,4,0,4,25,1,6,8,0,0,15,0,9,17,9,6,13,16,11,16,10,22,5,26,4,8,7,0,2,6,9,10,3,3,8,3,6,9,13,11,0,6,12,29,18,2,9,0,2,1,8,12,21,0,0,0,3,1,6,7,13,3,0,3,0,3,0,24,5,30,9,0,27,2,3,4,0,5,7,12,6,21,1,6,3,10,11,12,4,10,13,5,2,10,13,15,6,13,26,0,1,2,5,13,13,16,6,7,9,8,10,11,6,5,1,10,39,4,3,9,7,5,24,12,15,19,20,6,6,19,30,2,6,13,34,0,3,6,13,4,0,7,14,3,3,4,0,4,19,0,20,34,11,3,0,0,12,17,0,2,25,2,1,1,0,4,5,19,13,8,5,0,6,12,0,13,2,0,10,2,6,3,4,2,9,0,0,5,19,40,1,0,9,17,3,0,4,16,3,7,0,0,11,24,3,11,2,5,2,15,38,4,27,8,6,6,23,0,18,7,0,8,20,1,8,4,10,6,0,1,6,0,17,18,17,1,12,10,13,8,4,1,14,0,3,10,0,1,9,0,6,11,20,5,2,1,4,1,0,0,13,6,17,0,25,11,9,6,5,3,25,8,4,18,8,0,10,7,14,10,10,7,3,0,3,10,3,3,2,20,4,7,2,6,4,54,16,20,14,0,3,6,13,7,23,18,13,2,0,8,6,2,9,11,8,0,14,24,3,0,10,4,3,5,11,7,14,16,0,4,7,6,18,3,1,2,6,2,9,7,1,3,10,11,41,0,11,6,0,10,2,6,2,13,5,0,0,5,31,13,0,0,7,0,0,0,0,9,17,7,9,10,2,3,3,17,19,10,0,6,0,5,47,5,1,0,1,0,7,0,4,12,0,2,0,3,8,20,17,0,10,7,0,5,18,4,3,8,10,8,18,0,0,1,5,26,7,0,0,11,9,2,3,13,5,14,2,4,10,224,23,4,8,3,2,4,3,0,8,8,0,7,0,5,3,26,4,4,0,21,12,21,0,3,14,8,1,2,19,0,0,5,5,5,3,8,20,0,3,0,9,17,2,19,20,4,2,4,10,2,2,0,0,2,3,5,1,0,0,0,6,0,14,2,0,3,7,0,22,4,4,21,0,0,1,9,4,6,7,9,7,4,10,0,5,8,0,0,3,4,0,12,2,2,3,24,5,9,6,7,12,9,0,2,3,9,14,5,2,3,0,0,3,3,1,13,6,0,12,6,0,0,8,6,5,5,9,0,0,0,9,5,0,3,12,1,2,10,9,8,0,5,9,11,19,0,8,1,0,5,4,3,0,0,4,0,2,0,12,3,0,4,2,5,34,6,4,12,5,2,7,0,14,0,3,4,3,11,0,6,5,4,6,4,3,2,8,8,0,6,4,22,28,0,9,3,1,3,10,0,0,1,7,14,1,0,1,6,4,12,8,1,0,7,1,4,20,7,3,7,5,4,0,5,8,3,6,5,15,2,2,0,7,4,9,5,6,10,2,14,6,1,5,6,2,3,0,13,11,14,0,18,0,6,6,6,6,9,4,2,2,3,7,29,0,2,2,33,3,11,6,0,1,0,5,4,6,1,2,14,6,12,13,26,10,4,12,3,0,6,4,7,3,0,4,2,2,5,10,0,5,4,2,4,3,5,8,15,1,0,7,0,10,5,6,8,0,13,2,8,11,6,8,8,0,1,1,0,4,8,1,7,2,0,6,3,11,2,12,1,3,6,3,8,3,1,6,0,17,0,5,1,4,16,4,3,1,2,5,8,3,16,0,1,5,7,2,1,0,1,29,5,0,2,5,20,14,0,0,0,1,0,2,0,277,0,0,3,12,0,6,1,5,0,1,0,5,0,8,1,7,5,12,6,17,6,8,0,7,4,13,7,9,0,0,8,3,3,4,1,14,0,5,1,3,1,1,0,1,5,5,6,0,10,9,0,26,7,1,0,9,3,1,3,1,4,3,0,5,11,0,11,0,8,1,0,2,12,3,0,8,4,0,194,5,0,6,10,0,1,1,3,3,5,0,10,23,0,2,3,6,4,0,9,2,0,2,0,10,19,0,4,5,0,2,1,6,0,2,0,4,4,12,3,1,0,7,0,2,0,6,0,4,0,1,1,1,6,5,4,2,3,8,1,3,7,6,0,0,2,1,0,6,7,2,1,9,3,8,0,17,7,9,5,5,0,1,0,0,5,4,0,0,2,7,2,0,4,2,0,5,2,17,2,0,20,3,3,17,0,1,6,1,2,6,1,13,7,1,4,0,7,4,4,0,2,4,0,3,7,1,3,0,0,4,0,1,0,0,5,2,3,8,3,8,19,6,6,8,8,2,1,0,6,2,1,0,2,10,14,6,2,4,26,9,0,10,2,4,0,2,1,4,7,2,4,1,2,2,5,4,1,0,0,3,5,3,3,9,1,4,2,0,7,3,4,2,1,2,1,3,0,0,0,4,1,1,0,1,2,2,2,1,0,0,6,0,6,2,0,0,2,3,2,7,8,5,5,21,0,10,5,0,5,8,12,2,4,32,4,3,1,12,0,2,1,1,0,0,2,0,10,0,6,3,0,3,0,4,7,6,4,5,1,0,1,0,6,0,2,0,0,1,7,2,4,1,0,0,28,0,4,1,4,16,0,5,8,0,5,2,0,4,0,8,1,6,1,0,2,1,0,0,3,11,1,4,1,6,12,0,2,1,2,0,2,0,13,0,2,2,2,2,2,4,0,1,1,7,0,12,0,0,18,0,15,0,6,10,4,22,1,0,3,18,2,0,0,1,10,5,4,1,12,18,3,0,2,4,6,2,5,4,10,1,12,0,4,10,1,0,4,8,4,1,0,5,0,3,0,6,5,9,1,1,9,13,4,4,0,0,1,11,0,2,16,2,4,1,5,6,6,3,4,4,0,5,5,1,8,2,3,1,2,4,1,8,0,0,3,13,2,8,5,0,0,4,2,1,0,0,1,3,0,2,2,3,5,1,0,7,0,3,3,0,2,3,2,8,0,4,8,5,0,1,3,0,11,18,1,1,3,0,9,0,5,7,0,0,1,0,2,12,4,7,0,11,0,3,6,0,1,3,0,6,1,1,0,10,1,4,8,23,0,3,1,8,1,0,0,29,0,1,4,1,0,8,2,2,0,2,5,6,0,3,0,7,3,7,20,0,4,0,4,0,0,2,7,4,3,6,5,0,8,1,305,6,5,0,2,0,5,1,6,7,5,2,4,6,0,1,5,0,3,8,5,0,2,4,0,2,0,22,0,0,0,1,7,9,1,7,1,5,3,3,5,0,6,5,0,2,6,0,2,14,9,0,1,2,2,0,0,2,4,1,1,0,3,1,1,3,0,0,6,0,15,5,0,9,0,5,1,4,3,6,13,3,3,4,0,1,7,6,5,1,9,2,1,4,5,0,2,8,3,5,3,0,5,1,1,3,0,1,0,6,0,2,0,3,0,8,0,3,1,1,7,5,0,4,0,5,3,0,2,0,1,153,0,0,0,0,0,3,0,0,1,3,5,1,3,0,4,4,0,2,8,1,3,3,3,4,0,3,13,3,1,0,7,2,4,21,5,0,2,0,6,1,1,0,8,3,3,0,1,1,0,1,2,0,0,11,4,2,0,7,2,0,0,0,0,1,0,0,1,0,3,0,6,0,0,0,2,6,0,0,95,2,6,4,1,2,13,1,3,4,2,1,1,4,0,6,17,2,0,2,1,2,0,0,3,8,13,1,0,1,0,1,1,7,0,0,0,0,0,2,3,0,5,6,7,0,0,7,1,4,6,1,4,1,2,4,1,0,1,1,1,5,2,0,1,0,1,3,2,14,3,1,7,5,0,7,2,46,10,8,2,0,5,7,2,0,0,0,3,3,0,0,1,0,0,0,4,0,8,8,0,0,1,7,0,7,3,0,1,14,0,0,1,1,0,11,7,13,3,3,2,0,0,0,10,0,4,1,7,1,3,0,2,0,0,0,1,3,0,0,5,9,2,0,4,15,5,6,0,3,1,3,6,1,0,0,0,6,1,7,0,2,2,1,3,14,1,0,6,5,1,1,1,3,3,1,3,9,1,0,4,3,1,0,1,1,1,1,0,0,0,1,0,0,0,3,16,0,2,1,0,3,0,3,4,3,1,4,7,0,0,1,1,1,0,2,0,4,0,4,8,3,5,6,1,0,1,0,10,3,1,11,5,0,2,6,0,2,2,0,0,2,0,0,0,1,0,0,2,8,0,3,0,0,0,0,0,0,9,1,1,0,0,1,0,6,3,3,0,4,0,3,1,1,0,2,2,0,9,1,152,0,6,0,0,7,2,1,1,6,0,0,1,1,2,3,7,0,10,0,5,0,1,0,0,0,2,10,6,0,3,0,4,0,3,1,0,11,1,1,0,0,1,2,1,3,3,1,0,3,0,0,1,4,1,5,2,4,0,7,0,0,2,4,2,2,2,1,0,1,2,0,0,1,1,1,2,0,0,1,0,4,1,1,0,0,0,0,2,3,1,8,0,3,0,7,7,3,0,1,0,0,0,1,3,3,4,1,1,0,2,0,2,7,6,3,0,0,2,4,14,0,10,0,5,1,6,4,2,0,53,1,0,1,5,5,3,0,4,2,3,0,1,7,3,5,2,1,0,2,0,0,0,0,1,0,0,1,0,0,0,0,3,4,7,0,1,6,2,0,1,1,0,0,1,2,0,4,0,3,0,5,0,5,0,0,1,3,2,5,3,2,1,2,0,0,1,1,2,6,0,0,0,6,0,0,1,10,0,1,2,0,6,13,0,11,3,0,4,1,2,3,3,0,0,0,0,0,8,4,0,1,0,1,1,1,6,3,0,6,0,3,0,0,0,1,1,3,3,5,1,0,0,12,4,5,10,0,1,0,2,5,1,0,8,1,3,5,0,2,0,0,0,0,2,2,0,2,0,0,4,3,2,1,0,4,5,0,2,0,0,9,1,3,1,7,0,4,1,0,2,0,0,3,1,24,3,0,0,0,0,1,1,4,4,2,1,0,7,3,0,3,0,0,0,4,5,0,3,14,5,0,0,2,1,0,0,0,0,2,2,8,5,0,2,1,0,0,1,8,5,2,0,2,3,7,6,3,1,1,0,0,2,4,6,0,1,4,0,2,5,1,5,1,0,1,2,2,0,0,0,1,0,4,0,4,0,0,0,0,3,2,0,1,1,4,0,1,1,0,4,2,4,1,0,20,4,0,5,0,5,1,1,4,5,3,0,0,1,2,2,4,6,1,1,0,1,0,1,1,2,0,5,2,0,0,0,3,0,0,2,1,10,6,0,0,0,8,0,0,0,2,0,3,0,3,0,3,0,2,2,3,0,0,0,3,1,0,3,2,1,2,2,0,3,1,6,1,0,0,6,3,1,2,0,0,0,0,1,3,3,0,1,0,3,0,0,2,6,0,0,3,0,0,0,0,1,3,1,5,0,1,2,1,10,0,1,5,0,0,0,0,0,3,3,1,4,0,1,0,0,0,4,71,3,3,1,3,2,1,1,2,5,0,2,3,0,0,0,3,3,0,0,4,0,0,2,0,2,1,0,0,1,4,5,2,0,2,0,3,1,0,0,1,0,0,1,0,1,0,1,8,2,2,3,1,2,0,4,2,2,2,3,2,0,1,2,2,0,2,3,1,2,0,0,3,0,0,5,0,2,0,0,2,5,0,0,0,0,0,0,141,1,1,2,0,1,6,5,6,2,4,1,2,2,2,3,0,0,0,1,0,5,1,4,0,5,0,0,1,1,0,0,0,6,2,0,0,0,0,5,1,4,1,7,5,5,0,0,8,0,5,0,0,3,1,0,0,14,0,2,0,2,0,0,1,0,3,2,5,4,1,7,5,2,5,3,0,2,0,0,0,2,1,0,0,0,2,2,0,0,3,6,0,0,0,5,0,0,1,2,6,0,2,1,0,4,1,0,0,5,1,2,4,2,2,1,0,0,3,3,0,4,0,0,6,0,4,0,0,0,1,0,0,2,2,1,1,0,1,2,1,0,0,0,2,2,2,2,0,0,5,0,1,0,0,0,0,4,0,3,0,1,1,0,6,1,5,10,0,1,8,0,3,4,0,1,0,2,0,9,0,0,1,1,0,1,3,2,5,2,4,2,0,3,0,6,1,5,0,0,0,0,1,0,10,1,6,1,0,2,2,1,0,0,0,1,0,0,1,8,0,0,0,4,1,3,0,0,2,0,0,0,6,2,0,0,1,0,0,3,0,2,0,0,1,0,0,0,3,0,2,0,0,2,4,2,2,0,0,1,0,3,0,4,0,1,0,0,1,0,1,9,0,0,0,1,0,1,0,0,0,4,3,2,1,0,4,1,0,2,1,3,1,1,3,2,0,2,1,1,4,5,0,0,0,0,0,0,1,0,1,2,1,0,0,10,37,0,3,3,2,0,0,1,0,3,0,0,1,0,2,9,0,18,0,4,2,12,1,2,1,3,0,2,5,0,2,3,0,1,0,2,0,0,2,1,2,0,0,5,1,0,0,1,0,13,3,1,2,1,0,9,2,2,0,0,0,6,0,10,3,2,1,2,2,0,6,0,0,0,0,0,0,12,0,5,0,5,5,0,6,1,0,0,2,0,3,0,2,2,0,0,0,7,0,0,2,3,3,2,0,1,0,11,1,2,1,5,0,4,2,1,0,2,0,0,0,3,0,5,0,0,0,0,0,1,3,1,1,0,3,0,0,5,2,2,2,1,2,1,0,0,0,0,1,1,2,0,0,0,0,1,1,0,6,2,0,3,0,4,0,1,0,3,1,4,2,3,1,2,1,0,3,9,0,0,2,1,13,0,3,6,0,4,3,0,2,0,1,0,0,0,2,1,0,0,1,8,1,1,0,2,0,0,4,2,2,1,3,0,0,1,2,0,0,3,2,0,0,1,0,0,1,1,7,11,2,2,3,2,3,7,0,0,0,0,0,1,0,0,0,2,1,1,0,0,1,2,0,1,0,2,1,0,134,2,63,0,0,1,2,0,2,0,1,2,0,0,6,3,0,1,3,1,4,3,2,7,0,0,1,0,0,0,3,2,0,3,1,0,0,0,9,9,1,2,7,0,0,2,6,0,1,0,0,1,0,5,0,1,0,0,1,3,1,0,0,17,1,2,1,0,0,1,19,0,6,2,0,1,0,2,7,2,0,0,0,2,4,1,1,2,0,1,0,0,4,0,2,0,0,0,0,10,3,1,0,2,2,2,0,0,0,6,4,2,0,0,1,0,0,0,0,0,0,2,0,2,5,2,0,2,0,3,2,90,2,5,0,0,0,4,1,3,0,0,1,2,0,0,1,0,1,0,0,2,0,1,1,0,3,1,0,1,4,0,6,2,0,3,2,4,0,2,0,2,0,0,4,3,2,1,0,0,0,0,0,1,0,1,3,1,0,0,0,0,6,4,4,0,4,7,0,4,3,0,2,2,7,5,1,1,0,0,0,0,0,4,2,0,0,0,0,1,0,3,3,1,0,1,1,0,0,0,7,0,0,3,3,2,14,0,0,2,0,0,2,4,0,2,0,1,0,0,1,4,0,2,1,0,0,1,0,4,0,0,0,3,0,1,0,3,4,0,7,0,0,2,2,0,6,6,2,0,2,3,0,0,0,4,4,0,0,10,0,1,0,0,0,2,2,2,0,2,0,0,0,1,0,2,0,0,0,8,8,0,2,0,0,0,0,2,1,0,3,3,0,0,5,3,0,1,4,0,0,0,0,1,0,1,3,0,3,0,0,1,3,1,0,0,0,1,2,0,1,0,0,0,3,1,0,1,1,0,0,4,3,3,0,0,1,0,1,0,0,0,1,1,2,0,0,0,1,2,1,0,0,2,4,1,0,1,0,0,1,0,0,1,0,2,0,5,0,0,1,0,0,1,0,1,0,5,2,0,0,0,0,1,0,4,0,3,0,0,4,2,0,0,0,0,0,0,3,0,0,0,0,9,1,0,2,0,4,0,2,0,2,1,0,1,0,0,0,0,1,1,1,0,0,0,0,0,0,1,0,0,10,0,3,2,0,0,0,1,3,0,1,1,2,2,0,1,0,0,0,0,3,12,1,1,0,2,0,0,7,0,0,1,0,0,0,0,0,0,1,1,2,0,0,0,1,2,2,0,0,1,1,1,3,1,0,1,3,1,4,0,0,5,0,0,0,2,2,0,9,1,3,1,0,0,0,4,0,0,0,1,3,3,0,1,2,0,2,0,3,0,0,0,0,0,0,3,0,0,1,0,0,1,4,0,3,0,1,2,0,2,0,0,0,3,0,5,0,0,5,1,1,3,1,2,10,1,0,1,0,0,0,2,2,0,5,1,0,1,0,1,0,0,3,5,0,0,0,7,1,0,9,1,4,2,0,0,0,1,0,0,3,0,0,1,0,0,0,8,0,0,4,0,3,1,2,1,0,2,0,0,0,0,0,0,3,0,0,2,1,0,0,0,1,2,0,0,2,1,3,0,2,0,0,0,3,0,3,0,1,0,1,1,0,0,0,0,1,0,1,0,0,0,1,1,0,2,1,0,9,0,2,0,0,1,0,2,1,0,3,0,1,1,2,0,0,0,1,1,2,0,2,1,0,15,0,0,0,6,4,0,0,0,1,2,0,0,0,0,0,0,0,0,1,0,0,0,0,1,0,1,5,1,0,0,0,0,0,0,0,0,0,0,0,0,0,2,0,0,1,2,0,0,1,9,0,5,2,0,0,0,0,0,0,0,2,1,3,0,3,0,0,0,2,0,0,2,0,1,0,0,0,0,0,0,3,1,0,0,1,1,0,0,0,4,0,6,1,2,0,1,1,0,0,0,0,0,0,0,0,0,0,0,0,0,0,0,0,3,0,0,0,0,0,0,0,0,0,0,0,0,0,3,0,1,0,0,0,0,0,0,1,0,0,0,1,0,5,0,0,0,0,0,0,0,0,0,0,0,0,0,0,0,0
"2010 Gordon, Jaimy, Lord of Misrule",high,4196,2208,1872,1988,1610,826,1826,1419,1209,1031,1243,997,1055,1047,844,663,656,569,722,394,507,555,325,640,118,325,275,477,448,345,293,494,415,298,337,259,179,362,49,307,282,521,194,313,185,207,275,257,174,198,302,226,257,177,113,174,138,254,239,170,258,284,166,239,178,147,92,173,68,99,233,100,157,181,201,114,328,146,191,124,157,99,101,131,154,105,137,155,216,133,198,105,101,77,115,100,136,103,155,72,116,315,133,105,75,110,126,66,136,116,157,199,20,106,65,51,107,69,65,50,52,61,86,72,42,27,123,107,115,89,70,66,90,38,91,63,6,89,51,56,12,96,34,49,39,83,65,80,94,88,58,48,47,30,109,116,83,65,74,92,39,52,84,84,92,64,63,51,40,83,9,54,31,40,42,42,49,54,88,48,64,33,28,28,97,73,41,43,62,72,68,26,48,43,59,59,13,41,43,40,76,22,22,62,14,48,36,95,58,85,23,80,12,33,53,43,26,2,53,22,51,16,26,40,42,42,49,41,58,37,13,52,30,15,37,15,73,52,55,22,31,12,32,34,10,35,48,75,11,42,57,20,72,26,47,69,73,35,50,63,48,16,3,43,20,22,28,52,49,43,24,62,28,33,28,28,23,20,47,48,17,13,60,15,38,4,37,6,48,18,27,20,16,135,36,60,22,35,24,50,51,42,20,24,8,10,98,143,14,13,51,12,28,23,36,14,16,79,15,10,33,17,15,42,54,36,23,12,10,15,14,35,9,10,36,49,28,2,38,33,22,27,26,10,18,28,15,13,13,33,24,19,37,104,11,24,12,35,13,34,26,9,27,15,11,24,38,34,10,36,46,10,21,18,23,32,21,4,20,10,24,11,29,19,7,7,0,32,32,42,39,18,15,15,26,29,10,12,22,22,9,21,10,13,33,10,16,15,19,12,22,20,19,33,49,1,19,23,6,24,6,0,12,41,15,24,12,14,28,17,27,47,4,40,1,6,15,7,0,27,18,27,7,22,13,23,29,17,27,23,4,14,10,19,10,36,10,10,14,36,26,10,0,9,19,26,7,12,1,13,0,10,14,201,6,12,17,3,0,25,12,13,12,15,2,36,7,11,9,15,18,27,35,16,10,12,13,20,4,29,13,7,4,9,13,7,1,9,13,1,3,36,22,23,8,25,0,14,33,6,32,15,13,15,14,17,9,24,18,9,3,30,20,8,6,1,25,20,3,1,15,5,10,36,9,13,0,586,12,11,7,19,13,1,33,3,7,22,10,2,19,26,16,5,18,12,16,5,23,1,15,7,21,18,30,9,17,4,10,11,5,4,17,20,4,24,9,24,18,4,4,12,12,6,27,11,2,11,7,12,27,11,14,8,13,173,0,10,20,17,17,1,13,11,3,15,23,73,10,37,3,4,7,17,9,11,20,9,8,4,11,5,10,20,7,0,15,19,11,4,24,19,41,1,4,6,7,12,5,18,0,8,11,12,2,1,11,68,8,0,7,8,16,13,14,15,9,15,18,4,14,12,3,14,7,16,22,11,10,10,4,15,6,13,14,11,1,2,3,28,19,6,7,16,0,9,16,0,6,5,18,48,28,8,11,12,4,11,7,2,7,11,21,23,1,14,3,5,22,7,32,6,12,2,10,19,8,1,8,16,8,25,8,5,0,24,5,12,5,3,1,20,8,0,1,0,4,11,22,6,18,8,14,13,2,1,7,3,6,8,10,10,3,14,6,4,4,10,9,18,5,7,23,1,0,7,4,8,9,8,22,9,2,2,16,18,2,2,19,9,10,8,0,30,10,2,0,8,3,23,21,3,5,6,13,1,13,2,1,4,8,3,15,2,10,18,31,0,8,6,4,9,2,14,7,12,14,3,14,2,5,43,13,12,0,23,14,6,0,9,16,6,14,6,9,4,5,0,6,1,19,17,1,7,2,1,0,2,3,11,14,17,15,6,15,4,8,0,19,8,7,8,16,2,0,12,3,11,3,5,9,13,1,14,5,7,13,16,17,11,9,0,1,2,14,11,3,0,6,5,9,15,12,3,2,6,10,6,11,9,4,0,9,0,6,6,18,26,9,11,5,14,0,7,2,1,2,0,2,58,15,14,4,0,4,19,4,11,16,18,5,7,4,5,8,10,3,12,12,5,6,1,12,8,2,8,3,9,1,29,0,6,8,0,3,5,3,6,3,4,2,190,4,2,1,8,2,6,2,0,0,2,13,1,0,19,6,0,0,5,12,8,5,10,1,6,1,3,19,0,25,0,5,0,17,7,0,0,0,25,6,5,0,9,0,0,14,1,3,9,2,3,7,1,6,2,15,7,0,9,9,8,2,11,5,4,10,10,15,0,16,9,2,11,2,3,0,51,25,5,4,7,4,7,6,0,3,4,0,10,9,27,0,1,2,5,15,6,0,0,0,1,3,10,8,5,5,0,5,3,1,10,9,5,1,0,1,7,72,3,0,0,5,6,0,5,4,1,5,7,7,6,4,2,10,6,21,4,1,2,4,1,2,4,0,0,6,2,7,14,12,0,3,7,3,1,11,2,0,0,8,0,2,46,11,3,5,19,5,7,10,0,15,4,4,4,5,9,5,15,1,2,5,8,9,1,0,3,0,0,1,0,2,3,0,2,13,5,1,1,0,8,3,13,3,10,0,0,25,0,3,9,9,4,7,5,0,175,4,0,5,4,0,1,4,23,6,13,0,5,3,0,1,15,6,1,1,5,6,9,0,9,5,33,19,0,0,0,4,0,1,5,3,2,4,2,2,26,11,5,9,2,128,1,8,0,2,1,1,2,9,6,4,0,2,0,0,1,2,5,0,0,1,8,4,10,7,3,4,11,1,0,3,7,0,2,9,2,42,5,1,0,1,0,0,2,0,5,0,0,1,4,3,6,7,9,26,6,5,1,0,4,4,5,6,5,2,1,8,4,11,0,7,1,1,11,8,32,9,2,1,16,1,6,276,5,11,2,6,7,11,6,2,0,9,5,5,4,0,2,0,6,2,0,3,7,0,1,3,6,6,18,7,0,8,3,3,8,3,1,3,12,8,8,3,2,4,16,5,0,0,13,4,0,3,0,1,2,5,35,1,0,11,5,0,1,0,0,0,3,0,0,5,3,66,13,2,2,8,3,16,10,11,2,1,2,3,1,10,0,0,0,0,2,0,8,4,0,2,4,4,5,7,3,0,2,6,6,4,1,5,0,2,11,6,0,1,0,2,7,1,5,0,0,4,5,2,0,6,1,2,4,1,22,2,4,15,13,9,3,3,11,0,10,2,0,2,2,4,0,7,6,4,0,3,15,17,0,7,2,3,2,0,13,0,3,5,3,6,5,8,5,8,1,0,1,4,4,1,6,3,9,0,2,16,8,0,126,0,17,4,0,0,0,0,0,0,4,7,2,2,5,3,1,0,18,0,0,0,0,1,3,2,8,0,1,7,2,1,1,0,1,0,2,3,304,1,2,5,2,7,2,1,2,1,3,3,0,3,1,6,1,12,3,2,8,7,1,9,3,3,0,6,5,2,0,0,6,1,5,5,8,1,0,1,1,3,5,0,4,6,12,4,2,4,1,3,3,1,9,0,9,0,1,1,6,6,0,0,5,0,0,0,9,1,0,4,3,6,7,1,8,0,0,4,1,0,6,0,5,2,3,3,0,5,9,0,1,3,1,5,0,0,0,1,27,2,3,1,1,0,1,10,2,0,1,1,0,5,3,15,4,7,11,5,6,1,3,2,5,10,1,2,7,3,1,6,0,5,4,0,8,1,3,2,8,0,1,0,7,9,3,6,144,5,0,1,3,10,1,1,0,12,29,0,19,1,0,6,1,7,11,3,1,0,0,7,1,4,0,2,7,8,4,3,2,2,2,0,6,0,7,8,4,9,0,5,5,4,8,0,4,1,0,2,2,0,3,4,2,2,6,3,9,0,8,2,3,4,0,1,1,0,5,0,10,3,3,12,4,2,1,7,4,2,2,0,6,1,0,0,1,0,8,4,0,3,0,3,0,2,10,6,2,9,4,6,5,8,1,0,3,0,1,13,1,4,0,6,7,12,0,2,1,2,1,5,1,13,1,3,3,0,0,2,1,1,0,0,9,4,3,0,0,5,3,0,0,0,1,0,3,8,3,0,8,3,3,0,1,0,6,0,5,1,1,7,14,2,1,2,2,0,4,16,0,8,2,2,0,11,10,3,1,3,0,2,2,5,0,4,1,1,13,4,2,6,0,0,3,0,3,6,10,0,8,7,0,4,3,1,5,0,3,0,0,3,0,0,4,0,1,4,2,0,1,4,0,0,3,0,0,7,0,10,0,11,10,9,1,8,0,0,1,11,0,1,0,3,5,0,4,0,3,2,0,3,9,0,0,1,0,0,2,0,0,3,2,34,2,3,5,0,1,3,0,1,2,0,1,1,0,5,2,2,6,0,8,0,11,4,2,0,0,1,3,6,6,0,3,1,2,3,2,1,2,3,1,2,0,0,0,0,0,1,1,3,1,7,2,1,0,2,11,4,0,0,0,0,5,0,7,2,2,5,14,1,0,0,3,5,71,2,3,0,0,1,7,3,0,1,1,1,1,4,2,2,0,2,0,8,10,1,0,2,7,0,1,4,9,11,3,0,0,8,0,6,3,1,3,1,5,0,1,3,4,0,1,2,2,0,0,61,1,0,0,6,3,3,1,3,3,5,0,2,11,0,0,1,2,3,0,4,1,2,6,14,7,3,3,3,2,12,5,0,6,0,0,1,0,9,1,1,0,4,13,0,17,0,0,1,0,0,7,0,0,0,2,0,7,4,7,1,0,0,2,4,1,1,5,1,5,3,3,9,4,0,9,0,1,1,5,12,0,1,0,4,2,2,2,0,2,2,0,3,2,1,7,0,2,2,2,1,5,4,0,0,1,1,0,11,0,0,0,0,0,1,0,20,0,0,4,0,1,3,8,6,1,20,4,0,2,0,4,0,0,0,0,1,3,0,11,0,7,10,0,1,19,3,8,2,2,2,0,0,4,1,1,1,1,0,0,1,1,0,9,0,0,1,0,10,0,1,5,8,1,1,0,0,6,0,0,0,5,4,6,1,7,4,3,1,0,1,0,5,0,16,10,2,24,5,0,0,1,0,0,0,3,4,0,1,2,2,2,0,0,1,4,0,3,2,3,2,2,1,3,1,5,1,0,0,1,0,0,4,2,5,2,1,2,1,2,5,3,3,0,0,1,8,1,1,2,0,0,0,0,7,4,2,0,0,7,0,5,3,3,0,4,0,8,0,0,0,0,1,0,1,3,3,0,0,0,1,2,1,3,0,8,3,1,0,0,2,2,2,5,2,1,0,2,1,1,2,0,0,0,2,3,4,0,0,0,0,2,1,0,0,1,0,1,0,1,1,3,2,0,3,5,4,2,1,1,0,0,12,0,8,4,4,5,0,2,1,0,1,0,1,0,0,1,4,0,1,0,2,0,0,7,0,0,0,1,1,2,3,6,1,33,4,0,0,9,7,0,0,0,0,6,5,0,0,0,1,4,0,0,4,0,3,0,1,1,2,4,2,0,1,1,0,0,0,3,6,2,2,1,0,1,3,0,0,7,1,4,0,3,1,0,38,7,1,1,2,2,4,1,4,2,1,2,2,0,4,5,3,0,0,0,5,0,15,1,0,1,0,5,1,4,1,0,0,0,2,16,0,1,3,2,1,1,0,0,5,7,1,2,0,5,3,0,3,0,1,0,0,3,1,1,2,9,2,0,0,0,4,0,2,0,0,0,5,1,4,11,0,0,0,1,3,1,2,0,0,0,172,0,2,4,0,1,1,2,1,0,2,0,4,0,0,1,2,1,0,6,3,1,81,1,3,3,5,2,6,2,8,0,2,1,0,6,0,17,3,8,2,1,8,0,1,6,2,2,5,1,2,2,0,3,0,1,0,3,0,0,2,1,0,1,2,0,0,0,0,1,0,0,2,0,1,14,0,2,3,3,3,3,1,2,2,2,4,2,1,0,9,0,3,0,0,1,0,0,2,0,4,5,2,6,0,0,0,1,3,1,0,2,0,0,9,1,1,0,2,1,0,0,0,1,1,3,4,1,1,2,1,3,0,0,0,1,0,0,4,2,1,0,2,0,2,0,1,6,6,2,0,0,1,0,1,0,2,0,3,6,0,0,1,1,0,1,0,14,0,0,2,0,9,3,10,2,0,0,1,2,2,3,1,0,2,3,0,0,2,0,0,0,0,2,0,2,0,1,0,2,1,0,0,2,8,1,0,0,4,1,2,4,4,0,0,0,3,0,0,1,5,1,2,12,1,1,1,1,2,1,0,0,9,1,0,9,0,3,3,1,1,2,0,0,0,3,2,0,1,4,11,5,1,2,0,0,1,1,0,0,0,0,0,1,0,0,2,0,1,2,0,0,6,1,0,3,0,1,0,0,2,2,4,0,1,0,7,1,3,2,0,2,0,2,2,1,0,1,0,4,4,0,2,0,1,5,1,4,0,2,1,2,0,2,1,0,3,1,1,0,0,2,0,1,4,2,4,1,0,0,0,4,0,0,0,0,0,1,0,0,4,2,1,1,0,0,0,1,3,0,0,1,4,0,0,0,0,1,1,2,0,2,0,2,1,1,0,5,4,5,2,11,2,0,3,0,1,1,0,3,0,1,0,0,3,0,3,1,4,0,3,1,0,1,1,0,0,0,6,1,0,1,0,9,0,5,0,0,1,0,2,2,1,0,1,2,1,0,1,2,8,6,5,0,0,0,12,1,0,0,0,0,0,0,2,0,0,5,1,0,0,5,161,0,0,2,1,1,1,3,4,1,3,8,0,2,0,2,0,0,0,1,2,0,0,1,0,2,4,1,8,1,1,4,0,1,4,1,5,1,4,1,5,0,3,1,3,2,0,0,2,3,1,2,2,4,0,0,3,0,4,0,0,1,0,0,2,0,0,0,0,2,0,3,47,0,0,0,2,1,0,5,0,0,2,1,0,3,0,1,0,2,0,3,0,3,3,5,0,5,0,2,0,6,4,3,0,0,1,4,0,1,2,0,2,0,0,1,0,2,0,1,3,0,0,0,3,0,2,5,3,0,0,2,0,2,0,0,1,0,0,0,0,1,0,2,0,2,0,2,2,1,5,3,4,2,0,0,0,0,1,4,1,4,2,4,1,0,2,4,1,2,6,0,1,3,9,0,0,0,5,0,2,2,0,1,2,0,4,0,4,1,2,2,0,6,2,1,1,0,4,1,1,0,1,0,0,0,8,1,0,0,0,2,0,0,1,0,1,0,1,0,1,1,0,0,0,0,2,0,2,0,1,6,2,1,0,2,0,0,0,1,3,0,0,0,2,0,0,0,8,46,3,0,4,2,0,0,6,1,0,0,12,0,5,0,1,0,4,3,0,1,3,0,0,0,0,0,6,0,3,2,2,5,0,0,0,0,0,5,2,0,0,0,0,1,0,5,0,3,1,0,1,2,2,0,2,2,1,1,1,7,1,2,0,0,1,3,0,0,0,3,1,0,3,0,3,0,0,4,0,14,0,0,4,4,2,4,3,0,2,1,0,1,1,0,5,0,2,2,0,3,0,4,0,0,1,0,1,1,0,2,0,5,52,1,0,5,2,0,1,10,0,0,0,1,4,2,0,1,2,3,1,2,1,4,2,0,0,0,5,1,1,0,0,0,3,1,4,0,1,1,0,0,0,2,0,0,3,1,1,0,0,2,0,0,1,1,0,0,2,0,3,0,3,0,0,0,1,0,0,0,0,2,3,0,0,0,0,0,0,2,1,0,0,6,3,0,0,0,0,3,3,7,4,3,0,0,2,2,2,1,0,1,0,4,0,0,0,2,2,0,0,4,2,2,0,0,1,0,0,0,34,1,0,1,0,0,0,1,0,0,0,0,0,0,0,0,0,2,1,1,3,0,1,0,2,7,4,1,0,0,0,5,3,0,1,0,0,0,0,1,0,0,7,0,0,2,3,1,4,0,0,0,3,1,1,0,0,0,1,0,4,2,4,0,7,1,0,2,1,4,1,4,0,0,3,0,0,0,1,6,1,0,1,0,0,5,19,0,0,1,3,0,4,0,1,0,1,3,3,3,1,0,3,1,0,2,4,0,2,0,0,2,3,1,0,0,0,0,1,0,0,1,1,0,1,0,0,3,0,0,0,0,0,1,0,0,1,4,0,0,0,1,1,0,4,0,0,2,1,1,0,4,0,2,0,0,1,0,0,0,0,3,0,3,1,3,0,0,0,0,0,0,2,0,1,2,2,0,0,0,8,2,0,1,0,0,7,0,0,1,2,1,1,1,6,0,0,0,0,3,2,0,0,0,4,0,0,0,30,2,0,0,1,2,5,0,1,3,4,3,3,1,0,1,0,1,0,1,0,0,1,1,0,3,1,0,0,2,1,3,0,0,0,2,6,4,0,0,2,1,0,0,0,1,0,1,1,4,1,1,6,1,3,0,0,1,2,0,0,2,5,0,0,4,1,1,0,0,0,0,0,0,1,0,0,5,0,0,0,0,0,0,1,0,0,0,3,1,3,0,0,1,0,5,0,1,1,0,3,2,4,0,0,0,3,6,1,0,0,0,1,0,0,0,3,3,0,3,0,3,0,0,0,0,0,0,2,2,0,0,2,2,0,0,0,0,3,3,1,6,0,4,1,1,2,4,1,2,0,0,0,1,2,0,1,3,2,1,0,0,1,0,0,0,0,0,8,0,0,0,1,1,0,0,0,1,1,0,2,1,0,0,1,5,2,3,2,0,0,0,0,1,0,8,1,0,0,4,0,0,7,0,0,0,1,0,0,1,9,0,0,14,2,1,0,1,1,0,0,1,4,1,1,0,0,0,1,3,1,0,0,0,1,0,1,0,3,0,2,0,1,0,2,3,0,3,1,3,0,0,0,5,0,1,0,6,0,6,0,1,0,0,2,0,2,1,4,0,0,2,0,3,0,0,3,6,1,7,12,0,0,2,0,3,1,0,0,3,3,1,5,4,0,1,0,3,1,2,3,5,2,2,0,4,0,0,6,0,0,1,2,1,0,0,1,0,4,1,0,0,2,0,1,1,0,0,0,0,0,0,1,0,0,11,3,5,3,2,0,0,1,1,0,0,0,1,1,1,1,0,0,2,0,3,6,0,0,1,0,0,0,0,2,1,0,1,27,2,3,0,7,0,0,1,0,0,0,1,0,2,1,1,1,0,0,3,0,2,0,4,4,3,2,0,0,0,1,0,0,2,1,5,0,1,2,1,0,1,0,0,0,0,2,0,0,0,0,1,0,0,1,1,0,0,0,0,0,1,21,3,0,2,1,2,1,1,0,0,0,0,2,0,0,2,0,1,0,0,0,3,0,3,0,0,0,0,0,4,3,0,1,0,0,0,1,0,0,2,0,0,3,0,1,0,0,0,0,0,1,2,0,0,0,5,0,2,0,0,0,0,0,2,0,0,1,0,5,1,1,0,0,0,1,0,0,1,4,0,3,2,1,1,1,0,0,1,1,2,0,2,0,0,0,0,18,0,4,3,4,2,3,2,1,0,0,3,0,5,0,1,2,0,3,0,0,0,1,0,2,3,0,1,0,1,0,0,7,0,7,8,0,1,2,0,1,0,0,1,2,0,0,2,2,3,0,5,0,0,3,0,0,5,0,0,2,3,1,1,2,0,1,0,0,0,0,0,0,1,1,2,0,1,4,0,2,1,0,0,0,3,0,6,3,1,1,0,0,2,1,1,1,0,1,1,0,0,1,0,0,4,2,0,0,3,1,1,0,0,2,2,2,1,0,0,0,0,1,0,1,11,2,0,6,0,1,2,0,0,0,0,0,1,0,0,2,0,0,0,0,1,0,0,2,2,2,0,2,1,2,3,0,0,1,0,3,0,0,0,2,1,0,0,0,0,0,5,2,1,0,0,1,0,0,0,0,5,0,0,0,0,0,0,0,0,4,0,0,3,0,1,5,3,13,0,0,0,0,0,1,1,2,0,0,0,0,2,2,1,0,0,1,2,0,0,0,4,0,3,0,0,4,0,0,0,0,1,0,0,0,0,2,0,0,0,0,6,0,1,1,0,0,3,0,1,0,0,1,0,0,1,3,3,0,0,1,0,1,0,4,0,0,2,0,3,0,0,0,0,2,0,11,0,1,20,3,0,2,1,0,2,0,2,0,0,0,1,1,1,0,0,2,0,0,2,1,1,1,0,2,2,0,0,0,0,1,0,0,0,0,0,0,0,0,0,1,0,0,1,1,0,0,1,2,0,0,0,0,0,0,0,0,2,5,5,0,0,2,0,0,0,0,0,2,1,0,0,1,2,3,0,3,1,0,1,0,4,0,0,1,0,0,3,0,0,0,0,1,0,0,0,0,0,0,0,1,0,0,0,0,1,0,5,0,1,7,0,0,3,0,7,1,1,0,0,0,2,1,0,0,2,1,0,3,4,2,0,2,0,0,0,1,0,1,1,0,1,0,0,0,1,0,1,0,0,0,0,3,0,1,2,1,2,4,1,0,0,2,1,1,2,0,0,0,0,0,0,0,2,0,1,0,2,2,0,0,0,1,1,3,0,1,1,0,0,0,0,0,0,1,0,1,0,1,0,0,2,0,0,1,0,0,0,0,3,0,1,4,0,0,0,0,3,0,2,0,1,0,2,0,0,0,0,0,0,0,0,0,0,1,0,0,0,0,1,2,0,0,1,1,0,4,2,0,0,0,0,1,1,0,0,0,0,0,0,0,1,0,0,1,0,1,0,1,0,0,0,0,0,0,1,1,0,0,0,0,1,0,0,1,0,0,2,1,0,0,0,2,1,1,0,0,0,1,2,1,1,0,5,3,0,2,0,0,0,4,0,0,0,1,2,0,0,0,0,0,0,0,0,0,0,0,0,0,1,0,0,0,0,1,0,0,0,0,0,2,0,0,0,0,1,4,2,0,0,0,0,1,0,0,0,0,0,0,0,3,1,0,1,0,0,0,0,0,0,0,2,2,0,0,0,1,0,0,0,2,0,3,0,0,0,0,0,2,0,0,0,1,0,0,0,0,0,1,0,0,0,1,0,3,0,0,0,0,0,0,0,2,0,0,2,0,0,2,1,0,0,0,0,0,0,0,5,0,0,0,0,0,0,0,0,1,0,0,0,0,0,1,0,0,0,0,0,0,0,0,0,0,0,0,0,0,0,0,0,0,0,0,0,0,0,0,2,0,0,0,0,0,0,0,0,0,0,0,0,0,0,0,0,0,0,0,0,0,0
"2010 Nunez, Sigrid, Salvation City",high,3084,2046,2299,1668,1385,581,2077,1037,1576,1042,609,1128,1006,549,557,448,1006,487,501,288,398,814,422,587,134,586,142,555,256,324,249,279,342,522,334,376,426,365,132,297,347,452,306,205,447,371,353,279,370,152,151,289,322,117,138,152,353,210,181,250,109,140,185,188,108,252,187,93,141,161,116,67,238,115,129,188,76,229,213,82,76,123,85,111,155,60,90,82,212,196,131,118,133,47,142,102,70,178,108,151,210,85,119,152,140,80,105,112,106,148,76,57,41,78,115,32,80,66,122,239,31,48,41,76,75,71,58,74,146,83,68,42,48,39,37,135,23,60,42,127,65,91,266,36,103,44,79,94,55,86,133,57,51,76,59,26,109,54,36,118,88,95,128,102,26,23,61,50,81,40,23,32,103,21,19,65,70,38,49,61,126,106,21,50,52,75,69,70,28,97,22,36,59,91,23,51,145,31,28,135,50,32,50,63,119,8,43,19,76,43,179,27,31,37,26,41,28,15,88,27,62,74,39,22,36,22,52,26,23,56,25,18,11,48,52,47,40,32,28,77,46,28,18,45,41,44,12,49,49,37,41,19,17,4,9,26,51,42,14,49,42,51,24,25,60,34,52,51,11,34,65,90,45,40,21,29,48,46,42,50,16,26,32,56,48,17,38,42,48,19,7,34,10,32,39,47,46,32,15,49,56,34,23,17,20,21,18,42,19,10,31,22,4,53,54,11,8,16,23,20,29,35,62,65,27,11,82,30,34,11,53,54,17,16,8,47,14,65,25,57,22,54,31,6,46,16,23,7,24,13,49,10,47,23,20,24,28,79,16,21,4,7,29,22,12,7,21,17,18,41,39,8,6,25,6,30,13,20,49,26,11,12,11,13,19,9,0,33,23,10,26,50,42,8,22,52,16,25,20,11,90,8,17,30,29,48,34,20,11,28,7,44,13,20,12,4,25,10,16,53,35,0,7,17,12,4,55,11,21,15,13,37,14,37,4,6,10,35,12,36,11,14,6,16,19,15,10,26,22,17,9,10,79,43,16,23,31,24,33,15,13,8,0,57,48,22,4,23,3,4,18,8,7,10,11,19,10,6,0,13,40,11,12,16,51,12,7,1,14,16,21,11,8,23,24,7,15,10,9,11,28,13,5,10,13,8,51,29,13,13,12,3,23,11,13,30,0,12,13,21,26,34,9,9,6,15,13,39,18,1,1,20,21,7,8,0,26,10,8,15,10,16,27,4,13,7,0,13,0,4,8,11,16,1,8,23,14,26,31,3,4,8,23,3,21,16,18,3,12,7,29,12,16,6,26,4,12,8,24,37,17,44,21,4,0,8,10,25,5,16,18,3,8,11,10,19,19,5,20,21,26,1,27,13,19,0,1,43,4,16,10,6,20,6,55,7,15,8,17,2,12,6,23,17,7,8,14,12,9,3,5,6,2,29,14,0,4,1,37,10,11,9,7,9,3,20,12,4,22,7,721,14,16,12,9,26,1,4,9,7,8,19,4,15,23,15,13,16,16,7,20,13,21,14,18,13,2,7,18,8,4,21,15,12,24,36,1,15,3,2,45,12,5,4,4,4,22,0,2,17,11,1,9,17,3,27,5,7,22,8,8,12,2,9,8,26,25,3,4,19,10,1,3,0,21,6,9,144,17,7,22,7,2,1,0,9,4,15,2,4,8,17,12,5,2,0,4,15,6,1,3,3,10,19,4,1,0,13,11,4,5,5,6,62,4,92,12,6,5,22,9,4,5,10,1,6,13,6,38,1,7,6,3,3,3,32,5,18,8,9,10,11,2,6,7,13,0,14,0,11,4,6,2,12,13,2,9,15,9,4,3,4,10,1,4,11,1,0,15,13,12,3,5,8,8,13,6,0,3,2,18,6,7,8,0,8,56,12,0,3,2,8,5,8,12,5,2,0,4,2,9,5,1,12,8,15,2,4,7,18,3,13,1,10,2,0,6,0,7,7,11,5,17,6,0,3,1,6,28,2,11,19,7,4,7,5,2,15,2,7,4,8,2,3,2,16,4,0,12,13,15,2,1,4,3,0,20,4,4,1,8,0,8,0,16,9,1,6,20,12,10,0,5,3,11,20,5,0,3,0,4,4,4,2,5,7,9,6,0,4,9,13,3,3,1,2,8,15,9,1,7,10,6,7,7,2,11,12,8,10,0,12,10,0,1,6,13,6,5,2,5,0,15,0,14,3,8,19,6,8,0,9,9,0,2,2,18,0,5,5,6,2,13,11,11,6,0,5,10,0,1,0,8,0,1,7,0,0,1,18,6,10,3,1,5,4,6,4,6,9,1,5,2,0,2,1,9,1,16,4,4,2,3,20,7,6,12,17,23,16,31,11,3,4,2,18,1,1,1,4,4,9,31,4,9,0,4,9,2,3,13,0,0,2,6,3,3,13,0,0,0,0,2,11,1,8,1,0,6,4,0,3,7,2,3,4,5,8,2,1,18,0,11,10,1,3,3,4,7,5,0,6,4,11,2,5,5,8,6,9,14,4,2,18,0,5,8,3,5,10,2,19,0,4,10,13,6,2,2,2,7,17,5,46,2,16,5,5,1,2,8,47,2,18,8,3,3,1,1,3,4,3,7,3,5,5,1,10,24,7,2,1,2,0,0,1,1,11,12,1,0,4,12,3,3,7,7,1,3,0,0,2,55,1,9,4,0,1,5,0,9,7,0,6,3,6,5,3,0,9,7,0,6,13,4,3,0,7,9,2,0,1,5,3,20,0,0,2,3,5,6,7,6,7,1,4,3,0,13,5,6,11,3,5,3,0,3,17,1,17,3,14,2,0,12,1,11,3,10,5,4,1,10,2,5,8,2,3,0,2,13,0,1,5,0,1,10,2,4,7,14,3,2,5,0,4,1,4,0,17,0,5,2,3,4,3,6,5,7,7,0,4,0,25,8,4,16,7,4,1,6,10,1,15,6,4,1,6,1,4,0,11,10,29,4,3,3,5,9,1,14,4,2,0,6,9,16,3,1,11,1,0,1,6,2,8,4,2,5,9,7,2,16,0,2,14,6,0,3,2,7,8,1,2,7,12,5,6,5,5,3,1,2,0,2,1,6,4,2,10,2,3,4,0,4,0,0,9,0,0,3,0,1,12,3,10,5,1,18,6,1,16,3,1,4,6,3,0,15,13,0,0,0,2,0,14,0,0,9,4,4,9,6,8,0,5,1,4,9,3,4,2,1,6,6,6,0,4,3,21,3,1,0,0,15,2,1,1,0,3,2,9,2,13,0,5,0,1,3,2,7,6,0,2,13,0,1,2,5,1,7,4,0,0,3,9,3,0,4,3,17,13,9,8,0,5,2,7,3,0,9,15,6,3,2,13,6,15,4,4,8,22,2,1,1,2,0,0,0,6,2,0,1,0,0,6,0,1,4,1,14,7,2,8,3,2,0,0,4,3,2,3,4,4,16,2,0,2,0,1,3,0,2,2,3,0,2,6,14,8,4,3,4,10,6,2,4,0,2,3,2,12,6,2,4,9,14,0,2,14,5,0,15,0,4,9,4,1,3,6,5,3,10,0,5,6,16,1,4,2,5,1,4,4,4,9,2,5,14,16,0,6,0,0,8,3,0,0,1,3,0,0,0,4,7,1,4,2,5,4,18,4,2,13,2,3,0,5,0,3,1,0,8,0,14,8,1,1,0,0,1,0,1,3,0,0,8,5,4,10,8,2,1,3,0,1,1,7,5,4,0,1,7,1,7,1,0,3,0,0,2,8,12,23,3,4,1,0,2,3,2,5,1,3,5,3,0,6,0,1,4,4,2,9,3,0,0,4,7,0,2,0,3,1,0,2,6,1,5,3,0,4,6,1,3,5,5,5,6,1,1,2,0,5,3,2,2,0,0,5,7,6,1,6,1,0,3,4,2,6,1,7,3,0,2,2,5,0,5,2,4,7,1,3,0,7,7,5,4,1,12,1,3,2,0,5,0,2,1,1,6,2,5,4,2,3,0,3,4,0,1,3,0,11,2,1,1,4,1,5,1,3,4,8,0,3,1,5,0,2,6,5,0,8,1,0,8,8,0,9,1,6,2,4,1,0,3,0,2,1,2,1,3,5,2,0,1,0,4,5,3,5,0,0,3,3,0,5,0,0,1,1,11,5,3,1,1,4,0,8,1,3,70,1,2,5,6,0,1,2,5,4,3,9,0,4,4,3,0,2,4,4,4,0,9,1,2,2,2,3,4,4,0,3,0,3,4,0,6,0,0,3,1,0,0,3,5,0,10,8,4,0,0,1,0,13,2,4,4,4,0,0,2,0,256,9,3,0,0,2,0,4,1,0,4,4,1,9,9,9,4,0,0,0,1,2,3,0,2,1,4,0,0,3,1,0,9,4,0,0,2,5,0,0,0,9,0,0,0,1,5,2,4,7,0,2,1,4,1,2,1,2,1,1,1,0,0,0,2,4,2,10,1,0,4,5,1,0,12,3,0,9,7,2,1,1,1,15,2,4,0,0,1,0,3,2,3,0,3,1,1,0,4,4,4,3,0,2,0,2,0,8,0,9,0,0,1,0,4,11,1,0,2,5,0,57,1,3,1,0,1,4,4,3,1,0,4,1,8,1,0,1,1,0,0,0,0,0,8,5,11,3,5,1,2,11,4,0,8,1,2,4,5,6,5,3,4,3,8,2,0,1,4,2,0,0,7,6,15,0,0,4,0,2,5,2,3,0,7,3,4,4,1,0,1,2,1,2,2,8,0,0,4,14,0,2,0,1,1,1,3,4,0,9,1,1,5,1,0,0,0,0,2,3,0,0,0,1,1,6,6,10,1,5,0,6,3,4,0,3,3,0,4,2,3,1,0,0,0,0,0,2,0,0,1,0,4,5,1,4,0,5,2,2,2,3,2,2,0,2,1,0,2,0,3,0,0,2,1,1,4,0,0,3,0,8,1,0,1,0,0,1,1,3,5,2,0,0,0,3,0,5,1,9,1,0,0,0,4,1,13,1,1,1,0,0,4,1,4,1,5,2,7,8,4,2,0,6,4,7,10,0,1,0,0,2,2,0,0,0,6,0,1,1,0,2,1,1,3,3,2,6,0,0,1,9,1,1,4,0,0,2,3,4,2,2,1,3,3,0,0,0,1,4,1,0,0,8,2,3,0,3,0,6,3,0,3,0,1,2,1,2,6,4,2,2,50,0,5,7,0,0,3,4,7,2,0,0,1,2,6,2,3,7,4,6,1,1,1,1,0,2,0,1,5,2,3,2,1,1,5,2,2,2,0,37,6,1,0,0,8,0,1,0,1,1,1,2,2,0,5,1,0,6,2,0,2,4,2,0,0,5,7,2,0,2,2,0,3,5,0,0,0,14,0,0,5,3,1,0,0,0,19,0,0,0,2,1,6,5,3,3,3,4,0,3,4,0,10,3,3,3,2,0,0,3,0,1,5,4,3,3,4,2,0,1,1,0,0,1,4,0,3,18,0,0,0,2,4,0,1,2,1,0,1,2,0,5,7,2,0,2,0,0,4,0,1,6,2,0,7,1,4,1,0,4,1,0,0,2,2,1,0,2,1,2,0,1,1,0,0,0,1,6,3,2,0,4,3,3,0,2,0,5,0,1,2,0,1,10,6,0,8,1,7,2,1,2,10,4,1,2,0,0,0,0,0,0,4,0,2,1,0,0,0,3,4,4,5,6,1,0,1,2,0,0,5,0,2,3,1,4,0,1,1,0,0,6,1,1,1,0,1,0,1,3,6,0,3,0,2,1,0,1,9,6,0,2,0,0,1,4,2,1,3,7,1,2,0,1,0,0,0,1,0,0,1,1,0,0,0,0,2,3,2,0,3,0,0,0,0,1,1,5,2,1,0,11,5,1,2,0,2,0,5,1,0,2,8,0,7,1,3,1,4,6,1,0,0,1,5,4,6,2,0,0,1,1,1,2,0,8,0,6,1,0,0,2,5,0,2,0,1,0,1,0,0,1,0,0,0,4,1,2,6,1,7,7,2,0,1,3,3,1,1,1,4,0,0,4,0,1,3,0,1,0,0,0,4,0,0,5,0,1,0,4,0,0,1,2,4,0,2,1,2,0,0,1,4,2,0,6,4,3,1,2,0,1,6,9,1,7,0,2,2,5,1,4,2,1,2,3,0,2,2,10,3,0,0,2,1,0,2,3,0,0,0,0,0,1,2,3,2,0,3,0,0,0,1,0,0,0,1,2,22,1,1,0,0,0,1,1,4,0,0,1,10,0,2,3,1,1,0,2,3,0,4,1,4,1,4,0,1,0,1,2,4,13,2,0,4,2,3,0,1,0,5,1,2,0,5,5,2,0,0,0,0,0,0,2,1,0,2,6,1,7,1,0,2,0,4,0,0,5,0,1,1,0,0,3,0,0,1,2,7,2,1,3,0,0,2,1,1,2,2,0,5,2,1,1,0,0,3,1,1,2,2,1,3,0,2,0,0,2,0,0,0,0,1,1,4,1,4,1,2,3,0,0,3,1,2,2,0,1,3,6,4,0,1,0,2,0,0,0,0,0,2,3,1,0,2,3,3,0,1,0,0,0,1,0,1,18,0,2,1,2,0,2,0,1,144,1,1,3,0,2,0,2,2,2,0,2,1,0,0,3,0,3,2,0,0,2,2,6,0,0,1,18,0,0,3,3,1,0,0,1,0,1,0,0,2,0,0,0,1,2,1,1,1,0,0,1,0,0,2,7,1,1,0,1,0,0,1,1,0,3,10,0,0,2,0,0,0,1,1,1,2,2,0,1,0,0,0,4,0,5,12,0,1,1,0,3,10,1,0,3,0,0,0,0,3,0,2,5,0,4,1,2,1,2,0,3,0,0,0,6,2,2,1,2,0,2,1,2,2,3,3,0,0,3,2,5,2,0,1,4,2,4,0,0,0,3,0,3,0,1,1,0,0,0,1,0,1,2,0,0,4,2,0,4,0,0,0,0,0,2,0,2,0,0,3,0,5,0,4,1,0,2,5,3,3,1,1,2,3,6,0,5,0,1,0,1,0,1,0,3,0,2,0,3,1,4,2,0,0,0,3,1,0,1,0,2,1,0,5,0,1,8,0,2,4,1,2,1,0,0,3,1,1,2,1,1,1,1,0,0,0,2,2,1,0,2,2,1,1,2,0,2,1,0,1,0,0,1,2,2,2,1,0,0,1,74,5,0,0,1,2,0,0,3,0,1,0,1,3,3,0,2,2,1,1,0,1,0,2,2,0,0,2,0,0,3,2,5,3,4,1,0,2,4,0,2,0,1,0,2,0,1,1,0,1,3,2,0,0,0,1,3,4,0,2,0,2,4,0,5,0,0,0,0,0,2,1,0,0,1,4,1,3,2,2,0,3,2,1,0,2,2,4,2,4,1,3,1,0,5,0,2,0,0,4,1,1,0,0,1,1,1,0,3,0,0,1,0,1,1,0,16,1,0,0,2,2,3,0,0,0,0,0,1,0,1,0,1,1,1,2,3,2,0,0,0,0,0,1,1,0,1,1,3,2,0,1,0,0,6,0,2,1,0,0,3,4,5,1,3,0,0,4,1,1,0,0,1,3,1,1,2,1,1,3,0,0,4,0,2,0,0,0,0,1,0,0,0,1,3,0,1,0,3,0,3,5,1,1,1,3,5,0,0,3,1,1,0,5,9,8,13,1,2,0,5,1,5,4,0,0,2,0,1,1,0,2,2,0,0,0,0,0,0,0,0,4,0,1,0,0,1,0,0,7,1,0,0,0,0,3,1,0,5,1,2,0,0,0,0,2,0,6,0,0,0,0,0,0,2,1,0,2,5,7,1,3,0,1,2,1,1,4,1,0,2,0,1,0,0,1,0,0,0,1,2,0,1,3,2,0,1,1,4,0,2,1,0,1,1,0,0,0,0,6,0,0,2,0,10,0,0,3,0,7,7,5,0,3,1,0,0,2,0,0,3,1,2,0,0,0,0,0,2,4,3,1,6,5,2,0,1,3,0,0,0,1,1,0,2,0,0,1,1,0,0,0,4,0,3,0,12,0,3,4,0,0,2,2,0,0,0,1,0,1,1,3,0,3,0,0,1,0,0,13,0,6,0,0,0,0,0,5,0,0,2,1,0,0,4,0,1,9,0,1,1,0,0,0,1,0,1,1,0,3,0,18,0,0,2,2,10,0,0,3,0,0,3,0,4,0,0,0,0,0,1,0,0,10,2,2,1,0,1,2,0,1,0,0,0,0,0,1,0,1,0,1,1,3,4,0,1,0,1,0,2,3,0,2,1,0,0,0,0,2,0,1,1,1,1,5,2,0,1,2,0,2,2,1,5,2,2,1,2,0,1,0,0,0,4,0,3,0,2,3,3,0,3,2,1,0,3,1,0,0,0,1,0,0,8,1,0,0,2,5,1,0,5,0,0,4,0,2,1,3,0,1,3,0,0,4,1,0,3,4,5,0,0,0,1,0,0,2,0,1,0,1,0,5,0,0,4,0,0,2,4,0,0,0,2,3,0,0,4,0,1,0,0,1,0,5,0,4,2,0,0,0,3,0,0,0,0,0,0,1,0,0,0,3,0,0,1,0,0,1,0,0,0,2,0,0,5,0,1,0,0,2,6,0,0,0,0,1,0,1,0,0,0,0,0,2,1,2,0,0,0,0,1,2,4,1,2,0,0,1,2,2,1,1,1,1,0,1,0,0,0,3,2,0,4,0,2,0,3,0,0,0,2,0,3,2,0,2,0,0,2,1,4,2,0,0,3,0,0,0,1,1,1,1,1,4,0,2,1,0,2,0,1,0,0,0,0,2,1,0,0,24,0,0,2,1,1,0,0,0,1,0,6,0,1,1,0,0,4,2,0,2,0,2,2,0,0,1,0,0,0,0,5,1,1,0,1,0,0,1,0,0,0,1,0,2,0,4,2,0,2,2,1,4,1,1,1,1,1,2,0,0,4,0,0,0,0,7,1,0,0,2,0,0,1,2,2,2,0,0,0,1,0,4,2,0,0,0,0,0,0,2,0,1,0,2,4,0,2,0,11,0,0,0,3,1,3,0,0,0,0,1,0,3,2,1,0,0,0,0,0,2,2,0,1,1,0,2,0,1,11,2,0,0,0,3,0,0,0,4,0,4,0,4,0,1,1,3,0,0,1,0,1,3,2,0,3,0,0,0,0,0,0,0,0,2,2,2,0,0,1,0,0,0,0,3,3,2,1,1,0,0,1,2,2,0,0,0,0,1,2,0,6,0,2,0,3,0,0,0,0,0,0,2,0,0,1,2,2,2,0,0,0,0,0,4,0,1,0,0,1,2,1,1,0,0,0,0,6,1,1,0,1,0,0,1,0,1,1,2,2,0,2,0,6,5,1,5,0,0,1,2,0,0,0,0,0,2,2,0,0,0,0,1,1,2,1,0,0,0,2,0,0,0,0,0,0,4,0,1,0,0,0,1,0,0,0,3,0,1,1,18,1,3,0,1,2,0,1,0,0,0,1,0,0,0,0,0,0,1,0,2,0,0,0,0,5,3,1,0,5,2,0,1,16,0,0,0,0,0,0,0,1,2,2,1,1,0,0,1,0,6,0,0,0,10,0,1,2,2,0,0,0,0,1,0,0,3,1,0,0,1,2,4,0,0,1,1,0,0,1,0,1,2,0,1,1,1,1,1,2,0,4,1,3,4,2,6,3,3,5,0,0,0,0,2,0,0,5,0,0,1,0,1,0,1,0,0,1,1,1,0,0,0,0,0,0,0,0,1,2,0,0,1,1,2,1,0,1,2,2,0,0,1,0,0,1,0,0,1,0,1,1,0,1,2,0,1,0,4,0,2,0,0,5,0,0,0,0,0,0,0,5,2,0,1,0,2,2,1,1,0,3,4,0,1,1,0,1,0,0,0,3,0,0,0,1,0,4,0,0,1,1,1,3,0,2,0,1,6,0,5,2,1,1,2,1,1,0,1,0,0,0,0,0,0,0,0,0,1,0,1,2,1,0,0,0,0,0,0,0,0,1,0,0,0,1,1,1,1,0,0,1,0,0,0,0,1,0,1,3,3,0,0,4,0,2,0,1,2,3,0,1,0,0,0,2,0,0,4,2,0,1,0,0,1,0,0,3,0,6,0,1,0,1,1,4,2,1,2,0,0,0,0,0,0,0,0,2,0,0,2,1,0,0,0,0,2,5,1,0,0,0,0,5,0,0,0,0,1,1,0,0,3,0,0,0,4,1,0,3,3,1,2,1,0,0,0,0,0,2,0,0,2,0,1,1,0,0,1,0,2,0,0,0,1,1,0,1,0,2,0,2,1,3,0,0,0,2,3,2,3,0,1,1,4,0,2,3,1,0,1,1,0,0,0,0,0,1,0,0,1,3,1,0,0,0,0,0,0,0,0,0,0,0,0,2,2,2,0,0,1,0,0,2,0,0,5,2,2,1,0,3,2,2,11,0,0,0,0,1,2,1,0,0,0,0,0,0,0,1,1,1,0,2,0,1,4,0,1,1,0,0,0,0,0,4,0,5,2,0,1,2,1,0,0,0,2,0,0,1,0,2,0,0,1,0,2,4,0,0,1,2,4,0,0,0,0,0,0,1,0,0,0,0,1,2,0,0,0,0,0,6,0,1,0,1,0,2,3,2,4,6,0,6,0,0,0,0,0,2,3,0,1,0,1,0,1,0,1,0,0,3,0,0,0,2,0,1,0,0,0,0,3,0,0,0,0,3,2,0,0,1,0,0,0,1,2,1,0,0,1,2,1,1,10,1,0,1,0,2,0,1,2,0,0,0,1,2,0,4,3,0,0,1,1,2,0,0,0,1,0,0,2,0,2,0,0,0,0,0,0,0,1,1,0,0,0,1,3,0,1,0,0,5,0,0,0,0,0,0,2,0,1,0,1,0,0,1,3,1,3,0,0,1,0,6,1,2,0,0,0,0,1,1,0,0,0,1,1,2,2,1,0,0,1,0,0,0,0,0,1,0,0,1,0,1,1,1,0,2,0,1,0,0,0,0,1,0,2,1,0,0,0,1,0,0,0,0,1,0,1,1,0,0,1,0,1,0,0,1,1,0,0,0,0,0,1,0,0,0,3,1,0,0,0,0,0,2,0,0,0,0,0,0,0,0,1,0,0,5,0,0,0,0,0,0,0,0,0,0,0,0,0,0,0,0,1,0,0,0,0,0,0,0,0,0,0,0,0,0,0,0,0,0,0,0,0,0,0,0,0,0,0,0,0,0,2,0,0,0,0,0,0,0,0,0,0,0,0,0,0,0,0,0,0,0,0,0
"2012 Erdrich, Louise, The Round House",high,5546,3344,2457,2337,1891,3397,1485,1445,1918,1187,847,990,1329,1009,1018,864,1015,769,571,961,722,720,497,429,1421,403,909,419,634,253,407,576,343,258,316,351,516,353,843,299,252,256,509,243,256,348,346,395,318,390,404,242,329,310,226,273,150,217,193,254,395,157,191,209,208,201,216,257,104,233,216,101,162,134,250,94,132,209,152,91,222,59,77,147,161,181,190,129,187,168,93,157,104,130,110,177,189,123,154,137,105,109,135,46,150,153,133,156,82,126,98,186,185,119,111,116,145,63,171,119,131,84,249,179,91,127,80,96,153,93,106,172,81,153,87,52,237,116,104,54,148,81,121,51,118,219,68,64,95,87,119,61,118,88,60,65,32,79,64,35,33,56,51,65,81,61,60,89,94,63,172,42,115,52,119,46,61,75,75,73,104,91,51,66,91,97,49,80,55,84,35,39,48,44,80,84,460,52,54,111,52,49,52,66,34,2,78,59,76,46,282,42,39,55,52,70,89,36,42,124,34,27,41,48,39,46,93,49,38,55,46,44,71,67,50,81,58,50,26,41,58,35,50,50,37,54,20,77,37,49,42,94,53,90,42,33,33,58,50,11,27,23,56,39,68,34,38,47,30,37,38,30,68,41,100,25,39,42,34,26,28,44,38,40,26,7,31,53,36,49,40,19,16,33,22,50,74,29,37,43,33,63,44,87,52,29,70,31,37,10,51,49,35,19,17,58,6,43,35,19,23,42,91,41,23,46,19,36,30,53,73,18,20,50,49,24,25,40,40,68,43,34,42,34,49,28,27,27,21,19,23,39,51,35,24,55,43,48,52,15,9,33,20,19,18,16,28,34,15,33,21,33,16,54,21,43,22,10,48,14,21,31,10,25,17,32,0,35,33,41,44,16,28,41,19,30,32,52,20,13,51,24,28,17,34,12,21,16,28,39,32,28,41,21,27,20,13,34,21,22,41,4,8,10,18,21,18,49,12,17,23,23,40,15,2,40,32,40,11,16,26,21,20,14,20,10,32,15,30,36,36,16,15,13,10,25,25,23,47,14,20,45,0,4,26,15,38,22,11,30,14,22,16,3,30,19,35,11,0,22,20,22,17,18,24,48,26,20,20,14,34,31,22,17,6,35,19,36,6,20,39,21,12,32,15,3,26,26,36,34,11,22,20,33,14,17,0,18,34,30,18,22,18,16,22,33,15,16,10,21,6,20,18,15,41,4,20,6,25,19,39,13,17,14,39,6,0,10,2,19,13,21,22,8,20,35,17,23,25,4,44,29,13,13,6,23,36,23,56,19,24,20,18,24,25,15,16,18,26,22,27,7,23,19,1,34,12,37,34,7,28,6,17,7,19,8,6,17,26,8,22,25,18,14,49,0,0,17,25,7,24,9,5,14,40,17,10,54,30,25,25,22,15,10,20,21,27,39,22,7,39,25,17,18,5,0,23,22,19,38,15,11,25,17,11,23,34,8,9,36,0,29,16,11,6,17,44,37,13,1,6,11,21,9,30,14,39,6,7,21,8,21,6,17,7,27,3,18,10,13,9,7,10,17,16,8,1,25,24,8,18,19,16,26,36,8,16,3,23,14,7,7,33,12,10,22,10,9,6,21,2,18,5,29,10,13,6,8,28,10,13,6,20,2,19,9,13,43,9,19,8,4,22,7,0,15,9,29,5,12,8,19,0,10,1,11,32,14,1,6,24,28,15,17,14,22,8,15,19,9,18,7,11,7,15,4,7,6,5,6,16,3,23,20,1,17,11,15,23,12,28,5,6,15,13,11,12,21,14,20,36,26,0,26,10,22,4,11,0,11,14,14,39,16,7,13,35,9,2,31,11,4,7,3,8,8,10,0,16,28,14,10,3,14,9,7,9,8,4,6,11,0,26,17,6,14,19,12,0,13,21,30,10,21,13,10,2,0,9,13,10,13,13,18,12,19,58,9,4,9,13,10,11,7,5,7,4,81,25,13,14,5,18,28,0,27,5,12,4,10,7,6,9,16,6,12,20,10,14,11,4,11,10,9,9,6,8,0,29,24,19,4,31,11,10,8,9,1,9,8,7,0,11,0,5,31,5,7,9,14,10,4,4,19,10,2,8,0,9,2,8,11,14,13,4,14,4,34,26,5,18,6,8,7,2,4,3,12,16,41,9,7,8,6,5,12,4,9,5,1,0,9,17,0,6,1,14,2,3,14,13,129,14,8,9,17,11,14,25,0,4,12,17,16,11,6,7,0,1,27,8,4,7,19,15,9,0,6,16,0,16,0,2,0,33,4,0,0,3,10,7,4,4,20,16,7,14,0,6,8,5,13,7,1,0,49,6,33,4,2,16,15,17,5,17,2,6,55,8,14,11,11,0,2,10,7,14,24,9,7,11,18,42,18,4,0,6,11,10,4,19,28,0,2,6,10,11,4,0,0,0,10,4,10,3,5,4,0,12,7,14,5,8,17,11,6,9,6,13,16,4,0,7,12,6,3,15,9,4,7,1,57,5,8,8,22,12,11,9,13,7,3,7,7,0,4,0,6,11,9,15,7,9,7,8,13,15,2,1,0,25,82,1,0,10,15,11,13,5,2,7,9,10,11,13,17,15,1,15,1,70,1,10,3,17,16,5,15,8,4,6,4,9,20,0,18,46,8,1,0,2,5,34,13,7,13,10,0,12,0,5,6,5,16,8,7,0,6,17,0,7,7,0,7,2,22,6,14,1,12,15,0,1,12,10,3,1,4,26,5,0,10,10,15,5,0,0,7,8,2,4,13,16,1,21,10,3,16,13,9,8,0,13,10,23,0,10,7,4,4,7,8,6,0,3,1,0,9,8,1,2,7,14,7,1,5,1,2,0,12,11,0,0,5,0,2,7,2,18,19,1,1,0,11,0,26,8,4,0,96,5,16,24,2,8,7,7,2,9,4,0,6,3,5,2,17,10,17,0,8,13,4,7,8,2,7,1,4,16,6,22,3,8,22,20,8,18,16,9,4,16,9,2,0,6,36,2,12,2,9,2,23,11,13,2,4,9,0,12,14,8,17,6,0,9,10,1,25,0,3,6,11,4,7,30,9,9,4,1,6,12,11,9,0,1,1,7,6,5,5,11,3,5,2,3,0,0,23,0,1,0,0,3,15,3,3,14,6,2,3,0,12,22,49,2,1,1,0,10,18,0,0,0,13,0,7,1,0,3,25,10,3,11,11,0,5,10,5,12,3,6,11,2,4,15,2,6,0,6,10,13,8,0,0,9,7,13,3,12,1,4,19,5,6,0,6,12,3,5,0,5,8,0,7,4,0,9,1,10,5,4,3,5,0,15,3,18,0,4,1,7,6,5,11,0,36,7,11,17,6,3,3,12,5,10,3,11,7,1,4,10,5,2,2,11,10,0,3,4,10,10,0,0,0,0,2,0,11,4,1,6,4,0,14,6,10,1,0,4,3,2,4,9,9,6,5,1,8,1,9,5,8,0,2,12,0,5,1,10,13,3,20,5,7,9,4,1,0,9,7,1,7,6,4,3,1,18,1,13,16,2,9,10,5,5,0,2,10,15,5,3,8,2,0,3,1,11,2,8,6,2,5,7,21,2,6,4,10,26,10,0,5,4,10,3,5,4,0,10,2,0,0,0,6,7,2,3,3,8,4,12,4,2,2,10,8,0,0,1,12,4,3,24,0,2,5,15,12,1,8,4,15,16,0,11,18,3,3,4,13,9,2,9,2,0,2,0,6,7,0,10,14,8,2,17,3,1,6,2,0,6,10,10,7,14,8,19,0,7,7,3,6,0,6,3,8,6,3,2,5,13,3,1,0,4,38,8,10,3,2,1,0,6,6,0,3,14,2,11,9,4,18,9,3,0,5,5,2,2,0,3,7,10,11,6,1,2,3,0,6,4,2,7,2,6,0,3,9,4,8,5,6,5,0,8,2,11,1,1,3,2,36,9,4,0,2,6,13,5,11,2,6,2,3,0,6,0,3,1,5,7,6,2,27,1,4,6,3,0,0,1,3,0,3,7,0,2,3,7,5,0,7,5,2,3,1,7,1,3,4,3,17,32,7,5,3,10,1,13,11,1,1,1,3,1,2,1,3,0,0,19,4,7,2,2,1,2,0,15,7,5,2,16,115,4,5,0,2,0,0,1,4,7,12,4,12,4,2,0,6,0,26,0,1,1,0,10,4,5,9,8,6,2,1,1,2,11,0,5,0,8,8,16,0,6,0,2,6,1,5,0,2,0,1,17,3,4,2,8,4,0,2,0,5,0,3,2,0,6,10,30,9,0,0,2,0,5,8,2,5,0,4,3,1,0,2,2,0,0,2,0,1,8,0,2,2,7,10,14,4,9,0,0,15,3,4,17,0,3,7,0,0,0,3,2,0,1,1,354,4,1,7,0,1,0,5,2,0,6,5,0,7,4,3,0,8,1,1,6,0,2,2,9,5,3,0,5,2,3,3,7,4,2,0,2,6,5,2,3,7,1,4,5,4,0,5,4,4,3,1,1,1,5,2,16,6,21,0,2,5,5,0,7,12,3,5,3,7,3,0,2,8,0,1,3,0,7,0,5,9,9,4,6,9,1,0,7,4,3,0,2,2,4,8,1,0,7,1,12,3,6,6,1,0,5,3,1,0,22,10,4,5,12,2,2,5,7,4,4,4,2,1,12,2,2,10,2,3,5,4,0,0,5,2,0,1,5,15,19,2,8,4,5,1,5,11,0,0,1,3,4,1,8,10,2,8,0,1,9,2,2,0,8,2,1,4,0,0,2,1,7,1,2,3,13,69,0,5,0,0,1,0,3,5,0,0,1,14,2,9,2,3,4,19,0,4,5,1,6,3,8,4,4,1,29,8,0,2,0,0,4,4,0,0,4,0,10,3,6,2,0,9,2,0,2,1,2,10,6,4,0,0,3,0,2,0,0,12,6,0,1,93,0,0,2,10,5,2,4,4,1,5,1,2,4,3,1,12,5,6,0,10,4,0,5,0,0,0,3,6,1,4,3,4,2,0,4,7,0,2,5,9,0,0,5,3,2,0,4,0,10,1,1,2,6,6,2,0,8,0,7,1,2,2,3,7,7,11,4,0,4,6,2,0,8,6,3,8,4,0,5,2,11,2,1,13,2,2,3,0,0,0,1,1,0,6,1,0,4,6,3,3,1,1,2,3,6,1,0,3,4,1,1,6,0,1,3,11,6,4,8,3,1,6,2,1,4,6,5,0,1,10,9,4,8,1,3,2,12,1,1,7,0,6,0,12,1,8,1,4,0,12,4,2,1,1,6,4,3,1,0,5,1,0,0,5,2,4,0,0,1,4,0,4,7,4,0,9,3,5,0,2,1,2,5,11,3,2,1,3,4,0,0,0,2,0,0,10,7,7,0,5,0,3,1,0,3,1,0,1,2,5,5,5,4,2,2,0,1,9,1,2,0,0,33,2,10,4,1,16,3,0,4,3,1,21,0,2,0,4,2,0,1,5,6,0,1,1,2,0,0,6,3,4,6,3,4,1,4,4,0,4,0,0,1,3,2,3,6,0,4,0,4,6,0,1,6,0,6,4,6,0,6,7,0,2,0,0,2,6,0,14,4,7,1,3,0,6,5,2,0,4,3,2,0,3,5,0,3,3,9,6,1,1,4,2,3,8,4,3,3,4,1,4,2,5,0,0,4,0,1,1,0,0,0,1,4,3,2,7,2,4,2,1,6,8,4,1,4,4,5,2,4,7,0,16,10,3,8,3,0,0,5,1,9,6,3,2,4,7,0,1,0,4,2,4,1,1,0,2,2,12,0,4,3,11,0,0,5,0,8,0,0,3,0,0,3,5,0,1,0,8,2,4,0,1,6,3,0,1,3,0,3,7,4,1,0,2,1,3,0,15,2,4,0,2,5,1,3,0,0,4,1,0,1,2,2,1,4,2,2,3,3,4,0,4,5,8,0,1,0,6,0,1,3,0,0,1,2,0,1,0,4,0,1,1,5,8,3,0,0,1,6,6,2,7,4,2,2,6,3,1,1,2,8,6,1,1,5,3,3,1,2,0,2,1,0,5,2,0,5,5,1,4,0,7,0,5,4,6,0,0,2,1,0,0,4,3,2,9,1,6,2,2,1,5,0,2,0,2,5,2,7,1,1,2,0,0,1,4,3,5,3,1,0,2,9,1,2,2,5,0,6,1,1,0,2,3,0,0,0,1,0,2,6,0,8,5,5,6,0,0,6,3,10,1,3,0,1,2,1,2,3,3,0,3,2,3,0,10,0,5,0,4,3,0,2,3,2,1,4,1,2,4,0,1,0,7,1,0,3,0,0,0,1,4,2,4,0,1,0,2,3,2,0,0,5,5,0,0,0,4,0,2,4,6,0,0,2,3,3,0,11,1,3,2,9,1,4,2,1,0,1,0,6,0,7,0,4,0,2,2,4,2,0,2,0,0,7,8,0,14,0,1,1,2,2,5,3,2,0,0,1,3,0,0,0,3,7,3,2,1,2,16,9,2,0,0,2,0,0,1,10,3,1,3,2,3,26,0,2,0,2,0,5,3,10,3,6,7,1,2,0,0,1,1,0,0,1,1,0,1,0,1,0,1,1,5,0,1,0,4,3,4,0,5,4,1,1,1,0,5,2,0,0,0,12,1,3,4,0,29,4,7,0,2,4,0,18,0,2,5,4,2,0,2,0,1,1,0,1,1,3,0,0,1,0,3,0,2,0,0,1,0,2,2,0,1,0,12,0,0,3,0,5,5,3,5,0,2,3,0,8,1,7,2,3,0,0,3,2,0,0,5,1,1,0,0,1,5,1,2,1,1,0,3,0,1,1,1,2,3,4,4,6,3,3,4,2,1,0,5,0,2,5,4,0,5,6,1,0,0,14,1,3,6,3,2,2,2,5,1,6,0,0,6,1,2,6,6,1,4,0,0,4,1,2,2,1,1,5,0,3,6,6,3,2,3,2,0,0,3,1,0,4,6,0,5,2,0,5,0,3,12,1,0,0,3,3,0,2,2,1,4,3,0,0,5,3,0,2,1,0,0,0,2,0,1,0,2,4,2,2,1,1,2,2,1,1,0,0,5,0,1,1,2,0,55,0,4,2,1,2,1,2,2,9,35,0,7,1,1,7,0,0,0,0,2,11,0,0,3,0,6,14,3,6,4,0,1,0,3,0,1,4,2,4,0,17,9,2,0,6,1,4,4,3,0,5,2,1,0,0,2,2,1,6,2,1,4,1,0,3,2,4,4,5,2,0,4,0,2,0,0,0,1,0,0,2,0,1,2,0,2,1,0,0,1,5,4,1,1,8,4,3,5,4,3,1,0,4,1,3,5,4,0,0,1,5,2,0,5,0,0,2,0,2,1,2,6,2,0,0,9,2,1,3,0,2,3,2,1,2,0,2,3,0,0,3,1,3,1,0,1,2,4,9,11,0,0,6,0,5,2,2,0,0,2,1,2,1,4,0,6,9,1,1,1,0,1,0,0,0,0,6,0,4,1,1,0,0,3,0,2,0,10,0,1,1,3,5,7,3,0,0,5,0,0,3,5,2,0,2,22,0,10,0,0,0,5,4,2,1,5,3,2,0,0,1,0,3,1,3,1,1,6,2,5,1,0,0,3,4,0,3,2,0,5,0,3,0,5,2,1,1,2,38,4,4,4,3,2,3,0,6,8,0,0,1,2,0,0,3,3,0,0,5,1,1,0,2,0,8,0,0,4,0,1,0,4,3,0,2,5,2,0,0,5,4,0,4,0,0,0,0,2,2,2,0,0,0,7,0,0,1,0,0,2,0,4,0,0,1,11,0,4,2,0,4,0,4,0,2,0,1,1,4,6,5,4,2,0,2,1,2,2,0,1,0,6,0,0,1,2,4,0,0,0,0,10,1,2,5,3,2,1,2,3,0,2,0,151,0,2,1,3,2,0,2,0,6,1,2,2,3,1,1,1,1,5,5,0,1,4,0,0,0,8,0,7,1,3,1,0,2,6,9,0,0,4,0,6,0,4,14,2,0,0,2,2,0,0,0,7,6,1,2,2,2,6,2,2,3,1,1,8,0,3,0,0,12,3,3,3,0,0,0,0,1,0,3,2,11,0,0,0,1,0,3,0,2,2,2,2,2,4,1,5,1,5,0,0,1,0,3,1,0,0,0,7,4,0,3,4,1,4,2,1,4,0,1,0,2,0,0,1,1,0,4,0,0,2,0,0,3,3,0,0,2,2,0,0,0,2,0,0,1,0,2,1,2,1,2,0,3,0,0,3,0,6,2,3,5,2,1,0,2,0,7,1,2,6,3,6,2,2,0,3,1,3,8,0,4,0,4,1,2,0,10,1,2,4,0,0,0,0,3,3,2,2,4,4,2,1,3,0,0,1,3,0,1,0,0,0,4,2,5,1,0,2,0,1,3,0,0,0,6,1,4,0,0,0,8,1,2,5,3,7,0,3,1,0,3,1,0,0,0,4,1,2,0,2,1,1,1,0,0,3,0,0,0,4,6,2,1,0,2,0,0,3,0,3,0,0,4,0,1,0,4,0,0,1,0,3,2,0,0,2,0,1,0,0,1,2,0,5,6,2,8,6,2,9,4,0,4,3,0,0,0,1,3,1,2,2,8,3,3,0,0,7,4,0,3,0,0,2,7,0,0,0,0,0,4,3,2,1,9,4,1,0,1,1,6,3,1,1,2,0,0,1,6,10,1,3,0,2,0,2,0,1,2,3,1,5,0,1,1,0,0,0,5,1,1,3,2,0,23,3,0,3,0,2,1,4,12,1,1,3,0,4,5,0,0,2,0,0,0,1,7,1,3,0,4,1,0,5,1,1,0,0,3,3,0,1,4,7,1,1,2,13,2,5,5,1,0,2,3,0,5,0,0,1,3,1,6,2,34,0,3,0,1,0,1,0,7,0,0,0,0,3,2,0,0,1,3,1,0,2,8,0,3,2,0,1,2,0,1,2,1,1,3,1,0,152,2,4,1,0,2,0,0,2,0,1,0,0,0,1,0,5,2,0,2,0,1,1,0,2,7,3,1,2,0,0,5,2,0,0,0,1,5,0,2,0,2,0,0,0,0,0,0,0,1,3,0,1,5,0,1,2,0,6,5,4,1,1,2,0,3,3,3,0,1,1,0,0,4,2,3,1,3,2,3,4,4,6,0,0,0,1,0,0,1,1,0,0,0,7,3,2,2,1,5,0,4,1,6,2,1,4,1,0,1,2,0,0,6,1,7,0,0,3,1,0,4,1,9,3,1,3,0,0,3,0,0,1,0,1,1,3,1,0,4,0,1,115,0,8,3,0,3,1,2,3,0,0,1,0,1,0,0,2,0,4,0,1,0,0,0,0,0,0,1,4,0,0,1,5,0,1,11,4,3,1,0,0,0,1,2,5,0,1,0,1,2,2,2,3,0,0,3,1,0,0,0,0,2,0,2,0,6,2,2,2,13,0,45,1,0,0,3,0,1,0,0,0,1,0,0,0,1,5,0,0,2,0,0,2,4,7,3,1,4,0,2,5,0,2,0,1,0,0,1,0,2,2,1,0,4,0,5,0,3,5,6,7,0,3,0,0,0,6,0,1,0,2,0,0,5,3,2,1,1,2,0,1,0,1,5,0,3,1,4,1,2,0,0,5,0,0,0,0,2,0,2,2,3,1,4,0,0,4,0,0,4,1,0,1,3,0,3,1,2,0,1,4,1,0,0,0,3,2,5,10,1,3,3,1,0,0,1,2,0,0,0,8,2,4,3,0,1,3,0,0,7,3,0,3,6,0,3,0,0,0,1,44,1,0,0,1,1,1,0,2,1,4,0,2,1,0,2,4,0,0,0,2,1,0,0,3,1,6,1,2,1,0,1,2,0,0,3,0,7,0,1,3,0,1,1,1,1,0,0,1,0,1,0,2,5,0,1,0,1,2,0,1,3,0,0,0,0,3,1,7,0,3,1,0,2,0,1,0,0,0,0,2,0,0,0,0,1,58,1,2,3,3,2,1,5,0,1,0,0,1,3,0,1,0,0,8,2,1,0,1,0,2,1,2,2,0,1,2,19,0,1,0,0,3,0,1,0,0,3,1,0,1,2,1,2,0,0,2,1,0,0,0,2,4,1,3,2,1,3,3,0,3,1,5,1,1,10,0,3,1,0,0,1,0,0,1,0,2,0,1,0,1,1,0,0,0,6,0,5,1,0,0,0,4,1,0,0,1,17,3,3,0,4,0,1,4,0,3,3,3,0,4,4,0,0,0,5,0,0,5,0,14,0,1,1,0,1,0,1,2,0,0,2,4,1,0,0,1,1,1,0,1,3,1,2,1,4,0,1,0,0,2,15,1,1,0,0,0,2,0,1,0,0,4,0,0,0,7,0,0,0,1,0,4,0,0,1,0,1,0,0,0,0,0,0,2,2,0,0,1,0,2,0,1,2,3,0,3,0,3,1,1,4,0,0,3,0,2,6,0,3,1,3,2,2,3,3,3,3,3,0,0,5,1,1,1,0,1,1,0,2,2,3,1,1,1,0,0,0,2,4,0,3,7,1,0,1,2,2,0,0,4,0,0,0,3,0,2,2,3,0,0,0,0,0,5,2,2,2,0,0,0,0,2,0,3,2,0,1,0,0,0,2,0,6,2,0,0,1,9,1,3,2,3,7,1,0,5,1,0,0,1,3,1,1,4,2,2,0,2,4,2,1,1,7,1,1,0,0,0,3,0,0,1,1,2,3,0,0,6,2,0,1,1,0,2,1,0,2,5,0,1,0,2,3,0,0,0,1,2,1,0,0,0,0,2,0,0,0,3,2,0,0,2,1,0,0,2,3,0,0,2,0,1,3,0,0,1,6,3,0,6,0,0,4,3,1,3,1,1,1,0,0,1,0,1,4,0,3,0,1,0,2,0,1,1,2,0,4,0,0,2,1,0,1,0,0,1,0,0,3,0,0,0,0,0,0,4,0,0,1,0,2,0,1,0,0,0,0,2,1,0,0,2,1,2,0,0,0,0,0,0,0,0,1,0,0,1,0,0,1,2,7,0,0,0,0,0,0,0,0,0,1,0,2,1,0,0,0,2,0,1,0,0,0,7,0,1,3,0,0,0,0,0,0,2,0,0,0,0,0,0,0,1,2,0,0,0,0,0,2,0,0,0,0,0,0,0,0,0,0,0,1,0,1,0,0,0,1,0,0,0,0,0,0,0,0,0,0,0,0,0,0,0,0,0,4,0,0,0,0,0,0,0,0,0,0,0,0,0,0,0,0,0,0,0,0,0,0,0,0,0,0,0,0,0
"2013 McBride, James, The Good Lord Bird",high,7162,4618,3446,3188,2142,3003,2527,1826,2317,1692,1578,1440,1638,528,452,1137,558,842,1312,1013,690,867,666,949,666,335,995,821,865,675,588,767,402,374,324,206,63,455,628,427,308,446,616,365,304,346,342,370,196,349,466,703,236,279,174,316,122,272,271,336,386,291,364,203,360,268,292,243,89,110,232,147,130,178,513,253,297,349,223,346,434,96,938,230,271,163,202,165,131,184,160,159,93,137,63,130,175,169,201,146,135,127,113,162,59,234,101,110,100,95,351,928,224,155,133,133,107,156,123,81,90,219,112,83,119,98,131,78,3,172,54,58,150,111,78,98,171,178,76,69,122,121,78,23,1,82,102,37,142,31,105,20,131,114,154,107,127,66,98,60,63,30,27,163,132,17,108,153,85,86,77,65,39,103,10,86,77,76,72,53,59,70,38,50,84,52,19,100,130,150,66,118,129,48,213,63,30,83,75,53,107,86,30,60,144,137,67,34,121,94,10,64,302,50,92,35,10,89,66,65,67,68,52,81,24,29,23,53,58,19,53,25,106,23,187,20,47,49,35,65,60,2,87,28,50,43,82,83,24,96,57,70,85,62,45,67,25,61,34,38,60,52,37,45,20,34,36,17,50,45,13,50,62,33,5,42,96,63,69,258,49,21,61,22,14,19,32,34,46,21,51,38,0,43,103,34,25,36,22,64,48,34,7,99,2,44,63,104,83,16,42,81,71,41,24,65,62,25,60,11,63,7,58,46,13,74,128,34,46,25,38,29,40,66,87,51,68,53,33,13,46,43,47,8,64,18,38,0,95,38,28,30,25,80,16,15,10,40,69,9,59,29,19,45,24,9,31,47,25,87,27,45,42,19,24,45,23,47,15,4,28,28,66,23,43,0,0,139,39,9,8,30,17,1,27,16,21,9,28,22,5,33,24,52,13,45,35,32,32,50,12,21,40,116,27,3,4,37,28,31,10,0,80,92,54,54,20,19,11,38,75,27,17,19,1,55,52,40,0,38,21,40,30,36,11,17,28,14,32,97,24,70,11,26,0,29,29,18,23,61,23,21,1,18,25,23,1,63,7,20,123,20,19,284,21,14,46,13,0,22,29,11,21,27,60,74,15,6,10,41,32,27,6,21,18,38,36,27,49,73,23,29,7,50,63,50,43,24,8,4,11,8,43,35,35,41,0,37,13,43,15,15,56,9,11,12,32,36,51,3,130,7,22,1,43,7,14,24,15,20,44,22,5,22,23,19,0,86,28,23,0,18,21,49,22,24,14,8,7,0,9,36,21,29,11,17,52,20,11,35,22,23,48,15,19,15,47,21,16,20,13,9,27,23,14,37,24,29,140,40,8,14,22,14,41,19,32,32,33,31,19,21,17,4,32,0,0,11,19,8,46,35,6,8,20,149,11,124,17,7,20,6,14,19,21,7,24,30,15,9,19,3,5,37,2,107,22,21,4,7,21,10,16,8,0,25,29,8,3,18,0,17,40,3,7,18,26,84,18,5,12,47,19,32,0,8,14,20,35,10,3,8,7,9,37,27,29,12,19,23,1,9,8,55,16,336,0,8,19,24,12,4,15,23,1,24,20,178,16,34,21,39,22,28,21,11,8,25,15,3,2,17,44,12,24,0,16,11,15,16,2,0,17,1,7,34,26,2,24,17,17,15,3,12,1,20,19,5,25,12,5,4,12,16,5,0,19,8,17,6,11,33,28,8,5,6,12,5,28,18,30,30,13,34,5,2,10,27,152,20,10,14,120,17,0,7,20,5,21,6,11,11,21,12,14,23,12,22,15,20,21,22,1,23,12,8,0,20,0,32,35,39,34,4,9,0,0,19,3,4,21,6,16,33,7,22,20,0,11,1,27,10,6,6,24,23,15,6,20,4,14,1,39,19,9,11,7,8,0,9,14,25,2,13,22,13,3,0,10,10,22,9,0,6,8,1,15,0,15,25,10,19,5,18,28,1,8,0,44,3,16,19,4,10,0,12,11,27,3,42,9,22,4,2,69,20,33,11,53,3,10,1,15,5,4,8,11,0,8,2,11,0,5,2,2,13,8,26,15,2,38,0,16,0,13,0,6,15,22,27,17,0,14,6,40,1,6,0,13,49,0,10,4,2,4,21,29,0,9,6,18,0,3,3,9,38,11,11,6,0,8,16,6,8,2,17,20,9,3,74,0,32,9,0,6,12,3,107,23,13,1,1,2,3,8,10,11,4,2,0,0,9,16,0,3,270,11,38,6,14,7,6,9,10,8,17,1,4,9,0,20,0,17,21,3,7,0,0,17,18,9,55,5,13,0,3,13,3,3,28,0,15,0,0,0,0,28,53,0,25,5,0,1,6,16,14,22,1,13,14,1,15,7,23,7,7,29,17,24,11,5,11,3,11,101,0,31,0,1,22,15,0,0,0,20,8,10,2,0,0,0,16,7,8,3,6,2,0,4,14,0,202,5,6,26,11,17,2,8,40,0,0,4,12,7,7,2,7,11,19,2,13,0,0,26,10,38,5,9,13,4,8,24,7,0,0,6,29,14,5,10,24,2,7,6,1,20,10,4,0,25,0,4,97,21,9,22,55,9,28,26,8,25,5,6,8,3,11,1,17,2,48,10,9,9,1,2,15,15,9,1,7,8,10,0,2,9,1,8,157,3,7,18,4,10,12,24,5,9,3,64,5,29,7,13,9,0,9,8,0,14,15,0,4,0,0,3,14,0,12,0,0,15,23,18,73,0,2,20,24,0,5,48,5,2,0,0,1,6,4,17,0,21,15,9,23,3,19,6,7,15,20,82,1,1,0,10,17,1,0,9,10,13,0,0,1,0,2,13,33,3,6,2,18,3,5,17,1,1,6,3,0,1,4,0,5,24,0,20,8,1,52,0,16,0,4,6,4,0,0,45,15,22,7,0,7,8,7,13,2,0,8,3,3,11,6,0,31,248,0,23,5,10,20,9,0,0,2,4,2,10,69,1,4,0,9,2,6,4,6,20,3,0,0,10,2,13,7,0,1,0,3,6,28,9,6,5,12,2,7,22,3,2,0,8,0,3,15,4,0,6,1,6,0,10,9,8,4,16,0,0,1,10,0,12,0,3,0,7,11,0,3,2,5,0,0,0,14,0,0,13,0,20,5,44,12,7,21,82,20,48,7,3,1,0,0,4,0,3,10,0,0,0,15,0,16,2,0,6,1,2,2,13,4,0,4,8,26,8,2,13,0,9,36,9,1,2,1,17,16,10,4,0,0,17,14,0,12,3,3,6,0,0,6,1,1,2,19,16,2,10,1,0,9,8,0,3,10,11,3,3,24,1,0,12,16,10,0,29,7,3,22,2,6,0,56,0,0,2,1,2,3,25,4,0,8,1,8,0,6,12,6,9,5,19,30,0,0,1,8,4,0,1,0,0,6,0,14,22,0,6,26,5,1,3,13,7,47,5,0,55,14,7,1,7,7,45,5,11,2,3,6,19,1,8,1,4,2,5,5,9,7,22,5,32,5,2,0,7,13,1,8,10,5,3,3,7,2,10,7,0,0,5,42,6,5,36,2,4,28,3,6,2,0,0,0,0,0,21,26,2,3,9,8,17,16,0,12,6,2,0,9,2,6,1,5,2,0,0,4,0,0,0,14,28,3,0,0,3,3,7,3,0,0,1,30,0,7,2,2,6,1,7,0,6,7,2,4,24,1,0,0,4,0,3,24,5,12,6,7,16,1,23,8,0,2,2,9,3,5,0,3,2,2,13,3,0,3,1,1,16,0,8,2,0,7,12,0,4,20,1,22,3,1,1,23,21,6,26,8,0,8,2,7,45,0,3,11,22,8,2,0,10,0,0,31,1,16,6,3,1,9,2,0,25,9,0,1,13,0,2,22,1,39,6,14,14,5,0,5,5,4,0,5,1,0,4,1,7,0,0,15,2,0,26,1,1,2,4,21,2,9,2,4,0,26,42,0,3,13,3,68,13,6,0,11,0,9,1,10,8,11,23,47,2,2,1,2,4,0,20,9,0,10,2,0,14,4,2,0,0,2,4,9,6,0,5,0,4,0,1,5,0,3,10,0,5,2,10,0,25,0,0,4,0,24,7,0,20,1,6,1,2,2,5,9,4,4,6,7,1,1,0,0,1,1,0,0,0,0,0,2,13,6,18,2,5,4,0,4,8,31,0,0,0,2,9,4,12,22,1,7,9,35,7,1,3,3,0,5,5,4,3,19,0,1,4,2,3,3,26,6,4,10,8,7,103,2,4,4,0,17,1,1,3,7,0,0,1,10,8,9,0,4,20,0,6,5,0,1,0,7,2,1,0,2,2,0,0,0,0,9,2,0,20,2,3,40,6,6,16,0,0,5,1,6,9,0,8,7,0,42,0,0,6,0,29,6,0,55,0,3,0,6,0,3,0,2,8,6,4,12,0,2,0,6,2,3,0,3,1,3,4,8,12,0,5,8,3,3,7,3,0,0,1,8,6,2,1,5,1,4,2,2,10,9,3,5,7,0,2,0,0,4,1,0,2,0,21,1,9,0,9,0,0,4,3,7,3,0,6,17,0,9,0,4,3,21,2,7,4,3,4,2,8,0,1,6,2,0,1,11,3,4,106,0,3,18,3,7,4,3,0,0,0,5,3,2,19,2,10,9,1,5,2,2,5,0,6,5,0,3,1,3,7,1,9,21,13,2,0,6,0,2,0,0,0,0,3,2,2,0,11,0,2,0,3,38,0,3,0,15,2,1,0,1,0,2,3,8,0,120,2,6,0,5,0,0,0,3,7,1,0,0,5,9,4,13,0,0,5,0,4,3,0,0,0,8,0,14,0,7,0,1,0,3,6,5,3,6,0,10,0,30,4,0,0,4,0,0,2,7,24,0,8,0,3,0,1,3,0,2,1,0,1,2,6,7,0,0,0,0,0,0,4,0,0,0,5,1,2,0,0,1,1,4,0,0,7,1,0,0,2,9,4,4,1,7,2,9,7,0,0,3,2,1,1,0,5,1,0,1,4,12,23,0,0,4,2,0,7,15,0,0,0,19,0,6,0,0,9,0,10,1,5,8,3,2,5,0,2,10,1,2,0,2,8,18,0,3,9,0,5,0,7,13,1,1,6,0,3,3,6,3,1,10,6,3,0,15,0,0,0,10,0,6,4,1,2,0,9,7,8,4,2,0,1,11,1,5,9,0,5,1,3,3,53,0,0,0,8,1,2,0,0,2,0,0,0,1,11,0,5,7,4,3,4,1,8,8,0,7,0,4,1,5,9,4,1,2,0,13,0,5,0,3,1,0,7,2,2,2,2,20,2,0,7,7,7,0,0,11,0,1,0,0,0,0,57,5,0,2,6,2,4,8,6,0,16,26,3,0,0,0,0,2,2,6,0,3,0,2,0,6,3,0,7,1,0,0,0,0,3,0,4,3,2,0,9,2,0,1,1,0,0,0,1,4,8,20,8,0,0,0,0,7,1,1,0,1,1,0,7,1,0,0,0,0,0,0,1,2,2,0,0,3,1,21,4,0,0,3,0,102,2,0,0,11,1,0,2,0,4,5,0,0,0,111,10,5,13,3,0,1,0,0,0,20,0,0,0,3,0,10,4,1,0,1,11,1,4,7,3,2,0,1,7,0,6,3,8,0,8,5,1,2,1,6,3,4,0,2,9,16,1,1,0,4,0,0,0,1,0,0,0,1,2,6,3,2,1,3,3,7,3,0,0,0,1,0,5,1,9,2,11,6,0,1,2,0,1,0,1,1,1,3,1,0,1,8,1,2,0,1,3,4,0,4,0,0,0,3,1,4,0,4,5,30,0,0,2,0,0,3,0,0,1,9,0,6,2,7,0,8,10,31,8,0,0,0,9,1,3,7,1,0,1,1,5,0,3,78,1,2,0,1,1,13,2,4,7,70,3,20,1,14,1,15,2,0,0,3,0,0,0,5,0,6,13,1,0,3,0,0,2,1,0,1,3,49,1,0,0,3,0,0,2,2,0,0,0,10,6,0,2,2,4,4,2,5,1,0,6,1,4,1,1,2,4,1,7,3,31,2,2,0,4,2,2,0,0,1,15,5,0,0,0,1,3,3,5,0,3,10,0,0,0,0,0,6,9,2,1,2,0,6,0,3,0,0,1,1,9,0,1,1,45,6,2,12,1,2,1,0,0,2,5,0,6,2,0,0,0,3,0,0,0,0,5,0,4,3,0,0,2,0,7,0,0,7,0,0,0,2,11,0,4,0,7,2,0,0,1,7,1,0,2,1,0,2,0,1,0,0,0,0,0,4,5,0,8,0,7,2,0,3,2,14,1,0,3,2,4,0,2,0,1,0,0,11,1,0,2,2,0,0,2,0,0,3,0,3,3,1,2,4,2,0,3,1,8,6,0,7,5,11,2,3,2,4,0,1,0,0,6,1,3,2,0,0,0,3,0,0,0,1,0,2,2,0,0,2,0,0,7,2,6,1,4,0,0,6,0,0,0,3,0,1,11,2,0,4,32,3,3,0,1,0,0,2,0,3,4,3,3,4,0,0,0,1,2,0,14,0,4,5,1,0,5,2,0,1,1,0,0,1,0,0,1,5,2,7,2,0,0,0,6,6,0,3,0,0,5,11,0,3,0,1,1,1,1,4,4,0,0,7,2,2,7,5,0,1,1,4,1,0,5,7,0,10,2,3,0,0,0,0,0,1,5,0,2,0,3,0,1,0,0,7,2,0,0,1,3,6,2,0,0,28,0,3,0,0,5,0,3,6,3,0,0,1,0,0,5,6,3,0,1,0,0,0,10,0,0,5,0,2,0,0,1,2,2,3,4,1,0,0,0,2,0,1,0,0,1,3,1,8,6,4,1,4,0,0,0,0,3,1,0,0,0,0,0,0,2,2,7,3,3,1,17,1,3,0,3,1,1,0,3,2,0,0,0,1,0,1,1,0,1,0,4,1,0,0,2,1,1,4,6,10,0,2,2,0,2,2,1,0,1,0,0,0,0,1,2,2,0,1,0,0,1,1,0,18,2,2,0,0,0,1,6,11,0,0,0,6,0,1,0,1,55,4,0,1,1,0,0,0,1,1,3,7,0,4,0,0,11,5,13,0,0,0,1,9,0,0,0,0,6,3,1,4,15,2,1,1,11,0,0,3,7,0,0,7,2,7,1,4,5,0,0,0,0,0,0,0,19,1,0,0,3,2,5,2,3,0,0,6,6,0,0,4,0,6,0,2,2,0,1,7,1,9,0,0,2,0,2,6,6,4,1,9,0,1,2,0,3,0,4,0,0,1,6,0,6,3,1,4,4,1,2,2,3,0,0,1,0,0,0,0,0,0,1,0,2,1,15,2,0,0,7,0,0,1,0,0,0,7,3,3,1,8,10,7,0,1,5,0,6,0,0,3,0,0,5,0,2,5,5,0,0,1,0,9,3,4,0,5,2,1,0,0,0,0,0,1,26,0,3,2,0,0,1,3,0,1,2,0,2,0,0,3,0,1,0,2,0,1,1,0,0,0,1,1,6,1,1,1,0,0,6,0,2,7,8,0,0,0,6,0,1,0,1,0,0,5,0,4,0,0,6,4,3,1,2,1,2,0,1,4,4,0,7,1,1,0,1,0,1,1,0,0,2,6,3,2,0,2,0,3,0,17,0,0,1,0,0,7,13,1,1,1,0,0,0,0,3,3,5,0,0,5,1,4,0,1,2,0,1,0,3,5,13,0,0,4,0,0,1,4,0,2,0,0,5,0,2,3,98,6,1,0,0,2,0,16,1,3,0,5,4,0,0,0,3,3,0,0,0,0,0,0,0,0,1,0,1,3,0,0,1,0,0,0,3,0,2,0,3,0,0,0,16,0,2,5,0,8,0,65,0,0,3,0,0,0,9,2,1,0,1,0,5,0,7,2,0,0,0,1,0,2,2,0,0,8,0,3,2,0,1,0,2,7,2,5,2,0,9,5,0,3,5,8,5,1,0,1,7,7,1,4,0,2,2,5,1,1,3,17,0,1,0,0,0,14,8,0,1,0,4,3,1,0,3,7,0,18,1,3,2,2,2,0,4,2,1,4,0,13,0,0,6,0,1,2,1,82,0,0,4,2,4,0,1,0,0,0,0,42,1,0,2,1,0,1,6,0,0,2,1,0,0,0,1,0,55,2,0,1,0,5,2,0,1,0,1,1,0,2,3,0,9,1,3,0,0,1,0,0,6,1,0,0,16,2,13,0,2,0,4,1,7,0,0,0,0,4,0,0,0,1,2,0,1,0,0,0,1,5,0,3,12,0,1,1,0,0,2,0,0,0,1,10,4,135,0,2,5,2,0,2,5,0,12,0,0,5,0,0,1,2,2,0,0,1,0,11,4,1,1,1,0,3,12,7,2,0,0,0,0,2,0,3,2,0,6,5,0,0,0,0,0,0,0,1,2,0,0,0,6,0,3,0,9,3,0,1,3,4,0,3,0,1,0,0,13,0,0,3,2,4,0,3,1,3,1,1,0,4,0,0,4,0,1,0,0,8,0,0,0,3,0,7,2,0,4,0,0,0,2,0,0,3,0,0,6,0,0,2,0,1,4,5,1,1,0,0,0,0,8,2,0,0,4,0,0,2,0,2,0,1,4,10,12,0,16,4,2,0,2,2,1,6,0,2,1,0,4,1,0,1,1,28,3,0,0,0,4,2,0,0,0,4,2,1,2,4,0,85,0,3,0,2,8,7,0,3,0,0,0,0,6,2,5,3,0,0,0,0,8,0,0,0,1,4,1,0,0,1,0,0,0,1,0,0,2,2,0,0,0,0,2,0,0,1,1,0,0,1,0,3,0,0,14,0,0,0,0,1,0,0,0,0,16,3,0,5,0,4,21,2,6,0,5,0,0,4,2,0,0,0,0,5,3,4,2,0,0,0,0,0,7,0,0,4,0,2,2,8,6,1,1,6,1,3,2,2,0,2,0,0,0,0,0,0,0,0,0,0,1,0,1,2,2,0,2,2,0,1,2,0,0,6,0,8,0,0,0,0,5,0,1,0,0,142,0,1,0,2,0,1,0,2,0,1,1,1,1,0,0,3,0,0,5,0,0,0,0,3,0,0,2,1,0,0,0,0,7,0,4,1,8,8,3,3,0,0,0,1,3,0,0,4,0,2,0,3,5,0,0,0,0,0,0,9,0,5,0,0,0,3,0,0,1,0,0,0,0,0,0,0,0,6,0,2,9,1,0,0,0,0,1,0,2,0,3,0,4,1,11,0,1,7,1,5,0,3,0,0,1,2,0,0,0,7,1,0,0,0,1,3,0,0,0,0,1,0,1,0,1,0,0,0,2,0,0,0,5,0,0,0,0,1,0,1,0,3,0,0,2,1,1,0,0,1,3,0,1,1,0,0,1,2,0,0,0,0,0,1,1,6,0,1,1,1,10,0,2,2,0,0,4,0,0,5,0,0,0,0,2,0,3,0,0,0,2,0,5,1,1,85,0,0,7,0,1,0,0,5,0,0,0,0,1,2,0,0,1,0,0,6,1,0,3,0,0,0,4,3,0,0,0,0,2,3,0,1,5,0,0,2,12,12,0,0,0,0,0,1,0,0,0,4,0,1,19,0,3,0,0,2,7,0,0,1,3,0,0,3,0,3,10,1,6,2,0,21,0,0,0,1,0,1,0,2,0,0,0,2,1,1,2,2,0,0,1,1,0,0,5,0,1,0,0,1,2,0,0,0,0,1,2,0,30,2,2,19,1,1,0,0,1,1,0,3,0,3,0,0,38,0,1,0,0,77,3,4,1,0,3,0,4,0,0,0,0,1,4,0,2,0,3,0,0,0,0,0,0,2,0,0,1,3,3,0,1,1,3,0,2,2,0,1,0,0,2,0,0,0,2,0,1,0,0,0,0,1,0,0,6,0,1,13,3,0,0,0,0,1,0,4,2,0,5,0,8,0,0,2,1,0,0,3,0,7,0,2,5,0,2,0,1,1,0,0,1,3,0,0,0,0,0,0,5,13,0,2,13,0,3,0,0,0,0,3,0,10,0,1,3,0,3,0,3,0,0,1,1,1,1,0,3,8,0,4,0,0,22,10,0,3,0,2,0,3,0,0,1,0,0,0,2,0,0,2,4,0,0,0,88,1,0,4,4,0,0,0,3,0,0,7,3,0,1,0,0,0,1,0,0,0,0,0,0,1,0,0,0,2,0,0,9,0,0,7,0,3,63,5,0,0,4,2,2,0,9,2,2,4,7,8,0,0,0,0,1,3,0,0,0,0,3,0,0,7,1,0,5,5,0,16,0,0,0,2,1,0,0,0,0,3,2,0,0,0,0,5,4,0,2,0,3,7,0,0,0,0,0,0,4,0,0,0,13,0,3,0,0,5,0,0,0,0,2,1,0,6,0,2,0,0,2,0,1,1,0,0,0,0,1,0,0,0,0,0,0,1,0,0,0,0,4,2,0,2,1,10,0,0,0,1,0,5,2,4,0,2,0,0,3,3,0,3,2,2,1,0,4,8,8,6,1,0,0,1,0,2,1,16,0,29,0,130,5,2,9,0,2,1,1,0,0,1,1,6,1,2,1,0,0,0,0,1,0,0,0,1,7,5,0,0,0,15,0,0,0,0,0,2,0,1,0,1,0,1,0,2,3,6,0,1,0,3,6,1,0,0,0,0,0,1,1,1,2,0,2,1,0,1,1,0,0,0,0,3,0,0,0,3,0,0,2,0,0,0,0,0,0,0,1,0,0,0,8,2,1,0,0,1,0,0,0,1,0,1,0,0,1,0,0,0,0,1,4,0,0,0,114,0,2,0,0,0,1,3,1,5,1,1,0,0,0,0,2,0,1,0,0,0,2,0,25,2,4,1,0,1,0,0,0,1,3,2,2,9,7,1,1,1,0,1,7,0,0,0,0,1,0,0,4,1,0,0,4,3,1,0,1,0,0,4,0,0,0,0,0,0,0,0,0,0,0,3,0,1,0,7,2,0,4,0,119,0,0,1,0,7,0,0,5,0,3,5,0,2,0,0,0,0,0,8,0,0,3,0,0,0,0,1,0,0,0,0,1,1,0,0,0,0,0,0,0,0,1,1,0,0,0,0,0,0,0,0,5,0,1,0,0,0,0,2,0,0,0,0,0,1,0,0,1,0,0,1,0,0,2,0,0,1,0,0,0,0,0,0,1,2,0,0,0,0,0,0,1,0,1,0,0,0,0,0,0,0,0,2,0,0,0,0,0,0,0,0,13,0,0,0,0,0,0,0,0,0,0,0,0,0,0,0,0,0,0,0,0,0,0,0,0,0,0,0
"2013 Pynchon, Thomas, Bleeding Edge",high,6305,2944,3625,3736,3128,1111,568,2578,559,1505,1572,447,1021,931,739,1328,147,1094,1157,53,901,687,808,240,303,731,412,571,813,1316,641,693,677,902,880,509,170,725,304,471,431,623,414,465,487,254,426,522,189,219,398,271,224,497,436,379,365,301,254,433,333,282,364,352,272,347,234,281,444,119,299,254,279,206,175,335,107,94,580,444,232,558,41,218,296,12,204,358,257,286,145,229,265,181,202,186,271,160,146,121,155,201,148,219,92,377,183,147,158,236,165,132,95,77,117,63,143,186,45,148,11,143,61,47,88,32,156,222,42,111,48,46,123,39,50,179,49,95,41,184,34,108,23,225,74,72,83,118,109,344,155,41,30,116,64,202,452,126,39,47,123,12,41,121,74,115,103,146,34,106,32,101,121,67,26,229,66,77,107,123,145,24,52,69,86,55,97,52,85,80,68,37,160,95,23,32,13,80,25,123,126,21,46,98,137,19,104,37,24,78,28,58,26,121,38,92,9,35,122,5,79,49,31,63,112,63,120,49,87,140,66,31,6,50,50,12,40,60,40,72,66,37,69,72,83,26,28,43,3,41,72,17,78,9,23,42,66,103,51,86,80,49,153,69,118,33,93,59,21,100,40,120,108,50,16,72,70,71,60,33,44,21,48,54,39,119,87,14,78,38,13,22,62,32,63,60,15,82,175,40,57,41,1,52,22,167,103,31,10,74,91,16,32,47,49,8,27,30,37,53,24,29,31,10,92,43,24,84,27,6,27,51,25,4,16,74,106,18,52,42,39,28,19,55,32,11,29,80,74,100,64,4,35,70,47,39,54,6,29,46,12,3,90,19,86,3,87,40,137,32,46,30,29,33,10,19,19,21,45,98,28,11,13,0,28,24,0,33,32,17,15,39,46,52,39,53,4,37,28,15,69,6,9,25,20,79,40,40,56,24,13,18,30,63,74,23,51,29,38,57,23,11,11,107,25,59,6,16,47,90,16,13,3,24,10,23,22,7,10,33,41,42,28,28,50,67,42,24,41,25,5,28,4,51,102,44,31,12,14,61,6,14,2,82,60,35,1,27,28,13,12,17,50,39,32,51,10,35,0,27,63,17,24,3,12,17,15,3,50,55,29,8,19,19,63,1,31,14,34,11,14,4,16,5,23,71,13,24,4,53,7,7,86,3,16,19,0,83,0,18,40,1,30,61,20,10,29,66,19,63,6,1,41,33,2,2,41,37,13,16,6,28,106,59,17,26,0,0,12,60,29,27,33,3,5,36,47,72,25,31,28,16,21,13,38,45,11,10,24,8,7,29,13,21,7,4,21,12,25,38,8,18,43,21,6,26,10,32,5,35,27,8,3,10,18,58,56,5,5,31,8,24,66,19,34,0,1,10,0,77,8,0,27,52,5,45,22,11,12,18,5,19,5,23,2,30,10,7,5,51,0,2,24,72,0,1,12,5,3,5,22,8,12,2,112,44,5,14,3,7,0,3,11,21,25,25,35,53,28,22,35,8,3,26,0,32,9,21,31,24,7,28,2,31,13,15,57,18,35,27,24,63,17,7,63,9,9,31,8,9,48,4,12,12,11,3,75,3,13,14,100,125,2,26,8,7,5,27,36,4,0,3,17,24,10,59,26,29,31,22,56,13,11,7,6,15,22,18,16,15,29,23,7,2,54,29,44,18,13,32,14,19,49,13,4,3,19,16,35,12,159,7,11,21,14,19,36,11,18,52,4,3,18,5,12,69,42,7,2,10,0,45,49,10,2,16,13,3,20,7,3,22,13,16,0,25,29,11,100,23,17,1,2,4,6,12,12,10,1,19,5,12,6,14,21,1,2,14,20,8,6,5,16,7,23,87,94,1,3,20,14,4,15,8,21,33,31,31,8,8,22,11,4,39,4,17,5,6,0,6,8,7,4,17,0,12,19,0,4,18,6,3,9,19,9,31,7,58,15,5,2,6,1,16,44,13,7,0,15,12,27,5,5,35,0,18,17,6,17,32,49,29,27,3,22,12,9,22,7,22,3,13,6,8,19,6,6,5,10,22,24,21,13,2,21,41,79,21,3,30,15,0,1,0,19,12,16,5,12,17,29,12,4,1,5,20,53,0,8,14,33,4,11,1,29,28,22,4,21,48,13,43,7,39,22,38,14,36,9,37,26,10,8,3,2,22,2,16,103,14,0,11,2,4,16,16,41,24,9,3,16,1,8,19,32,4,8,31,5,30,0,3,9,11,4,29,6,1,5,16,1,9,17,4,10,38,1,12,12,0,15,0,37,0,3,11,1,0,26,9,9,12,5,7,7,8,1,0,8,13,41,16,12,6,1,9,3,3,16,10,4,9,9,17,25,5,12,5,12,5,35,20,5,10,1,23,3,5,3,40,26,14,1,64,6,0,20,20,25,9,46,2,0,13,12,10,19,26,92,0,2,5,12,13,30,13,30,0,22,19,15,5,41,8,10,11,45,15,22,0,15,0,15,1,3,13,24,6,10,10,32,5,12,17,16,6,14,39,15,4,5,14,1,4,789,1,5,15,5,8,9,20,16,9,22,12,15,7,7,1,2,45,37,1,6,1,5,10,48,10,13,11,4,15,8,7,4,10,10,7,10,6,9,29,15,7,1,1,10,19,14,7,14,3,2,10,10,0,6,7,0,21,11,4,10,9,16,10,15,0,1,8,2,11,21,6,0,4,1,0,31,1,0,8,2,6,23,3,4,5,11,0,20,13,9,7,1,13,7,14,0,2,55,5,23,0,0,4,3,5,5,3,16,0,7,9,37,5,6,15,26,35,2,2,4,0,6,3,14,10,16,10,10,4,12,13,0,29,19,24,4,18,6,11,18,5,0,5,2,5,6,0,31,14,0,2,6,20,11,10,2,6,26,0,0,5,11,4,0,7,3,7,14,25,9,24,11,17,11,3,0,6,12,50,7,27,9,1,0,2,4,3,6,15,20,16,14,3,3,9,5,80,5,17,2,23,1,0,11,19,8,2,21,0,10,1,20,4,3,10,2,7,7,11,13,6,31,2,18,11,5,3,9,0,1,25,6,9,36,24,3,3,13,1,0,9,6,9,13,5,21,4,20,0,8,12,22,13,0,12,10,2,10,6,13,0,0,8,0,39,0,0,21,1,7,7,2,2,26,6,11,1,14,9,9,6,16,0,2,20,0,0,0,10,0,2,5,0,31,6,22,4,18,17,0,2,0,10,13,2,7,8,10,24,10,10,14,4,1,12,2,6,0,0,19,7,16,3,2,29,4,11,1,14,1,1,21,19,8,5,11,20,2,14,9,0,10,10,8,3,25,12,13,0,1,6,3,2,13,60,9,30,4,3,0,3,5,54,2,10,39,15,10,6,5,12,2,0,7,0,4,18,21,2,2,17,0,0,7,27,9,0,31,0,0,5,0,4,30,6,9,9,21,1,16,4,12,1,1,22,4,2,11,5,21,9,22,15,18,2,8,2,36,5,15,2,25,5,2,7,1,0,34,3,2,13,7,0,7,8,13,1,3,13,1,6,29,1,7,6,7,23,2,12,10,6,1,0,8,3,11,10,10,0,12,4,6,4,18,6,4,4,24,5,11,1,1,6,0,1,0,6,1,5,15,5,7,1,13,8,0,2,0,14,9,8,32,3,9,2,8,9,4,0,1,6,0,5,0,8,5,4,1,1,16,16,10,7,3,3,4,10,9,44,10,3,6,2,6,2,21,8,11,8,0,5,1,4,7,17,4,3,0,6,6,31,11,1,12,2,0,4,3,19,1,2,3,0,1,11,60,1,17,9,7,0,19,19,0,1,6,6,4,1,4,2,11,3,5,1,11,0,4,16,0,5,4,10,10,6,16,12,1,8,5,11,8,38,18,2,9,3,2,44,5,3,14,7,0,1,12,11,16,7,10,1,2,0,2,1,7,13,7,1,10,6,6,4,33,11,3,6,4,2,0,6,1,12,2,0,9,9,7,16,2,7,0,1,2,6,5,8,10,2,7,0,9,3,1,0,6,3,5,17,14,27,5,2,5,14,26,8,28,15,3,2,9,1,7,11,3,0,7,15,22,0,2,13,5,10,2,1,8,17,5,6,3,7,10,5,4,13,7,3,14,20,0,0,9,4,5,6,0,0,14,3,0,12,0,0,0,3,5,21,1,5,10,14,0,6,22,5,2,8,14,0,3,2,18,7,8,4,4,1,23,4,1,2,14,7,0,0,7,1,2,16,1,2,2,0,7,5,1,8,1,15,2,14,5,5,0,9,1,22,1,2,6,15,3,6,2,3,1,131,9,21,25,5,1,10,0,3,2,1,0,9,5,4,1,5,0,1,4,0,8,4,1,5,0,3,9,0,0,12,8,1,3,6,5,11,16,18,0,6,5,0,6,19,0,6,3,5,0,17,0,4,10,1,8,5,3,20,10,3,4,2,0,1,9,13,7,3,4,5,2,3,3,3,7,8,1,3,9,0,7,14,0,7,8,4,6,4,2,12,0,6,3,5,11,8,8,9,4,1,5,11,16,0,12,2,2,17,2,2,4,4,7,4,4,10,5,3,8,3,3,11,10,2,4,1,5,1,5,5,2,0,2,3,10,0,2,0,16,2,0,5,4,11,2,6,9,9,11,0,2,1,20,15,8,8,6,5,3,5,2,6,4,0,10,12,13,3,2,6,21,4,4,4,6,2,5,0,4,5,0,3,21,0,1,1,34,19,1,10,1,11,1,1,10,18,11,1,38,0,1,7,1,3,3,8,17,0,8,25,14,4,0,0,19,4,4,3,6,8,1,5,4,3,0,0,1,0,6,2,0,0,17,13,30,3,2,3,3,2,0,8,16,2,3,18,6,3,11,2,17,4,11,4,2,9,0,14,0,0,8,0,6,2,1,4,0,0,2,3,6,9,3,4,1,8,17,20,11,1,19,0,0,1,1,5,4,1,0,4,2,3,3,4,7,3,5,7,4,6,5,12,8,2,15,7,0,35,1,11,10,9,0,1,9,4,12,3,7,3,8,0,21,2,22,0,3,2,4,1,3,5,19,15,17,9,6,6,3,7,1,3,2,0,1,0,9,0,4,30,7,3,3,3,2,3,17,0,0,2,5,4,16,6,3,7,1,7,0,3,11,6,9,2,19,1,4,0,42,11,0,7,2,9,10,3,1,8,3,9,9,5,4,9,5,10,3,2,6,4,8,4,2,6,11,3,0,1,12,1,9,3,2,14,1,7,4,7,7,0,3,4,1,6,1,0,9,0,0,0,2,2,6,3,15,6,4,2,19,4,9,6,5,3,0,1,26,6,0,4,4,2,3,4,1,1,10,7,1,1,3,17,9,1,6,1,7,5,17,2,16,10,17,0,3,3,6,4,7,5,0,0,8,6,6,9,3,5,3,29,5,0,2,1,3,10,6,4,3,7,11,0,3,7,0,1,7,0,7,0,2,7,3,6,2,2,6,1,8,19,6,6,3,4,0,1,11,9,6,4,8,0,0,2,8,1,23,5,2,0,3,2,3,0,6,2,0,0,12,1,4,0,0,0,1,1,5,3,38,3,0,4,11,1,7,4,2,0,7,5,1,4,2,1,8,0,0,27,2,3,6,0,0,3,15,16,4,3,2,2,1,2,0,0,2,6,11,0,1,6,0,4,1,10,5,2,5,1,1,2,2,16,0,0,6,6,6,3,3,1,0,18,1,2,1,24,2,8,1,5,6,15,4,25,0,8,6,2,21,2,9,8,4,4,2,39,0,0,5,10,1,2,1,6,4,0,3,8,0,0,4,7,1,4,0,4,7,3,2,1,5,3,6,2,13,1,10,0,0,1,0,0,8,1,1,4,4,7,3,1,0,12,1,6,1,6,0,7,2,0,8,3,3,1,2,2,23,6,2,2,4,2,0,8,1,1,0,0,2,13,3,14,4,4,12,2,3,16,4,10,4,3,3,4,1,1,1,2,0,7,8,3,0,9,10,1,3,39,0,2,20,0,1,0,5,0,0,17,1,31,2,16,8,0,1,0,7,9,7,1,3,0,19,1,8,1,54,1,1,0,4,0,1,1,3,1,4,13,2,1,2,1,0,0,2,2,82,0,4,3,2,0,10,5,4,6,2,1,7,9,0,2,3,0,25,21,7,13,1,6,7,3,1,4,7,2,15,9,10,1,5,1,2,1,0,2,1,0,0,15,14,3,15,1,1,6,5,2,8,11,15,0,3,7,0,0,0,0,2,9,1,4,2,0,14,14,3,10,5,7,0,3,5,4,2,1,2,0,0,7,8,0,13,4,2,1,4,14,11,5,2,0,12,1,5,0,5,8,1,0,18,3,3,0,4,4,1,10,28,3,0,0,1,6,3,10,7,9,1,8,0,0,8,2,1,1,1,1,8,5,4,1,2,7,2,4,2,3,7,0,0,8,1,2,10,0,6,1,3,1,0,8,0,0,8,1,0,0,0,17,1,3,10,4,0,9,4,2,2,1,0,2,0,8,1,3,11,3,2,0,1,3,5,0,4,2,2,2,1,11,4,0,6,1,10,0,0,1,2,0,0,5,4,6,2,2,2,5,4,0,1,0,0,0,4,1,1,6,1,1,27,2,8,4,5,0,0,4,0,2,0,26,3,2,3,10,0,1,4,5,0,3,1,3,0,17,2,6,6,0,5,4,9,0,1,1,2,10,3,0,2,5,0,4,9,1,3,1,7,0,12,8,1,0,3,10,1,4,1,2,10,1,3,1,6,5,0,1,8,4,1,0,10,0,1,4,2,0,1,2,7,1,1,7,1,4,3,0,0,13,2,7,2,0,1,0,0,8,0,2,1,1,0,1,2,3,7,0,4,5,0,4,8,1,0,0,1,0,0,5,1,1,1,4,1,13,1,6,1,5,5,4,1,10,2,1,0,1,6,2,1,3,2,1,4,18,0,10,0,3,4,3,2,5,11,0,2,0,2,5,2,2,2,4,26,10,6,7,1,2,3,5,0,1,0,3,2,1,5,1,3,9,0,10,4,4,7,2,37,4,1,10,6,2,2,1,10,1,0,3,0,12,3,10,5,11,4,1,0,5,0,0,1,12,4,2,0,0,2,0,6,8,10,5,0,6,1,5,0,10,6,3,5,1,0,1,6,5,2,4,4,15,0,5,1,0,0,1,3,2,12,4,1,1,1,14,1,11,0,3,0,0,4,4,0,1,4,0,1,5,1,11,5,0,2,2,12,3,13,0,4,2,2,6,3,16,1,0,1,6,3,1,4,2,0,1,3,3,3,0,2,4,4,0,4,0,4,0,1,8,0,5,3,1,1,13,2,1,2,10,2,7,7,5,3,2,1,0,1,0,0,4,10,10,2,0,0,2,0,0,1,3,4,25,3,1,1,5,4,3,1,3,4,0,1,5,6,2,1,5,5,2,0,4,1,9,2,5,7,3,6,1,1,7,0,2,2,1,6,1,2,6,4,2,1,3,4,0,6,1,11,6,0,1,2,2,0,10,1,9,0,2,3,1,4,0,4,6,4,3,2,0,1,0,0,1,5,1,1,1,1,2,1,1,0,2,9,3,8,2,7,1,0,0,8,0,0,5,15,0,1,4,10,4,2,12,1,2,3,0,4,1,4,1,3,0,3,4,0,4,0,4,0,0,1,2,6,5,4,0,15,7,3,6,3,3,1,5,5,0,7,8,0,0,1,6,7,2,3,4,5,4,0,1,0,1,3,1,3,0,0,0,1,3,1,3,1,0,2,2,33,1,4,0,2,0,0,3,7,7,2,34,0,2,0,1,0,1,11,0,0,0,0,7,2,2,7,1,14,0,1,1,2,0,3,37,0,0,2,0,5,2,3,0,4,0,8,7,6,2,1,0,1,3,0,0,9,1,4,1,6,0,6,2,1,1,6,3,1,0,6,4,4,4,0,8,5,0,0,3,2,2,2,0,1,0,1,5,2,3,0,2,4,3,0,3,1,7,0,0,1,4,0,1,15,2,1,3,0,2,1,0,0,0,0,2,0,8,3,3,2,2,0,0,5,3,12,0,1,0,0,1,4,0,1,0,4,2,0,1,1,4,12,6,5,1,10,0,6,9,2,0,1,3,1,4,2,0,6,0,12,3,1,0,0,0,4,2,3,7,2,7,8,2,1,3,3,2,1,0,0,19,0,1,2,5,1,0,14,0,4,0,0,6,4,9,0,1,0,1,0,42,1,0,0,0,0,6,2,1,1,6,4,3,2,2,1,3,12,5,0,3,6,8,6,8,2,17,3,2,0,4,0,6,10,4,0,0,2,0,2,4,3,0,4,7,0,2,7,2,2,11,11,5,9,1,1,0,0,4,1,7,0,1,1,7,3,3,0,0,0,2,1,5,4,3,14,1,0,1,0,12,3,0,2,2,1,2,4,2,2,4,0,0,0,3,2,3,0,1,1,0,2,11,1,3,3,0,2,3,8,0,6,1,1,7,3,2,1,3,0,0,16,2,0,0,0,0,1,24,1,4,0,3,2,0,10,0,3,0,0,18,2,0,9,3,5,5,0,0,3,5,15,0,2,3,2,1,2,3,4,0,0,1,0,0,3,0,15,4,11,0,0,2,4,1,1,2,0,173,1,3,2,4,5,4,0,1,1,2,1,5,1,0,0,1,0,2,5,1,0,2,1,0,2,1,7,0,2,0,5,7,2,3,3,5,3,2,1,1,1,3,2,0,8,12,4,1,3,1,1,4,2,2,3,0,1,0,1,0,1,8,0,0,0,6,7,4,6,1,1,0,1,4,1,3,0,1,2,2,0,2,2,22,15,9,1,4,4,3,6,1,4,16,1,3,0,0,2,3,0,2,4,0,0,0,23,3,1,9,7,5,0,1,2,2,0,4,0,1,2,6,5,5,0,0,1,0,0,1,1,4,1,0,13,0,4,0,2,38,13,2,0,0,0,1,1,2,12,9,1,2,4,3,2,1,4,0,0,23,0,1,3,4,7,27,2,3,3,0,0,9,1,5,0,0,2,0,6,1,0,4,0,14,5,1,0,0,5,0,0,0,0,3,2,5,0,0,8,13,5,1,4,1,6,7,7,0,3,0,0,4,4,7,8,0,3,2,4,0,8,1,1,0,3,3,1,3,4,0,1,4,5,0,0,0,2,0,2,1,3,0,8,1,2,1,3,3,0,1,1,0,0,22,0,6,4,0,0,1,0,0,2,1,2,0,2,2,3,1,1,7,1,2,6,2,6,0,0,7,0,5,1,5,0,1,7,2,1,4,0,3,0,10,2,0,4,0,8,7,6,4,0,7,2,2,4,1,0,0,1,0,6,1,3,8,6,4,0,1,0,0,12,2,0,120,3,0,0,2,0,1,9,3,3,1,2,4,0,1,1,3,6,1,16,1,0,3,3,10,0,1,0,1,6,2,0,2,2,1,4,3,3,0,0,0,0,1,4,1,7,0,0,0,1,0,2,2,0,6,2,2,0,0,1,0,2,1,1,8,5,1,0,1,4,2,5,3,8,2,3,0,0,3,2,2,4,2,2,3,3,1,0,2,4,2,0,4,6,1,1,0,0,1,2,0,1,0,8,0,8,3,3,1,0,6,3,0,3,2,0,0,3,1,0,0,1,4,0,2,2,0,0,5,0,3,0,5,2,9,8,0,3,0,1,4,5,10,3,0,3,3,5,5,7,1,3,1,2,3,3,4,1,1,0,4,1,2,3,1,3,0,0,0,112,0,6,3,1,0,0,0,2,0,3,3,8,0,18,0,22,4,12,1,1,0,3,0,2,0,8,3,7,4,1,1,6,0,3,16,19,5,0,3,4,0,2,0,10,0,1,2,2,0,2,0,8,2,6,3,10,11,5,2,3,0,5,0,0,0,9,1,18,2,0,1,3,6,2,4,2,4,12,5,0,2,1,0,0,1,6,0,0,5,2,0,0,0,5,0,6,1,5,3,0,5,35,1,1,5,5,0,2,5,3,4,0,2,0,0,5,5,1,1,0,0,5,0,0,4,7,3,0,0,3,0,10,7,0,3,3,6,7,1,4,1,1,0,0,1,5,2,0,2,0,4,3,13,0,2,8,3,2,5,6,1,2,7,2,4,0,5,0,4,4,1,4,0,2,9,1,0,1,1,0,2,0,3,0,2,0,1,7,0,7,2,0,4,0,1,0,23,0,0,0,3,0,2,2,4,2,4,0,0,1,0,2,0,0,1,0,12,1,2,3,91,1,0,1,0,1,0,0,4,0,1,0,2,5,5,0,2,1,0,2,6,0,1,13,1,1,1,4,0,2,0,5,4,0,0,1,3,1,1,0,0,0,7,8,2,6,12,3,2,0,0,7,3,2,3,0,0,4,4,4,4,2,3,2,2,1,3,4,0,0,1,0,5,7,0,1,0,0,0,1,1,0,0,0,6,0,2,0,1,0,2,6,17,4,4,11,7,0,2,0,6,1,2,0,0,1,0,13,2,0,3,0,0,1,6,2,10,3,2,0,0,9,4,2,10,0,0,1,0,1,8,0,1,4,9,4,7,1,0,5,1,6,0,4,0,1,1,7,4,3,0,0,1,3,5,4,3,11,0,1,9,0,5,0,0,0,13,3,1,0,0,0,0,3,1,3,0,1,1,1,1,2,4,0,1,0,3,1,0,0,6,5,1,3,0,4,2,20,1,9,4,10,5,3,0,3,3,0,14,2,1,1,1,0,1,0,2,2,0,0,1,1,0,4,5,2,0,0,2,4,3,0,0,1,2,0,0,19,0,3,1,1,0,6,17,2,15,1,2,0,4,1,2,5,10,4,0,0,1,2,2,1,1,3,2,2,10,1,1,2,2,0,0,1,1,7,1,7,0,4,0,0,1,1,6,2,4,0,0,0,0,2,14,4,12,6,2,3,6,2,1,1,11,0,5,3,1,0,3,1,7,6,2,3,1,1,1,3,0,1,5,1,0,0,2,3,3,0,1,0,10,0,8,1,8,0,2,0,5,2,0,0,5,2,6,1,1,2,1,1,0,6,4,0,5,3,0,7,0,2,0,0,3,0,5,5,4,2,0,0,0,4,0,0,2,7,5,4,46,0,7,2,1,3,5,0,3,0,0,2,0,0,4,1,0,1,0,0,0,1,5,0,0,2,9,0,1,0,5,6,31,4,2,0,5,3,1,16,2,0,0,0,0,0,0,1,0,0,0,1,0,0,0,10,0,3,0,0,0,5,0,0,0,0,1,0,0,0,0,1,0,1,0,0,0,0,0,0,2,0,0,0,0,0,3,1,0,0,0,0,0,0,0,0,0,0,0,0,0,0,0
"2017 Tuck, Lily, Sisters",high,643,484,334,348,270,533,169,219,226,106,97,151,108,174,171,105,143,92,103,98,88,58,66,52,181,84,90,44,43,92,47,48,54,35,25,74,49,34,84,46,31,49,25,25,56,38,46,28,29,28,19,28,26,22,43,26,17,15,25,14,17,19,36,8,34,28,22,15,33,57,19,8,38,11,22,17,25,14,12,4,14,9,8,12,18,13,16,16,10,28,19,16,21,4,16,30,12,16,19,18,28,16,11,11,9,18,12,13,8,9,11,16,13,11,24,5,7,16,18,7,40,11,16,3,11,42,3,11,8,14,9,8,1,19,9,10,18,3,18,6,7,6,0,4,10,8,12,5,8,9,10,14,4,11,9,17,11,8,10,2,17,9,2,9,3,2,11,20,5,15,0,14,11,3,1,3,4,4,11,7,7,9,7,4,2,11,6,5,3,6,4,14,6,14,8,5,6,6,7,1,7,2,16,16,9,4,14,8,0,6,19,3,6,3,1,14,5,1,9,4,5,11,12,2,7,4,14,19,0,5,3,8,2,3,8,0,4,5,6,9,1,6,1,2,3,7,9,8,6,2,0,4,5,1,2,5,5,2,7,4,5,13,7,3,30,18,1,14,3,2,6,4,9,8,10,11,4,9,2,4,8,9,2,21,2,3,5,4,6,3,0,3,5,8,4,4,10,3,6,0,3,13,0,4,2,0,5,3,4,0,2,10,11,5,7,1,2,3,2,0,4,4,4,5,0,4,0,4,9,5,6,1,3,2,0,6,5,7,6,1,0,12,3,7,1,1,1,3,8,1,4,3,1,3,0,6,2,0,5,6,2,1,3,4,3,4,3,3,1,1,2,1,1,3,4,2,0,23,5,2,1,1,7,5,0,0,0,2,2,4,13,8,1,2,1,4,6,5,11,0,8,0,1,5,5,2,5,4,4,3,1,2,0,9,1,4,1,3,3,6,13,0,3,4,1,1,1,3,3,1,8,3,0,1,2,1,1,3,0,0,2,3,4,3,6,3,3,1,3,1,1,0,3,0,0,3,2,12,1,1,0,4,0,10,7,7,0,3,94,0,8,2,7,0,2,7,2,3,0,2,2,3,0,0,6,4,0,0,5,1,6,4,2,4,5,2,3,3,1,4,3,0,1,2,1,4,0,0,5,4,3,4,1,0,2,3,0,0,6,1,1,4,7,3,3,2,0,0,0,2,1,0,1,1,5,0,4,5,1,14,3,10,4,2,4,3,0,0,1,2,2,0,8,0,2,5,2,4,11,19,1,0,6,2,3,2,2,2,8,5,25,3,0,0,11,3,1,7,0,10,0,1,0,1,0,1,4,4,1,3,1,6,2,3,0,0,1,0,3,1,0,0,17,1,3,0,1,0,0,1,1,0,1,2,0,1,4,1,4,2,0,1,3,1,1,3,0,1,1,0,1,0,0,0,4,0,2,0,6,3,2,8,4,2,0,4,0,13,0,1,0,0,0,3,0,1,0,2,0,2,0,5,1,0,0,2,0,0,0,1,0,1,0,1,3,0,4,0,1,5,0,1,1,3,2,0,1,0,1,2,0,20,1,2,2,2,2,0,0,4,3,1,0,1,0,2,36,6,2,4,1,1,1,0,2,0,2,0,2,3,0,0,0,0,0,0,6,3,1,2,1,3,1,2,0,0,3,7,0,0,1,0,3,2,0,1,0,0,0,1,0,1,0,1,0,0,3,17,1,3,0,1,2,0,1,8,1,1,1,0,3,1,0,0,0,5,3,0,0,10,1,2,0,0,0,2,0,1,3,0,3,4,0,0,0,1,0,0,0,0,1,6,0,3,0,9,4,4,1,0,1,1,3,1,8,1,0,0,0,1,5,4,0,0,2,2,0,0,1,1,8,0,1,1,0,0,2,1,0,1,0,1,1,3,0,1,4,0,2,2,1,0,0,0,1,11,0,0,2,2,1,3,2,1,1,1,4,0,0,1,0,5,3,3,0,0,0,5,1,0,0,5,1,0,0,0,0,0,0,4,1,0,8,0,4,0,1,0,1,5,1,1,1,11,1,0,0,0,0,1,2,0,1,0,1,3,0,3,0,0,7,5,0,0,2,1,3,1,1,0,3,4,0,0,3,0,1,2,7,0,3,0,0,4,0,6,1,0,1,1,1,4,4,3,14,0,0,0,2,0,0,0,1,0,2,2,5,0,0,2,3,0,2,1,1,0,9,9,0,1,0,0,2,0,0,0,1,0,0,2,1,0,2,0,6,1,7,0,0,0,0,0,2,0,1,2,0,0,0,0,1,0,0,0,1,4,1,0,3,1,0,0,0,0,0,3,2,1,0,0,1,1,0,4,0,1,0,1,1,1,0,0,1,1,2,1,0,0,2,1,4,0,1,1,0,0,1,1,0,2,2,0,0,1,0,0,4,2,0,0,1,0,0,0,1,0,1,0,2,1,0,1,0,4,2,0,5,1,0,2,5,0,1,0,0,1,0,0,0,0,0,1,0,1,1,1,1,1,0,2,2,0,0,2,0,1,0,0,0,2,0,4,0,1,0,1,0,0,0,1,0,2,0,0,0,0,0,1,4,0,0,0,1,0,0,3,0,1,2,1,0,0,1,4,3,0,0,0,1,0,8,1,11,0,0,1,3,1,0,0,0,0,0,2,1,3,0,4,1,0,3,1,0,0,0,0,0,2,2,0,2,0,0,0,0,1,1,1,0,0,0,0,2,0,1,0,0,1,0,5,0,0,0,0,2,0,0,0,0,0,2,2,0,1,1,0,0,1,6,0,0,1,0,1,2,0,0,0,0,0,0,1,1,0,2,0,1,1,1,1,0,4,0,1,1,0,2,2,0,0,0,0,1,0,0,0,0,0,0,3,0,0,0,0,0,1,2,2,0,4,0,2,1,0,4,1,0,1,0,0,0,2,1,0,2,2,2,2,0,0,1,0,0,3,3,1,4,2,0,2,8,0,2,2,1,1,0,1,1,0,1,0,2,0,0,4,1,1,4,0,0,0,2,0,4,0,1,0,2,1,1,4,1,0,3,0,1,1,0,3,0,0,2,0,3,1,1,2,0,2,3,2,2,0,0,1,0,1,0,1,0,2,0,1,2,0,0,0,0,0,0,0,2,0,0,0,0,0,0,0,0,0,2,0,0,0,1,0,0,2,0,0,0,3,0,3,0,0,5,0,0,0,1,1,0,4,0,0,3,0,1,4,2,0,1,0,0,4,0,1,1,3,0,0,0,3,0,1,0,0,0,0,0,0,0,1,0,0,0,0,0,1,0,1,0,0,0,0,1,0,0,0,0,0,2,0,0,0,2,0,0,0,0,1,0,0,0,4,4,0,0,0,0,1,0,0,0,0,14,0,1,0,2,0,0,0,0,0,0,0,0,0,2,0,0,0,0,0,3,0,1,0,1,1,1,1,0,0,1,0,0,0,0,1,0,0,1,2,0,1,0,0,0,3,1,0,1,7,3,5,1,1,0,2,0,0,1,0,0,3,0,0,1,0,3,5,0,2,0,0,3,0,0,3,5,0,0,0,0,1,0,0,1,0,0,1,2,0,2,0,4,0,3,0,0,1,1,1,0,1,0,0,1,0,0,0,0,0,3,0,0,0,0,3,0,0,0,5,0,1,2,1,7,3,2,0,0,0,0,0,0,0,2,0,0,1,1,4,0,0,3,0,0,1,0,0,2,4,3,1,0,3,0,1,0,0,7,0,0,5,0,3,0,0,0,1,4,0,1,0,1,0,1,0,1,0,0,0,0,0,0,2,0,0,0,0,1,0,0,7,0,1,1,0,0,0,0,0,1,0,0,0,0,3,0,1,1,0,0,2,0,0,0,1,0,0,0,0,0,1,2,0,0,0,3,0,0,0,0,1,0,0,0,1,0,0,1,1,0,0,1,0,0,0,2,2,0,2,0,0,0,1,0,1,0,0,0,3,0,2,0,0,2,0,1,0,0,1,2,0,1,1,0,1,1,1,2,0,1,0,1,0,2,0,0,2,3,0,0,0,1,2,2,1,0,2,1,0,0,2,0,0,0,2,0,0,0,0,0,2,0,9,1,1,3,0,1,1,2,0,1,0,0,0,0,0,0,0,1,0,1,0,0,0,0,0,0,1,0,0,0,0,0,4,1,0,0,0,0,0,0,0,0,0,0,0,0,2,0,0,2,0,0,0,1,2,0,0,1,0,1,4,0,0,0,0,0,0,1,1,0,0,0,0,0,1,0,0,1,0,0,0,2,0,0,0,3,3,2,0,0,0,0,1,0,4,0,0,4,2,0,0,2,0,0,0,2,0,0,0,0,2,0,0,0,0,0,1,0,0,1,0,0,0,1,1,0,0,1,0,0,0,0,0,0,0,1,0,0,0,0,0,0,0,0,1,1,0,1,1,0,0,5,0,0,3,0,3,1,0,1,0,0,0,0,0,1,2,0,0,1,1,0,0,3,1,0,1,2,3,0,2,1,0,0,2,0,0,0,1,0,0,1,0,1,1,3,0,0,0,3,0,1,0,2,1,0,0,0,4,0,0,2,0,0,0,0,0,1,2,0,0,1,0,0,0,0,1,1,0,0,2,2,1,0,0,0,0,0,2,0,1,0,0,0,1,0,1,0,1,0,0,0,0,2,0,0,0,0,0,0,0,0,2,0,0,0,1,0,3,0,1,2,0,0,0,0,0,13,0,0,0,0,1,1,0,0,0,0,2,0,2,2,0,1,0,0,0,0,0,0,0,0,2,0,0,0,0,0,0,1,0,0,0,2,2,0,2,0,0,0,0,1,0,0,0,0,2,2,0,0,0,0,0,0,0,0,1,0,1,2,0,0,0,0,0,0,1,0,5,0,0,1,0,1,0,0,0,0,1,0,0,1,0,0,0,1,2,2,1,0,1,0,0,0,0,0,0,1,0,0,0,0,0,0,0,0,0,0,0,0,0,0,1,0,0,0,0,1,0,2,0,1,0,1,0,0,6,0,1,0,0,1,0,0,0,1,0,3,1,0,1,0,0,3,0,0,0,1,0,0,0,0,0,0,0,0,0,0,0,0,1,0,0,0,0,0,0,1,1,0,0,2,0,0,0,1,0,0,1,1,0,0,1,2,0,0,2,0,2,0,0,0,0,0,1,1,2,0,1,0,0,0,0,0,0,0,2,0,1,0,6,1,0,0,0,1,2,0,1,0,3,0,0,0,0,2,0,0,2,1,0,0,0,1,0,1,1,0,0,3,0,0,0,0,0,1,0,1,1,1,0,0,0,0,0,0,0,0,8,1,0,2,0,0,1,0,0,4,0,0,1,0,0,0,2,0,0,2,0,0,0,0,3,0,1,0,1,0,0,0,1,0,7,5,0,0,0,0,0,0,0,0,0,0,0,0,0,0,1,0,6,1,0,1,0,1,2,2,0,1,0,0,0,0,2,0,0,0,0,1,0,1,0,0,0,14,1,0,0,0,0,3,2,0,0,0,0,1,1,0,0,0,0,0,0,0,0,1,2,0,0,0,0,4,0,0,0,0,0,1,0,0,0,0,0,0,0,1,1,0,0,3,0,0,0,0,0,0,0,0,1,0,0,0,1,0,0,1,0,0,0,0,0,0,0,0,0,0,0,0,0,0,0,1,0,0,0,0,0,0,0,2,1,0,0,0,0,0,0,0,0,0,1,0,0,1,0,0,1,0,0,0,0,0,0,2,3,0,1,0,1,1,0,0,2,3,0,0,3,0,0,0,0,1,1,0,0,1,0,0,0,0,1,0,0,0,0,0,0,0,2,1,0,0,0,1,0,0,1,2,0,0,0,0,0,0,0,0,0,0,0,0,0,1,1,1,0,0,0,0,0,0,0,0,0,2,0,1,0,0,0,0,2,0,1,0,0,2,0,0,0,0,0,0,0,1,0,1,0,0,0,0,0,0,0,3,0,0,0,0,1,0,1,0,0,0,1,0,0,0,0,0,0,2,0,1,0,0,0,0,0,1,0,0,0,0,1,5,0,1,0,0,0,1,0,0,1,0,0,1,2,0,0,0,0,0,0,1,0,0,0,0,0,0,0,0,0,0,0,1,0,2,0,0,0,0,0,0,2,0,5,0,0,2,0,0,1,1,0,1,0,0,0,0,0,0,0,0,1,1,0,0,0,0,1,0,5,0,0,6,0,0,0,0,0,0,0,0,3,0,0,0,1,0,0,0,0,1,0,0,0,0,2,0,0,0,0,4,0,0,0,0,1,3,0,1,0,1,0,1,0,0,0,1,0,1,0,0,4,1,0,0,0,0,0,0,0,0,0,0,0,0,3,2,0,0,0,1,0,4,0,0,0,0,0,0,0,0,0,0,0,0,0,0,0,0,0,0,0,0,0,0,0,1,0,0,2,0,0,1,1,1,0,0,0,1,0,4,0,0,0,0,1,0,0,3,0,0,0,0,1,1,1,0,0,0,0,0,0,0,0,0,0,0,0,0,0,0,0,0,0,0,0,5,1,2,0,0,0,0,2,0,0,1,0,0,0,0,0,1,1,0,1,3,1,0,0,0,0,1,0,0,0,0,0,0,0,1,0,0,0,0,0,1,0,1,0,0,0,0,0,0,0,0,0,0,0,4,3,0,0,0,2,2,0,0,0,1,0,0,0,1,0,0,0,0,0,1,0,1,0,1,0,0,0,0,0,0,0,0,0,1,0,0,1,0,2,0,0,0,1,0,0,0,1,1,4,0,0,0,0,0,4,1,0,0,0,0,0,0,0,0,0,2,0,0,1,0,1,0,0,0,0,0,1,0,0,1,0,0,0,1,0,0,0,0,0,0,4,0,0,1,0,0,1,2,0,0,0,0,0,0,0,0,1,0,0,1,0,0,0,0,0,0,1,0,0,0,0,0,1,0,1,0,0,0,0,0,0,0,0,0,0,0,0,0,0,2,0,1,0,0,1,0,0,0,0,1,0,0,0,0,5,1,0,0,0,0,8,0,0,0,0,0,0,0,0,0,3,0,0,1,0,0,0,0,1,0,0,0,0,0,0,0,0,0,2,0,0,0,0,0,0,0,0,0,0,0,0,0,0,0,0,0,0,0,1,0,0,0,1,0,0,0,1,0,0,0,2,0,0,1,0,1,0,0,0,0,0,0,0,0,3,0,2,3,0,1,0,0,0,0,0,0,0,0,0,3,0,0,0,0,0,0,0,0,0,3,0,1,4,0,0,0,0,1,0,0,0,0,0,0,4,0,0,2,0,0,0,0,0,2,0,0,0,1,0,0,0,0,0,0,1,0,0,0,0,0,1,0,0,0,2,0,1,0,0,1,0,0,0,0,0,0,0,7,0,0,0,0,0,0,0,0,0,1,0,0,0,0,0,0,1,0,0,1,0,0,0,0,0,0,9,0,0,0,1,2,0,0,0,0,0,1,0,0,0,0,0,0,0,0,0,0,0,1,0,0,0,1,0,1,0,1,0,0,0,1,0,0,2,0,0,5,2,0,0,0,0,0,1,1,0,0,0,0,0,0,0,1,0,0,0,0,0,0,0,0,0,0,9,0,0,0,1,1,0,0,0,0,0,0,0,0,0,0,0,0,2,0,0,0,0,1,0,0,0,0,0,0,0,0,0,0,0,7,0,0,0,1,0,0,0,0,0,0,0,0,0,2,1,0,1,0,0,1,0,0,0,0,1,0,1,0,0,1,0,0,0,0,0,0,4,0,0,0,0,0,0,0,0,0,0,0,0,0,0,0,0,1,0,3,0,1,1,0,0,0,0,0,0,2,0,0,0,0,0,0,0,0,0,0,0,0,0,0,0,0,0,3,0,0,0,0,0,0,0,0,0,0,0,2,0,0,0,0,1,0,1,0,0,0,0,0,0,0,1,0,0,0,0,0,4,1,0,0,0,0,0,0,0,0,0,1,1,0,0,0,0,2,0,0,0,1,0,0,0,0,0,0,0,0,1,0,1,0,0,0,1,0,0,0,2,0,1,0,0,0,0,0,0,0,0,1,0,0,0,0,1,2,0,1,0,0,0,1,0,0,0,0,0,0,0,0,0,0,1,0,0,3,0,0,0,1,0,2,0,0,1,0,0,0,0,1,0,0,0,1,0,0,0,0,2,2,0,0,0,0,1,0,0,1,2,0,0,0,0,0,0,0,0,0,2,0,0,0,0,0,2,0,2,0,3,0,0,2,0,0,0,0,0,0,0,0,0,0,1,1,0,0,0,0,3,0,0,0,0,0,0,0,0,0,0,2,0,0,1,0,0,0,0,0,3,1,0,0,2,0,0,1,0,0,0,0,1,0,0,0,1,0,0,0,0,0,0,0,0,0,0,0,0,0,0,0,0,0,0,0,0,0,1,0,1,0,0,0,0,0,0,0,0,0,0,0,0,0,0,0,0,0,0,0,0,0,0,0,1,0,0,0,3,0,0,0,0,0,0,0,0,2,0,0,0,0,0,1,0,0,1,0,0,0,0,1,0,0,0,0,0,0,0,0,0,0,0,0,0,0,0,1,0,0,0,0,0,0,0,0,0,0,0,0,0,0,1,0,0,0,0,0,0,1,0,2,0,0,0,0,0,1,0,0,0,1,0,0,0,0,0,0,0,0,3,0,1,1,0,1,0,0,0,0,0,0,0,0,0,3,0,0,0,0,0,0,0,0,0,1,0,1,1,1,0,0,0,1,0,0,0,0,0,3,0,0,0,0,0,1,0,0,0,0,0,0,0,0,0,0,0,0,0,0,1,2,0,0,0,0,3,0,1,0,0,0,0,0,0,0,2,0,0,2,0,0,2,0,1,0,0,0,0,0,0,0,1,0,0,0,0,1,0,0,0,0,1,0,0,0,0,0,0,0,1,0,0,0,1,0,0,0,0,0,1,0,0,0,0,1,0,0,0,3,0,0,0,0,0,0,1,1,2,0,0,0,0,0,0,0,3,0,2,0,0,0,0,0,1,0,0,0,0,1,0,0,0,2,0,0,0,0,0,0,0,0,0,0,0,0,0,0,0,1,0,0,0,0,0,0,3,0,0,0,0,0,0,0,0,0,0,0,0,0,0,3,1,0,0,1,0,0,1,0,0,0,0,0,0,1,0,0,0,1,0,0,0,0,0,0,0,0,0,0,0,1,0,0,0,1,0,1,0,0,0,0,0,1,0,0,0,0,0,2,0,0,0,2,0,1,0,0,1,0,1,0,0,0,0,0,0,0,0,0,0,0,1,0,0,0,0,0,0,0,0,0,0,0,0,0,0,0,0,0,0,0,0,0,0,0,0,0,0,0,0,1,0,0,0,0,0,0,0,0,1,0,0,0,0,0,0,0,0,0,0,0,1,0,0,0,0,0,0,1,0,0,0,0,0,0,0,1,0,1,0,0,0,0,0,0,0,0,0,1,0,2,0,0,1,0,0,0,0,0,0,0,0,0,0,0,0,0,0,0,0,0,0,0,0,0,0,0,0,0,0,0,0,0,0,0,0,0,0,0,0,0,0,0,0,0,1,0,0,0,0,0,0,0,1,0,0,0,0,0,0,0,0,0,0,2,0,0,0,0,0,0,1,0,0,0,1,0,0,0,0,0,0,2,0,1,0,0,0,0,0,0,1,0,0,0,0,0,0,0,0,0,0,0,0,0,0,0,0,0,1,1,0,0,0,0,0,1,0,0,0,0,0,0,2,1,0,0,0,0,0,0,1,1,0,0,0,0,0,0,0,0,1,0,1,0,0,0,0,0,0,0,0,0,0,0,0,0,0,0,0,0,1,0,0,0,0,0,0,0,0,0,0,0,0,0,0,0,0,0,0,0,0,0,0,0,0,0,0,0,0,0,0,0,0,0,0,0,0,1,0,0,0,1,0,0,0,1,0,0,0,0,0,0,0,1,0,0,0,0,0,0,0,0,0,0,0,0,0,0,0,0,0,0,0,0,0,0,0,0,0,1,0,0,0,0,0,0,0,0,0,0,0,0,0,0,0,1,0,0,0,0,0,0,0,0,0,0,0,0,0,0,0,0,1,0,0,0,0,0,0,0,0,0,0,0,1,1,0,0,0,0,0,0,0,0,0,0,0,0,0,0,0,0,0,0,1,0,0,0,0,0,0,0,0,0,0,1,0,0,1,0,2,0,0,0,0,0,0,0,0,1,0,0,0,0,0,0,1,0,0,0,2,0,0,0,0,0,0,0,1,0,0,0,0,0,0,0,1,0,0,0,0,0,0,0,0,0,0,0,0,1,0,0,0,0,0,0,1,0,0,0,0,0,0,0,0,1,0,0,0,0,0,0,0,0,0,0,0,0,0,0,0,0,0,0,0,1,0,0,2,0,0,0,0,0,0,1,0,0,0,0,0,0,0,0,0,0,0,0,0,1,0,0,0,0,0,0,0,0,1,0,0,0,0,0,0,0,0,0,1,0,0,0,0,0,0,0,0,0,1,0,0,0,0,0,0,0,0,0,0,0,0,0,1,0,0,0,0,0,0,0,0,0,1,0,0,1,0,0,1,0,0,0,1,0,0,0,0,0,0,0,0,0,0,0,0,0,0,1,0,0,0,0,0,0,0,0,0,0,0,0,0,0,0,0,0,0,0,0,0,0,0,0,0,0,0,0,0,1,0,0,1,0,0,0,0,0,0,0,0,0,0,0,0,0,0,0,0,0,0,0,0,0,0,0,0,0,0,0,0,0,0,0,0,0,0,0,0,0,0,0,0,0,0,0,0,0,0,0,0,0,0,0,0,0,0,0,0,0,0,0,0,0,0,1,1,0,0,0,0,0,0,0,0,0,0,0,0,0,0,0,0,0,0,0,0,0,0,0,0,1,0,0,1,0,1,0,0,0,0,0,0,0,0,0,0,0,0,0,0,0,0,0,0,0,0,0,0,0,0,0,0,0,0,0,0,0,1,0,0,0,0,0,0,0,0,0,0,0,0,0,1,0,0,0,0,0,0,0,0,2,0,0,0,0,2,0,0,0,0,0,0,1,0,0,0,0,0,1,0,0,0,0,0,0,0,1,0,0,0,1,0,0,0,0,0,0,0,0,0,0,0,0,0,0,0,0,0,0,0,0,0,0,0,0,0,1,0,0,0,0,0,0,0,0,0,0,0,2,0,0,0,0,0,0,0,0,0,1,0,0,1,0,0,0,0,0,0,0,0,0,0,0,0,0,0,0,0,0,0,0,0,0,0,0,0,0,0,0,0,0,0,2,0,0,0,0,0,0,0,0,0,0,0,0,0,0,0,0,0,0,0,0,0,0,0,0,0,0,0,0,0,0,0,0,0
"2018 Frazier, Charles, Varina",high,5207,4447,2457,2818,2503,658,972,1498,639,752,690,749,838,986,1015,661,545,748,714,751,655,595,462,298,174,351,211,599,303,246,493,295,219,309,141,252,226,494,225,317,255,345,134,164,297,307,442,326,261,373,281,305,158,194,272,285,215,112,131,176,261,130,139,114,200,201,371,191,87,92,100,111,197,91,67,160,177,122,160,91,104,83,134,111,170,163,115,93,152,125,81,134,120,135,60,204,141,159,90,139,99,163,75,178,72,111,140,52,62,63,60,163,134,73,109,49,107,63,93,161,40,84,102,65,55,61,158,48,61,46,47,103,58,80,103,124,73,72,76,49,138,38,28,71,85,35,86,90,71,76,169,81,40,41,69,39,55,101,109,40,126,42,38,48,50,80,73,45,54,60,33,108,105,85,20,15,82,82,63,37,65,69,75,53,53,57,35,25,66,147,50,135,59,66,100,49,36,31,66,78,42,38,35,29,61,25,60,131,44,110,45,84,80,47,79,85,96,82,38,84,75,74,75,74,28,49,37,63,57,30,64,48,90,20,15,19,49,38,85,75,35,57,40,50,66,58,45,56,10,45,44,59,56,72,37,32,18,63,77,88,56,23,19,64,54,39,38,19,42,33,20,26,42,32,27,69,97,33,45,36,22,33,21,49,50,19,53,25,30,41,32,180,0,90,34,21,41,25,13,24,49,62,0,30,42,15,67,49,31,18,32,8,12,26,32,56,17,56,31,54,60,37,66,55,39,25,22,43,66,16,38,31,33,18,47,20,32,157,18,19,59,40,28,19,41,17,38,0,43,19,50,20,19,26,19,57,17,27,20,55,41,9,13,39,58,5,41,32,28,26,43,12,36,14,23,22,32,35,48,25,22,18,34,11,26,3,0,41,23,53,6,35,30,2,14,42,23,8,51,14,29,15,9,46,21,43,30,58,13,20,25,25,22,37,65,7,29,24,26,19,25,0,22,26,20,32,17,20,36,40,17,36,16,25,9,56,28,49,0,21,17,30,26,40,10,12,12,15,14,25,38,27,20,12,13,15,22,57,35,24,31,17,19,37,12,22,13,31,38,19,22,8,32,7,34,10,21,9,0,20,19,4,9,8,23,15,28,23,11,14,23,16,38,38,32,5,17,12,139,17,13,17,13,14,34,27,23,27,18,14,21,16,31,29,23,29,0,13,24,10,29,43,17,13,25,34,18,15,19,32,11,14,17,21,10,80,73,12,18,54,47,15,7,9,11,22,0,38,16,5,16,30,29,12,14,33,33,14,26,8,3,28,10,39,25,33,31,22,15,31,17,19,30,19,11,8,18,6,23,28,20,12,6,18,2,29,8,5,38,41,15,17,13,40,21,17,24,14,43,34,2,14,19,17,35,22,0,5,13,26,18,3,13,28,5,34,20,7,30,55,21,3,22,12,7,5,7,5,21,1,6,14,33,87,9,2,27,4,13,12,17,43,18,12,0,15,17,20,14,12,0,30,16,16,38,7,19,16,12,6,7,25,8,11,2,15,12,17,8,6,9,11,10,7,35,11,4,19,8,16,5,9,15,14,7,11,21,51,8,26,12,29,8,6,8,18,10,2,10,29,20,11,10,13,12,17,16,5,6,46,10,17,67,21,27,1,18,22,16,30,2,0,59,11,10,25,19,2,34,7,15,15,18,7,0,15,31,11,33,8,25,6,22,5,137,867,13,15,29,8,5,26,9,37,4,7,5,17,2,11,2,10,10,7,5,0,14,32,8,15,17,7,6,9,0,9,5,10,46,4,11,18,19,20,5,10,19,22,13,5,10,24,0,9,25,39,0,13,19,6,8,18,29,6,15,1,0,18,28,1,9,8,24,39,2,14,28,0,24,16,8,40,8,7,6,6,4,10,14,14,14,0,39,7,13,25,17,17,0,9,37,26,17,31,5,18,7,0,7,0,29,10,16,15,8,12,4,0,32,6,11,50,11,4,28,22,31,0,12,25,13,12,12,14,2,5,0,20,22,15,28,11,17,15,3,13,19,10,26,9,14,18,28,2,27,20,8,0,4,24,4,4,9,10,3,3,0,10,27,2,11,0,20,0,20,13,25,11,19,4,8,1,26,21,9,34,35,14,14,3,0,5,23,3,7,14,16,6,12,7,13,0,2,11,15,10,5,10,11,0,9,7,5,5,15,7,14,9,4,0,0,6,6,2,21,10,17,33,42,5,10,55,9,17,1,22,16,12,3,0,3,4,7,7,0,4,6,4,8,5,6,4,16,12,26,15,8,21,13,0,13,0,2,2,14,3,0,0,1,10,23,12,1,5,0,9,30,0,3,8,4,7,0,0,0,0,4,7,0,12,0,6,21,7,2,11,18,4,9,8,5,4,4,11,10,14,2,20,16,0,7,13,5,18,19,0,12,6,1,11,11,12,0,5,15,2,11,11,0,0,0,0,6,12,2,7,13,0,5,8,0,11,9,6,8,13,9,13,5,9,4,0,5,1,3,22,2,4,12,6,1,4,9,3,9,2,11,17,6,3,10,25,16,15,0,1,4,15,23,0,9,52,1,8,17,22,3,20,13,0,1,0,8,6,21,9,3,14,7,30,5,7,22,14,2,10,10,7,11,7,3,61,14,9,0,5,5,8,14,10,24,13,7,3,0,7,7,9,0,0,0,13,18,24,8,6,19,2,2,0,36,10,9,12,17,8,0,4,10,0,9,13,51,2,12,10,2,18,0,4,1,0,7,9,2,26,1,24,10,7,1,9,2,4,2,0,0,10,1,3,16,1,9,4,3,6,1,13,14,14,11,2,44,4,6,0,6,10,1,15,7,6,16,0,1,0,0,5,7,13,1,3,6,6,2,12,8,2,0,7,1,0,2,7,0,0,12,11,4,9,2,2,0,4,0,13,5,8,0,0,2,8,8,2,10,7,14,5,6,6,0,12,9,7,17,4,0,12,1,0,8,2,7,12,12,8,3,2,3,15,10,7,10,5,7,6,4,5,19,7,7,5,2,0,6,4,4,2,5,6,1,15,3,5,0,2,2,32,1,6,10,16,5,0,5,0,4,19,7,0,30,3,7,18,7,1,1,9,10,3,0,14,15,0,12,6,4,3,3,12,1,20,3,1,15,0,0,11,0,0,8,0,9,2,3,3,8,5,7,6,10,12,5,4,6,0,15,4,0,24,0,0,0,10,0,7,12,0,2,0,12,12,12,14,0,8,1,5,4,32,15,3,2,5,22,12,3,16,12,7,3,11,0,0,2,10,2,7,4,2,20,0,0,2,0,15,6,7,2,6,14,3,0,20,8,0,6,1,6,3,1,4,6,0,15,20,4,0,9,15,3,13,5,17,0,6,4,1,6,0,9,5,6,17,0,4,8,0,15,1,6,12,2,10,6,1,2,0,18,6,12,0,0,0,0,1,0,4,7,2,3,4,13,1,23,6,0,0,40,1,5,9,1,1,13,1,3,12,7,4,12,3,2,0,3,1,13,23,9,9,6,7,1,25,3,5,8,0,17,4,7,4,19,12,5,9,1,2,6,7,0,4,5,2,10,15,8,4,2,13,6,15,3,0,4,17,7,3,1,8,17,3,7,9,6,3,1,11,2,4,0,6,0,0,9,7,4,0,23,0,0,9,0,4,3,3,6,9,6,5,4,3,0,2,8,10,0,7,0,0,0,3,7,0,16,13,6,9,7,11,1,0,2,1,7,0,4,2,14,1,3,6,7,9,0,0,0,9,2,5,1,1,4,9,10,5,2,3,13,14,7,8,8,3,15,6,0,0,5,4,0,8,2,10,2,3,21,9,3,3,0,15,0,7,4,0,6,8,7,2,2,0,2,18,0,7,2,7,5,6,5,3,8,1,5,11,17,11,3,0,2,0,0,3,7,9,0,5,0,5,0,8,7,6,1,0,6,6,0,8,2,2,5,0,11,5,1,4,3,0,8,5,5,3,0,0,14,6,5,0,3,7,3,4,1,14,0,6,5,2,5,11,8,22,12,4,3,3,2,0,7,2,1,8,7,0,7,3,0,3,0,2,4,6,0,1,3,1,7,6,4,8,0,7,0,1,7,2,12,4,7,5,11,8,13,9,6,1,11,8,6,0,3,2,6,0,8,0,7,8,3,11,0,0,0,4,0,5,0,0,7,3,5,3,7,0,1,5,0,11,0,11,1,3,1,1,2,8,7,7,9,3,0,2,6,8,19,3,3,9,4,11,3,8,10,5,0,5,5,2,6,16,1,5,1,8,5,2,7,5,0,2,1,3,3,9,0,7,2,6,7,2,1,7,3,0,1,2,6,4,0,3,1,1,0,26,4,0,0,5,0,7,8,0,1,1,1,18,5,3,4,0,0,6,4,2,14,0,4,7,0,1,0,3,2,0,12,4,0,2,1,9,0,12,0,1,0,12,11,1,6,7,1,5,3,16,0,1,3,1,2,4,10,3,6,8,4,0,2,5,12,4,0,0,8,3,25,7,0,8,2,4,7,6,1,4,18,6,4,1,2,12,3,0,2,1,3,276,8,1,16,0,1,9,0,8,0,1,1,1,9,5,5,8,2,7,2,7,13,4,5,11,2,3,6,0,0,2,8,0,2,6,14,3,27,1,11,6,3,4,8,7,2,0,1,8,3,2,6,15,1,3,5,3,5,5,4,0,6,19,4,7,5,2,0,4,10,8,4,6,0,3,3,13,0,1,0,0,4,0,0,9,0,15,4,2,2,0,0,17,7,1,1,1,6,7,2,0,4,1,0,24,5,2,4,2,0,0,0,4,0,2,0,1,13,5,21,7,0,0,1,0,6,6,0,0,6,5,4,2,11,6,5,7,0,5,2,3,1,5,7,1,4,14,6,3,0,3,0,1,0,11,15,0,4,0,7,0,14,3,0,4,18,0,4,2,2,3,4,0,9,0,3,0,8,0,0,3,4,2,6,0,0,4,8,2,11,2,13,9,2,10,3,8,2,4,0,7,8,3,27,2,1,2,3,0,0,0,3,3,8,2,6,7,3,0,1,16,2,3,2,8,3,0,6,8,2,4,2,2,3,9,1,13,5,3,5,77,1,0,2,3,2,5,3,10,14,1,6,6,1,6,2,11,0,7,10,4,8,0,13,4,4,7,1,4,13,8,2,1,0,0,1,7,1,5,1,5,2,1,4,2,0,6,2,7,8,6,0,8,4,1,8,5,2,2,8,1,6,9,0,1,8,5,11,1,4,5,1,9,5,7,1,9,1,5,10,1,8,4,7,10,0,1,14,6,2,6,0,4,1,1,1,2,0,1,1,1,0,7,3,1,0,4,1,2,6,6,3,2,7,5,0,2,1,6,4,2,14,7,2,2,7,3,3,3,2,7,2,3,9,5,0,0,2,0,2,0,0,1,8,8,0,5,0,0,4,0,0,7,1,2,4,7,1,0,5,3,4,3,7,0,2,0,0,16,3,3,2,5,5,0,1,15,2,4,11,6,0,2,5,9,3,9,0,0,3,3,2,12,3,2,3,11,2,1,6,1,3,1,4,2,0,0,4,0,0,6,1,0,5,7,1,1,0,12,5,5,1,3,9,2,3,3,5,2,0,7,5,39,0,1,5,2,3,2,1,8,2,6,1,2,10,5,0,2,3,0,5,1,5,0,1,2,7,0,5,5,2,0,1,5,1,3,0,5,0,0,1,0,5,4,0,12,0,5,2,3,9,3,2,6,2,9,2,6,0,3,12,1,7,9,5,1,2,5,0,4,1,0,4,0,2,0,5,0,3,1,2,1,1,1,0,5,4,1,7,8,1,1,2,1,6,1,7,5,0,3,1,0,1,0,0,2,0,0,10,2,0,8,3,15,6,1,8,4,0,10,1,2,2,7,2,0,11,3,2,2,1,0,2,0,1,13,3,0,2,12,5,0,8,6,2,0,8,4,5,0,2,1,2,4,6,3,0,3,1,9,1,3,0,2,0,1,3,0,0,9,5,0,1,0,0,1,8,0,1,3,0,0,0,2,0,0,5,0,0,0,3,3,2,6,12,4,12,5,6,1,3,0,2,4,5,0,5,16,4,0,8,0,3,10,1,6,2,0,0,3,3,7,4,0,4,1,8,0,0,0,4,10,2,1,1,1,1,3,0,4,2,3,5,1,4,7,3,14,39,3,1,0,8,0,3,7,0,11,0,0,4,2,8,0,3,0,5,0,3,4,4,0,10,1,0,6,3,0,1,2,3,3,0,0,2,2,1,1,14,0,3,9,0,10,2,7,0,6,4,0,2,2,4,4,0,1,1,0,0,8,5,7,8,0,5,0,66,3,3,2,12,0,3,6,34,4,3,14,0,3,2,2,5,0,6,1,0,0,2,4,0,6,12,4,4,2,2,0,2,0,6,1,4,9,6,8,5,6,9,7,3,1,3,3,5,0,5,3,3,2,0,0,6,3,9,0,0,3,0,2,2,5,0,3,1,1,2,2,6,0,5,0,0,9,2,7,0,6,0,1,2,2,6,2,1,0,5,5,0,0,0,2,0,2,7,1,6,2,3,3,0,0,0,3,13,0,23,2,5,0,17,3,7,7,0,0,0,0,0,0,2,1,12,2,3,3,7,0,3,2,0,7,0,0,6,8,0,4,0,5,12,2,1,6,0,3,7,3,5,3,7,0,0,2,2,4,1,0,6,2,0,1,6,2,4,1,1,0,1,2,4,0,1,0,3,0,4,0,0,2,3,0,0,3,13,4,5,5,2,7,0,3,0,0,0,0,4,0,3,1,0,1,0,0,2,5,0,1,5,6,0,5,15,0,0,1,3,4,4,0,0,2,1,2,6,0,0,0,0,0,0,2,3,5,5,5,1,8,6,2,9,0,0,1,0,0,2,1,4,3,3,7,0,0,10,1,0,1,8,0,1,0,6,0,7,0,0,3,6,2,0,2,4,3,0,1,3,18,7,3,3,1,1,0,2,2,0,9,5,7,0,9,0,1,0,2,4,6,0,3,0,0,1,0,1,0,3,1,2,0,1,4,0,7,4,5,1,3,0,3,5,2,3,3,0,3,0,4,2,12,0,1,3,3,3,4,0,0,0,3,0,3,0,1,0,0,2,4,8,0,0,1,3,2,1,2,1,7,3,2,3,8,1,1,0,0,1,0,0,5,5,0,0,1,1,0,0,5,0,6,6,2,0,7,0,0,4,2,1,7,0,3,1,0,1,0,0,6,6,0,0,4,0,1,1,17,2,1,1,3,5,3,0,0,2,2,4,4,5,9,1,2,11,4,7,3,1,1,2,0,1,0,1,7,1,4,6,2,4,1,4,5,1,0,0,6,2,0,5,2,4,0,1,0,3,0,7,2,6,3,2,1,0,6,0,0,0,4,1,6,8,1,10,6,0,5,4,0,1,0,0,3,2,5,1,3,0,6,0,0,3,2,4,4,13,0,5,0,5,3,0,3,0,0,1,9,2,1,2,1,1,1,1,0,3,3,11,1,2,0,0,2,0,3,0,5,1,0,6,0,4,0,7,1,4,4,1,0,71,1,14,6,2,7,6,3,0,0,2,4,0,2,2,2,1,0,2,5,0,0,4,1,0,12,0,1,3,3,4,5,3,5,5,0,0,0,5,0,7,3,0,0,1,3,7,3,0,2,30,3,0,2,1,1,3,0,4,0,2,7,7,4,1,3,2,0,2,3,3,1,2,2,0,6,5,3,0,12,1,2,0,1,1,0,1,2,0,0,1,4,6,3,0,0,1,0,3,3,0,1,1,0,4,7,0,3,3,2,11,0,0,0,0,3,2,3,7,0,2,5,6,0,0,0,1,1,0,1,1,0,9,0,0,1,4,0,1,1,5,2,0,4,0,2,4,2,0,1,0,2,0,1,9,6,0,0,3,7,1,0,1,2,10,8,1,0,7,0,0,5,0,3,1,0,0,2,2,2,2,0,0,0,2,3,1,0,1,0,0,2,0,2,4,1,3,0,0,2,2,0,1,3,1,3,3,7,4,1,1,2,0,5,0,0,1,1,2,0,1,0,3,3,1,0,0,2,0,4,1,2,2,2,7,0,7,5,5,3,0,1,0,0,1,3,3,1,1,15,0,0,1,4,7,0,0,0,1,1,0,3,3,0,6,3,5,4,1,0,2,21,0,3,0,0,0,0,8,1,0,0,0,6,2,1,18,1,0,1,0,2,3,1,2,2,2,2,0,0,0,0,1,5,0,7,4,4,0,0,0,4,4,3,0,0,11,1,11,6,0,0,1,14,1,0,0,2,0,0,3,3,0,8,10,1,3,1,28,1,0,0,2,2,1,0,0,0,5,7,2,1,0,1,2,3,1,0,7,3,2,2,3,1,2,0,0,2,0,2,7,1,2,0,6,6,2,0,3,0,13,1,0,0,5,0,24,3,0,7,4,5,3,7,1,0,3,2,8,0,6,0,2,1,1,0,1,0,0,3,0,3,0,3,2,5,2,0,3,0,0,1,0,2,2,6,0,0,4,0,1,6,2,0,5,2,1,23,0,3,1,0,1,4,0,0,0,0,8,3,0,0,0,1,0,7,0,4,4,0,0,1,0,0,0,0,3,0,1,2,0,0,1,5,1,0,1,0,4,0,0,0,0,3,1,6,3,2,1,0,3,1,5,0,1,3,1,2,0,4,0,3,1,3,12,6,6,1,0,0,2,3,0,2,2,3,1,4,4,1,5,1,1,2,1,1,0,11,0,10,2,3,1,1,12,1,1,4,0,6,2,0,4,6,2,0,0,7,1,1,0,0,1,2,0,0,3,2,2,3,4,2,0,2,0,6,2,5,0,0,1,0,0,0,6,0,0,0,0,0,4,1,0,0,5,2,8,2,2,2,4,3,1,1,2,4,6,0,0,1,2,20,4,0,0,0,2,1,0,1,2,0,0,0,1,0,1,0,1,0,2,0,0,1,8,2,2,3,8,6,0,6,1,0,2,0,0,7,8,1,0,0,4,5,1,2,3,0,2,1,4,8,1,0,5,2,12,0,0,13,0,0,1,13,0,0,2,0,0,4,5,1,6,0,0,1,0,1,4,1,0,7,0,1,0,0,1,0,3,1,0,1,1,0,3,6,5,3,0,2,0,0,4,1,0,2,0,16,21,0,4,1,2,1,0,0,3,0,3,8,0,1,1,4,2,3,2,1,1,2,0,0,0,0,2,0,0,1,2,0,1,1,7,4,3,3,0,4,5,1,0,6,1,0,3,4,2,3,0,0,4,3,0,0,3,0,5,3,3,1,7,2,4,0,0,0,2,0,1,5,1,1,2,3,0,1,4,9,2,0,1,1,1,2,0,1,2,0,14,0,9,0,0,0,0,1,0,1,0,2,2,2,1,0,6,2,0,1,2,3,4,0,1,1,14,3,1,2,0,1,0,1,1,4,0,1,3,6,0,2,2,2,0,0,1,0,0,0,0,0,0,0,3,0,1,0,0,0,0,0,0,0,0,4,6,7,1,3,3,3,1,1,2,2,0,1,2,5,1,0,0,0,2,3,14,0,1,0,1,1,0,7,1,0,0,4,1,15,1,0,4,0,2,1,9,0,0,0,0,3,3,3,0,0,10,1,0,2,0,1,5,7,4,3,1,0,1,4,2,1,0,2,1,3,3,1,1,5,0,10,1,3,1,1,0,12,0,7,1,4,3,4,2,1,6,2,0,2,5,0,1,0,6,1,5,0,15,0,5,0,1,0,0,1,2,4,8,4,1,1,0,5,5,0,3,2,1,3,1,5,1,2,0,2,4,0,1,1,4,4,4,0,1,2,1,0,0,0,11,2,3,1,9,0,3,1,0,2,1,1,0,4,1,0,1,6,0,0,0,0,4,0,4,7,0,6,1,1,0,0,8,2,3,1,1,0,0,0,0,1,3,4,4,3,5,4,0,2,0,1,0,5,0,1,2,0,3,0,2,0,3,0,3,0,0,0,1,3,3,0,5,0,1,0,3,6,0,0,9,0,1,0,0,0,4,0,1,2,4,0,0,3,0,0,1,0,0,1,0,1,1,3,2,1,7,1,1,1,1,3,1,1,4,3,6,3,0,2,0,0,1,1,0,1,0,1,3,3,0,1,1,0,6,0,3,0,4,0,0,0,1,0,0,0,0,0,8,0,0,1,0,0,0,3,0,0,1,1,1,0,1,1,1,9,0,0,6,0,3,1,0,0,1,2,0,0,1,1,1,1,0,3,1,0,1,1,0,1,0,0,1,2,1,1,1,1,6,2,0,1,1,0,1,0,0,4,1,1,0,0,6,0,0,0,0,0,3,4,0,0,4,2,1,5,2,0,1,8,0,6,13,2,2,0,9,14,1,0,0,0,2,8,1,1,2,0,1,0,0,1,3,0,0,0,0,0,7,0,3,0,0,2,2,5,4,0,1,4,0,0,0,1,2,2,5,0,3,0,1,0,0,1,0,1,8,0,5,4,1,3,0,0,0,0,0,1,2,0,0,2,0,2,3,1,0,12,2,0,2,0,0,1,1,1,0,5,3,4,3,2,0,3,0,10,1,0,2,2,4,2,0,2,4,5,0,0,1,3,5,2,0,0,4,5,0,0,0,3,0,2,1,1,2,4,0,3,2,0,5,0,2,3,1,3,1,0,1,1,0,1,0,0,4,3,0,2,1,0,6,5,0,1,1,4,1,0,3,0,5,0,1,0,5,1,1,2,0,5,0,1,0,6,0,13,0,0,0,1,1,0,0,2,3,4,0,0,2,5,3,6,0,0,0,2,5,2,4,3,5,0,0,0,0,0,0,0,0,0,0,0,0,0,0,1,0,1,6,9,7,1,10,0,0,0,0,1,0,0,1,0,2,0,1,0,1,1,7,0,0,4,0,0,0,0,4,0,0,11,9,0,1,5,0,1,3,1,0,1,0,5,1,1,3,2,0,0,3,1,2,1,1,1,0,0,1,0,0,2,2,2,0,0,0,2,0,0,2,0,1,1,0,6,4,0,0,2,0,0,3,0,0,1,6,0,0,0,0,6,0,0,0,0,3,2,0,0,1,2,4,0,0,0,0,2,0,0,1,0,0,1,0,0,0,0,0,0,0,0,0,2,0,0,0,0,5,12,0,0,1,0,0,0,3,7,0,1,0,0,0,2,0,0,2,0,0,0,0,25,0,0,1,1,1,0,0,0,0,1,1,23,0,0,0,0,0,0,0,0,0,0,2,0,0,1,0,0,0,0,0,0,21,0,1,2,0,0,0,0,0,0,0,0,1,0,0,0,0,1,0,0,0,0,0,0,0,0,0,0,0,0,0,0,0,0
"2018 Nunez, Sigrid, The Friend",high,2206,1038,1462,1474,1060,1317,443,726,570,629,781,272,825,391,272,272,267,298,385,166,280,427,320,219,259,373,284,190,140,487,175,131,270,322,250,299,182,203,165,266,209,213,169,165,312,250,231,132,182,70,69,122,134,61,125,161,157,131,178,134,41,117,235,100,156,127,90,46,175,104,72,82,173,75,46,103,76,59,130,35,37,122,73,44,61,12,46,86,138,81,119,52,86,31,89,77,25,114,55,64,133,35,32,100,64,104,49,53,87,86,46,31,52,34,74,16,37,50,47,142,24,48,18,39,16,41,38,32,44,52,21,28,55,26,14,88,39,13,25,78,21,79,19,26,86,38,41,68,43,35,73,53,8,68,46,37,135,27,34,35,36,27,22,55,14,37,35,37,38,12,64,61,58,21,8,35,90,32,41,25,76,43,16,31,29,46,38,37,16,49,4,31,24,50,18,7,15,38,96,72,57,15,21,57,67,2,15,12,13,18,22,14,23,52,18,26,14,5,54,6,34,62,11,5,20,9,45,29,22,36,16,13,2,13,23,17,14,11,11,55,32,53,1,18,30,20,12,22,72,13,29,9,9,3,11,22,28,34,26,47,36,32,25,21,48,61,26,53,9,25,48,50,41,20,11,22,17,33,14,17,7,9,28,56,23,16,16,25,19,14,3,101,5,34,8,36,10,27,23,24,28,13,5,5,9,20,9,15,5,13,15,41,46,38,45,1,11,7,16,7,28,13,19,4,22,9,17,16,71,2,20,27,12,12,0,19,6,14,27,26,13,34,18,18,18,13,32,5,26,9,29,2,38,9,12,12,14,17,7,32,7,0,58,72,19,0,18,10,17,21,16,7,11,2,10,6,36,62,39,44,5,1,9,1,10,1,0,22,23,7,173,21,54,0,20,12,6,8,18,4,15,3,2,21,12,41,13,13,16,19,5,32,6,9,5,12,19,6,14,51,13,0,14,12,10,8,19,3,18,11,8,19,3,23,5,2,3,32,0,17,21,13,3,21,9,15,2,19,14,11,2,12,30,24,21,12,12,69,8,5,6,0,0,11,69,15,0,18,18,6,18,5,8,1,5,34,3,13,0,17,21,1,2,6,15,3,3,4,4,15,19,9,2,14,26,0,9,2,10,6,4,12,6,3,5,5,8,19,5,7,15,1,18,6,43,27,0,5,1,6,11,19,5,8,8,5,9,23,11,3,4,6,9,7,1,0,8,17,3,15,1,18,13,5,2,6,0,2,13,5,6,10,10,0,6,14,4,13,52,18,2,4,19,0,14,16,6,0,4,5,4,5,5,4,11,1,4,4,11,18,4,14,14,6,0,5,9,10,3,4,27,6,6,8,2,19,15,0,9,10,4,1,18,34,5,0,0,9,0,16,2,0,18,10,4,3,9,3,7,5,1,3,11,12,5,3,0,2,9,5,2,1,0,0,6,0,3,0,2,5,8,12,18,3,0,4,11,12,4,1,0,2,11,11,3,9,1,2,3,1,12,4,1,8,7,8,1,13,17,7,15,7,7,20,5,11,11,5,11,10,3,13,14,5,8,10,0,29,2,3,19,6,2,2,3,3,23,0,1,5,7,2,3,9,2,25,10,12,11,6,2,5,0,4,5,1,16,2,12,7,1,0,0,1,8,3,5,5,19,4,9,3,2,1,0,4,1,5,0,4,4,2,9,2,5,0,9,3,4,2,2,0,5,26,1,1,0,4,3,3,1,2,7,1,0,6,25,6,11,16,3,1,1,3,1,7,6,5,6,1,3,17,2,2,0,15,3,44,8,5,4,1,0,2,4,27,0,8,0,12,0,1,1,9,10,2,7,7,3,0,1,3,8,1,8,18,0,0,3,10,8,30,2,7,1,4,4,7,8,3,15,0,0,3,1,2,5,5,0,8,0,1,0,2,5,0,3,0,3,0,4,2,4,10,5,14,4,6,114,7,0,13,2,2,1,0,72,0,1,4,6,4,5,4,0,1,1,3,14,2,11,8,6,1,7,4,2,4,2,14,5,5,10,1,4,13,2,0,6,9,7,8,1,0,5,2,5,4,4,0,6,0,3,0,18,80,0,2,7,5,5,1,2,2,2,12,5,2,5,1,6,1,2,1,3,6,4,3,4,0,3,4,2,4,5,1,5,4,6,1,6,4,5,2,6,3,3,5,22,12,0,10,8,0,1,10,3,7,5,1,5,2,3,6,14,2,6,11,2,3,0,5,5,4,0,1,10,0,1,3,1,1,11,13,8,10,1,1,1,0,1,0,10,0,1,2,0,0,0,1,10,4,3,4,6,3,8,6,6,5,0,1,0,0,1,1,6,1,4,3,2,0,5,15,5,6,7,3,6,18,10,8,6,3,0,18,0,0,2,2,1,1,0,0,4,0,3,5,2,6,6,3,0,6,2,2,5,6,0,0,0,6,2,7,1,5,1,0,10,4,0,2,1,1,0,2,0,4,2,2,6,0,9,1,5,3,1,0,0,3,9,3,3,5,9,2,3,4,7,7,6,6,1,6,0,3,2,0,1,2,2,15,0,4,2,6,5,2,1,0,2,2,9,1,1,3,0,5,13,2,7,17,4,6,3,0,0,3,3,5,1,0,4,3,4,1,0,2,9,14,3,7,10,0,0,0,0,9,0,0,0,0,7,4,1,2,0,1,0,0,12,0,1,2,2,0,0,1,3,0,4,4,0,6,1,2,6,4,0,3,1,0,10,5,4,4,0,2,4,3,0,1,3,0,15,0,0,1,0,4,6,1,1,0,2,0,7,1,1,5,3,9,1,1,1,0,4,8,1,6,3,7,0,0,4,0,3,7,9,1,6,7,0,0,0,2,0,3,0,1,0,0,1,2,0,0,6,1,2,3,0,11,0,6,0,2,2,1,0,0,0,4,2,2,1,4,2,0,5,2,0,1,4,15,1,2,21,2,0,0,2,8,0,8,6,4,3,35,0,5,1,4,3,4,1,2,0,3,3,0,4,1,0,0,0,4,0,0,4,6,3,4,3,1,3,2,0,0,4,10,0,2,12,0,0,3,8,1,3,5,0,25,2,0,1,12,2,4,4,0,3,4,1,0,4,2,6,0,0,11,1,3,8,0,8,0,0,0,1,0,2,0,5,8,0,8,3,0,0,1,0,4,1,2,4,2,3,1,1,0,0,0,0,3,0,9,1,0,13,5,8,5,4,4,2,7,0,2,6,0,1,0,3,5,3,1,1,0,3,4,0,2,1,0,2,0,3,0,0,4,3,8,1,6,0,2,0,1,2,17,0,6,0,3,6,0,3,2,3,1,6,5,1,0,0,8,4,0,0,10,5,8,4,6,0,0,3,5,0,1,18,1,2,3,1,5,4,2,2,0,3,4,2,0,3,4,0,0,0,1,1,0,1,0,0,3,0,1,0,1,12,4,4,2,0,1,0,0,0,2,2,0,5,0,3,4,4,6,3,3,5,1,1,4,6,0,7,11,3,9,6,0,4,7,1,3,9,0,1,1,1,1,1,6,31,3,5,1,1,4,0,0,7,0,1,0,0,0,4,1,3,4,2,0,3,1,9,1,2,1,12,1,3,1,3,3,0,3,1,4,0,5,1,5,8,0,0,0,0,0,0,0,0,2,3,0,2,9,3,3,5,1,2,40,2,0,0,5,0,2,0,1,1,0,18,14,2,2,8,0,2,0,0,5,0,0,1,5,1,7,4,4,1,3,0,0,4,8,1,5,0,0,1,2,5,1,9,1,5,0,0,6,6,11,3,8,1,0,8,0,0,4,2,7,2,1,0,11,0,0,3,0,4,2,4,2,2,0,1,1,3,0,9,2,0,3,4,0,1,3,1,1,0,7,1,4,1,5,3,2,1,2,0,2,0,0,2,2,0,1,1,9,4,0,0,0,2,2,0,2,0,2,4,3,4,8,2,2,1,1,3,1,1,1,0,2,3,2,0,0,2,1,2,0,0,2,0,5,9,0,1,1,0,0,2,0,0,0,7,0,4,5,0,5,4,4,1,0,0,9,0,1,1,3,0,1,0,4,2,4,3,1,0,1,8,0,2,6,0,2,0,1,6,1,0,0,0,8,1,3,1,1,1,5,0,2,0,0,2,1,5,3,0,0,7,4,0,4,0,0,0,0,5,0,1,0,0,1,0,2,1,3,0,1,0,1,2,1,3,0,3,1,3,2,0,0,0,2,2,6,1,5,1,2,1,0,7,1,0,2,1,1,1,1,4,2,2,1,2,0,0,2,3,0,0,2,3,4,7,0,0,2,0,0,0,2,3,0,39,6,0,2,5,0,0,8,2,1,3,0,0,1,0,0,6,8,0,1,2,4,3,1,0,0,1,1,4,0,1,1,0,0,0,2,1,0,1,1,0,2,0,4,0,1,0,1,2,2,1,0,1,2,4,3,0,0,3,3,4,0,6,0,3,1,1,1,4,0,3,8,3,2,1,0,1,4,0,0,2,1,0,7,2,11,1,2,0,9,8,0,1,1,3,1,4,4,1,0,3,7,1,0,1,1,2,6,0,0,3,2,0,3,1,4,1,0,0,1,5,2,1,0,0,2,0,0,0,1,0,0,2,4,2,0,0,0,1,0,7,0,0,0,0,0,0,2,1,4,1,1,1,3,0,0,5,0,2,0,7,0,0,1,3,3,2,0,0,4,3,1,1,0,3,5,0,0,2,2,2,2,0,1,1,1,1,0,0,0,0,0,0,2,0,1,6,0,3,0,1,1,2,3,1,3,0,4,0,0,2,1,3,7,1,6,2,0,12,1,0,0,0,0,6,0,0,0,3,2,0,1,1,7,2,2,0,5,2,3,0,6,0,1,1,0,1,3,0,0,0,1,0,1,3,0,0,0,1,3,0,1,0,3,3,5,0,3,1,0,3,0,0,1,0,0,2,0,0,0,3,0,1,0,0,0,2,3,0,1,2,0,2,3,3,0,0,6,1,2,0,0,0,2,2,3,3,0,0,0,1,1,4,0,7,1,1,0,3,2,12,4,2,0,6,1,2,0,0,2,0,1,4,2,6,0,0,1,3,0,2,0,3,0,0,8,0,3,2,2,0,1,0,4,1,1,0,0,1,1,2,4,1,0,1,2,0,1,1,1,6,0,0,0,0,2,0,4,2,4,1,5,0,3,0,5,1,3,5,2,0,1,0,2,4,0,1,0,1,0,2,5,0,9,3,6,1,0,2,1,0,3,6,2,1,1,3,4,2,1,0,1,2,1,0,0,1,0,6,3,0,0,4,1,2,0,1,0,0,0,0,0,5,3,0,0,1,0,2,3,0,0,3,5,4,0,5,2,0,4,2,0,0,3,0,0,1,0,0,3,0,1,1,0,3,1,31,0,4,1,2,0,0,0,0,0,2,0,1,0,5,6,8,0,4,0,1,1,0,0,3,2,4,3,11,0,0,0,1,1,0,0,0,1,3,4,0,0,0,1,0,0,1,0,2,15,1,0,4,2,5,2,0,7,0,0,1,0,0,4,0,1,0,2,3,0,7,0,1,5,0,12,5,2,0,1,0,2,1,0,0,0,2,0,1,0,47,4,1,0,4,0,0,0,1,7,1,0,0,1,2,10,0,1,0,1,0,0,1,0,0,9,4,0,4,1,0,1,1,0,1,3,2,2,0,1,2,1,0,0,2,0,3,1,0,0,0,4,1,0,5,4,0,1,0,12,0,2,6,0,0,3,0,0,0,0,0,1,1,4,0,0,2,0,1,1,2,2,0,16,1,0,9,1,0,1,3,3,0,0,0,0,0,0,3,2,7,2,0,1,1,2,0,0,0,1,0,0,1,0,0,1,2,0,0,5,4,0,6,7,0,0,2,2,0,0,0,1,1,15,6,0,3,1,2,1,0,1,0,1,2,0,2,0,0,0,3,6,3,2,2,0,9,8,1,4,1,0,0,1,0,2,0,1,0,1,7,3,0,0,2,0,2,0,0,1,3,0,1,1,0,0,0,2,0,2,1,2,5,2,2,1,4,1,1,0,0,0,2,1,2,0,0,1,2,0,3,2,0,4,4,0,2,4,0,0,0,2,0,5,0,3,5,0,2,0,0,0,0,1,6,1,0,1,0,2,0,2,2,2,0,0,1,7,0,1,0,6,0,3,0,0,5,5,0,7,4,24,1,0,0,0,20,0,0,0,3,0,0,0,0,1,1,0,0,3,0,0,0,2,2,0,0,0,14,0,1,0,0,0,1,0,0,6,5,1,0,4,7,0,1,2,2,0,0,0,1,0,1,0,1,2,2,0,0,0,3,1,2,2,1,0,3,0,0,2,5,0,0,0,1,2,7,2,0,3,0,1,0,0,0,0,2,1,2,3,0,3,1,1,0,0,0,1,1,5,1,0,1,1,0,1,2,0,1,0,1,0,1,1,0,0,2,1,0,2,0,0,0,1,2,0,0,0,3,0,0,0,0,0,0,2,0,1,0,3,0,0,0,1,1,2,3,2,0,0,1,3,0,0,1,6,0,2,0,4,2,1,0,0,0,0,0,0,0,0,1,1,0,0,0,0,0,7,3,0,2,1,0,0,2,0,0,0,0,6,0,1,1,0,0,0,0,3,0,0,0,1,0,34,7,2,0,0,1,1,0,2,3,1,1,0,0,0,0,1,0,0,0,3,3,0,9,1,3,0,0,1,1,0,1,0,2,1,0,1,3,2,0,1,1,1,0,1,0,1,3,1,2,0,0,1,0,0,1,1,2,0,1,2,0,0,0,0,0,2,0,0,0,1,0,2,0,1,0,5,2,3,9,0,4,0,0,1,1,2,0,0,0,3,0,0,1,0,0,1,0,2,0,0,9,0,0,0,0,0,3,3,2,2,2,2,0,0,0,1,2,1,0,1,0,3,0,7,0,0,2,0,2,3,0,1,0,0,0,3,2,0,1,2,2,0,1,0,2,0,1,1,1,1,1,0,0,0,0,0,0,1,0,3,1,0,0,1,0,0,2,1,0,0,0,1,1,0,3,1,0,0,1,2,0,0,4,1,0,0,0,2,1,1,1,1,0,2,0,0,0,0,2,2,1,2,0,0,0,0,0,0,2,1,0,3,0,0,0,4,0,0,0,3,8,1,0,1,0,0,5,3,0,3,0,2,0,5,0,1,0,2,2,0,0,0,2,1,0,3,1,0,0,0,0,0,0,0,3,0,0,1,3,0,1,0,0,0,0,3,1,1,2,0,0,0,0,0,5,0,1,3,0,0,0,0,3,0,1,0,2,1,0,0,0,0,2,0,0,1,0,2,0,0,1,0,0,0,1,0,0,0,1,0,3,0,0,0,0,6,0,4,2,0,0,0,0,3,0,0,0,0,0,1,0,0,1,2,0,1,0,2,0,0,0,0,8,1,1,0,3,0,0,1,1,0,2,1,0,0,2,1,0,0,3,8,1,1,1,0,4,0,0,3,0,1,0,0,2,0,2,0,2,1,1,1,0,0,0,1,0,1,3,0,1,0,0,2,1,4,1,0,0,0,0,4,2,0,0,0,0,0,0,2,0,0,1,1,1,0,2,0,0,0,0,0,0,1,1,1,3,1,2,3,1,6,1,0,0,0,2,0,0,0,0,0,1,0,0,1,0,3,0,0,0,2,1,0,2,0,3,0,0,2,2,0,0,1,0,0,3,1,0,4,4,1,0,2,0,4,0,1,0,1,0,0,2,1,0,5,0,0,0,0,1,0,2,0,3,0,0,1,0,0,1,0,2,1,2,0,0,1,0,0,0,30,0,1,3,0,1,0,1,2,3,0,0,3,0,0,1,5,0,0,0,1,1,0,0,0,1,0,0,1,3,0,0,1,1,2,0,0,1,0,0,2,1,1,0,0,0,0,0,0,0,0,3,2,2,0,2,0,0,0,0,0,1,0,0,0,0,3,1,0,2,0,0,1,1,1,2,4,0,1,1,1,0,2,0,0,0,1,2,1,1,0,4,0,0,0,0,1,0,0,2,2,0,0,0,0,0,8,0,0,0,0,0,0,0,0,0,1,0,3,1,0,0,1,6,1,2,0,0,1,5,0,0,0,1,2,1,1,0,0,0,1,0,0,1,2,3,12,0,0,0,0,0,0,0,3,1,1,0,1,3,0,2,0,0,2,1,1,0,5,0,1,1,0,3,1,0,0,1,4,0,0,0,0,1,2,0,0,2,0,0,0,0,0,0,0,0,0,1,0,0,1,2,0,0,1,0,0,0,0,1,1,0,0,1,5,1,0,0,0,0,0,0,0,1,0,0,3,3,0,0,0,2,1,2,0,6,1,3,1,0,1,0,3,0,3,1,2,0,0,1,1,1,0,0,0,0,1,1,3,8,1,0,0,0,0,1,0,0,0,0,0,0,0,0,0,0,2,2,0,0,5,1,1,0,1,1,0,2,0,2,1,0,0,0,0,0,0,0,2,1,0,0,0,1,0,0,0,0,0,1,0,41,1,2,0,3,0,1,2,0,0,0,0,0,0,0,1,0,0,0,0,2,1,0,0,0,0,6,0,0,1,0,0,0,3,0,0,0,2,0,0,2,0,0,3,0,0,0,1,0,1,0,0,0,0,0,1,0,0,0,0,0,0,0,1,1,0,0,8,2,0,2,0,1,1,0,1,0,0,0,0,0,0,0,0,2,0,5,1,1,0,1,1,0,0,1,0,0,0,3,1,1,0,0,3,0,3,1,4,1,0,0,0,0,0,0,2,3,0,0,2,1,0,0,4,0,0,1,0,0,1,0,0,1,1,0,0,1,0,1,1,0,4,2,1,1,0,0,3,1,1,0,0,0,0,0,0,0,0,0,0,0,0,0,0,0,2,1,0,0,1,0,1,3,0,0,4,0,0,1,0,0,0,4,1,1,1,0,2,0,0,0,0,0,0,0,0,1,0,1,0,0,1,1,1,0,1,0,0,0,1,1,2,0,5,0,0,0,0,1,0,5,1,1,0,0,0,2,3,1,0,0,0,4,0,0,2,0,2,0,0,0,0,0,0,0,1,0,1,0,0,0,4,1,0,0,3,1,2,0,0,0,0,1,0,13,4,0,0,0,0,0,3,0,0,0,0,2,0,0,1,1,1,0,0,2,0,3,0,0,1,0,0,2,0,0,0,0,0,1,0,0,0,1,0,0,4,0,0,0,2,0,0,1,1,0,0,0,0,3,0,2,0,0,1,0,2,0,2,5,2,1,0,0,0,2,0,0,1,1,0,2,3,0,2,2,0,1,1,2,0,2,0,0,0,0,1,0,1,1,0,2,0,0,0,0,0,0,0,2,0,1,1,0,0,0,0,1,0,0,0,0,1,0,0,0,0,0,2,2,0,0,3,1,2,0,0,3,0,1,0,1,1,1,0,0,0,0,0,1,0,0,0,0,16,1,0,0,2,0,0,0,1,0,0,0,0,0,0,1,0,0,0,0,0,0,2,0,0,0,0,2,1,0,0,1,0,2,0,5,2,1,0,0,6,0,0,0,1,0,0,1,0,1,0,2,0,0,0,2,0,0,2,0,0,1,4,0,0,0,0,0,1,2,0,1,0,0,0,0,3,3,0,1,1,0,0,5,0,1,0,5,0,7,2,0,1,0,0,0,2,0,1,0,7,1,0,0,4,0,2,0,5,0,0,0,1,2,0,0,0,1,0,0,1,1,3,0,4,0,3,1,3,0,0,2,0,1,0,0,2,0,0,0,1,0,0,1,0,2,2,0,0,1,0,6,0,1,0,0,1,0,0,1,0,0,2,3,0,1,0,1,1,0,0,0,0,0,2,7,0,1,0,1,0,1,2,0,0,0,0,1,0,1,0,0,0,1,0,0,0,3,0,1,2,0,0,4,0,1,1,3,1,1,0,2,5,1,0,1,0,1,0,0,2,0,0,0,2,0,0,0,0,0,0,9,2,1,2,1,1,6,0,1,1,0,2,5,1,0,0,2,1,1,0,2,5,1,0,1,0,1,0,0,1,3,0,3,0,0,0,0,1,0,0,0,0,0,1,0,4,0,0,0,9,0,1,0,2,1,7,3,0,0,0,1,0,0,0,0,0,0,0,1,0,0,0,0,1,0,0,3,1,0,0,0,0,0,0,0,3,0,0,0,0,0,0,0,1,1,0,0,0,1,0,1,1,1,0,0,1,0,3,7,0,0,0,0,0,0,0,1,0,0,0,0,1,0,0,0,0,3,2,4,1,1,0,1,0,1,0,0,0,0,2,0,0,0,0,1,2,0,2,1,0,2,0,0,2,0,0,3,0,0,0,0,1,2,0,0,0,0,1,2,0,0,1,1,2,1,1,0,0,2,0,0,1,0,0,0,3,0,0,0,2,0,1,0,0,0,2,0,0,0,0,0,0,0,0,0,1,0,0,2,2,0,0,0,1,3,1,3,1,1,1,0,0,0,0,1,0,0,1,0,1,0,1,3,0,0,0,0,0,0,0,0,2,0,2,0,0,0,3,1,0,0,0,0,0,0,0,0,1,1,0,0,0,0,0,0,0,2,0,0,2,0,0,1,0,4,4,0,3,1,0,0,0,0,0,5,0,0,0,0,0,0,0,0,0,0,0,0,0,2,2,0,0,0,0,0,2,1,0,0,1,0,0,0,1,1,0,4,4,2,2,1,3,0,2,0,0,0,0,0,0,1,0,5,0,2,0,0,0,0,1,0,1,1,0,0,0,1,0,0,0,0,0,1,0,3,1,0,0,0,0,0,0,0,0,0,0,0,0,2,0,0,1,2,1,0,0,0,1,0,1,0,0,0,0,1,4,0,2,0,0,0,0,0,0,0,0,0,2,0,0,0,0,0,0,0,0,0,0,0,0,2,1,0,0,0,2,1,0,1,0,1,2,2,0,0,0,1,0,0,0,5,4,1,1,0,2,0,0,0,1,2,1,1,0,4,0,0,0,0,0,1,1,0,0,0,0,0,1,0,0,0,1,3,0,0,2,0,0,0,0,0,9,0,0,0,0,2,1,0,0,1,0,0,0,0,0,0,1,0,0,0,1,0,0,0,0,0,0,0,1,0,1,0,0,2,0,0,0,0,0,0,0,0,0,0,0,0,0,1,0,1,0,0,0,0,0,0,3,0,1,0,0,0,0,2,0,2,1,0,0,0,0,0,5,2,0,0,0,0,0,0,0,0,0,0,0,0,0,0,0,1,0,0,0,0,0,0,0,0,0,0,0,0,0,0,0,0,0,0,0,0,0,0,0,0,0,0,0,0,0,0,0,0,0,0,0,0,0,0,0,0,0,0,0,0,0
"2020 McBride, James, Deacon King Kong",high,6438,2875,2663,2923,2056,1574,2484,1855,1782,1497,1445,1529,1416,966,730,783,688,683,837,909,806,547,508,956,369,340,457,463,646,366,510,466,439,304,344,150,273,383,289,428,301,380,371,352,445,356,335,362,160,380,392,291,227,274,254,261,174,280,262,265,250,350,435,256,336,190,180,259,79,197,245,226,178,171,469,142,240,267,191,220,168,205,360,197,155,117,184,157,155,152,126,137,101,102,80,137,199,164,191,170,159,140,66,129,158,179,135,142,93,136,204,423,68,156,126,147,105,158,92,108,135,37,82,50,92,124,147,80,115,110,129,104,233,83,169,94,83,121,97,61,58,132,187,65,83,79,106,53,94,85,114,25,75,53,146,153,25,66,114,106,126,148,107,127,97,37,76,77,107,68,42,161,48,98,74,62,100,69,82,69,75,75,20,69,65,109,48,76,70,119,78,71,64,67,109,68,75,91,81,29,88,63,59,78,62,74,66,52,69,81,87,38,51,39,33,48,32,70,78,75,42,62,42,40,57,33,31,108,67,25,100,32,59,22,123,48,27,43,36,42,57,11,77,63,55,51,132,73,30,79,58,58,58,54,70,66,38,66,29,69,52,53,44,36,24,36,43,6,90,38,27,66,46,49,33,59,80,46,65,118,38,28,34,65,25,78,42,52,48,38,47,44,6,73,66,45,35,56,34,48,48,28,39,33,20,57,155,56,55,18,33,25,22,46,15,36,33,16,30,29,21,22,41,56,24,72,64,39,30,30,33,21,35,32,13,41,38,28,49,46,51,46,38,18,86,26,54,115,54,66,21,55,26,39,33,34,17,36,41,47,67,55,37,20,22,31,13,29,27,56,12,72,42,14,43,23,32,58,10,15,57,40,44,24,19,32,0,58,30,12,13,34,27,14,29,10,18,24,35,16,32,16,28,35,12,30,34,37,30,45,46,16,24,9,21,3,52,37,24,30,27,2,79,118,53,54,21,12,14,17,56,57,26,46,4,11,35,36,0,42,60,29,16,49,15,13,36,26,23,28,45,56,17,21,4,29,24,10,17,45,11,20,0,40,31,60,4,17,42,12,60,23,30,272,27,26,24,116,0,36,20,31,27,22,30,143,19,14,15,45,14,49,13,35,13,43,27,20,18,42,16,11,13,35,33,38,23,21,11,10,17,41,43,31,30,13,1,10,27,33,38,37,33,13,9,23,15,31,26,1,3,18,18,4,39,2,10,13,38,13,24,17,22,29,16,15,0,7,33,29,51,18,44,8,21,42,18,8,9,30,19,27,21,10,15,11,26,6,8,24,75,10,11,28,29,18,23,227,13,22,9,4,17,32,1,13,14,26,30,29,7,23,4,26,25,12,5,34,37,24,18,8,41,6,26,0,0,14,20,9,15,62,9,16,256,26,9,33,31,6,8,14,26,14,12,40,64,26,11,18,12,24,3,36,12,0,23,9,17,9,14,17,23,12,37,17,25,30,8,15,0,14,18,21,5,21,23,69,22,10,28,49,5,12,21,7,9,10,42,39,16,9,11,9,20,18,28,6,11,15,24,24,4,45,16,15,10,8,20,21,6,1,6,36,6,31,28,20,26,16,16,60,29,17,16,10,25,18,36,8,5,20,7,14,25,53,14,5,24,15,2,52,38,8,5,20,10,8,6,28,12,25,5,7,0,13,4,33,7,23,5,23,58,8,0,0,12,10,15,12,7,6,16,18,9,17,26,15,35,1,15,14,8,77,2,45,12,13,30,18,18,9,96,20,0,7,22,2,7,11,6,4,9,14,2,20,3,5,19,20,72,13,55,12,4,3,1,10,0,27,17,13,12,12,7,16,0,13,3,7,10,8,20,0,5,17,40,2,14,6,24,9,9,14,15,43,19,8,25,30,10,10,4,7,9,10,20,16,0,7,6,11,9,23,14,7,3,0,8,9,13,5,4,10,10,22,7,1,1,19,3,7,10,6,5,7,8,0,20,16,11,32,7,4,0,18,16,18,4,21,7,25,6,5,195,13,16,15,19,7,10,4,8,11,7,7,9,1,10,17,13,12,16,2,1,25,9,12,9,12,15,0,24,0,12,3,16,32,15,22,18,4,24,10,8,12,6,1,12,8,19,30,2,2,11,36,9,9,16,3,24,20,18,8,16,8,21,9,4,3,11,8,27,36,2,46,0,8,5,2,0,12,10,1,15,6,21,17,5,21,10,70,9,9,12,6,18,5,4,0,4,14,5,1,8,60,8,0,3,18,6,2,17,12,15,24,0,11,16,0,12,1,28,8,2,8,7,1,1,10,18,11,2,5,5,8,14,1,11,18,17,7,4,10,2,2,14,18,6,20,11,7,21,16,10,10,14,13,11,4,4,18,1,11,24,10,19,27,60,2,11,18,20,13,13,0,9,7,1,7,30,11,0,0,13,9,23,3,0,0,0,1,12,8,4,10,2,1,3,7,0,51,12,2,8,117,0,1,6,3,4,0,1,13,15,18,4,1,37,11,49,12,4,2,20,3,1,6,8,11,9,8,7,9,0,7,7,22,14,9,14,21,3,1,6,12,10,4,13,3,7,3,0,21,0,13,20,8,8,17,12,7,13,10,7,6,8,9,5,2,3,6,15,5,9,6,0,13,8,1,9,8,7,9,0,0,8,12,5,1,0,6,4,20,3,7,1,5,9,0,6,4,8,17,13,6,0,17,4,0,11,18,0,10,3,3,9,20,12,7,6,0,7,12,4,4,0,9,11,12,0,10,15,3,4,0,0,4,10,1,5,9,15,1,4,31,11,11,6,4,8,15,0,2,10,0,8,4,2,3,11,1,2,0,9,27,0,8,10,15,8,11,8,17,0,2,6,5,0,1,6,0,13,5,0,6,5,19,15,26,0,2,55,28,0,1,5,7,0,3,7,7,10,19,9,5,13,17,4,0,0,15,5,5,21,6,1,53,12,2,37,7,13,9,3,3,30,1,12,2,31,38,1,16,9,9,1,1,11,3,17,8,0,1,13,7,9,5,6,4,0,2,24,4,3,9,11,9,3,2,11,6,12,0,3,12,12,2,8,16,6,0,5,21,6,4,11,8,4,1,3,3,4,0,16,1,3,0,8,6,6,10,2,2,3,0,0,12,0,71,2,0,18,1,21,9,6,5,67,4,22,1,8,1,46,1,1,0,2,1,0,0,0,9,0,12,3,0,0,13,1,6,1,2,0,3,29,26,5,1,14,8,7,14,4,1,7,23,7,3,9,1,0,0,8,7,6,6,6,6,2,5,6,4,0,1,11,11,8,5,16,10,0,10,9,0,1,9,4,14,2,8,10,19,28,10,17,0,1,5,1,11,6,10,0,0,0,2,5,15,5,2,5,3,2,10,10,5,3,27,13,5,2,3,10,14,0,29,2,9,7,0,1,0,0,2,0,11,17,8,6,1,8,2,5,0,30,0,7,1,1,3,10,5,8,6,4,10,8,8,5,15,1,3,10,0,5,4,2,5,6,14,10,8,11,2,3,0,7,2,4,0,7,2,7,1,8,2,12,10,2,3,9,22,7,11,3,8,1,114,4,7,4,0,1,3,14,5,3,6,5,0,6,2,9,6,1,16,3,3,501,0,2,1,1,5,2,0,2,6,0,8,0,12,8,9,0,2,5,2,15,15,0,5,0,10,0,5,0,3,7,8,10,0,3,2,2,11,1,5,2,0,1,18,5,2,3,4,1,8,11,6,10,16,0,0,0,7,9,17,24,12,0,3,13,5,0,5,1,0,9,0,8,1,0,8,13,0,7,10,6,9,7,1,4,19,0,5,1,8,3,17,4,2,13,2,52,13,4,3,1,0,3,8,0,6,7,1,0,7,1,6,5,0,3,1,5,0,7,4,0,2,0,18,4,10,35,10,0,7,5,2,10,24,3,0,5,0,10,5,5,11,2,0,17,13,8,0,2,24,1,2,4,7,0,0,6,0,4,18,5,8,0,1,1,9,0,14,12,3,10,10,16,3,4,5,10,5,6,0,39,3,0,10,4,0,6,7,0,5,3,7,2,3,29,4,6,0,0,2,0,5,0,14,15,1,2,1,1,5,1,0,0,1,16,1,3,0,29,2,8,10,8,4,11,9,3,0,2,4,7,5,0,0,3,1,0,5,0,0,0,1,7,12,0,8,1,3,0,8,1,18,1,1,0,0,8,6,27,13,6,2,4,33,7,1,3,3,24,1,5,14,8,0,33,3,1,4,2,2,1,2,2,0,6,4,1,5,4,0,0,24,16,4,1,1,5,1,1,8,3,4,0,4,1,0,6,0,1,3,0,1,6,2,0,0,6,0,2,2,0,6,1,0,16,5,9,1,3,7,22,0,0,7,5,7,3,2,4,5,0,9,0,5,17,0,3,83,0,2,0,13,0,7,10,4,9,16,8,101,8,7,2,13,0,7,1,6,0,4,4,4,4,13,13,7,2,11,3,10,2,3,0,0,2,10,10,5,1,4,1,4,7,0,9,1,1,2,5,1,2,2,3,0,4,3,2,0,5,3,8,0,1,8,18,1,2,2,5,9,0,9,1,8,4,2,4,5,4,6,1,0,7,9,6,0,17,2,4,0,1,2,0,2,0,1,0,1,4,1,4,4,4,0,0,3,2,11,4,3,13,18,4,2,1,8,5,7,5,0,1,0,4,3,5,0,0,5,12,3,0,3,5,3,0,302,3,3,1,0,6,14,7,0,3,3,0,15,0,5,5,29,7,4,2,1,7,7,4,4,6,1,6,0,0,0,0,1,1,6,3,3,10,5,4,0,1,2,0,7,6,0,2,5,0,0,1,6,0,7,0,10,2,3,0,3,3,8,2,3,0,7,3,2,6,2,1,6,0,2,1,5,3,0,1,0,2,0,1,2,0,13,0,1,6,5,3,67,0,0,4,1,2,0,4,0,0,3,7,0,8,0,5,15,2,8,3,1,2,6,1,4,3,1,0,26,10,1,9,2,0,2,6,2,5,0,330,0,3,6,19,1,0,5,7,0,0,3,1,2,10,5,3,1,0,1,0,0,3,2,3,0,4,4,8,8,7,0,8,0,8,2,3,3,2,3,3,6,0,3,3,1,0,0,10,2,2,1,3,37,3,1,1,1,3,7,4,6,3,2,0,0,2,1,0,8,2,5,2,0,1,5,1,3,3,1,0,3,4,11,6,5,7,0,3,4,7,2,1,1,5,1,1,0,1,1,18,2,0,2,5,6,3,8,4,1,4,0,0,3,2,20,0,0,2,8,17,0,3,4,0,9,5,2,0,3,5,0,8,0,0,4,0,2,0,0,2,3,0,2,6,6,0,4,0,1,2,1,1,2,0,3,16,0,11,9,4,0,1,1,0,68,8,0,0,0,5,4,0,4,0,5,1,2,0,0,6,5,2,2,3,2,11,7,6,1,2,33,5,4,10,3,2,0,0,0,2,8,4,8,7,79,1,4,4,2,1,20,0,3,2,3,0,7,2,0,1,1,1,0,3,5,9,4,3,4,12,10,3,2,0,3,4,0,2,3,0,8,8,0,2,2,2,8,0,0,3,28,0,10,5,1,4,0,0,0,0,0,0,0,0,15,8,3,2,2,0,10,1,2,2,8,3,5,0,1,1,0,2,2,4,0,4,2,6,2,2,9,2,5,0,2,0,3,0,5,0,0,0,1,2,4,0,0,0,2,2,5,3,4,9,2,1,3,1,2,5,0,1,0,0,1,8,3,9,5,0,4,5,11,7,1,3,0,8,2,1,1,1,9,2,1,0,0,10,3,0,1,0,1,4,8,11,11,1,5,2,2,2,0,20,0,0,4,0,0,3,0,0,7,1,1,0,9,23,2,0,0,5,3,1,1,6,8,4,5,0,3,5,0,1,17,1,5,4,0,0,3,2,0,4,1,1,22,4,2,7,1,4,1,0,1,1,1,0,7,6,5,1,2,0,3,0,2,3,3,0,7,2,0,2,3,5,1,0,1,7,6,0,0,0,1,1,2,2,3,2,1,3,3,1,2,1,3,9,5,8,16,2,0,33,10,5,0,4,0,5,1,3,0,0,1,2,4,0,12,2,8,3,4,2,0,4,7,9,262,2,0,11,8,3,0,11,3,14,3,1,3,9,4,3,2,1,1,34,4,1,11,0,7,1,1,6,1,1,1,0,1,0,1,3,0,1,2,1,0,8,1,8,8,1,1,0,1,4,0,7,2,1,11,0,0,0,3,8,0,7,0,4,0,59,2,10,3,23,1,3,4,0,16,4,5,2,2,2,0,3,7,0,1,0,1,4,0,0,0,5,4,0,2,0,2,4,1,1,41,6,3,3,2,0,2,8,0,0,0,1,1,6,3,9,16,2,1,6,5,2,1,4,1,3,5,0,3,2,0,1,3,0,5,0,2,6,16,3,2,1,3,2,0,2,2,2,5,3,2,0,6,10,4,0,71,2,3,5,5,11,2,1,2,2,0,0,10,0,13,0,1,7,0,4,0,3,2,3,1,88,0,2,8,0,19,3,4,1,1,0,0,11,0,3,2,0,1,1,15,8,2,0,8,0,0,0,0,1,9,0,0,4,2,1,6,12,0,2,0,4,17,0,2,2,2,4,6,0,1,2,1,1,4,0,1,2,5,0,3,9,3,3,8,0,1,3,3,2,5,9,2,5,0,5,4,0,4,1,1,1,0,1,0,1,1,4,0,0,5,0,0,2,5,0,5,0,4,1,9,5,9,0,10,0,0,6,2,2,8,0,1,0,3,2,0,24,5,1,3,3,0,0,1,3,2,0,4,0,1,1,0,1,4,5,8,3,2,1,4,0,1,3,3,6,1,5,3,0,3,6,9,3,5,0,1,0,26,2,1,2,4,2,0,0,38,0,1,3,0,5,2,3,0,4,3,0,8,2,7,3,1,0,1,1,0,0,2,1,2,0,0,4,3,1,0,1,0,1,1,14,18,0,10,1,3,3,0,1,2,0,0,0,0,0,0,2,4,3,1,1,2,2,5,0,1,0,1,0,1,0,1,0,24,0,11,0,0,0,1,0,3,2,2,2,3,3,2,0,0,2,2,5,1,0,2,0,3,3,10,26,0,0,1,5,1,2,4,155,1,4,19,0,6,4,0,2,0,1,2,0,6,0,2,0,1,0,14,1,2,1,1,1,1,1,1,0,2,2,3,3,0,0,3,11,26,1,7,3,1,6,0,0,3,0,3,2,0,8,0,4,3,4,2,2,0,4,4,1,5,13,3,5,9,3,0,0,0,3,2,1,0,0,0,6,2,0,0,8,4,7,4,3,2,0,0,0,3,2,2,3,3,1,0,0,0,2,0,9,2,0,5,2,1,0,0,117,0,0,1,2,2,1,2,3,0,0,4,0,0,8,0,1,4,0,2,3,6,2,1,3,0,2,3,6,8,7,2,0,3,5,3,0,0,2,0,1,4,9,2,22,1,0,0,1,2,2,1,4,1,1,0,1,1,0,0,0,18,3,0,3,3,2,0,0,2,3,1,3,0,3,0,10,3,22,1,20,0,0,1,0,0,2,0,0,2,3,2,1,13,0,0,3,3,3,4,5,2,1,2,1,9,4,0,2,52,0,0,3,4,0,1,24,1,2,11,3,0,1,1,0,9,0,6,13,0,2,1,1,2,0,6,1,2,1,3,2,0,6,4,0,1,0,1,3,1,5,0,0,1,5,0,0,1,1,0,0,3,0,5,1,2,0,3,4,0,2,0,3,0,0,2,6,0,4,11,0,1,3,1,2,2,2,0,0,2,0,1,0,0,2,2,3,0,0,0,0,35,1,4,0,0,2,7,4,0,2,0,4,0,4,2,1,0,6,1,3,2,0,6,0,0,0,2,1,0,0,0,0,3,0,5,0,0,1,1,1,2,2,1,1,2,0,5,0,0,0,2,1,4,2,0,2,0,2,11,4,1,1,0,1,0,9,1,12,6,1,1,0,1,2,0,1,0,3,1,1,6,2,0,0,0,1,0,0,1,3,6,1,1,0,0,4,0,0,0,0,2,5,5,6,3,5,3,1,0,6,5,2,4,0,0,0,1,5,0,2,8,4,0,1,0,0,1,8,3,0,1,0,1,0,0,2,1,4,3,0,6,4,0,4,3,4,9,0,0,1,0,6,1,0,0,6,2,3,0,3,5,2,2,1,0,0,3,10,0,1,1,0,0,0,0,2,0,0,1,0,5,4,0,3,1,8,2,2,0,2,0,0,4,6,1,2,1,1,0,4,0,0,1,0,0,2,4,2,3,0,2,0,0,1,0,1,0,4,46,1,0,2,1,3,1,0,2,4,9,11,0,0,0,0,0,1,1,6,1,0,0,0,3,2,0,2,2,2,4,2,5,6,2,0,1,0,0,4,0,6,0,8,3,5,5,1,1,1,0,3,4,1,0,0,1,1,8,0,0,3,1,0,2,8,0,0,2,3,3,8,0,7,1,0,1,4,1,2,8,2,5,6,0,9,6,0,0,0,6,2,3,1,0,6,166,0,0,0,6,0,0,1,0,5,0,3,0,15,0,0,1,2,0,0,0,3,0,0,24,2,1,0,1,0,0,0,2,0,2,5,0,0,6,1,8,0,2,4,3,6,0,1,21,2,0,0,3,0,3,0,0,3,0,17,0,4,2,4,1,2,9,5,5,5,0,1,0,4,4,1,0,3,4,3,44,2,0,0,26,2,4,0,2,1,0,0,1,2,4,10,0,0,2,4,0,2,1,1,0,4,2,1,0,5,0,0,0,0,4,0,0,0,3,0,2,1,0,0,2,1,1,0,0,0,6,2,5,0,0,5,2,0,2,6,0,0,0,5,1,0,6,2,0,0,1,5,1,4,2,1,2,3,3,2,1,0,0,0,4,10,3,4,2,1,0,0,0,5,0,5,2,4,3,1,6,1,1,1,1,0,4,6,3,1,0,0,2,5,0,1,0,0,1,0,3,2,1,1,0,1,0,1,2,5,0,0,0,2,2,0,1,1,0,0,0,2,1,2,0,0,15,1,0,3,0,13,0,4,6,0,1,9,1,1,1,0,2,0,0,6,0,0,2,1,6,0,0,0,0,0,0,1,9,0,1,1,2,1,1,5,0,5,0,4,0,2,2,0,96,3,0,1,0,8,0,0,0,3,3,6,5,9,1,0,0,0,1,1,0,2,2,1,0,1,1,2,7,2,0,0,9,1,0,3,3,0,1,0,1,0,0,3,1,6,0,4,0,0,2,0,1,5,1,1,2,0,0,0,6,2,0,2,1,0,0,2,4,0,0,1,2,1,0,4,0,1,0,1,3,4,0,0,0,5,1,0,0,0,1,0,3,0,5,0,0,2,4,2,1,0,2,3,1,2,0,0,1,1,4,0,0,0,0,0,0,3,8,0,0,0,0,7,1,0,3,0,0,2,3,0,5,0,0,0,0,3,0,0,0,0,6,2,0,0,0,3,5,0,2,1,2,0,0,0,2,0,0,0,0,6,0,0,0,2,1,0,0,1,0,0,0,1,0,58,1,0,1,0,2,2,0,0,1,0,0,1,0,0,8,0,0,1,0,7,2,0,0,0,2,0,1,0,3,0,0,1,3,1,0,0,1,2,0,0,3,3,0,0,1,1,2,3,0,26,1,1,2,0,0,1,1,0,0,2,2,1,0,3,1,1,0,1,0,1,0,4,3,8,0,1,0,2,1,0,0,0,4,0,0,1,2,7,11,1,1,0,0,4,0,3,0,14,2,2,0,7,1,2,0,1,13,1,1,2,3,3,1,0,2,0,1,0,0,1,0,3,1,4,1,2,0,0,1,0,0,5,0,1,2,2,0,0,4,1,1,0,0,1,2,0,1,1,1,0,1,1,0,0,1,2,0,0,0,1,1,1,1,0,0,0,8,0,1,0,3,1,1,0,0,1,0,1,1,6,0,0,0,0,3,1,1,0,0,1,0,1,0,2,1,0,0,2,1,2,0,1,0,2,0,0,9,2,7,13,4,0,0,0,0,0,5,1,10,0,3,1,1,2,0,0,0,1,1,3,1,0,0,0,4,0,6,0,0,8,3,0,0,1,0,2,0,0,4,4,0,0,0,1,0,0,2,4,0,1,1,11,0,0,2,4,0,0,1,5,0,4,0,1,1,1,0,2,0,0,2,0,0,0,0,0,3,1,3,0,1,0,1,1,0,0,4,0,1,1,4,4,0,1,0,3,0,6,0,1,1,13,6,0,3,0,0,0,3,0,0,0,1,0,1,0,8,0,0,2,6,1,0,1,0,0,3,11,0,0,0,0,0,0,7,0,2,0,1,8,3,0,3,1,36,0,0,1,0,1,0,1,0,1,0,7,1,1,2,2,1,0,0,0,0,2,1,0,15,2,0,1,1,11,0,2,1,0,0,0,0,0,2,1,0,1,1,0,0,0,2,0,0,0,1,0,3,1,3,4,4,0,1,0,7,3,0,0,0,2,0,4,1,0,0,2,0,4,0,3,2,2,2,1,2,0,1,2,1,0,0,1,0,0,12,1,2,2,1,4,1,0,0,0,2,0,9,0,1,1,0,5,1,0,1,1,0,3,1,0,0,0,1,0,7,0,0,1,0,0,0,0,1,0,0,1,4,1,1,4,1,2,1,2,4,2,0,0,0,0,1,0,1,1,0,4,0,2,0,0,1,0,2,0,2,0,0,2,0,0,0,2,0,0,0,0,2,0,0,0,0,0,1,0,0,0,0,0,0,1,0,0,2,1,2,0,1,0,2,0,0,0,1,0,0,0,1,0,0,9,0,0,0,0,3,0,3,0,0,4,2,3,0,0,1,1,0,1,0,0,1,0,0,9,2,1,0,0,1,1,0,0,4,1,0,3,4,5,0,1,10,0,0,4,0,1,0,2,0,0,1,0,0,4,0,0,0,1,0,1,0,0,2,0,0,0,0,0,1,0,0,0,2,0,2,0,13,9,0,0,0,3,0,14,0,0,0,1,1,2,0,0,2,2,0,4,0,0,0,0,0,2,0,2,0,2,0,0,0,0,0,0,0,0,0,0,2,0,0,0,0,0,1,0,0,1,6,0,0,0,0,0,0,0,0,0,0,1,0,0,0,0,7,0,0,2,0,0,1,0,0,1,0,1,1,0,0,0,0,0,2,0,0,0,0,0,0,0,1,0,0,1,0,0,0,0,0,0,0,1,0,0,0,0,0,1,0,0,0,0,0,0,0,2,0,0,0,0,0,0,0,0,0,0,0,0,0,0,0,0,0,0,0,0,0,0,0,0,0,0,0,0,0
"1979 Straub, Peter, Ghost Story",pop,9680,5115,4277,4203,3887,2884,3650,2633,2808,2064,2354,2541,2116,1320,1225,1325,1838,1057,1002,1389,1239,1034,976,1235,494,910,695,709,810,560,635,828,787,616,601,762,634,691,631,494,605,644,474,516,531,485,406,444,533,488,596,549,514,626,491,421,481,384,470,518,483,334,342,392,410,347,325,379,250,391,359,272,206,405,221,329,360,183,238,313,309,235,287,194,205,452,217,223,272,341,176,296,278,293,311,234,327,207,189,260,204,243,281,270,350,225,221,255,224,251,234,294,240,247,215,273,225,258,177,130,221,136,314,229,271,128,179,223,267,202,484,176,195,163,181,154,152,315,161,148,307,163,119,185,155,175,121,110,149,103,130,133,193,174,112,84,77,156,182,215,146,153,66,143,139,138,116,98,132,188,81,120,104,153,264,119,133,97,115,106,90,126,130,110,109,104,124,204,165,70,85,114,109,76,101,155,95,80,135,115,115,158,74,106,104,114,91,98,75,69,91,80,134,84,108,58,97,206,141,90,69,129,119,148,64,117,94,93,77,125,147,67,118,132,154,34,94,119,113,48,97,76,60,87,82,47,74,84,59,133,72,46,65,58,76,77,65,49,80,43,75,63,139,119,45,47,57,109,63,71,77,62,99,79,84,72,86,77,110,60,91,85,63,76,93,118,57,131,101,70,74,30,24,85,73,61,59,73,90,28,63,69,66,61,129,63,36,179,94,23,60,63,79,78,39,69,40,41,43,68,40,50,44,151,66,160,39,56,42,83,52,52,85,59,100,48,66,60,42,104,71,41,51,69,75,109,47,18,32,64,56,38,70,42,54,26,24,25,67,85,45,95,49,37,50,63,52,55,40,39,48,32,47,61,43,98,70,83,44,40,57,50,23,68,26,20,0,32,64,60,58,50,111,28,56,35,53,47,25,73,79,35,54,40,44,51,51,38,54,49,55,38,125,157,38,39,61,77,40,37,58,0,45,38,65,20,34,68,43,28,76,36,75,59,13,42,39,33,87,45,43,43,59,24,39,22,26,23,33,32,68,48,7,49,78,27,49,60,29,45,38,54,3,22,33,40,123,38,19,28,28,36,27,19,75,38,43,44,0,53,20,29,34,9,41,26,94,12,53,28,39,26,32,51,31,17,28,41,5,37,34,73,36,36,35,25,37,37,37,37,24,44,66,69,80,43,0,46,23,25,17,81,57,30,46,15,59,18,26,63,176,43,30,30,30,2,13,25,22,50,44,46,26,33,37,37,0,17,34,22,54,37,32,9,47,63,46,27,20,31,11,25,44,90,22,41,38,62,11,77,49,66,24,85,32,53,25,15,28,30,18,48,18,37,2,13,31,4,23,40,31,29,20,33,17,48,8,40,33,28,17,55,33,25,19,0,1,51,49,41,28,39,39,24,24,12,21,15,28,66,30,50,15,23,27,15,18,44,27,54,35,52,54,43,19,0,16,58,51,33,7,40,42,19,14,24,29,16,38,30,0,34,17,25,27,24,28,33,27,13,21,28,31,10,13,27,11,45,29,22,22,28,43,15,43,14,29,31,21,40,47,16,16,17,36,21,1,27,32,16,39,28,13,13,59,28,24,0,38,30,20,5,15,32,23,21,13,21,11,24,5,33,15,33,37,20,13,14,19,22,44,12,10,2,41,26,18,28,33,26,59,11,9,13,0,31,36,24,7,28,19,17,44,34,88,0,32,28,11,40,20,21,30,31,6,71,10,32,37,5,28,24,14,31,25,24,23,42,20,20,18,16,23,70,0,8,47,34,61,10,12,28,19,39,29,42,11,8,12,8,37,26,1,35,21,31,0,26,1,30,39,14,13,24,6,35,3,23,26,46,28,30,18,62,29,5,27,2,22,17,40,17,3,19,19,15,32,22,23,16,14,9,51,8,0,8,17,17,0,18,13,32,20,4,35,22,32,0,20,13,15,25,3,9,23,61,21,24,27,31,22,8,15,24,18,17,22,0,13,23,18,13,5,17,43,17,1,18,48,8,9,13,14,5,8,13,34,28,10,8,20,39,14,15,11,5,1,0,10,39,3,11,8,24,57,8,19,4,16,11,16,0,30,1,17,16,8,11,8,12,15,58,9,44,30,9,14,4,3,7,0,8,31,4,14,25,7,16,20,33,10,1,26,21,9,10,9,12,27,5,14,28,12,38,5,16,10,20,17,0,0,15,17,2,23,20,55,2,12,3,33,0,18,7,15,21,8,11,23,0,2,17,13,6,13,21,24,3,22,17,13,21,11,12,32,14,4,11,37,0,4,0,12,0,7,36,0,1,1,18,12,11,14,179,14,19,9,1,5,21,3,5,24,0,12,5,22,11,7,13,20,19,14,23,14,57,43,21,17,18,34,6,18,11,23,44,12,5,15,5,6,8,16,24,6,0,13,31,18,18,18,6,0,9,26,81,9,5,0,0,8,9,19,8,6,11,3,0,17,19,14,8,24,32,18,32,2,17,7,1,3,0,18,12,10,13,7,16,21,17,20,12,25,24,11,5,11,16,17,25,12,13,14,20,0,1,13,10,18,6,7,2,7,6,23,11,7,18,4,583,32,11,20,9,21,12,16,8,11,32,50,6,16,24,44,2,17,23,14,1,3,3,20,14,6,11,0,14,14,16,9,23,19,3,0,13,28,7,2,0,37,21,2,9,20,9,6,16,11,1,8,20,19,8,10,22,0,19,5,0,21,12,1,11,24,10,20,13,2,26,16,0,9,9,3,3,2,4,13,17,0,13,13,16,17,0,0,11,16,19,11,15,11,0,38,1,5,6,8,9,15,14,24,6,15,0,3,7,4,12,52,11,8,0,1,0,0,5,7,14,4,18,14,11,1,31,21,23,1,7,11,0,25,6,0,22,10,6,5,14,0,3,10,16,0,8,7,50,0,6,8,14,11,9,10,14,9,5,10,8,0,11,10,14,0,16,6,20,1,23,3,19,19,8,11,6,3,25,11,2,8,1,32,5,1,13,11,4,0,8,3,12,7,0,15,14,6,9,13,24,1,15,21,12,2,19,10,2,4,10,6,20,14,0,19,4,6,32,14,6,16,21,28,11,11,10,11,7,14,24,27,13,17,0,12,6,8,7,30,3,1,7,19,16,4,0,0,36,0,4,2,0,2,12,15,9,5,21,6,6,30,8,8,2,30,7,35,1,14,0,0,2,0,15,0,11,1,0,2,18,12,11,24,13,0,14,13,5,14,12,3,12,13,8,29,10,7,2,6,15,8,10,0,0,3,8,6,5,18,25,16,3,3,7,3,17,5,11,9,12,7,14,0,11,21,0,21,17,9,12,12,8,9,0,4,8,6,791,17,1,19,1,26,16,0,4,19,25,13,10,5,9,3,29,9,11,8,7,1,8,5,39,10,18,6,8,18,0,10,5,11,0,2,0,0,3,0,14,0,7,15,12,25,1,24,15,0,0,2,1,2,20,8,12,7,12,35,8,0,9,7,16,4,10,7,8,6,15,5,3,5,13,7,20,19,7,14,0,11,9,9,3,9,4,4,19,12,8,12,8,19,12,6,16,9,9,2,9,33,6,22,10,10,0,22,2,8,6,17,3,8,7,12,4,9,9,21,5,10,22,0,5,17,2,9,20,6,0,15,12,0,1,0,9,4,9,8,9,23,16,2,5,19,15,14,10,2,8,1,7,10,6,17,0,4,4,9,16,4,1,4,2,8,2,12,21,11,6,3,4,23,4,14,6,0,0,82,5,8,7,8,6,8,11,6,11,22,11,7,3,14,11,4,16,8,9,12,0,8,15,20,15,11,5,27,15,0,3,1,10,11,16,14,2,5,0,7,5,3,15,19,0,9,0,0,19,18,0,12,11,15,6,11,1,5,8,5,8,1,2,3,6,4,2,36,16,9,7,0,8,2,3,3,3,3,1,14,1,2,4,10,14,13,0,9,12,9,4,10,5,3,4,6,6,0,2,8,11,11,1,3,7,7,2,6,6,0,6,18,5,14,2,4,2,4,7,4,17,10,0,4,0,460,11,21,6,17,3,44,12,6,7,12,13,10,11,6,4,13,8,11,15,0,4,1,0,7,7,21,6,5,1,4,14,20,5,9,10,1,8,3,13,3,9,20,18,3,451,6,3,9,4,0,0,10,7,0,2,0,0,2,13,4,8,2,2,2,9,0,10,23,2,0,4,0,9,7,2,15,0,2,5,3,10,10,31,9,5,14,5,7,19,2,2,3,6,3,3,2,28,0,8,0,11,7,7,2,6,21,10,1,0,21,0,0,9,9,11,14,31,2,13,0,4,3,1,7,1,22,2,0,17,1,6,0,10,1,4,3,5,0,17,5,594,14,4,16,2,6,13,9,1,0,3,11,16,4,0,23,4,0,0,0,4,4,0,4,3,0,4,2,5,0,4,2,8,4,13,9,9,20,7,0,5,1,11,0,8,2,6,4,6,13,17,7,13,2,3,3,3,6,5,0,0,11,7,2,3,9,3,2,4,9,0,0,8,4,11,11,5,2,8,14,3,1,6,1,1,3,5,11,0,3,2,1,5,23,3,12,9,10,5,7,3,12,4,26,13,6,4,5,18,8,5,6,0,2,7,11,0,6,12,3,2,7,7,12,4,8,12,11,7,2,0,0,7,5,13,14,3,7,8,7,11,2,5,8,7,3,6,2,8,2,4,8,6,1,13,6,1,0,2,4,6,0,3,3,6,0,33,11,3,2,1,8,24,0,1,0,3,2,7,4,14,2,6,2,0,5,10,2,0,5,11,5,10,0,0,9,9,3,10,8,23,12,6,5,5,0,0,6,0,4,10,0,0,4,2,16,3,7,5,10,2,0,3,6,11,3,8,6,2,15,1,34,10,0,10,3,2,2,11,8,0,5,0,3,8,9,3,0,10,3,9,8,2,10,2,4,2,7,3,2,0,7,0,0,6,1,2,10,27,0,7,4,7,2,1,4,1,2,7,7,2,9,9,1,10,4,6,15,10,13,0,12,17,0,0,2,5,2,8,15,9,5,0,2,2,3,0,8,3,4,2,9,4,17,5,10,10,5,13,1,4,18,23,0,0,1,0,6,12,4,3,5,6,3,4,1,7,10,4,2,9,3,5,5,7,11,7,8,1,11,6,1,10,4,4,5,1,0,26,1,6,3,25,8,8,2,8,19,9,19,3,12,8,3,2,3,3,6,2,5,10,0,23,2,8,10,9,4,2,4,7,2,7,2,2,2,11,5,4,4,4,6,6,8,2,7,1,4,6,0,0,12,1,3,10,9,15,4,6,8,10,10,10,3,1,15,2,1,1,4,2,3,1,6,5,2,0,18,6,2,9,9,4,20,8,7,1,13,1,5,2,3,4,3,2,5,6,8,0,4,1,13,0,6,4,2,2,0,3,0,4,2,0,14,3,2,16,15,8,4,5,2,1,12,0,1,2,10,14,5,0,113,3,15,4,2,25,4,0,6,1,1,0,5,4,0,1,10,0,3,5,3,5,0,15,3,0,2,6,5,0,6,7,9,5,3,3,0,8,5,2,3,0,6,2,3,6,3,15,4,12,1,4,6,0,9,12,10,6,11,11,14,5,0,1,6,0,0,4,0,3,7,8,0,4,3,8,2,0,7,6,0,8,6,0,3,4,3,0,12,15,5,7,2,10,5,19,0,3,14,4,0,2,0,256,1,0,4,10,0,0,0,11,2,4,3,6,7,3,10,6,2,4,1,1,0,10,6,9,1,3,2,4,3,9,7,2,7,0,3,3,4,13,7,8,7,9,1,1,0,3,2,5,5,7,0,2,8,6,71,10,3,17,24,1,3,4,3,0,0,1,0,0,11,3,0,9,6,12,13,2,4,6,5,5,0,4,6,4,7,4,3,3,6,3,14,0,9,0,8,1,8,2,10,5,10,211,2,7,5,4,13,5,6,8,4,2,5,4,11,3,0,15,2,7,4,2,2,4,23,12,5,8,0,3,1,0,2,0,1,25,3,0,8,6,0,0,46,2,7,2,6,0,2,3,3,3,6,1,9,1,1,4,4,14,2,2,8,4,0,8,5,7,7,9,4,0,5,6,7,4,0,9,0,0,20,5,2,0,3,1,5,0,8,0,3,5,2,2,1,12,5,13,0,0,2,9,2,3,1,3,5,7,0,6,5,2,5,3,4,4,13,17,3,4,1,0,0,0,4,6,1,0,5,3,1,1,0,54,0,3,10,0,1,3,3,4,0,0,0,2,0,22,5,4,5,9,0,4,12,2,27,4,2,5,4,3,5,3,0,3,8,0,15,7,1,5,5,0,6,4,6,6,0,2,2,2,3,4,0,6,2,0,2,1,4,3,5,7,4,5,0,0,4,0,0,5,15,1,1,1,8,5,9,0,18,5,8,4,8,0,0,3,6,1,7,2,4,3,2,0,7,15,5,1,0,0,0,5,1,8,0,5,1,8,5,6,0,0,3,3,2,6,0,21,12,5,1,3,4,2,0,2,0,4,4,2,2,1,4,9,5,1,2,0,3,1,1,10,1,2,18,2,6,2,0,0,0,5,0,3,5,1,11,5,19,5,4,2,7,0,0,2,0,0,3,0,4,1,1,1,1,1,4,7,3,17,1,3,4,4,0,3,2,10,0,8,0,4,1,3,3,3,0,15,13,4,0,3,6,2,4,1,3,1,3,0,6,9,6,4,1,3,0,3,9,0,1,0,8,0,5,3,108,1,5,1,0,1,3,1,0,7,5,4,0,2,0,0,3,3,2,4,0,1,0,4,0,0,1,5,6,12,33,2,0,14,3,0,0,4,4,0,2,0,5,9,10,7,5,3,0,2,0,8,13,5,0,18,4,4,5,22,6,8,0,9,0,9,8,0,1,14,8,4,3,12,6,6,5,7,5,0,7,2,2,2,4,1,4,1,0,1,4,6,3,12,14,6,0,2,5,5,9,5,2,3,10,0,10,6,0,2,4,5,5,16,5,3,0,0,0,0,1,1,13,0,6,0,5,5,1,2,0,1,4,3,5,5,2,0,1,7,0,3,4,2,3,2,0,2,0,1,2,1,2,5,2,4,1,42,7,1,21,2,3,4,0,3,0,3,1,15,0,0,0,1,20,2,8,2,3,3,6,3,1,1,7,4,0,0,4,0,0,1,2,8,0,5,6,3,2,2,1,4,2,1,3,2,0,0,4,3,0,1,6,1,4,1,4,4,6,5,0,0,0,0,9,2,0,3,13,1,0,3,4,1,1,0,2,11,6,6,2,5,0,11,6,5,0,0,11,2,1,0,5,41,2,2,3,3,8,7,5,4,4,5,4,0,5,3,1,3,0,5,1,0,11,0,13,0,1,4,0,3,3,4,0,3,0,0,0,1,6,3,2,2,2,8,10,9,5,1,3,0,1,1,5,15,0,0,8,2,0,0,2,5,1,5,5,1,7,1,2,6,4,6,13,9,1,0,6,2,12,1,1,3,0,2,5,3,3,0,1,0,2,1,0,4,0,3,3,5,3,0,12,0,1,4,2,1,2,0,0,1,9,3,1,2,0,1,0,2,1,1,3,2,2,5,3,2,8,2,0,0,5,5,14,3,3,3,7,4,0,4,3,2,0,10,7,5,5,3,3,3,1,0,3,8,7,3,6,6,0,2,8,1,3,2,2,0,4,5,2,8,5,5,2,3,1,0,1,8,6,2,4,19,5,3,0,6,1,1,0,4,0,0,7,1,2,8,2,2,8,0,2,6,1,0,6,1,2,58,0,14,0,0,1,0,0,0,8,0,3,0,2,4,0,2,0,1,6,0,2,8,1,5,0,0,0,3,8,7,3,0,10,0,0,0,3,0,11,4,1,1,8,2,0,5,2,3,0,0,4,1,0,8,0,11,0,0,4,5,5,1,3,3,4,5,2,1,1,0,2,5,0,0,1,0,0,2,0,2,2,0,9,65,3,3,3,7,3,4,0,1,4,2,5,3,1,5,0,1,5,1,2,6,7,6,1,0,1,3,4,1,27,1,0,5,4,0,3,0,2,0,4,3,1,0,4,0,7,0,4,0,5,2,1,5,3,11,2,1,0,3,1,0,2,4,4,1,3,0,10,0,0,10,1,9,2,0,6,0,7,5,11,0,4,5,8,4,1,0,2,1,3,7,2,2,0,2,4,2,0,3,12,1,0,0,1,1,11,15,0,3,1,1,0,2,12,1,0,1,5,0,6,1,1,1,7,0,7,5,2,3,3,12,0,0,6,3,0,0,1,1,2,0,9,1,1,2,1,0,3,1,0,3,4,7,0,7,2,0,2,0,0,7,1,0,3,0,4,3,0,4,0,4,5,7,4,0,5,8,1,3,0,4,5,3,0,0,0,2,1,3,0,5,6,2,1,3,1,2,7,8,2,6,1,1,0,4,4,4,3,5,5,0,0,23,0,3,2,0,10,0,5,3,4,1,4,1,4,2,1,8,0,2,6,3,3,0,2,1,4,6,4,16,3,7,0,1,3,3,0,4,2,0,2,6,1,3,7,1,1,0,0,2,4,1,1,0,3,4,0,0,4,12,0,2,0,4,5,6,0,6,2,0,9,1,1,5,2,1,1,11,1,1,0,4,6,0,2,0,3,0,0,2,5,7,1,1,4,3,3,8,1,3,8,2,4,3,0,2,2,0,11,6,0,0,2,1,2,2,10,0,3,2,11,5,2,5,1,1,2,0,2,0,1,7,1,2,9,1,2,1,0,1,2,3,4,9,0,3,2,0,0,3,9,1,0,2,2,0,2,4,0,4,0,4,1,5,4,0,2,1,2,0,6,12,6,2,3,9,0,1,0,4,0,0,0,5,0,6,11,6,0,0,0,3,0,0,0,3,3,5,3,4,1,4,1,3,4,0,2,0,2,0,2,1,2,4,3,2,4,4,1,0,5,0,0,6,0,4,0,5,3,4,3,23,4,3,7,1,0,0,4,9,4,6,0,3,0,0,0,3,3,3,1,0,5,0,6,0,5,0,1,0,0,5,2,1,0,7,0,2,2,2,3,0,1,0,3,5,2,2,0,4,12,5,1,0,0,2,3,1,1,1,8,0,1,0,5,1,1,4,1,0,5,10,1,4,0,8,1,0,3,6,11,3,3,3,1,0,2,22,7,1,6,1,1,3,4,1,4,5,1,2,8,1,1,1,7,1,2,1,0,1,10,0,2,1,0,0,1,2,1,10,3,4,1,2,3,5,4,10,0,1,1,0,0,4,0,0,3,0,2,0,0,0,0,2,3,2,8,1,1,0,11,3,8,1,2,1,3,7,2,2,0,4,1,0,3,1,1,1,8,2,8,1,0,0,2,0,3,2,0,0,0,0,0,3,0,7,1,2,3,3,0,1,0,1,1,1,2,0,7,1,1,1,3,1,0,0,0,2,1,2,0,8,4,2,0,1,9,2,0,0,1,13,0,1,1,0,1,0,2,0,2,1,1,0,9,0,1,7,3,0,3,0,3,4,3,0,3,3,0,0,5,1,0,3,4,0,1,3,0,3,0,11,1,0,1,5,2,3,3,1,0,2,0,3,5,1,8,0,3,1,0,1,0,6,0,2,1,0,1,3,6,3,0,1,0,3,2,4,6,0,3,0,1,1,3,0,0,0,6,1,0,0,1,2,2,0,1,1,1,3,2,1,0,3,0,2,0,5,7,1,5,3,0,0,4,1,1,4,2,4,2,3,3,0,3,0,5,0,0,9,1,4,1,6,0,4,3,7,4,0,6,4,1,0,1,0,4,2,1,0,14,4,4,0,3,8,2,3,7,3,4,0,5,3,0,7,9,4,3,3,2,5,1,3,3,1,4,5,2,0,0,1,2,0,1,2,0,0,1,4,2,1,2,2,2,0,3,3,12,0,1,0,0,0,1,8,0,1,3,2,2,0,0,2,6,0,0,3,1,0,4,0,2,6,1,5,0,4,4,1,0,4,3,7,2,3,1,0,8,0,3,4,0,0,0,5,0,0,0,0,2,1,4,1,1,4,3,1,5,0,2,0,0,3,1,2,0,1,1,1,5,4,12,1,0,0,2,3,3,2,2,4,1,0,1,7,1,1,0,3,6,2,4,4,0,1,3,3,4,3,1,6,7,1,1,0,8,0,1,0,10,8,1,1,0,1,17,0,2,2,1,1,1,0,11,0,3,3,5,1,0,0,6,1,3,2,0,0,2,5,2,0,1,2,0,3,5,4,2,0,0,3,2,1,1,1,4,5,9,4,6,0,5,1,1,0,0,0,0,1,8,3,3,1,0,2,0,4,10,0,5,0,3,1,1,1,0,0,1,0,2,2,1,3,1,1,6,5,1,8,0,3,0,5,0,5,1,2,3,4,2,0,0,10,16,6,0,1,0,3,0,3,4,1,2,2,0,1,0,2,10,0,0,3,4,0,0,6,0,1,6,1,2,0,0,0,176,5,0,3,0,0,0,1,9,2,0,1,0,0,0,4,1,1,0,2,0,4,2,16,0,0,0,1,5,2,1,2,6,1,0,3,2,1,5,0,4,1,0,2,2,0,3,1,5,1,0,6,2,3,0,0,6,2,1,5,5,0,1,1,0,0,0,4,0,1,1,1,1,1,0,4,1,0,3,0,1,2,0,0,1,1,7,1,1,9,1,0,1,3,3,2,2,0,1,7,0,0,0,1,1,2,2,0,0,5,8,9,0,2,5,1,0,6,1,1,1,2,0,3,2,0,0,4,2,99,0,2,3,0,4,0,1,9,0,2,1,5,0,1,0,1,1,0,3,1,1,2,2,1,0,0,1,1,3,0,0,0,0,2,1,6,3,9,1,0,1,2,2,1,4,2,2,3,1,5,2,1,1,0,1,3,0,4,3,1,0,0,0,0,5,0,0,0,0,2,1,2,0,0,1,1,3,4,9,0,4,0,1,1,0,2,0,0,4,2,0,3,2,3,1,0,0,7,6,3,0,0,0,0,5,2,8,0,5,2,1,4,1,3,0,0,7,1,0,6,2,4,16,8,3,0,1,0,2,0,0,0,2,0,0,1,3,4,1,2,1,3,0,0,0,0,7,0,1,0,3,0,1,0,0,7,0,0,0,1,165,0,6,5,1,1,13,0,2,5,0,0,1,0,0,0,6,0,161,0,1,0,4,0,0,0,0,7,0,0,0,0,106,0,0,0,0,115,0,0,5,0,0,0,5,91,1,0,0,143,0,0,0,0,2,0,0,0,0,0,3,0,0,0,0,0,0,0,0,0,0,0,0,0,0,0,0,1,0,0,0,0,0,0,0,0,0,0,0,0,0,0,0,0
"1980 Crichton, Michael, Congo",pop,5629,2049,1894,1778,1802,230,1039,1454,1492,740,303,497,846,780,556,574,778,512,534,810,571,481,477,207,30,424,38,808,188,223,403,192,241,295,315,183,527,261,253,211,161,174,243,318,134,156,203,140,214,188,170,266,200,187,284,297,170,83,124,97,129,76,83,186,63,133,286,166,176,157,76,30,62,78,65,170,122,49,73,63,95,113,88,65,69,78,91,77,88,87,36,79,142,115,54,73,98,95,63,101,78,38,65,119,59,163,77,76,57,59,76,44,50,90,119,26,92,60,70,88,98,65,68,36,28,35,58,62,57,39,101,87,69,32,49,61,50,47,37,88,17,73,2,35,71,46,58,27,50,16,67,88,61,89,50,24,43,89,72,32,81,52,20,37,46,78,45,35,41,48,7,102,43,27,7,91,46,46,42,42,29,36,70,103,13,21,33,60,21,37,19,38,41,42,54,24,4,52,14,14,42,74,75,44,37,4,67,74,16,13,14,47,92,36,35,47,49,44,18,19,40,85,33,58,16,51,31,14,29,14,41,48,26,27,34,0,27,29,43,48,35,8,17,36,73,25,66,26,14,32,33,69,25,14,90,22,30,27,23,77,20,12,29,41,36,2,15,27,72,45,9,22,31,38,21,56,68,16,17,12,30,6,3,7,21,2,27,5,32,61,17,12,7,17,24,30,17,17,34,6,52,12,9,30,58,24,12,11,49,28,34,3,6,21,43,19,66,39,29,28,32,22,24,3,22,14,14,17,17,13,7,17,42,19,3,12,36,12,16,29,29,24,46,21,19,45,17,0,16,20,43,32,16,22,42,4,35,6,31,24,52,22,16,14,40,14,26,42,34,14,47,9,46,0,57,16,12,1,8,16,10,9,62,38,103,7,0,17,21,30,0,14,10,1,16,11,24,23,21,30,4,21,10,9,13,10,38,8,14,8,30,16,10,7,24,32,25,9,41,33,14,0,1,11,19,26,12,5,16,4,14,11,3,14,8,20,18,14,22,22,38,10,23,24,8,9,17,22,23,14,9,28,18,22,7,13,15,1,23,31,16,1,0,94,14,8,8,28,2,19,61,13,26,0,18,24,103,11,0,8,27,6,14,22,10,22,15,7,8,18,22,20,28,14,17,39,17,20,36,4,9,26,5,19,20,22,6,39,20,3,40,18,12,24,4,13,0,9,14,14,17,11,11,9,22,18,6,12,15,5,4,10,17,8,8,1,21,16,28,43,24,2,26,11,9,33,0,1,38,0,43,33,10,2,2,5,3,8,24,0,2,14,26,5,16,9,8,47,7,21,6,8,9,3,6,12,11,0,7,5,13,7,5,11,0,21,6,10,8,16,14,34,24,13,22,7,22,15,15,11,11,11,7,118,38,0,1,9,4,10,7,43,18,19,0,9,12,4,6,48,6,5,2,10,23,4,20,14,19,2,1,28,14,1,10,0,11,11,10,9,8,6,6,13,0,4,23,7,8,10,0,9,11,7,20,5,15,14,18,21,26,8,9,9,1,11,5,3,13,12,9,7,29,10,15,11,8,12,9,11,17,4,40,2,4,6,32,14,16,44,12,5,12,4,1,22,2,14,8,44,4,7,8,11,1,4,0,48,19,29,3,14,42,16,10,2,24,19,5,12,0,3,23,3,16,21,9,1,18,34,6,13,67,24,0,3,7,23,12,7,10,13,6,1,5,1,4,7,10,66,0,11,4,15,32,23,11,2,22,17,31,3,23,5,8,0,8,16,6,11,8,9,0,0,13,12,8,7,2,12,20,6,38,0,8,7,13,3,4,5,4,3,0,9,21,5,0,14,0,13,18,2,11,13,15,31,54,27,19,0,29,11,7,0,9,3,3,0,6,1,21,8,22,12,12,14,10,12,21,16,15,0,1,7,2,14,3,5,0,8,7,2,8,10,4,17,8,0,16,16,7,3,2,15,14,2,8,74,4,12,11,15,2,12,10,16,3,108,2,15,10,25,3,2,0,0,21,8,11,4,12,1,27,14,6,5,6,7,1,7,17,25,0,16,15,7,23,0,31,10,8,1,13,1,2,1,12,7,12,18,9,0,5,0,2,3,8,7,0,1,4,1,7,10,3,18,12,1,0,0,0,9,7,0,5,2,5,11,6,5,8,0,2,12,16,13,1,6,3,6,18,5,4,0,3,18,0,5,6,0,629,7,2,1,7,10,21,1,15,4,9,0,21,4,6,3,2,11,7,125,1,4,6,9,0,1,7,1,17,1,13,15,8,9,1,27,1,16,1,0,5,0,7,0,16,7,0,0,7,1,4,19,0,2,0,5,6,0,4,4,3,11,1,0,4,8,11,0,9,7,2,5,6,10,8,0,3,1,13,1,6,4,0,4,10,13,5,5,18,2,11,5,1,5,7,0,8,7,8,1,5,2,0,3,1,2,11,1,0,0,557,1,11,4,1,20,4,0,2,12,26,3,6,3,3,4,9,14,8,0,14,0,18,6,4,4,5,13,6,11,1,10,2,14,7,1,1,3,22,11,7,6,8,8,0,0,31,0,5,10,1,2,0,2,6,1,4,6,1,105,10,1,8,1,1,10,4,8,7,3,2,0,2,6,15,1,7,8,4,27,21,3,27,17,14,11,1,2,34,7,0,9,13,1,0,7,0,6,0,1,0,8,1,15,14,7,60,14,28,0,1,16,4,6,15,2,0,1,15,0,4,14,0,16,20,1,5,1,1,13,3,0,11,9,15,14,0,19,3,16,0,2,5,7,1,0,509,3,4,13,11,1,3,7,13,3,7,0,2,4,11,8,0,5,0,0,7,0,8,16,6,10,3,475,16,42,0,5,2,1,8,18,7,2,4,4,23,2,0,10,4,0,4,8,0,11,6,2,5,5,1,9,0,7,0,0,9,5,0,0,0,10,13,0,7,1,4,0,6,24,0,7,11,6,2,5,1,1,0,11,4,8,12,4,6,4,0,82,0,80,1,0,9,3,2,4,3,0,7,6,6,5,20,0,2,0,5,8,17,3,3,5,12,28,0,9,26,1,5,4,7,2,1,0,3,1,19,3,6,1,7,92,10,1,3,3,2,3,10,2,8,5,19,0,17,6,11,22,10,4,0,28,13,1,1,0,0,0,0,0,1,0,3,2,3,2,0,6,0,6,0,1,8,5,1,37,7,0,0,10,0,0,0,6,0,1,1,0,12,0,3,4,2,2,2,6,5,8,9,4,3,9,5,6,3,5,0,0,6,0,4,7,0,0,1,9,1,10,1,23,3,4,6,3,0,3,1,1,7,12,13,6,0,3,5,0,5,9,1,0,1,15,4,0,0,2,6,0,1,0,5,19,8,9,0,2,3,1,0,4,6,1,0,3,0,7,6,2,0,15,3,7,5,17,4,0,0,0,8,2,6,0,3,0,0,4,0,11,8,1,7,13,1,0,19,7,3,0,1,11,9,7,5,2,7,17,2,4,1,0,4,6,6,2,2,0,5,1,10,1,1,4,1,2,6,4,5,0,4,0,7,5,3,4,1,2,1,73,4,1,5,15,1,4,1,3,22,0,13,1,11,4,9,0,41,0,2,0,11,8,5,0,2,6,4,5,1,5,0,3,0,3,20,3,15,1,6,0,3,19,0,0,0,2,4,6,5,10,6,3,0,13,1,1,13,2,0,0,0,4,4,5,1,0,0,2,4,1,3,0,5,1,0,1,0,30,25,3,9,12,4,2,6,10,0,1,2,8,4,10,0,6,5,0,1,7,3,12,8,4,4,14,10,8,0,6,1,0,1,1,1,2,2,4,16,4,0,3,1,6,1,5,3,10,10,0,0,2,1,0,7,0,9,0,1,2,1,19,0,2,4,1,4,38,19,0,2,4,1,11,1,0,0,3,3,9,0,8,0,4,0,2,3,0,7,12,5,0,1,26,4,1,20,1,3,1,0,12,8,3,10,0,14,6,0,12,4,1,1,16,2,10,1,1,21,3,0,4,3,2,0,0,4,0,4,2,0,8,11,0,11,5,0,3,9,3,0,17,0,4,3,0,3,2,5,17,5,1,3,1,2,6,0,4,9,0,4,1,4,3,11,11,0,3,0,1,1,15,2,7,4,4,11,1,12,6,3,2,1,3,4,5,0,0,12,2,0,2,0,2,0,10,2,1,1,3,4,4,1,6,4,7,0,4,1,4,11,2,3,0,0,6,7,1,1,4,0,8,2,5,2,3,0,0,0,5,7,1,0,7,6,3,0,10,0,5,2,0,3,5,0,0,1,3,7,5,5,27,11,0,8,1,0,5,5,31,1,3,1,7,0,8,5,4,0,3,3,14,6,8,0,3,1,0,2,14,1,2,3,12,0,0,0,0,1,11,8,0,9,1,0,0,2,3,3,0,2,2,0,1,2,8,0,10,0,3,1,0,0,0,0,12,1,2,123,7,0,9,0,21,6,6,2,2,1,3,78,6,3,0,4,3,60,0,0,3,1,1,6,3,0,1,5,6,1,2,2,4,6,32,3,0,12,0,1,3,0,0,3,16,1,0,11,1,1,6,11,0,2,0,2,0,0,0,3,5,1,6,1,3,4,0,14,2,0,0,3,0,6,0,10,2,5,5,0,8,11,13,7,0,3,4,4,0,12,1,10,0,0,0,4,9,0,12,11,2,11,7,3,12,3,9,3,10,0,1,3,2,0,1,0,0,0,3,0,0,5,0,0,3,6,5,0,7,2,4,48,0,1,1,10,3,0,1,9,4,2,4,4,9,36,2,1,1,10,6,0,0,0,5,0,1,0,5,2,2,1,8,0,0,1,0,5,5,0,0,2,3,2,3,8,2,0,1,0,3,2,4,0,0,9,0,5,0,1,1,0,1,0,0,0,1,0,0,2,0,1,4,4,1,0,3,4,29,10,2,0,0,2,42,1,18,4,0,2,0,0,3,1,2,1,0,0,0,0,16,4,10,1,12,2,7,6,6,0,9,5,10,2,1,0,6,10,1,18,0,0,0,2,0,5,3,2,3,0,19,23,4,7,17,14,4,7,6,4,4,5,16,4,0,0,15,10,5,0,5,7,1,1,0,2,5,0,1,0,4,3,0,2,5,7,11,1,4,6,6,2,4,3,2,0,7,1,2,0,3,1,1,1,2,3,0,6,6,0,0,2,1,0,0,0,5,0,6,6,4,3,22,2,1,2,5,2,1,0,5,0,1,6,18,2,0,7,7,1,7,5,7,1,4,1,1,1,1,0,9,1,8,1,3,2,0,0,51,4,9,0,6,5,9,0,0,0,6,0,2,3,1,1,0,6,3,5,9,2,1,4,3,2,0,2,2,7,3,2,5,6,14,2,0,6,3,3,1,0,0,1,0,21,5,2,1,0,0,1,0,0,2,11,5,0,3,0,2,2,0,8,0,1,2,6,6,7,1,1,0,0,0,2,2,9,4,2,0,0,1,0,0,2,2,4,1,1,0,0,0,0,5,0,6,2,4,3,1,0,0,0,2,1,1,14,1,0,0,1,5,7,1,0,5,0,1,0,0,5,0,0,0,6,1,5,20,0,5,1,12,5,0,1,3,6,6,1,1,1,4,0,2,3,0,0,1,2,6,10,2,0,4,2,3,24,1,8,2,0,1,3,0,5,0,2,0,0,4,1,8,0,4,0,9,1,3,3,8,0,1,0,0,2,6,5,0,210,1,0,1,0,4,4,2,2,4,2,2,1,6,0,0,2,5,5,0,1,0,9,1,0,3,0,0,3,0,1,2,1,4,8,3,8,2,5,2,0,8,1,2,6,5,0,12,2,0,9,7,34,6,7,9,2,0,4,0,0,0,0,0,0,0,0,14,7,1,5,1,5,9,0,0,0,3,3,8,10,2,5,12,0,2,1,6,4,1,1,1,0,10,11,4,6,0,6,0,13,0,1,8,2,10,9,0,2,4,7,3,1,4,6,5,7,3,6,0,0,1,5,7,0,10,2,0,6,0,1,2,0,0,2,0,0,0,0,2,0,2,5,0,0,9,5,2,12,0,1,0,7,5,0,0,0,8,0,1,14,0,0,1,4,8,1,0,1,0,2,3,0,5,0,6,3,1,3,0,4,2,1,0,10,1,0,0,2,0,3,3,5,3,2,1,1,0,1,12,4,4,0,1,5,0,3,0,2,2,0,0,10,10,2,0,0,1,3,0,4,2,1,0,1,4,0,0,1,0,1,8,8,0,1,1,3,4,0,0,3,2,1,0,2,0,0,2,11,6,0,6,0,0,0,1,4,0,9,0,0,2,1,0,2,0,3,3,0,9,3,4,1,3,11,2,3,0,3,1,0,1,0,0,2,5,0,3,5,2,1,7,0,0,0,0,1,0,0,1,2,1,5,1,3,0,7,0,6,1,1,3,1,2,9,3,2,2,1,7,0,1,6,10,1,5,8,0,7,9,14,0,33,1,0,8,5,0,0,1,4,4,5,1,2,2,1,4,3,3,10,0,0,4,0,1,7,5,0,10,0,1,3,4,1,0,0,0,13,4,0,1,0,1,23,1,2,0,0,8,0,4,3,0,3,4,3,0,6,0,13,0,22,0,0,0,1,3,2,0,1,4,0,3,1,3,1,2,0,0,5,3,0,5,1,1,1,0,0,1,0,1,2,6,2,3,3,5,0,0,4,4,3,0,2,1,0,0,0,0,8,0,0,5,4,2,2,0,0,2,1,0,2,1,0,0,5,0,0,7,0,2,4,0,2,0,0,0,0,0,2,0,2,0,0,9,0,1,70,0,0,2,0,1,2,7,0,5,0,164,0,1,8,5,0,0,7,2,0,0,5,0,0,3,0,9,6,2,0,0,2,2,0,2,6,3,1,3,0,8,4,0,1,7,1,4,15,8,1,2,0,3,2,0,1,6,8,1,1,0,1,3,3,3,0,8,0,3,0,10,0,1,5,0,1,6,0,3,5,0,5,2,0,0,1,0,2,1,1,2,0,0,5,2,0,0,0,0,0,0,0,0,1,1,1,4,2,2,3,1,1,11,4,3,1,0,5,0,14,2,0,0,0,2,9,3,1,1,2,2,5,3,1,0,0,4,2,2,0,0,1,3,0,3,1,0,0,1,0,15,6,2,0,1,1,0,0,2,0,2,0,102,0,11,0,0,15,1,0,1,7,0,12,1,4,0,3,0,0,7,0,0,0,0,1,5,0,1,7,0,1,1,1,0,1,0,3,5,5,9,0,0,0,3,0,4,2,8,0,0,2,6,1,8,3,2,4,0,1,1,1,2,2,0,2,0,0,0,10,1,0,1,0,3,11,4,1,1,7,0,0,2,7,0,0,7,5,0,1,0,0,0,0,4,5,11,0,0,0,5,0,2,2,0,5,0,1,0,5,7,10,1,0,1,0,1,2,0,1,5,1,0,2,0,0,4,1,1,3,2,0,5,5,5,5,0,0,0,0,0,1,2,2,5,3,3,8,6,0,3,2,19,2,12,0,0,0,2,0,0,7,2,2,3,7,0,4,0,11,5,3,1,2,0,0,1,0,2,1,0,3,0,0,1,0,7,0,3,1,0,10,0,1,0,0,0,6,4,1,1,2,1,2,7,0,3,1,0,7,0,0,3,2,3,1,0,2,0,8,10,1,1,1,1,0,3,0,0,0,0,5,3,4,0,0,3,4,1,2,0,0,1,0,1,0,1,0,1,0,7,3,3,1,6,0,2,1,0,0,0,2,0,5,0,5,8,1,0,1,0,1,0,2,0,0,0,0,140,3,6,0,2,1,2,0,0,0,0,1,10,2,0,0,0,6,10,0,1,0,0,1,6,9,1,4,0,2,0,7,1,1,0,5,1,1,1,0,0,0,1,3,3,2,0,1,4,0,5,0,1,2,0,0,5,2,2,4,0,1,9,0,6,2,4,7,1,0,1,1,0,0,2,66,0,0,0,4,0,0,4,0,0,1,6,7,0,3,3,0,1,2,3,1,2,4,2,5,0,1,3,3,2,0,6,6,0,0,5,0,3,0,0,4,2,0,0,0,2,5,0,1,0,1,9,1,0,2,0,0,1,1,4,2,0,4,11,0,0,1,2,1,6,1,1,0,0,0,4,5,0,1,1,0,1,1,1,9,0,1,2,1,1,0,1,6,0,3,0,0,0,0,0,2,3,0,29,4,7,6,0,0,0,2,0,1,0,1,2,0,1,2,0,0,0,0,1,0,1,0,1,3,0,0,1,5,7,0,2,0,0,16,2,0,0,0,0,1,2,2,8,3,0,3,6,0,3,0,2,0,0,0,1,3,10,8,0,6,7,3,0,0,0,1,0,0,1,1,0,1,2,0,32,1,1,2,1,3,2,0,0,0,0,0,3,0,1,2,4,1,0,1,1,2,4,5,5,0,2,0,0,3,0,3,0,2,0,0,5,0,0,0,4,0,0,0,4,0,0,4,3,1,1,1,0,0,0,0,0,2,0,1,0,2,1,0,18,0,0,0,5,3,2,5,0,2,0,14,0,3,3,2,0,0,0,1,0,22,2,1,1,3,0,0,2,0,0,3,6,0,0,7,1,1,20,0,3,0,0,1,0,1,7,2,11,0,6,2,2,0,1,5,0,0,0,1,0,4,2,6,0,3,4,0,0,0,0,4,0,20,0,0,1,0,4,0,0,0,1,0,1,2,2,1,0,3,0,1,3,0,3,6,18,0,4,1,0,6,7,0,0,1,3,0,1,1,4,2,0,1,3,5,3,0,5,1,0,15,0,1,1,0,2,0,5,0,4,0,1,0,0,0,4,1,3,3,0,0,0,1,1,0,2,20,2,0,0,7,0,0,0,0,1,0,0,3,3,3,0,0,3,0,9,18,0,1,0,4,0,3,2,2,3,2,1,2,0,0,0,0,7,1,2,6,10,1,0,3,0,3,0,0,1,1,0,2,1,3,0,3,0,0,1,1,0,3,1,0,2,5,6,0,1,0,0,4,1,2,10,2,2,0,0,0,0,0,1,5,0,0,2,1,2,12,0,0,0,0,0,2,0,0,0,3,3,1,2,2,6,1,2,21,4,3,1,0,0,35,1,0,0,0,0,5,2,0,3,0,0,0,2,1,0,19,0,0,0,0,3,0,0,7,16,3,0,1,0,1,0,0,0,1,3,1,3,2,5,2,0,1,3,1,6,2,3,4,0,0,0,9,0,0,2,0,0,5,0,0,0,0,5,0,0,1,1,1,1,3,0,10,2,8,7,5,1,1,11,1,0,0,1,3,1,2,0,1,1,1,0,0,0,3,1,2,0,1,8,0,1,1,0,4,0,1,0,2,0,1,0,3,1,2,1,0,0,2,0,0,0,10,1,0,2,0,1,5,0,0,0,0,3,0,1,0,0,0,1,3,1,1,4,1,4,0,0,0,0,4,0,0,0,0,1,0,0,4,6,0,0,0,0,11,0,2,0,0,0,2,0,0,0,2,0,1,0,3,11,2,0,2,1,0,0,2,0,2,0,3,5,0,1,3,3,4,0,0,8,8,2,2,0,0,0,0,0,6,1,6,0,0,2,5,0,0,0,6,0,3,4,0,7,1,0,4,0,0,0,0,3,6,0,0,1,0,0,1,3,2,0,0,4,0,1,0,6,0,2,1,0,0,1,2,0,4,0,0,0,7,1,1,1,1,2,0,1,2,1,1,3,8,1,0,4,0,6,0,0,3,3,0,1,7,0,0,0,1,0,0,0,2,5,0,0,0,1,1,0,1,0,1,3,0,0,0,0,1,1,0,0,0,3,1,0,2,2,4,3,1,1,3,0,0,0,1,4,1,1,0,0,0,4,2,6,3,4,0,0,5,0,0,0,1,0,0,0,2,1,0,0,1,0,1,1,1,3,1,2,6,0,2,0,0,30,1,0,4,3,1,4,3,0,0,1,1,3,0,6,0,0,3,0,0,1,0,1,3,7,2,0,0,0,2,6,2,3,3,23,4,2,1,0,0,0,0,0,0,0,0,0,2,0,1,2,1,0,0,0,0,0,0,0,0,5,0,3,3,5,2,0,1,0,0,1,0,1,8,2,1,1,1,0,1,0,0,3,0,0,3,9,5,5,12,0,0,1,5,3,7,13,1,0,0,0,0,6,2,0,0,0,8,6,1,12,0,1,1,0,1,16,0,2,3,3,3,1,1,2,0,1,0,0,1,1,5,3,0,0,0,0,1,0,0,4,1,1,0,1,0,0,0,5,0,1,0,0,1,0,1,1,2,0,2,4,1,1,0,0,2,7,2,9,3,1,6,2,0,0,5,0,0,1,7,1,4,6,2,3,0,0,2,1,3,2,0,1,1,1,0,0,3,0,3,0,0,0,1,3,1,6,1,7,0,1,4,4,0,0,0,7,0,4,0,6,0,0,0,1,3,0,2,0,6,0,1,0,0,2,0,0,1,1,0,1,2,0,0,7,2,5,0,2,0,1,3,1,0,0,0,0,0,3,0,7,34,1,9,2,0,1,0,0,0,5,3,0,1,3,0,4,2,1,4,0,9,5,0,1,6,0,4,0,0,0,1,1,1,0,0,2,4,2,0,2,1,1,0,0,0,9,0,3,7,0,1,1,1,3,2,7,0,2,0,3,1,0,1,0,2,1,3,1,3,0,1,0,2,1,0,0,2,1,3,1,0,0,2,3,0,1,0,2,0,0,0,6,6,0,0,0,2,0,0,0,0,0,7,0,3,3,0,0,1,2,0,0,0,0,0,6,2,0,3,1,0,1,4,2,1,1,0,5,1,1,2,2,1,4,0,4,1,2,0,5,5,5,0,0,0,4,0,2,1,0,1,2,0,3,1,3,0,2,0,1,0,2,0,5,1,0,0,4,0,3,1,0,0,0,0,4,0,1,2,0,0,0,2,3,0,0,0,2,0,0,2,0,1,0,4,0,0,1,1,1,5,5,1,2,5,1,0,0,0,10,1,1,0,0,0,1,2,0,0,0,0,1,0,3,2,0,0,0,0,4,0,0,1,3,1,2,2,2,1,1,0,0,1,0,3,1,0,2,0,1,0,3,8,6,0,6,3,2,0,0,2,0,1,0,1,2,1,0,0,0,0,4,0,0,1,1,3,1,2,10,3,0,0,0,5,0,0,4,0,3,0,1,0,4,0,0,1,2,0,0,0,3,0,0,0,0,0,0,0,0,1,0,0,0,2,0,0,1,0,0,0,0,0,0,0,0,0,0,0,1,0,0,0,0,0,0,0,0,0,0,0,0,0,2,1,0,0,0,0,0,1,0,0,0,0,0,0,0,0,0,0,0,0,0,0,0
"1981 HarrisT, Thomas, Red Dragon",pop,6935,2451,2408,2422,1730,1085,2582,1947,1509,1481,1460,1487,709,826,767,1069,797,759,627,562,651,349,440,840,152,393,394,438,381,290,461,361,369,314,294,475,410,275,230,269,282,230,317,281,288,344,175,181,261,147,278,298,349,173,233,166,151,269,338,174,237,253,101,251,179,202,111,215,156,278,219,152,150,239,199,78,139,190,176,175,169,169,96,158,118,137,154,187,41,123,103,159,91,151,178,118,143,102,136,152,116,85,68,74,101,36,91,91,170,124,123,70,48,123,92,139,100,79,113,85,64,187,128,94,141,81,103,114,119,108,144,162,131,115,126,89,20,169,118,99,203,67,35,78,54,179,70,89,93,81,63,77,76,30,74,143,80,75,73,61,69,104,47,75,91,50,41,89,67,53,47,43,29,152,57,26,20,54,62,81,47,77,93,89,79,94,82,66,70,28,56,45,36,58,35,76,17,52,60,68,58,30,76,32,23,124,51,25,56,72,55,89,17,63,77,31,105,38,48,62,23,39,44,72,75,92,35,35,66,41,20,77,70,80,56,4,67,41,64,39,74,50,38,24,27,55,45,26,21,52,57,34,38,36,50,61,20,50,61,13,50,69,41,22,8,25,41,42,32,38,58,30,26,40,42,23,34,69,48,35,70,71,57,43,14,28,32,61,22,48,31,16,41,12,65,36,66,38,11,52,32,26,54,39,27,44,18,17,42,34,29,11,24,19,4,64,55,51,38,38,58,42,26,36,15,52,47,12,45,40,29,17,27,39,26,25,36,49,48,27,21,32,32,80,24,32,29,17,32,22,8,51,24,39,24,26,52,11,42,7,7,31,44,20,12,8,26,21,26,15,15,52,28,41,21,31,19,18,19,40,42,31,15,15,27,79,0,12,44,16,22,16,12,29,28,19,29,44,27,29,23,32,27,13,22,8,14,20,23,17,37,29,30,9,25,7,18,25,26,6,18,0,24,14,25,33,4,56,34,25,19,30,41,17,1,41,49,12,116,23,39,13,43,15,30,28,12,40,42,20,17,27,12,11,14,41,23,13,32,27,29,18,0,18,12,22,63,23,10,24,25,21,26,2,9,13,34,19,0,13,14,11,19,10,38,30,11,17,11,34,23,33,20,14,7,21,23,29,2,12,29,31,38,23,27,30,9,7,27,15,18,41,12,24,11,12,0,41,6,16,26,15,22,15,9,15,38,20,30,9,3,33,20,28,20,0,15,6,16,7,20,12,11,35,15,40,0,3,5,16,14,23,29,6,31,11,24,10,22,15,22,52,12,89,24,9,25,11,9,7,14,38,32,16,18,23,29,4,17,3,13,9,15,14,59,13,31,20,13,3,9,19,43,13,40,20,19,7,17,9,18,18,9,2,6,0,0,21,17,17,22,4,5,14,1,12,26,5,24,11,15,18,6,15,30,25,29,17,34,9,27,10,18,11,28,0,33,11,12,10,17,6,22,10,5,7,11,10,24,16,0,15,4,6,7,31,17,15,29,4,12,25,24,17,44,15,12,23,11,16,18,19,19,6,12,10,15,4,7,14,48,32,9,15,13,7,8,5,16,5,8,12,3,19,18,6,2,8,12,3,14,25,66,11,22,13,7,11,32,9,20,20,9,21,9,8,15,3,25,20,8,22,6,6,31,16,13,6,3,26,14,14,10,10,0,18,14,9,7,5,27,40,6,26,0,0,15,24,6,16,15,21,25,7,9,27,26,5,7,29,10,11,12,11,11,5,6,16,7,7,14,13,8,30,2,11,6,22,5,3,14,1,7,13,4,5,16,19,12,15,7,23,1,22,28,21,37,16,4,12,30,7,5,12,13,3,0,12,21,3,6,5,9,10,13,7,9,1,11,4,3,21,4,8,9,5,12,19,4,8,1,73,12,20,21,9,14,8,0,11,15,7,28,10,24,9,23,3,9,8,15,18,8,17,5,13,6,28,6,6,23,8,10,8,2,7,12,0,15,13,10,16,5,8,0,8,20,7,3,11,13,6,11,13,2,10,9,8,4,8,12,4,24,25,20,11,3,0,5,7,18,7,18,11,2,6,3,2,12,17,8,0,22,0,6,10,2,9,23,31,5,7,7,16,4,6,6,1,9,5,10,0,15,53,21,5,14,4,15,9,22,12,12,7,13,4,23,7,7,17,4,10,11,6,0,6,14,11,6,2,0,15,26,2,15,6,2,1,6,7,8,1,8,48,5,17,10,5,15,1,0,17,26,18,17,16,6,0,9,11,20,10,9,18,6,6,0,14,0,0,10,0,8,3,14,6,0,0,3,4,9,3,12,4,21,2,5,0,9,10,6,15,14,8,1,17,4,39,10,21,16,26,11,0,11,13,7,8,3,8,20,6,19,4,5,4,10,7,5,11,1,20,2,20,11,0,14,6,2,11,4,10,0,9,7,22,4,21,0,0,0,17,8,5,12,11,17,0,3,2,26,2,16,14,9,13,8,7,3,2,24,0,3,12,15,15,2,7,6,17,7,13,25,11,10,9,11,5,16,9,24,2,11,8,0,62,8,11,6,17,9,5,7,14,14,3,27,2,4,2,6,4,6,2,4,7,6,11,6,8,10,0,18,13,17,6,13,5,9,5,9,44,6,12,3,3,21,11,2,8,1,3,2,3,0,10,0,1,0,8,5,21,4,7,2,4,1,0,6,0,9,9,5,2,1,7,0,7,6,0,7,5,0,14,7,7,4,3,0,6,5,0,2,3,1,4,0,2,21,3,616,7,3,13,2,0,0,4,9,1,5,4,6,10,5,5,12,9,5,9,7,5,1,17,13,0,3,4,7,7,3,3,10,0,4,3,0,11,7,14,16,3,15,4,0,3,1,1,3,6,13,0,17,10,0,6,15,2,6,2,6,10,4,8,0,5,3,9,0,1,3,4,4,8,8,5,5,11,7,24,0,8,1,10,2,11,9,10,1,66,3,9,3,1,5,13,4,5,11,2,2,3,4,3,3,6,11,1,8,10,9,13,32,0,7,5,4,15,4,13,6,10,10,2,31,5,10,17,0,5,10,9,8,0,1,8,3,3,8,14,20,2,7,12,8,0,6,9,8,7,8,3,7,0,4,5,3,3,6,6,6,5,6,8,12,0,0,28,144,6,0,0,9,3,9,10,4,12,0,4,20,6,4,7,4,16,8,0,1,1,0,0,0,16,0,4,1,0,4,14,10,2,4,8,0,4,3,5,2,1,21,19,3,7,3,6,12,1,7,5,2,2,0,0,5,5,3,3,6,4,7,7,14,10,2,12,4,10,12,4,6,4,0,6,9,0,8,31,9,2,8,1,6,0,3,10,6,0,9,7,2,1,3,4,0,3,1,25,5,1,2,9,1,0,11,3,11,3,1,0,3,1,2,10,9,0,0,1,6,6,7,0,0,0,0,2,0,6,11,39,5,1,0,11,2,1,3,0,0,3,4,6,10,6,1,2,7,3,4,5,9,6,37,19,4,6,3,4,11,0,6,2,7,4,5,8,3,2,11,2,9,11,8,1,25,6,0,3,5,6,17,8,4,2,10,0,2,0,3,2,2,3,1,0,3,7,4,24,1,7,0,12,6,5,5,1,16,2,3,7,0,3,10,3,0,2,14,0,0,8,1,6,0,1,2,13,8,3,5,7,6,10,1,4,4,3,0,4,1,7,8,8,9,0,3,1,14,4,5,1,2,5,5,7,3,19,5,11,3,5,2,3,9,4,0,3,0,3,3,3,2,3,2,11,1,20,76,11,9,3,1,3,4,3,2,7,5,0,6,4,4,3,8,12,4,5,19,8,0,2,3,4,3,0,2,1,21,9,4,12,6,0,14,1,0,3,7,1,2,7,3,2,11,4,1,3,8,6,2,13,4,2,2,1,10,8,2,4,0,5,2,9,0,11,9,2,0,2,2,2,7,10,2,0,5,5,9,0,9,5,13,2,9,4,0,3,5,2,13,1,9,2,0,4,2,0,0,8,4,7,6,5,4,6,3,1,11,7,4,0,1,3,0,2,6,8,2,6,8,4,5,11,9,5,2,1,9,3,1,11,5,7,0,0,7,1,4,10,5,4,2,16,10,5,4,2,3,2,2,2,7,2,21,7,2,21,5,27,1,12,3,6,0,0,2,1,0,9,0,0,0,5,4,2,0,13,2,5,0,5,2,3,0,8,0,5,6,6,5,0,4,3,7,4,27,7,6,2,5,2,6,7,5,0,0,2,0,3,20,5,1,0,2,1,5,2,3,7,3,7,309,0,4,10,7,0,1,0,0,6,1,3,0,0,6,1,7,0,2,2,0,11,2,3,0,6,5,2,0,2,0,9,3,0,17,3,2,4,4,2,6,0,0,2,4,5,8,5,4,1,0,14,0,7,3,0,1,4,0,10,7,1,0,1,6,4,9,15,4,7,3,6,2,3,1,6,0,1,2,0,12,22,1,7,3,6,6,1,1,17,6,1,0,0,5,1,8,21,4,4,1,3,5,4,2,1,2,6,6,11,3,9,2,1,9,10,3,0,4,0,5,2,2,6,2,5,30,3,2,2,6,1,0,1,1,3,11,0,3,5,17,0,3,2,7,0,12,5,16,0,9,1,1,6,12,8,0,6,5,0,4,8,0,0,2,8,7,1,0,2,3,3,11,7,4,5,3,3,1,5,6,3,1,3,5,11,1,0,3,1,0,0,1,2,0,0,0,4,9,0,3,0,1,2,8,2,0,0,17,1,6,2,11,0,2,4,1,0,17,3,6,0,3,1,2,2,0,0,4,9,2,1,19,0,5,1,2,7,0,14,11,0,1,3,0,0,4,3,5,8,2,2,5,2,0,6,3,2,10,3,4,7,3,1,0,1,8,5,0,0,0,2,1,0,2,0,8,3,8,7,0,4,3,3,7,3,4,2,14,7,6,4,1,0,9,0,0,9,0,1,0,6,1,0,2,4,14,0,2,4,3,6,1,4,8,0,3,8,1,2,3,1,6,3,3,11,0,0,0,3,1,3,1,3,3,0,2,2,0,5,1,1,0,1,1,3,7,3,8,5,3,3,3,2,2,5,7,0,1,0,4,0,4,1,4,1,5,5,12,1,6,2,6,5,4,3,4,0,4,0,0,4,2,1,7,1,1,8,7,24,5,0,10,15,0,1,6,3,3,2,8,0,11,4,1,1,3,2,1,1,6,4,4,2,7,4,4,4,2,2,3,6,2,2,0,12,8,2,8,1,6,6,1,4,4,2,3,3,5,0,1,4,0,7,1,2,3,6,1,1,0,9,0,13,8,74,4,5,7,1,1,0,1,4,11,8,1,7,1,8,2,5,5,1,0,6,8,5,0,3,0,2,3,3,0,6,4,5,2,3,6,0,4,0,0,0,0,3,5,4,0,1,0,4,2,0,4,2,17,0,4,2,1,2,3,18,0,2,2,4,0,1,3,290,4,2,0,1,5,2,2,7,5,0,8,7,1,0,0,2,2,4,3,0,2,0,81,6,1,0,1,1,1,4,5,0,2,3,6,0,0,2,1,0,2,0,6,3,1,7,14,0,0,9,0,2,5,1,1,0,0,4,2,8,0,2,11,0,7,1,0,5,5,2,2,1,0,13,4,2,3,12,4,6,0,1,5,0,4,3,1,0,6,2,1,1,4,2,3,0,1,5,8,2,2,3,0,0,5,0,1,1,0,0,0,1,1,4,4,3,6,2,2,3,7,7,1,4,4,0,4,1,3,1,1,1,5,3,8,3,1,0,1,2,0,2,4,2,1,5,8,4,0,1,3,6,6,2,0,0,9,0,1,3,1,5,0,5,3,0,4,0,0,5,0,0,4,1,0,3,2,2,4,9,2,0,0,1,21,2,1,6,4,4,2,4,0,0,1,0,3,6,6,3,8,2,3,0,0,0,0,1,5,0,3,1,0,0,2,8,0,2,2,0,1,5,0,5,0,4,1,2,0,8,0,0,0,2,1,0,10,1,9,7,3,3,2,2,3,0,0,3,3,2,3,3,1,0,3,4,1,3,2,3,7,12,2,12,4,4,9,0,1,8,1,8,7,3,3,0,5,1,1,3,0,0,0,2,3,3,4,0,2,5,4,0,2,5,3,0,3,1,3,1,17,3,4,1,0,8,3,1,0,19,4,2,0,10,2,3,0,0,3,0,0,4,4,4,0,9,1,0,2,4,5,0,5,2,0,0,0,1,0,2,1,0,2,7,3,4,0,0,0,4,5,0,0,0,0,2,0,0,1,3,0,1,1,6,10,5,5,2,0,3,2,0,4,2,3,0,0,3,0,2,11,1,2,0,0,4,4,0,2,0,6,0,0,1,16,3,2,5,0,4,0,0,4,0,3,0,1,0,2,0,3,5,4,10,1,6,2,7,2,2,5,3,1,0,10,10,0,1,3,2,1,4,1,2,3,0,2,2,2,3,0,4,3,0,3,1,0,0,0,3,2,4,3,5,4,2,2,2,0,5,0,1,0,8,0,0,2,0,2,3,1,2,5,0,3,0,1,2,5,3,3,4,4,3,4,0,2,0,0,2,0,0,2,2,1,0,3,11,1,0,0,3,0,0,0,1,2,1,3,1,0,5,2,9,5,5,0,0,2,0,0,3,1,3,7,1,0,1,16,2,3,6,2,3,0,2,0,6,5,1,2,0,2,4,1,2,0,0,1,1,0,0,0,1,0,0,3,1,7,0,3,1,0,2,0,3,0,3,12,0,1,1,5,1,0,2,0,0,0,12,1,3,0,3,4,0,2,0,0,1,1,9,5,5,0,1,5,0,0,1,2,3,1,0,5,4,1,3,5,8,0,0,0,0,2,2,1,7,5,5,1,1,2,6,4,3,0,2,0,7,5,2,4,1,9,2,6,1,1,5,0,5,0,0,1,1,3,3,5,0,3,6,1,3,1,6,6,2,0,3,2,2,3,1,1,2,2,0,2,6,1,6,0,4,6,1,0,2,12,3,0,0,0,0,9,0,2,15,2,3,2,0,4,2,2,2,0,0,3,2,2,3,2,1,2,1,0,4,0,2,0,5,4,4,1,3,1,1,3,3,4,0,1,0,4,2,0,8,1,1,0,1,2,3,0,2,1,3,2,1,0,2,0,1,0,2,3,1,2,1,0,1,0,3,0,2,0,5,2,1,1,1,3,4,4,0,4,0,0,0,1,2,4,4,1,3,0,0,4,3,5,3,1,0,0,0,1,3,1,4,0,0,0,1,8,1,5,0,0,0,2,1,2,4,3,0,1,1,4,9,1,3,1,0,1,0,0,6,1,8,2,4,0,2,1,1,2,0,4,1,2,1,6,2,0,0,2,0,1,4,0,1,0,2,1,4,0,0,0,0,0,2,0,2,0,1,1,2,2,2,4,0,1,2,1,0,0,3,1,2,5,0,0,1,4,3,2,1,0,4,6,2,2,2,1,3,2,0,8,3,0,0,2,0,2,2,1,3,3,0,1,1,6,14,1,0,0,3,1,3,0,1,1,3,1,0,1,0,3,0,0,13,0,5,1,1,1,0,2,4,0,5,2,1,0,0,1,0,4,2,4,0,0,0,2,3,0,2,4,3,0,1,3,0,2,4,3,0,4,1,0,7,3,1,7,0,5,1,3,4,4,1,0,5,0,1,2,0,1,1,0,3,1,0,6,4,0,6,10,1,2,0,2,6,2,4,0,0,2,0,1,1,7,0,4,0,0,0,11,0,2,92,2,5,4,2,0,0,0,2,3,0,0,2,1,0,2,1,1,1,6,1,1,10,2,0,4,1,2,3,1,0,0,2,1,13,0,0,0,0,0,0,1,0,10,0,2,0,5,0,1,0,4,5,0,5,0,0,2,2,1,0,2,1,0,0,0,3,0,11,6,0,0,1,0,5,0,0,5,3,0,0,1,3,0,2,5,0,0,0,0,1,0,0,1,0,0,5,4,2,2,1,6,1,1,5,1,1,2,0,0,1,1,0,0,3,2,0,0,3,0,1,1,0,1,0,0,4,4,2,1,2,3,0,0,4,8,0,0,0,2,3,4,5,1,1,3,5,4,0,2,2,4,1,2,9,2,4,2,4,0,0,2,2,2,3,4,1,1,3,0,1,1,6,0,0,2,2,1,2,1,3,5,0,1,2,1,0,17,0,3,13,0,0,2,3,0,0,1,29,2,16,5,2,0,1,1,1,1,4,0,0,4,101,9,1,0,3,1,0,1,2,1,3,4,0,0,0,0,3,1,9,0,4,13,1,1,1,1,1,0,1,11,5,0,0,0,1,2,1,0,0,1,0,4,2,0,0,4,0,1,0,1,1,2,0,2,1,1,1,2,1,0,1,5,1,2,2,0,0,0,1,0,1,1,7,4,2,4,0,1,2,0,2,6,6,1,0,1,1,1,0,1,1,3,1,0,3,1,0,3,0,0,1,0,2,0,3,3,0,0,5,0,3,0,3,1,3,4,1,2,4,0,1,1,2,0,1,1,1,3,4,9,1,0,0,3,2,3,3,1,11,1,0,1,4,6,4,0,0,5,0,0,0,0,0,3,2,7,0,0,1,0,7,0,0,2,0,4,2,2,1,1,1,1,2,1,0,1,0,1,6,0,1,0,0,1,1,1,1,2,2,2,2,4,5,0,1,0,0,2,1,0,0,1,2,5,0,3,0,1,0,2,0,0,1,2,2,1,0,5,0,8,1,1,2,2,0,0,2,6,1,0,0,4,1,2,1,3,0,0,0,4,0,1,0,6,3,0,0,2,0,9,5,0,2,0,2,0,2,2,3,1,0,2,1,1,1,2,1,3,19,0,1,2,0,2,0,3,3,0,0,2,0,0,0,1,3,0,0,0,1,1,1,0,1,0,1,4,0,4,0,0,0,3,0,0,2,1,1,2,1,2,2,4,0,1,0,5,0,4,1,2,2,5,9,1,0,2,0,0,1,5,0,4,3,2,3,0,0,0,0,1,0,0,2,2,2,2,0,7,5,0,1,2,0,8,4,0,0,0,0,0,0,1,5,1,0,0,0,0,0,3,7,3,3,2,0,3,0,0,1,0,1,2,2,6,0,0,0,7,3,0,2,3,151,1,1,2,2,0,1,1,0,2,1,1,0,1,1,0,0,0,0,0,2,4,0,1,0,1,1,1,3,2,0,3,1,0,3,1,1,6,0,0,1,1,0,2,2,2,0,2,0,0,0,0,1,2,3,1,2,3,0,0,4,0,50,1,0,2,2,1,2,1,0,3,0,3,1,2,7,1,0,0,90,2,18,4,3,0,0,2,0,1,4,0,2,1,1,0,0,0,2,4,0,3,4,1,1,2,0,1,1,0,0,0,0,0,3,0,1,1,1,6,2,4,0,31,1,1,0,0,4,3,3,0,3,0,3,0,2,0,1,4,1,0,0,0,8,2,8,1,2,0,0,1,3,1,1,0,0,0,0,0,0,0,1,6,0,2,1,0,0,0,0,4,3,0,1,3,0,2,0,0,1,4,0,4,0,0,0,2,1,6,0,3,4,2,0,3,6,1,1,7,0,0,0,4,3,0,0,1,0,1,0,2,0,0,2,1,0,3,0,0,0,1,5,0,0,0,1,0,3,2,3,0,0,0,1,4,6,0,1,4,0,4,0,1,0,2,3,0,0,1,5,0,1,5,2,0,1,3,0,1,3,3,0,0,0,2,0,8,1,1,0,0,0,0,0,2,0,4,0,1,0,3,4,0,6,6,3,0,0,3,0,0,1,6,0,0,0,1,2,0,1,5,2,1,3,0,1,4,4,0,0,0,1,1,2,1,0,2,0,0,6,5,1,2,1,3,6,6,4,0,0,1,0,1,0,4,2,2,8,1,0,0,0,3,0,1,3,0,4,1,0,0,0,0,0,0,1,2,1,2,1,0,0,1,1,2,0,3,2,0,0,2,0,0,4,0,2,2,4,2,63,0,1,1,0,3,1,0,0,0,1,0,0,0,0,2,2,0,0,0,0,1,2,0,0,0,0,2,3,1,0,1,6,0,1,1,3,4,0,1,0,0,0,1,2,2,5,1,2,1,0,1,4,2,2,0,3,2,3,0,0,2,2,0,3,1,0,1,2,1,3,1,1,0,2,1,1,4,2,0,2,8,4,0,2,0,0,3,5,2,0,2,1,1,0,0,0,1,6,0,3,0,0,0,3,1,1,0,0,3,1,0,0,2,3,1,1,3,1,0,0,1,0,1,2,2,0,3,0,1,0,1,0,1,3,1,1,8,0,0,4,0,3,0,0,0,0,0,0,0,0,1,2,0,3,0,0,1,2,4,1,0,0,0,0,0,1,2,3,2,0,3,0,2,1,0,5,0,4,2,0,0,4,1,4,2,2,1,3,1,1,0,2,3,0,2,1,0,0,3,1,1,0,0,1,1,3,0,1,0,0,0,2,0,0,0,1,0,1,1,0,1,3,0,0,6,1,0,4,0,3,0,1,3,1,0,0,1,0,1,3,0,1,4,0,1,0,0,1,1,1,3,2,0,1,0,1,1,0,0,0,0,0,6,1,0,1,0,0,0,1,1,0,2,0,0,3,1,0,1,0,0,0,3,0,2,2,2,6,1,2,1,1,1,8,0,0,5,4,0,1,1,8,0,3,7,4,1,2,2,0,1,0,3,1,0,1,0,1,4,0,2,0,0,0,0,1,0,0,1,7,2,3,0,0,0,1,1,0,0,0,1,0,4,2,0,52,0,1,2,0,1,0,3,0,2,2,1,4,6,0,5,0,0,0,0,0,0,3,0,2,1,1,6,0,1,1,0,0,6,1,1,1,0,2,0,1,0,1,4,2,8,4,4,1,2,1,0,1,0,1,0,2,0,3,2,0,0,0,9,1,2,0,0,0,0,0,1,1,0,1,6,2,3,2,0,0,10,0,2,0,8,2,0,0,0,1,0,1,0,0,0,6,0,0,1,0,0,0,0,0,3,0,0,0,0,0,3,1,0,0,0,0,2,1,1,0,0,0,0,0,1,2,1,0,1,0,0,0,0,0,2,2,0,1,1,0,0,1,0,1,0,4,5,5,0,0,2,0,0,0,0,1,0,3,0,1,0,0,0,0,1,0,1,14,0,0,0,0,2,0,0,0,0,0,0,0,0,0,0,0,1,0,0,0,0,0,0,3,1,0,0,0,0,0,0,0,1,0,0,0,0,0,0,0,0,0,0,0,0,0,0,0,0,0,0,0,1,0,0,0,0,0,0,0,0,0,0,0,0,0,0,0,0,0,0,0,0,0,0,0,0,0,0,0,0,0,0,0,0,0
"1984 Clancy, Tom, The Hunt for Red October",pop,10563,3178,4540,4322,3063,1179,2025,1932,2631,1801,1378,1717,1737,146,371,1385,1666,886,1306,483,1004,690,723,542,216,870,221,893,488,891,659,480,661,773,1211,908,738,582,1014,648,486,358,409,397,362,229,283,369,510,219,324,380,372,270,572,439,578,366,496,294,293,166,254,312,298,322,528,321,414,250,312,56,262,222,177,287,443,170,263,190,286,132,217,303,215,146,106,339,150,251,128,149,255,164,187,178,159,178,294,207,150,138,130,209,179,185,184,111,202,229,124,101,288,132,249,64,96,190,169,102,227,418,140,63,180,75,104,114,124,123,67,122,163,178,91,189,390,54,142,166,20,130,162,64,58,43,161,141,120,103,119,147,100,166,89,105,149,34,252,162,169,29,59,128,77,120,140,96,76,57,31,134,102,47,21,132,62,77,85,121,47,60,131,65,72,61,81,76,88,102,38,230,180,97,89,61,26,155,10,122,52,35,60,101,101,101,101,33,42,59,9,99,264,94,81,84,52,11,69,33,74,111,108,36,54,72,44,57,82,90,72,64,32,47,33,6,12,57,23,100,26,57,47,63,112,81,194,38,23,44,87,131,78,44,108,69,41,88,48,42,53,73,55,92,90,10,67,88,171,82,29,42,140,45,54,76,64,44,33,78,25,51,62,29,58,3,55,13,97,139,40,26,65,59,60,77,36,79,24,22,76,27,101,102,50,59,27,11,51,58,45,20,42,67,52,45,151,243,70,91,40,107,28,32,3,11,35,49,62,27,33,54,67,35,3,75,71,18,40,33,46,54,39,66,19,23,30,37,62,46,39,42,27,74,57,27,71,28,30,54,145,46,58,13,53,54,49,16,90,64,60,33,122,1,82,13,22,33,7,45,15,19,181,63,133,6,0,36,24,23,0,23,39,39,66,33,7,22,52,77,32,17,27,15,69,42,49,42,43,15,31,22,21,4,33,52,44,41,74,30,32,0,12,21,46,48,33,13,45,21,32,30,32,17,23,58,28,17,48,48,68,22,93,25,25,65,14,42,92,32,34,36,50,45,26,31,28,17,34,46,30,11,0,7,10,53,5,30,1,28,70,43,32,8,35,45,10,24,0,10,32,20,12,14,7,11,122,11,36,79,23,55,17,22,54,4,24,27,53,16,23,29,43,20,58,45,30,21,33,47,44,6,40,10,36,40,0,30,26,30,25,17,27,52,35,19,15,22,22,63,7,7,29,27,21,0,39,20,45,25,9,30,15,31,8,12,1,1,79,9,48,47,32,391,17,20,33,57,27,5,19,20,31,0,31,20,22,2,12,61,50,56,48,9,31,20,16,2,19,20,14,47,17,23,112,51,21,24,2,40,42,74,17,41,51,22,17,4,5,12,9,11,21,10,25,0,1,11,19,36,32,4,16,20,2,18,9,9,8,12,5,42,7,35,21,27,14,27,7,3,5,8,6,13,63,3,8,13,18,21,50,3,4,17,30,8,50,31,58,21,2,8,18,23,10,1,21,18,47,148,40,35,14,51,23,11,1,14,11,7,9,24,14,34,25,10,19,17,17,24,27,29,31,5,56,14,81,32,15,71,19,7,14,25,2,28,47,313,16,127,19,32,1,19,52,15,4,4,24,18,25,7,7,12,22,19,24,22,21,19,2,10,46,163,11,22,29,8,31,39,8,22,4,3,0,21,9,13,66,9,8,18,11,11,18,32,49,4,28,33,13,3,12,12,68,8,43,4,8,50,36,6,22,11,22,17,31,1,13,21,34,7,4,1,2,39,5,2,3,13,3,5,49,7,7,23,6,23,14,28,9,9,0,8,34,13,4,27,0,15,25,0,17,20,97,12,4,21,24,5,27,16,9,1,34,14,14,21,0,8,15,5,188,27,39,48,32,48,49,48,22,0,4,16,260,28,13,12,6,9,8,11,4,10,0,12,20,0,1,43,11,7,10,26,50,7,20,30,3,13,12,15,12,11,45,32,3,0,8,13,20,31,8,18,0,5,7,17,12,17,17,14,28,10,7,10,43,14,15,22,48,29,32,35,6,7,9,8,3,5,14,2,27,31,32,7,7,15,13,25,27,0,21,0,10,0,11,14,25,25,18,1,24,39,6,14,15,0,11,3,0,9,8,0,4,1,29,5,3,12,12,5,3,15,23,44,46,32,28,13,28,13,11,13,8,17,0,8,7,1,0,8,12,14,18,8,80,6,54,37,7,0,15,11,18,7,21,8,18,56,1,13,12,13,1,13,20,25,77,0,8,2,11,10,3,16,0,21,14,0,14,0,5,89,0,3,0,0,17,3,2,18,2,9,1,89,15,0,9,18,40,35,3,0,31,11,18,11,47,36,17,14,6,14,18,12,23,1,6,2,5,18,0,15,16,8,5,3,9,19,19,5,4,16,3,0,28,18,14,5,22,25,0,4,12,8,15,9,0,0,0,48,12,16,5,12,22,0,22,10,42,3,4,5,5,0,34,29,44,59,53,23,36,17,22,18,9,30,5,9,10,5,4,7,24,17,7,10,32,19,3,29,5,4,0,7,25,0,14,28,0,13,4,44,2,5,9,23,30,3,10,0,4,8,29,15,4,12,10,0,1,5,10,6,76,28,10,19,17,15,12,33,4,5,16,18,118,17,41,7,0,22,8,5,0,11,3,10,1,9,0,14,6,4,19,5,5,4,126,0,4,37,3,30,5,22,0,2,6,0,15,40,0,7,5,2,3,2,5,6,28,0,7,10,4,14,2,5,6,26,0,6,10,0,75,0,0,2,10,43,42,9,27,1,10,5,3,14,4,17,10,18,0,17,6,0,13,8,35,12,20,31,15,0,39,16,0,8,20,11,53,0,6,10,14,14,12,26,13,14,6,0,14,27,0,8,6,16,27,5,0,12,1,15,0,16,9,2,0,2,68,4,4,3,9,4,19,3,15,6,0,11,47,14,14,17,0,7,6,3,5,2,4,28,13,7,1,0,3,12,1,4,2,2,6,11,10,2,3,30,8,1,13,15,33,2,0,1,15,4,0,4,16,109,8,5,18,16,4,17,9,1,5,0,1,18,11,4,24,9,12,0,3,1,2,35,0,11,31,3,13,2,18,29,20,60,23,107,1,11,6,2,2,1,12,0,0,1,0,0,1,0,13,0,14,10,2,49,1,20,37,0,7,2,16,21,1,0,3,24,0,0,0,11,0,2,134,0,5,2,22,18,9,12,0,5,4,14,7,1,5,4,1,11,23,14,2,5,5,14,12,8,0,0,19,11,1,14,2,12,20,10,44,14,22,0,1,4,16,18,14,1,0,5,7,0,0,11,0,0,4,24,6,0,6,10,11,0,2,11,18,6,6,13,637,1,7,4,3,10,9,8,4,2,1,5,1,12,1,2,7,9,1,7,6,7,0,0,0,15,14,0,127,0,0,9,0,11,9,3,14,1,2,8,0,24,117,0,191,71,8,9,6,9,4,37,30,9,76,4,11,11,9,7,11,4,12,3,4,6,14,11,1,13,6,12,5,0,5,76,22,5,9,19,3,1,2,1,28,12,3,111,4,1,4,18,4,1,8,14,13,1,6,0,8,0,7,0,9,15,6,5,2,3,5,3,3,11,0,9,0,7,8,2,7,5,36,29,6,17,11,185,0,9,18,2,9,14,6,6,6,27,1,1,26,7,0,9,0,3,14,10,3,0,4,11,4,3,15,69,4,3,2,0,5,0,4,16,30,16,46,18,6,10,0,13,2,2,8,19,13,10,0,4,2,13,9,14,9,13,7,10,23,4,2,16,4,0,6,7,18,5,8,2,6,13,4,3,15,4,1,13,45,5,13,2,3,4,10,13,7,0,14,6,1,2,7,27,3,3,1,2,3,1,0,21,1,20,0,10,17,5,0,11,1,6,1,2,0,11,61,7,0,1,8,33,10,0,3,1,25,3,7,0,4,4,2,21,5,4,7,4,5,2,0,11,12,0,2,15,8,11,21,7,1,1,0,2,2,11,5,0,14,0,9,2,11,6,7,0,4,24,1,1,4,11,1,4,3,12,0,9,15,14,3,8,15,18,10,6,0,1,0,6,13,17,5,0,7,8,0,11,4,8,1,107,0,23,8,34,12,2,5,7,2,14,24,0,0,1,9,12,0,0,2,4,0,3,2,1,1,5,6,13,5,2,14,6,2,2,11,1,0,14,0,5,9,11,1,1,3,11,12,0,10,3,0,13,2,15,2,0,11,2,4,87,8,3,1,6,4,20,1,9,1,14,28,0,7,23,0,1,6,2,11,5,10,0,11,1,3,3,2,0,7,3,6,77,4,9,0,50,10,59,0,13,5,87,2,5,0,2,3,0,11,10,2,5,3,13,3,1,0,3,2,2,18,3,9,27,0,1,0,2,23,0,11,2,0,1,1,20,0,2,14,3,0,3,4,1,6,2,1,8,0,0,0,13,0,12,4,16,5,1,11,15,4,12,7,6,1,3,74,0,1,11,3,2,1,5,34,8,8,1,7,2,1,1,6,18,5,3,2,3,12,17,1,9,6,2,1,79,4,1,6,11,13,5,1,3,6,5,0,5,8,6,9,4,3,7,4,3,10,2,2,0,3,0,8,0,13,7,4,5,0,10,12,15,3,2,5,4,13,0,1,10,82,1,3,9,8,2,8,5,18,0,5,10,3,8,14,23,1,11,10,0,33,15,4,2,234,21,4,2,0,0,0,0,1,6,10,0,1,9,6,5,0,0,7,1,13,4,3,4,12,6,0,0,2,11,3,1,7,1,18,8,0,5,1,3,5,12,0,14,3,1,5,2,0,0,21,0,12,1,0,0,14,15,0,3,11,8,1,1,0,12,3,14,19,10,10,4,5,1,3,2,2,53,0,29,1,10,12,0,5,91,5,4,14,8,0,1,16,10,7,14,2,1,3,24,26,9,25,0,6,0,0,0,18,96,1,0,0,0,4,0,7,11,3,52,2,4,19,30,1,2,62,11,1,14,0,5,12,0,10,10,0,0,2,2,1,5,1,7,7,96,1,2,7,7,7,7,4,63,0,10,9,22,1,2,1,9,24,15,0,1,17,0,3,0,2,221,8,3,2,4,4,0,2,1,16,13,1,0,13,7,0,1,4,3,1,73,7,15,0,6,4,5,2,3,2,0,17,3,0,2,8,4,0,1,2,2,0,11,9,7,11,8,8,1,4,7,4,9,6,13,2,4,1,9,0,1,9,2,2,3,34,9,1,11,0,3,1,10,2,2,4,21,2,3,4,2,0,1,4,0,7,0,6,16,0,3,4,2,0,0,19,0,1,0,7,9,2,24,17,6,8,5,19,0,1,1,2,0,3,4,0,9,6,5,0,11,4,2,8,3,11,3,4,32,1,9,0,6,0,0,15,1,8,1,0,11,0,10,2,0,3,1,1,2,3,12,24,4,10,0,3,0,0,2,0,0,9,0,0,0,0,0,8,2,2,0,1,3,1,4,2,0,0,21,4,77,11,3,1,0,1,3,11,1,8,7,9,6,0,1,4,0,7,10,0,0,4,0,14,0,8,0,6,0,7,2,1,3,0,4,5,0,2,20,2,5,2,2,0,19,0,3,5,0,419,0,12,9,6,4,0,6,8,3,77,3,5,8,0,7,6,0,0,5,2,0,0,3,4,11,4,3,0,5,8,4,3,1,8,0,0,0,3,198,0,8,0,127,0,1,0,3,7,2,4,1,6,1,8,5,0,0,2,7,9,3,2,1,10,1,1,1,1,1,13,0,8,4,0,1,3,9,8,4,51,1,0,6,10,8,3,1,0,24,2,1,4,6,3,18,2,12,20,0,2,0,0,8,0,0,8,0,0,7,16,1,9,0,6,5,4,4,0,0,0,2,6,0,6,8,0,2,4,0,5,0,1,3,2,3,0,9,4,0,2,4,0,3,3,8,5,0,4,14,1,5,2,4,30,1,9,0,1,5,32,5,0,5,7,9,0,1,5,4,17,4,5,0,1,0,0,3,0,0,0,4,2,4,7,2,0,1,8,9,7,1,12,1,0,9,1,8,10,7,2,4,9,4,2,21,2,0,5,3,1,0,26,2,0,5,0,3,1,1,1,0,3,3,6,0,11,0,1,2,1,4,11,1,0,2,15,14,0,2,10,17,3,1,0,1,0,1,5,0,7,3,10,4,2,2,2,0,5,0,0,0,4,1,4,61,3,3,1,0,11,0,5,7,10,0,3,1,9,0,0,0,0,3,3,0,4,0,0,10,7,1,5,4,0,0,1,20,7,0,2,1,2,2,1,0,8,0,1,3,2,3,6,6,4,10,15,2,17,1,7,2,0,0,1,27,7,2,1,13,8,1,3,1,0,0,0,11,13,16,0,0,16,0,2,3,1,0,2,0,0,0,4,5,3,34,7,1,7,4,3,8,0,14,4,1,14,3,13,0,5,4,0,7,0,3,2,12,2,0,0,0,8,12,2,2,2,25,4,0,47,2,12,0,0,55,0,8,10,0,6,5,10,0,3,6,1,0,3,1,37,10,2,3,1,0,1,2,3,0,0,5,3,34,1,1,0,9,2,0,2,8,10,0,0,3,0,0,5,83,0,1,2,13,16,10,6,20,11,2,0,0,3,2,0,9,1,1,2,8,5,2,16,5,1,1,1,4,1,1,7,2,9,7,10,1,1,2,2,0,0,0,19,2,0,0,39,5,9,0,2,2,5,0,4,3,0,2,3,3,0,15,4,0,7,0,4,2,46,1,0,0,1,6,9,1,6,7,1,9,0,0,2,3,0,3,0,2,0,9,0,1,0,1,7,5,3,0,8,0,2,4,5,7,0,0,0,9,12,6,7,3,3,1,0,6,2,4,4,1,0,5,15,2,1,6,0,2,1,4,8,0,5,1,2,1,1,9,0,0,3,2,2,0,6,0,3,5,1,10,0,3,0,5,1,2,4,6,1,0,0,0,2,3,1,2,5,0,5,0,4,71,23,1,3,5,46,0,0,0,1,0,3,7,0,9,2,12,3,9,1,0,2,21,3,0,0,0,16,8,14,1,0,1,0,6,3,9,2,5,2,3,13,7,10,0,3,8,4,3,0,4,0,19,6,5,0,0,0,0,0,8,4,41,0,4,1,3,2,11,7,1,3,1,3,9,0,5,0,10,0,1,7,2,0,6,2,1,0,17,2,5,0,33,4,0,0,12,5,0,4,0,1,4,2,8,1,0,0,7,1,4,19,1,1,28,0,3,5,10,1,0,3,1,10,4,3,8,1,5,2,0,11,3,2,0,1,0,2,3,6,0,0,12,4,5,1,5,8,2,9,0,0,0,5,20,3,11,0,0,1,0,5,0,1,19,0,18,0,0,0,1,6,0,12,1,2,4,1,0,9,3,34,9,0,1,1,12,10,1,0,3,3,1,6,4,0,15,1,7,0,63,7,16,2,1,2,0,1,1,0,0,3,2,4,0,10,2,2,11,2,0,0,3,2,6,16,0,0,6,0,1,0,0,0,0,13,2,1,0,3,4,5,5,7,0,0,8,0,2,4,1,2,20,0,0,9,19,1,1,2,0,14,0,7,0,0,0,6,2,1,0,2,0,16,5,1,7,3,1,10,0,2,7,7,0,7,0,4,1,0,2,2,3,2,10,1,1,0,0,3,0,0,13,7,7,0,8,1,2,1,1,8,21,4,5,4,5,0,0,0,7,2,1,8,56,0,6,127,189,0,0,0,12,3,0,8,7,1,0,44,0,5,20,4,0,2,1,0,0,10,3,0,6,3,2,8,2,0,1,5,12,0,0,0,0,14,0,1,7,0,0,0,3,0,3,3,0,0,1,1,2,2,0,6,3,3,2,0,3,36,8,1,3,1,1,1,0,0,1,7,6,16,1,2,10,3,55,5,1,0,3,4,5,1,8,4,0,0,14,4,0,0,15,1,5,4,0,5,0,2,0,2,0,12,1,2,8,0,6,3,1,1,1,246,4,5,2,13,3,1,6,3,10,7,5,5,0,0,1,20,2,0,3,0,9,2,0,0,4,5,0,0,0,1,4,4,1,1,1,0,6,2,4,7,0,38,7,11,1,1,7,1,1,3,0,0,9,0,1,0,0,17,6,0,0,0,0,0,0,2,2,4,1,4,2,14,2,1,3,1,0,3,3,3,2,0,0,0,2,3,0,1,0,5,0,5,2,6,67,0,0,3,1,0,0,2,0,3,4,0,2,2,4,1,1,12,43,0,0,0,6,2,0,1,0,3,3,1,2,17,5,3,1,6,14,0,3,0,0,3,3,2,2,1,4,28,0,2,12,6,0,0,0,1,2,0,4,6,2,0,2,0,19,1,2,1,0,0,6,1,26,0,0,0,6,0,39,0,0,0,8,1,8,19,9,0,1,2,0,1,0,25,4,0,10,3,0,15,0,1,25,0,17,0,0,4,9,0,5,0,3,1,1,0,4,27,1,0,1,0,3,7,0,0,2,0,11,2,0,0,1,8,1,3,0,1,4,0,0,3,5,2,3,0,0,2,0,3,2,6,1,66,0,8,1,0,0,1,4,7,0,7,0,4,1,0,5,0,0,8,20,0,5,0,1,1,4,4,1,0,0,4,0,0,4,4,0,0,3,3,2,0,4,0,0,23,1,8,3,0,0,3,2,1,17,2,25,3,2,1,1,2,7,0,3,0,0,0,0,1,0,3,0,4,1,0,0,2,6,1,0,1,0,0,3,1,1,1,0,9,1,6,0,0,2,0,0,4,0,0,0,7,4,0,3,0,8,0,2,191,3,0,12,3,21,0,13,1,1,4,1,0,8,2,2,0,2,3,2,2,0,2,1,0,1,1,8,0,0,1,1,4,8,1,0,2,1,6,1,1,2,0,14,3,5,6,0,15,0,0,1,2,1,7,33,4,4,7,0,5,0,3,1,3,1,12,3,2,1,5,1,2,6,0,0,4,1,0,7,0,4,12,4,2,78,40,0,1,4,4,0,0,0,2,0,0,3,8,0,0,1,1,0,0,0,0,5,2,3,1,0,4,0,1,3,2,2,6,10,16,2,3,16,0,1,2,3,5,0,3,101,2,0,2,0,2,9,2,0,46,1,1,1,8,0,0,0,1,9,2,1,2,0,2,134,1,1,1,1,2,0,0,0,3,1,2,14,0,0,5,15,2,5,0,6,9,0,0,1,2,0,12,2,0,0,0,0,1,4,0,1,0,0,1,4,0,3,4,0,8,0,48,4,15,34,0,6,1,199,1,3,2,2,9,1,0,0,5,0,2,0,6,3,19,0,0,1,4,0,0,23,0,0,2,0,0,1,3,0,6,2,1,0,0,0,1,0,0,0,63,9,0,1,33,2,3,4,0,1,4,2,0,1,3,1,5,0,0,1,2,2,2,20,0,52,1,87,2,3,0,5,1,0,0,2,1,4,0,0,2,3,0,5,2,0,0,0,5,0,0,2,2,0,3,14,0,2,3,2,1,4,0,2,13,0,22,1,3,8,1,0,1,1,47,212,4,0,0,0,2,1,3,1,0,0,0,2,9,5,0,1,1,0,1,2,0,0,1,1,0,0,10,2,0,2,3,0,2,3,6,1,0,2,0,0,2,25,1,2,0,6,0,4,12,1,0,2,3,5,0,11,2,1,1,2,0,1,2,3,142,2,8,0,3,4,4,0,6,8,5,1,0,2,0,4,0,0,1,4,0,5,0,0,1,165,6,0,0,1,3,1,2,0,2,3,1,0,1,0,2,4,5,0,0,0,1,0,0,1,0,3,2,0,1,2,0,1,2,0,1,3,0,3,1,1,19,1,1,0,3,1,0,10,16,7,3,4,0,0,1,1,2,0,7,2,9,0,0,2,2,1,9,3,0,0,1,0,2,0,11,9,1,11,8,1,3,1,0,2,6,1,0,0,4,0,0,1,10,0,2,0,0,4,0,1,4,10,5,1,0,0,2,1,3,5,6,11,8,4,6,1,0,0,0,0,0,0,0,0,2,1,0,1,3,2,0,1,2,1,0,0,0,4,0,7,2,12,5,0,0,11,2,1,0,1,0,9,6,0,1,2,2,0,2,1,1,1,2,6,8,4,11,2,0,7,2,2,2,5,2,2,3,0,10,3,3,0,0,0,10,6,2,4,0,2,7,0,5,7,1,7,4,0,0,4,6,1,38,0,0,0,2,1,4,1,6,99,6,0,1,0,4,0,107,1,1,1,0,0,1,0,0,1,1,1,0,0,7,0,2,4,2,7,0,2,2,0,1,11,0,2,7,2,0,0,2,4,6,0,3,26,1,1,1,11,10,0,1,0,2,3,1,3,3,1,0,4,0,0,0,1,2,4,0,0,0,3,0,3,0,3,2,2,2,4,4,5,0,0,172,3,6,12,17,1,0,2,3,1,0,0,0,0,0,1,0,4,3,0,4,1,2,5,12,3,0,1,3,4,1,0,0,0,1,2,1,4,0,7,0,5,1,0,18,0,6,3,2,3,0,0,1,0,2,1,13,7,1,0,1,3,11,0,4,3,0,0,41,1,13,0,1,5,14,0,0,4,1,0,99,3,3,0,15,16,5,0,1,4,0,2,9,1,3,2,35,0,6,2,0,0,0,2,4,0,1,1,8,1,3,0,5,0,3,0,0,7,1,3,2,2,8,1,2,5,1,6,9,0,3,1,0,0,0,2,1,0,2,5,0,14,0,1,0,0,5,1,2,5,23,0,2,9,5,0,2,0,0,8,0,0,9,3,4,1,0,0,0,2,0,6,1,1,0,3,0,6,2,8,0,3,0,0,6,11,0,0,0,0,5,5,0,0,0,4,2,3,6,0,0,2,0,7,0,0,1,24,2,0,8,1,0,17,6,1,0,0,0,2,3,0,4,2,1,1,6,0,0,0,0,5,1,3,2,2,0,2,0,2,0,1,5,2,7,0,4,0,1,1,0,2,0,1,8,1,0,7,0,14,4,0,0,0,0,6,2,1,3,1,0,5,2,22,3,0,1,0,1,0,1,0,0,0,2,0,9,0,2,0,51,0,0,1,3,2,2,17,0,4,8,2,1,2,1,3,1,0,2,30,0,0,30,2,0,3,0,0,2,0,0,1,0,6,13,0,0,0,6,2,0,0,1,1,0,5,0,57,1,2,0,7,0,3,0,6,1,0,6,0,0,0,135,0,6,0,0,0,2,0,0,0,1,0,17,0,0,0,0,0,0,0,0,0,0,0,0,0,1,10,0,0,0,0,0,0,0,0,0,0,0,0,0,5,0,0,0,0,0,0,0,0,0,0,0,0,0,0,0,0
"1988 DeMille, Nelson, The Charm School",pop,12610,6368,4959,4819,3639,2583,2609,3218,2082,1775,3401,1723,2146,923,718,1536,862,1112,1259,1567,1339,1158,893,873,544,893,590,1368,853,1142,757,602,720,797,928,880,783,541,939,628,657,466,763,765,654,256,595,499,388,832,481,676,413,612,575,405,350,618,645,256,327,559,406,385,644,312,449,368,759,365,450,422,301,459,307,264,491,293,353,678,267,312,428,410,163,584,298,393,158,225,161,294,186,294,426,110,281,235,364,176,151,137,263,163,396,219,168,176,301,176,180,122,230,134,159,295,136,312,159,326,318,374,236,99,246,135,158,133,176,200,302,205,292,292,208,165,235,99,193,211,73,218,129,204,120,262,163,111,201,135,88,236,261,160,100,101,166,125,190,134,105,90,61,99,135,139,87,72,121,106,82,113,114,277,234,155,92,186,142,93,69,83,408,142,115,110,99,145,134,65,150,221,69,87,83,95,22,88,124,109,135,152,131,94,107,78,69,111,63,54,28,98,278,89,60,104,80,283,67,159,100,105,174,95,122,117,107,80,104,59,128,111,214,95,89,9,32,94,100,83,101,103,63,64,74,66,102,47,93,94,94,51,95,211,85,100,71,82,90,76,73,55,136,84,129,56,73,77,100,77,72,18,77,56,109,45,44,58,63,65,115,103,81,48,39,75,70,42,58,186,121,23,52,89,95,67,61,49,21,42,55,49,144,52,89,69,26,19,132,128,66,28,118,43,62,78,125,157,57,170,46,114,46,38,27,119,70,69,80,133,32,53,54,77,206,87,43,43,47,41,81,41,101,71,49,48,48,35,56,53,46,62,45,45,53,36,31,22,72,43,75,218,73,119,31,198,34,43,114,48,45,76,112,41,83,40,63,72,52,51,93,78,147,49,37,33,0,64,56,53,6,41,46,17,51,58,40,42,42,50,154,45,62,42,33,35,40,19,39,32,53,42,57,28,50,96,44,33,56,63,43,9,37,90,42,64,63,58,89,27,46,43,34,25,102,39,69,29,0,22,70,35,102,45,57,37,59,129,53,35,58,64,91,52,33,36,71,24,80,41,46,8,0,69,23,45,88,27,14,48,38,35,28,4,70,24,81,106,0,42,26,36,65,27,4,22,45,34,70,34,30,18,31,56,34,105,24,70,40,49,33,27,62,92,27,29,40,19,47,38,51,26,30,37,52,34,3151,22,99,52,32,24,29,57,31,24,68,29,48,104,12,19,52,49,103,3,38,56,72,21,34,41,61,26,23,40,0,7,45,21,39,53,26,58,24,40,70,14,18,27,61,41,35,32,48,22,27,46,2,55,30,63,24,27,22,91,32,4,30,18,55,21,39,25,33,47,76,57,23,130,36,37,32,16,22,32,29,47,21,34,8,35,24,17,43,3,0,23,41,20,38,121,28,18,68,39,37,22,12,0,31,28,6,26,31,32,22,44,29,33,34,51,32,9,40,0,10,50,16,34,21,11,31,23,44,42,23,37,8,62,0,6,34,16,33,24,18,5,55,325,58,27,36,28,4,27,27,35,39,41,12,33,29,18,21,11,33,13,33,55,70,26,27,19,66,24,5,39,33,64,11,21,23,43,20,32,34,66,63,12,23,6,12,22,80,24,13,48,26,27,3,24,43,28,20,16,40,37,41,37,26,9,35,33,20,18,100,20,29,26,15,21,18,26,0,10,26,116,72,24,16,28,25,22,4,6,45,12,33,57,21,34,21,13,30,23,14,24,13,44,58,6,39,22,38,13,24,23,32,49,21,28,1,29,1,22,12,15,6,199,19,12,59,18,33,13,35,23,21,36,20,18,1,38,20,13,9,20,2,13,25,8,36,18,35,118,1,22,47,16,58,17,12,67,11,15,3,1,10,7,27,10,29,32,20,35,19,57,42,36,18,5,32,31,68,14,10,29,0,18,22,29,15,4,30,46,22,0,35,48,17,17,3,19,25,19,15,14,14,19,11,9,41,42,99,35,32,1,21,22,23,19,12,16,0,22,37,19,16,10,11,19,17,15,8,20,9,18,12,24,40,18,7,19,17,13,4,0,18,6,18,14,6,45,35,14,16,34,20,10,61,0,18,1,25,6,9,15,15,15,16,5,19,10,33,8,20,37,22,54,25,46,13,1,22,13,47,50,11,38,22,44,21,16,31,47,59,20,28,9,26,18,16,22,25,21,16,7,16,4,0,13,25,249,24,9,50,30,116,71,16,7,25,22,31,10,20,24,5,3,0,16,21,24,12,0,27,241,26,25,20,18,11,4,15,7,9,10,14,0,18,0,14,26,25,9,0,0,18,5,31,22,20,31,14,101,1,0,17,15,61,35,15,2,312,10,46,1,58,28,14,11,4,8,12,38,11,0,24,9,26,27,28,31,2,10,26,16,24,35,47,15,0,2,5,116,30,19,20,5,4,2,0,9,20,20,35,25,0,0,0,5,12,13,6,13,38,0,16,19,44,6,17,21,15,17,23,21,19,2,17,0,10,33,115,15,13,11,18,19,6,10,14,26,20,18,13,8,15,26,7,13,21,17,0,11,14,21,14,9,4,42,35,8,18,10,27,30,63,6,29,1,7,6,25,16,26,7,20,14,6,2,16,17,9,8,70,38,9,10,33,46,10,10,10,53,18,20,27,18,14,15,13,9,0,8,2,13,3,1,0,29,13,9,33,4,77,37,48,0,7,17,24,15,18,22,1178,14,6,0,11,17,0,7,17,3,12,12,1,7,49,0,17,12,1,20,9,6,2,13,0,33,19,3,23,0,0,36,36,13,70,17,34,24,5,13,18,6,14,20,7,5,2,12,14,0,33,9,7,20,68,24,49,0,86,3,11,21,10,5,31,24,8,8,1,54,30,22,1,12,12,0,25,17,0,75,3,7,23,16,0,20,5,18,0,19,17,15,0,2,39,28,7,15,9,9,13,22,9,15,0,15,21,7,9,20,17,15,0,42,10,10,18,21,11,19,4,3,5,32,9,1,2,4,0,15,20,2,16,20,4,7,3,1,18,28,3,16,16,8,0,14,20,3,1,17,12,54,6,9,15,8,8,0,33,6,20,5,18,29,17,2,22,5,7,10,7,11,12,1,4,7,11,0,27,75,23,23,26,14,4,21,11,0,14,0,2,7,0,3,9,0,16,8,4,8,48,17,9,9,8,4,4,0,5,7,24,0,13,61,0,1,0,16,0,4,33,0,18,13,28,15,17,7,0,14,37,5,18,26,7,7,3,10,7,2,5,26,5,2,21,26,0,0,21,9,4,34,12,24,17,3,4,9,8,16,1,14,15,10,9,25,0,7,12,0,5,36,7,9,23,24,12,0,21,0,29,0,10,8,5,14,17,15,0,38,0,16,11,33,6,10,6,4,6,3,4,19,6,2,6,3,5,21,7,20,0,0,21,24,6,0,403,0,0,3,977,37,5,6,4,2,17,4,2,6,11,0,10,26,8,12,2,5,4,16,35,4,44,12,9,16,20,7,8,12,9,5,6,5,9,40,14,9,12,10,16,0,8,11,6,7,15,16,2,6,7,41,9,2,33,6,1,4,4,91,12,5,7,7,8,2,19,0,4,9,4,2,6,16,8,2,10,6,24,4,16,9,0,6,0,8,10,16,15,3,14,0,10,20,0,19,2,8,8,20,9,6,9,8,3,25,34,77,3,8,0,6,0,10,14,20,2,0,4,7,12,8,6,20,11,5,1,1,7,8,6,5,41,10,8,18,15,10,0,26,1,4,5,10,0,12,3,4,3,6,8,3,16,6,8,7,10,8,2,15,28,0,9,3,0,4,17,28,21,34,1,4,77,7,19,4,26,3,0,9,7,4,7,14,11,0,10,1,1,36,3,69,3,8,3,6,20,10,0,24,20,26,5,27,7,7,4,6,9,11,2,9,0,14,45,13,7,2,9,154,18,6,13,0,18,12,12,0,3,2,8,11,0,7,33,16,1,6,0,1,6,9,10,1,9,7,4,12,3,5,0,5,5,9,7,21,5,8,10,2,5,3,21,0,10,26,1,5,5,27,10,6,46,6,5,14,16,9,6,8,8,1,4,6,5,13,1,3,15,0,24,3,2,7,14,10,2,7,5,24,6,6,1,1,10,6,16,6,30,1,6,4,10,2,18,1,0,0,11,11,0,12,0,0,0,5,12,7,0,9,10,9,0,3,0,4,0,9,1,9,11,4,8,2,14,5,37,7,10,4,6,26,4,4,7,8,8,0,0,4,19,12,0,9,1,5,3,5,4,3,3,11,10,11,0,2,5,0,74,3,4,18,3,5,3,8,0,2,25,6,7,14,12,13,0,31,5,9,0,5,7,71,1,11,0,4,1,0,5,6,13,3,15,10,9,1,0,24,11,4,8,7,13,14,56,4,0,6,22,0,8,4,0,8,3,7,0,11,19,12,5,4,5,4,17,4,12,0,0,4,1,11,4,6,1,9,23,13,3,4,11,11,6,2,9,3,1,0,12,6,1,7,12,3,0,7,7,1,8,10,83,3,10,30,4,55,15,13,8,16,17,10,5,14,3,43,15,3,7,10,28,3,4,5,2,1,0,2,43,15,11,8,5,5,2,0,7,3,9,0,3,7,4,0,7,0,22,2,4,68,11,5,4,12,6,6,3,0,5,7,3,0,5,2,1,9,4,6,8,9,7,6,6,21,12,26,3,6,6,5,8,9,6,2,254,9,3,11,0,4,1,3,2,1,3,12,10,9,3,8,1,0,0,14,1,13,9,10,6,1,0,0,4,8,4,2,8,4,19,4,0,20,5,18,5,13,4,3,6,1,4,3,0,1,16,0,14,1,0,0,19,5,8,5,6,4,17,2,0,12,8,12,9,7,4,23,7,1,0,5,37,2,0,12,1,16,4,0,9,0,4,5,5,9,625,3,40,1,4,6,10,4,7,4,7,2,11,0,6,0,0,2,3,8,2,0,0,2,0,0,11,7,6,4,1,2,6,14,4,4,29,15,5,3,0,3,10,10,3,37,0,0,8,4,2,2,12,12,6,33,14,6,6,4,15,4,3,94,4,10,4,7,9,1,5,3,10,4,24,4,4,0,2,0,9,14,13,4,0,9,5,0,4,16,5,14,0,7,9,4,4,4,10,5,5,5,9,18,8,10,7,9,8,46,2,0,10,9,1,12,26,3,0,22,10,0,36,9,11,2,7,7,10,6,5,10,5,8,12,39,3,2,4,7,13,4,8,7,1,20,1,5,3,6,4,1,11,6,7,1,5,31,4,2,7,7,0,4,3,0,7,2,0,10,0,12,14,6,2,0,5,1,12,2,4,7,25,16,20,0,8,7,4,8,0,13,4,1,0,8,3,7,15,4,4,2,5,1,3,9,4,4,25,9,3,7,5,9,3,0,2,11,10,10,0,7,0,21,29,0,17,5,1,4,3,4,4,6,6,4,0,2,2,7,3,0,1,0,0,0,0,8,6,2,11,5,16,13,3,7,1,9,0,2,8,31,6,3,0,0,0,19,5,3,7,1,17,3,4,10,3,1,3,43,0,3,7,8,4,0,5,3,4,7,11,1,1,9,0,9,12,0,4,5,1,9,1,7,3,10,0,3,20,0,0,4,9,23,8,5,0,19,1,11,11,4,15,9,0,6,7,0,2,3,3,1,1,8,4,4,2,6,5,0,39,2,6,2,17,2,0,0,0,6,11,14,0,4,0,2,3,9,0,1,3,2,21,0,6,5,3,9,1,7,4,8,4,5,15,0,7,6,8,2,6,0,10,9,2,8,7,6,1,14,5,5,0,12,5,2,4,4,0,2,6,2,18,1,2,4,1,20,3,5,0,0,0,6,0,0,1,1,0,7,8,17,6,6,2,0,1,3,0,1,2,3,15,10,7,25,5,5,2,2,1,0,10,4,10,6,9,4,6,6,5,9,2,2,2,3,6,0,6,9,4,7,0,0,12,8,5,10,5,2,50,3,0,27,4,5,3,3,10,0,4,0,6,9,0,0,4,5,1,0,0,4,13,0,1,3,1,0,6,11,8,1,13,9,0,13,1,5,7,4,8,7,15,8,15,8,6,4,7,1,8,1,4,4,284,12,1,2,3,2,5,0,7,4,1,0,6,4,0,0,3,3,7,5,4,1,1,0,1,0,7,5,0,0,2,2,2,1,6,9,3,2,28,1,0,2,2,2,0,0,1,0,4,6,18,342,5,13,11,6,8,0,12,3,15,0,11,5,8,2,0,0,0,6,5,0,3,0,11,4,11,11,4,5,0,11,2,0,4,2,1,8,0,6,4,0,6,7,11,2,14,11,8,7,0,8,8,2,5,4,9,5,2,3,1,1,14,3,25,4,9,1,3,1,0,0,0,14,7,5,8,0,6,3,11,3,21,0,2,3,4,15,6,8,7,1,3,1,5,5,4,121,1,0,5,5,21,5,9,0,4,8,0,3,0,3,2,3,7,18,38,0,28,4,8,1,5,3,1,4,31,4,10,6,0,35,0,6,7,1,8,82,1,1,4,8,3,0,6,1,38,14,2,4,9,8,2,1,0,0,2,15,5,62,2,4,6,19,6,3,14,0,10,0,0,5,0,0,19,13,3,5,7,8,2,9,6,13,30,0,0,8,4,0,0,5,0,6,2,3,0,13,9,10,1,5,3,2,6,2,1,2,6,6,9,2,7,3,1,0,17,6,2,0,0,2,19,7,8,0,1,0,1,0,1,5,0,2,13,4,0,16,13,1,12,2,10,8,246,1,1,0,1,1,3,1,8,24,0,8,0,0,0,2,4,0,3,15,0,15,2,0,0,13,21,4,9,0,8,3,9,7,6,4,1,1,0,6,9,7,5,8,6,6,8,1,6,7,5,2,0,1,1,7,0,5,1,0,4,5,15,0,1,4,3,1,2,7,2,3,7,1,4,1,1,5,7,8,1,8,1,2,0,9,1,0,2,10,3,4,15,0,1,4,6,3,1,2,6,1,3,14,47,4,4,6,2,0,4,24,6,0,1,3,2,13,3,23,3,6,4,0,3,53,5,5,0,8,10,2,2,1,0,0,0,4,3,4,2,3,10,3,3,4,9,0,4,2,1,4,0,0,319,2,14,3,3,0,0,1,4,6,3,4,1,6,11,2,2,2,3,14,0,0,21,15,0,0,0,8,0,3,1,6,2,3,4,0,5,2,0,0,0,50,2,2,5,8,6,1,11,0,0,5,20,7,0,0,7,3,3,0,3,1,2,0,8,0,5,9,6,0,1,3,3,0,4,5,5,4,0,3,7,6,1,5,4,0,2,0,7,2,1,6,9,1,2,13,2,2,4,0,0,5,7,2,1,2,1,0,3,0,4,1,2,10,8,8,1,6,0,7,0,0,231,9,2,22,6,3,7,8,3,2,3,0,0,0,26,7,2,0,1,0,7,4,0,13,1,4,0,5,18,9,3,1,2,5,5,0,0,0,4,0,1,2,5,10,10,10,5,2,5,3,5,3,3,1,3,7,0,3,0,17,3,4,7,5,3,0,5,12,2,10,9,20,0,1,1,9,10,2,3,3,0,0,6,2,0,4,2,2,8,1,6,1,0,0,3,2,5,0,2,3,4,10,6,0,5,0,1,6,3,5,5,3,5,4,2,0,5,0,5,2,2,6,0,2,0,4,8,2,1,6,0,12,0,1,1,4,4,3,3,0,4,7,12,0,4,1,0,1,9,2,7,0,1,16,23,1,3,6,5,3,10,0,3,3,2,6,8,0,3,27,1,8,2,2,6,0,8,6,4,12,5,3,2,12,1,3,2,2,4,0,13,0,4,2,4,6,0,2,0,0,0,0,2,0,3,8,0,26,4,0,3,1,2,1,0,2,1,0,2,2,2,1,10,0,0,0,1,6,4,0,3,3,14,3,7,4,9,10,6,6,3,12,1,3,0,2,5,0,0,42,0,1,4,0,5,1,6,3,3,1,1,3,2,5,0,3,2,4,7,2,0,17,1,2,4,5,1,4,2,8,0,1,2,3,5,2,0,3,4,2,9,7,20,0,1,0,15,0,0,2,4,2,2,1,8,26,3,1,9,1,8,1,4,1,4,2,4,2,1,1,8,1,1,0,2,0,1,26,0,1,0,3,0,0,2,0,2,1,3,1,0,4,10,0,3,9,1,12,1,0,0,4,0,1,2,1,5,0,1,0,0,13,0,9,3,14,8,3,4,2,0,0,0,1,1,2,0,3,12,7,1,0,10,7,1,1,4,0,3,2,0,4,2,6,3,3,0,1,2,4,14,7,0,2,0,0,4,3,3,1,4,4,8,0,2,16,8,1,0,3,4,2,1,4,3,4,5,1,4,11,5,6,0,6,0,1,2,5,0,0,0,4,0,10,1,3,1,1,0,2,2,1,10,1,0,0,0,0,4,1,2,4,2,0,2,4,8,3,3,1,2,0,3,8,1,3,1,5,4,0,3,0,7,10,0,3,0,6,1,1,0,1,1,5,2,6,2,1,8,2,0,1,12,6,26,0,3,2,2,0,1,3,11,0,12,1,3,2,111,0,34,2,0,0,2,20,1,0,22,1,2,2,0,2,0,0,7,9,1,2,2,9,0,4,5,8,1,5,3,0,2,0,4,1,0,1,3,0,6,7,1,2,5,0,3,1,3,0,2,0,0,9,0,0,3,3,2,12,8,4,0,4,0,7,6,13,3,4,11,2,2,2,1,0,3,10,0,0,3,5,0,2,10,8,6,1,6,1,1,1,0,3,0,0,2,1,3,5,0,0,10,11,1,1,0,14,10,2,0,4,5,6,0,1,0,0,7,0,2,4,1,2,0,1,2,3,5,0,1,0,0,0,3,0,0,0,1,4,0,5,2,14,2,10,4,1,0,2,1,5,17,0,1,5,1,0,0,4,1,3,5,2,3,0,5,0,4,0,1,3,0,7,5,43,0,1,1,1,2,2,3,0,7,4,3,13,1,1,17,3,0,8,11,13,4,3,2,2,2,0,5,0,0,5,0,0,3,1,15,9,0,0,0,1,80,1,0,0,2,0,0,1,0,0,3,5,8,2,2,3,4,0,5,0,3,2,4,2,3,0,3,1,6,6,13,0,17,9,3,1,1,0,7,0,2,3,5,0,0,2,6,0,0,10,3,0,4,0,2,4,3,8,4,16,5,2,1,5,1,0,1,2,13,0,0,0,1,0,9,0,2,0,5,8,0,3,1,2,0,4,5,5,3,2,0,3,3,0,5,0,7,2,0,7,6,0,0,9,10,4,2,2,2,2,7,0,15,0,1,9,1,0,1,6,1,0,1,2,1,43,2,0,4,6,4,0,0,5,4,0,1,0,0,0,0,0,0,9,4,3,0,0,1,2,2,1,0,3,5,4,1,1,4,3,1,3,1,2,4,1,0,17,10,5,11,3,0,3,5,0,1,3,2,3,0,0,3,0,8,2,3,0,1,0,2,0,0,1,2,0,0,1,0,2,5,0,4,4,1,15,1,0,14,1,0,8,4,4,7,1,5,0,8,1,1,1,0,1,1,0,2,8,0,4,4,7,0,7,7,4,0,0,3,0,3,3,1,2,1,0,3,0,5,1,1,0,1,6,0,1,0,0,3,0,1,1,1,0,0,1,0,2,0,2,0,3,4,9,5,3,1,0,0,1,10,10,1,5,3,1,0,0,2,3,0,4,1,1,0,3,3,10,0,0,1,2,3,1,0,0,1,0,2,0,0,2,4,1,5,0,3,2,16,0,3,1,3,5,1,0,0,0,2,0,1,1,1,3,4,0,2,2,4,3,2,1,2,1,2,24,1,0,5,4,3,2,1,0,1,1,3,3,4,4,0,0,1,3,1,0,0,2,3,0,0,5,2,0,2,2,3,2,6,1,1,1,6,25,13,0,6,0,0,7,1,7,3,20,0,0,2,3,1,1,1,5,8,0,7,0,0,4,5,4,1,0,0,1,4,0,4,4,1,1,26,9,0,3,0,0,3,1,1,0,0,0,3,5,0,9,1,0,0,6,3,0,0,2,38,3,4,2,0,6,8,1,1,2,15,2,0,2,2,0,4,5,2,0,3,1,1,0,3,2,0,7,8,0,15,1,0,6,7,1,4,0,0,0,1,5,2,1,6,16,0,3,0,7,1,5,0,2,4,0,13,2,1,7,1,3,3,1,5,3,0,0,0,0,3,1,2,2,3,0,0,1,6,0,1,1,5,0,2,6,3,0,0,1,1,0,1,5,4,0,5,6,3,2,4,2,14,0,0,0,0,5,1,7,2,1,10,0,8,2,6,0,2,3,1,2,2,10,1,0,3,2,0,16,5,5,1,2,1,3,0,0,2,0,4,0,0,2,0,3,26,1,12,1,13,1,3,0,5,14,0,0,0,9,7,0,5,0,0,1,0,1,4,1,1,4,1,0,0,2,7,0,3,5,5,0,13,17,0,1,1,2,0,2,0,0,0,2,1,5,232,1,0,1,0,1,11,0,2,1,1,1,4,4,1,2,8,4,2,7,0,1,1,2,6,5,3,3,3,1,18,5,11,0,0,13,3,3,6,1,3,2,1,2,1,3,7,4,4,0,0,0,0,2,12,1,2,5,1,4,0,0,0,2,4,0,4,0,1,3,14,4,2,1,2,3,0,2,1,2,0,4,5,5,1,0,0,5,3,2,1,1,3,1,1,0,0,2,1,0,3,3,0,4,0,1,8,4,1,0,8,0,0,0,1,7,20,0,0,1,2,2,3,0,0,4,0,3,2,1,18,1,4,10,1,2,0,4,2,4,1,2,4,1,6,1,1,0,0,0,14,1,5,6,3,5,2,10,3,0,4,2,4,6,8,0,6,1,3,4,1,0,7,3,2,6,3,0,0,0,1,4,3,4,0,0,0,1,7,2,0,0,1,3,0,6,2,0,0,12,3,2,8,0,1,5,5,4,1,0,1,8,0,5,196,1,0,0,0,0,0,1,1,5,1,7,0,1,2,2,3,2,0,1,2,4,5,1,19,1,1,0,6,0,2,3,0,0,89,205,4,8,1,1,3,3,3,3,9,12,0,8,3,5,3,0,11,4,2,13,1,4,0,2,3,2,0,2,0,0,7,7,2,0,7,0,6,0,0,0,2,10,0,2,4,11,0,6,0,5,0,3,0,12,0,23,1,70,15,2,0,0,0,0,1,0,2,0,1,0,4,0,0,47,0,0,19,0,0,161,0,0,0,0,0,1,0,0,0,147,1,0,2,0,2,0,0,0,134,1,0,0,0,0,0,0,0,0,0,0,0,0,0,12,0,0,0,0,0,0,0,0
"1988 Straub, Peter, Koko",pop,11527,6102,4560,5395,4768,2079,4339,3362,2668,1680,2225,2876,2082,849,956,1535,2327,1323,1059,1576,1467,766,1046,1770,314,769,465,839,1026,627,817,972,693,636,785,709,716,710,549,542,592,765,507,373,623,479,507,409,523,499,594,516,565,751,577,396,615,414,431,413,654,351,494,366,300,329,379,369,292,454,336,252,229,355,270,237,336,189,245,296,304,177,645,273,300,468,320,191,250,285,158,283,247,350,325,277,351,300,222,397,194,396,273,210,287,204,244,266,231,262,240,289,141,245,188,255,254,175,190,279,329,109,267,230,295,132,256,212,257,153,360,284,136,240,183,135,100,270,188,154,82,128,51,144,154,163,111,145,126,116,126,207,241,244,121,99,100,98,159,299,194,194,67,93,195,151,122,115,119,200,49,85,114,107,109,161,136,136,91,94,97,140,42,142,110,107,133,211,170,120,89,160,77,124,152,127,47,119,135,67,75,168,159,111,106,87,117,173,57,102,37,63,233,122,111,73,103,306,111,112,88,117,125,154,127,149,70,169,49,148,122,99,174,147,115,5,101,116,121,68,101,26,117,158,89,57,73,97,117,119,66,44,98,109,74,98,84,60,108,106,114,111,90,162,57,43,99,105,78,109,97,70,73,70,113,72,99,57,63,46,114,84,79,104,139,317,42,96,88,133,75,46,22,116,61,79,54,74,17,34,62,64,71,87,156,59,77,135,153,16,45,27,71,79,35,74,66,105,64,80,95,67,52,122,48,102,59,100,81,83,47,35,108,78,73,67,49,79,57,105,130,80,45,40,74,160,57,93,45,50,58,61,54,35,50,30,48,17,67,55,54,89,44,71,39,68,113,106,32,96,50,43,63,52,53,108,67,58,30,44,65,58,53,67,43,87,0,32,25,83,19,49,45,15,49,62,83,39,47,56,54,93,65,59,69,41,43,61,47,39,41,44,92,34,55,27,45,61,37,18,36,2,36,33,56,63,34,66,27,69,67,34,56,56,25,51,48,47,47,57,32,27,25,25,42,76,26,26,24,56,68,47,19,48,55,44,43,126,45,50,22,25,0,70,63,41,152,73,25,52,28,50,26,14,79,49,70,44,0,66,33,65,52,13,65,38,100,23,76,30,19,35,64,35,40,32,34,70,45,25,45,112,82,51,34,20,8,26,28,39,52,44,50,50,66,15,0,33,36,22,23,38,50,45,33,37,30,31,27,39,6,43,52,9,42,8,17,12,25,49,43,49,34,46,54,61,0,3,46,48,94,37,39,13,38,56,30,39,15,45,29,50,18,42,31,27,47,46,29,82,49,72,24,97,57,43,40,6,25,22,18,40,21,22,5,35,36,10,45,35,38,29,38,17,20,32,23,85,43,73,19,27,40,25,28,536,390,24,46,35,24,43,38,29,24,23,14,39,36,0,33,14,32,18,37,49,36,41,17,119,16,64,54,46,41,0,30,53,76,66,20,51,45,44,56,34,43,17,51,20,0,43,24,23,17,48,26,40,32,53,11,38,61,15,33,33,28,25,28,40,28,12,51,43,24,17,25,43,14,50,38,21,34,30,42,19,1,33,56,24,24,20,16,59,25,24,24,6,73,13,17,22,30,23,13,23,10,28,24,35,2,50,42,49,42,33,24,13,17,17,39,2,28,4,21,63,11,35,35,24,35,21,4,22,2,65,11,30,24,56,28,34,89,27,21,0,25,17,15,46,34,29,12,16,36,103,45,26,39,7,28,40,28,11,34,13,16,58,40,9,17,23,21,68,565,25,28,24,55,12,15,21,45,63,33,16,47,29,21,16,41,32,2,25,33,62,1,36,29,29,17,9,17,31,12,22,5,30,6,60,32,13,11,82,23,13,91,0,37,7,78,28,10,33,24,6,36,49,25,16,13,25,28,16,18,25,23,17,0,23,51,23,24,35,21,36,28,0,22,16,18,27,3,27,8,25,15,17,18,24,41,5,19,19,30,13,22,0,14,16,11,12,11,7,9,10,59,21,9,12,15,15,26,14,6,13,37,20,19,18,26,37,7,27,17,3,12,0,49,24,8,47,17,30,48,6,10,6,16,43,12,0,18,0,19,10,10,18,17,6,30,5,16,31,28,25,12,7,9,12,15,19,29,1,26,29,20,21,20,16,24,7,29,31,18,21,20,24,30,30,16,30,27,55,18,18,8,39,7,46,0,15,16,12,48,13,14,13,59,15,30,2,26,26,21,11,10,11,14,4,6,26,13,6,10,16,11,3,17,13,11,58,20,28,21,29,9,22,36,0,27,0,14,109,26,52,0,0,3,11,34,6,30,21,23,11,17,0,13,20,6,15,19,23,2,8,8,7,22,16,19,7,16,7,16,66,24,5,11,15,35,6,6,18,19,21,8,8,26,6,6,13,3,36,5,1282,6,24,11,9,15,17,0,15,12,39,27,13,0,0,0,22,21,26,44,7,9,0,14,26,22,12,9,33,20,16,4,6,6,15,37,0,26,8,5,13,16,22,13,16,38,12,27,21,9,8,4,9,16,32,11,9,8,11,0,0,19,37,17,14,12,4,25,21,35,14,17,27,63,0,37,5,17,3,10,22,23,4,12,25,29,1,29,35,34,7,12,24,13,6,7,22,16,9,17,15,4,9,30,20,12,28,19,8,0,28,6,11,3,9,0,35,8,13,18,21,21,70,4,0,27,20,16,3,23,8,13,19,16,0,14,9,1,9,29,31,25,24,3,24,11,0,24,15,19,35,0,7,16,9,0,12,15,11,13,0,0,45,24,21,12,19,9,1,40,8,14,9,18,11,23,10,4,12,15,0,5,3,7,25,15,14,5,0,5,3,0,14,9,23,6,10,21,11,2,12,30,3,1,15,17,0,37,9,0,9,23,13,12,11,1,4,12,25,0,5,6,12,1,2,4,11,10,7,27,17,33,62,8,35,0,5,6,7,8,8,31,19,0,107,14,23,44,9,15,7,31,25,28,15,12,1,19,9,6,25,32,16,6,12,14,17,10,90,10,22,13,20,4,21,3,15,9,8,11,13,9,7,15,18,12,25,12,0,29,3,12,30,29,21,32,4,28,14,8,11,11,6,8,20,25,19,19,16,14,63,7,8,21,11,10,2,20,6,39,2,0,16,0,9,38,0,11,10,7,12,8,18,3,14,44,13,20,1,4,39,13,7,24,10,0,0,0,14,0,19,0,0,7,34,22,15,9,12,0,23,11,10,10,7,6,4,11,6,14,20,20,4,27,15,28,11,0,0,9,25,7,10,17,23,11,12,18,7,19,7,10,11,14,11,15,12,0,5,6,0,22,15,13,17,7,3,30,0,6,7,3,0,18,5,15,5,13,24,1,9,4,20,37,23,7,13,0,10,21,13,5,4,0,10,19,15,3,12,9,6,0,15,6,14,16,0,3,0,0,10,0,6,9,38,19,10,22,8,9,6,9,0,4,4,13,9,13,11,4,1,22,9,0,22,4,17,2,4,11,1,10,9,3,9,10,18,7,16,8,22,15,3,20,22,17,17,19,3,5,19,11,14,7,12,13,14,9,5,4,26,5,54,13,11,6,14,20,0,8,3,12,17,25,7,9,3,12,8,14,8,14,10,4,31,0,6,25,59,9,21,6,0,34,6,0,11,0,12,2,9,1,10,9,8,10,6,80,4,10,12,0,4,1,19,38,13,14,2,6,8,9,21,1,2,2,4,16,8,19,3,5,9,8,12,22,8,9,10,0,3,9,5,17,1,15,25,2,3,37,16,10,3,4,15,14,8,3,8,2,4,13,0,9,6,1,1,6,5,4,18,3,10,10,8,24,12,5,1,7,7,20,25,14,15,9,0,2,22,1,3,6,9,14,6,7,5,15,14,9,7,5,1,14,41,3,6,1,2,40,18,8,12,0,21,11,5,4,8,7,14,16,7,10,6,11,16,11,0,4,17,7,9,21,3,3,4,17,5,0,8,5,6,10,20,7,5,11,34,26,10,0,11,7,5,18,11,9,5,5,5,23,16,7,0,2,13,3,10,8,27,14,10,6,5,9,0,14,12,5,17,4,9,19,9,21,7,0,1,10,75,13,8,17,3,8,40,18,10,4,4,3,8,14,1,5,31,6,4,13,6,12,0,9,13,21,6,0,0,20,2,0,4,0,11,0,8,6,7,51,3,3,9,0,4,4,4,0,8,6,14,18,7,4,5,4,6,6,8,13,26,11,2,14,7,8,10,7,15,0,1,2,6,3,8,3,8,3,9,5,12,3,47,4,3,0,9,8,1,1,29,8,3,24,26,1,15,0,1,15,0,14,10,2,10,0,6,1,9,0,14,6,6,14,7,0,10,12,0,1,10,6,3,3,9,8,2,1,28,7,13,6,5,13,18,1,26,0,11,16,0,3,8,0,8,7,9,690,8,7,17,2,11,9,3,27,9,5,11,25,3,0,5,9,9,3,8,17,19,8,5,6,9,2,1,8,7,2,0,5,12,11,3,3,8,2,4,4,6,14,20,1,19,5,6,6,21,8,11,6,24,5,0,17,3,15,1,8,7,10,5,31,4,1,52,3,8,28,3,23,0,17,3,6,10,3,0,8,3,13,0,8,13,9,0,4,5,14,4,0,2,8,13,9,33,7,10,4,0,8,10,13,4,7,2,4,8,6,15,0,12,7,30,6,8,5,4,7,1,2,13,3,15,1,17,0,2,5,9,0,3,8,16,2,10,6,6,1,4,9,22,0,0,0,5,8,9,6,8,5,10,12,3,9,6,1,1,11,15,12,12,0,104,7,7,0,7,5,11,5,4,4,2,0,0,7,627,13,1,0,0,6,12,6,10,8,7,3,1,0,2,2,4,18,6,4,1,6,0,9,6,4,15,0,6,5,9,1,0,10,0,10,1,8,7,0,13,2,8,2,6,0,13,39,8,4,95,0,0,6,0,0,6,0,9,5,0,0,12,3,4,26,1,3,5,12,3,8,6,8,20,2,9,3,10,5,25,7,1,25,31,0,0,7,9,12,11,7,8,2,2,3,19,2,5,4,7,3,18,10,6,26,11,35,2,12,12,2,2,13,28,3,42,12,0,8,4,8,0,1,3,4,10,1,3,3,3,19,7,1,6,9,18,5,3,9,3,9,1,5,29,8,6,5,10,1,0,5,3,1,23,1,5,6,14,9,7,8,3,12,4,12,9,3,19,7,2,5,10,3,14,5,20,4,3,12,1,6,5,15,5,8,7,4,11,2,10,5,3,3,7,8,1,7,7,5,11,0,0,29,10,7,5,3,7,0,12,20,11,0,1,4,6,21,10,6,7,11,5,3,1,12,4,1,2,3,8,15,13,0,4,1,7,5,8,4,26,8,2,4,5,2,22,3,5,4,1,8,2,17,0,13,10,7,6,0,1,0,4,1,0,9,0,16,4,6,6,3,12,3,2,27,2,0,12,8,15,9,0,0,1,21,3,5,13,3,6,0,3,3,7,9,4,0,6,4,3,5,2,1,529,2,4,1,0,1,2,4,4,10,4,8,5,4,8,0,7,51,1,7,0,6,7,11,4,7,10,16,2,0,9,2,0,10,6,5,14,7,7,11,5,32,0,2,0,0,4,9,2,2,11,0,6,1,1,2,2,11,7,0,4,10,0,6,2,4,0,4,11,2,1,9,24,4,4,1,3,14,8,7,6,0,0,0,0,2,3,0,0,0,7,5,1,11,2,1,0,12,8,0,8,1,8,8,6,15,3,3,6,7,2,9,4,20,16,5,0,2,10,1,9,13,11,9,8,2,7,0,6,4,3,7,8,0,1,6,0,0,12,5,3,36,8,0,2,12,0,0,5,0,0,2,11,0,4,6,14,5,3,9,2,5,6,2,4,11,3,5,2,13,4,1,1,9,4,3,2,1,4,9,8,5,8,7,1,5,3,4,2,12,10,4,0,10,1,15,2,4,3,2,9,2,10,2,2,0,7,0,8,3,12,1,5,3,0,2,5,0,8,3,0,7,8,0,0,1,2,4,5,8,1,3,4,2,4,7,8,7,4,8,3,9,10,7,3,7,1,10,0,10,1,7,5,3,1,14,5,2,5,1,3,0,1,9,6,2,0,9,4,2,0,6,2,7,5,1,4,2,19,1,3,5,2,11,4,3,3,5,9,4,4,2,6,1,4,11,4,6,26,3,2,7,4,7,2,1,0,10,13,11,3,7,8,5,9,3,52,52,6,7,0,8,19,7,5,0,0,0,1,2,3,7,2,4,11,3,11,7,10,2,12,4,7,3,7,4,6,0,5,18,0,1,7,4,4,17,27,5,7,1,4,8,3,5,40,2,25,0,0,2,1,5,4,3,2,5,8,12,22,0,0,12,0,10,4,1,1,0,6,8,2,15,8,11,2,13,10,1,5,0,2,12,9,5,3,5,2,5,5,8,5,3,3,10,0,1,8,2,12,0,4,4,2,20,18,0,1,9,1,6,8,11,24,6,6,1,3,3,5,0,1,436,8,0,6,1,1,1,9,0,4,0,0,7,0,1,3,5,2,5,3,5,2,6,0,3,3,2,2,4,0,4,3,2,5,5,3,2,0,2,36,0,0,1,0,7,5,7,4,2,8,3,8,8,1,0,5,9,4,0,5,2,0,1,3,1,13,2,2,5,2,16,4,8,3,0,3,10,4,6,3,4,0,1,0,14,6,4,65,1,14,1,2,11,1,4,0,10,0,2,5,0,3,3,2,1,2,4,5,1,3,4,0,0,11,0,0,2,12,9,1,1,10,0,5,1,0,0,1,7,2,4,3,0,5,9,0,0,6,7,1,0,0,8,32,10,2,4,2,0,2,0,4,15,4,1,5,9,6,11,6,7,9,2,13,0,4,6,0,1,9,14,11,10,15,8,1,7,3,1,3,2,7,6,0,5,4,2,10,5,4,4,2,25,8,4,1,0,4,9,13,12,3,8,5,6,0,3,5,3,1,3,21,3,1,0,3,2,2,3,4,2,1,9,169,6,0,5,5,3,3,2,6,0,2,3,17,9,4,2,12,0,12,2,1,2,3,0,0,0,9,3,1,6,4,5,4,0,5,21,165,29,10,8,1,0,12,0,2,3,3,3,2,0,7,8,5,3,2,2,3,6,0,3,2,4,5,2,0,0,23,0,2,2,6,0,2,12,2,2,1,14,3,3,1,5,5,0,2,3,4,5,2,4,4,1,0,6,0,3,2,2,0,1,3,1,4,1,2,11,1,0,5,8,5,8,0,6,7,9,4,8,10,1,11,4,2,3,4,5,2,3,0,3,1,3,5,2,1,11,4,5,1,6,8,1,0,6,6,2,0,3,10,3,0,11,0,10,6,0,6,6,2,7,2,0,6,0,366,0,5,4,3,2,3,2,3,3,13,2,26,2,5,1,12,2,4,2,1,9,4,0,5,0,1,3,6,18,4,4,4,4,2,13,4,1,0,5,5,3,7,3,3,2,12,3,7,8,3,5,4,6,0,1,4,0,3,0,2,6,6,1,3,4,0,1,8,2,3,5,5,0,7,0,2,2,0,2,0,0,4,2,7,6,11,0,6,1,0,0,13,11,0,3,3,14,4,3,8,6,6,8,2,7,1,4,22,5,3,8,7,10,7,2,0,0,14,11,4,5,3,0,2,2,5,3,1,4,2,1,2,0,6,10,6,0,9,1,2,4,2,1,4,3,11,3,5,3,6,10,1,2,5,1,5,3,0,1,1,1,0,6,1,11,3,1,0,5,2,2,0,0,18,0,0,8,4,8,26,10,2,4,0,15,7,15,2,11,0,0,0,2,5,3,11,0,4,4,2,9,10,10,0,6,0,0,13,7,0,4,8,4,0,0,4,2,5,3,3,3,2,9,1,0,14,4,4,3,7,2,6,3,1,5,6,6,5,3,0,1,6,0,4,0,5,1,0,0,4,1,4,0,0,3,0,9,3,2,6,2,2,8,1,4,2,3,1,5,2,0,1,2,1,6,1,3,2,0,1,1,3,3,3,2,3,0,8,12,10,6,2,0,0,2,5,2,0,0,2,1,4,9,2,5,7,2,5,2,1,1,6,3,0,1,9,2,2,2,5,6,0,4,2,3,7,1,2,3,1,3,37,24,0,8,0,3,1,6,3,7,2,5,9,7,16,3,7,2,2,4,6,0,0,21,9,5,5,3,16,10,20,0,9,1,2,5,2,10,7,0,2,12,19,5,14,0,6,1,6,1,1,3,2,14,11,0,12,5,7,0,8,1,16,4,2,3,2,5,13,3,9,2,1,0,6,0,4,4,4,5,1,2,0,3,2,11,2,0,0,1,4,0,1,0,5,3,6,7,3,2,4,1,6,1,1,6,3,0,0,0,0,1,1,6,2,5,7,2,3,2,14,13,6,3,0,3,1,2,0,4,11,5,4,0,1,3,7,4,1,11,0,5,1,7,2,2,0,0,0,0,2,11,1,7,2,2,0,0,0,6,2,6,4,2,15,3,3,4,2,4,4,5,7,2,0,2,4,1,0,0,0,3,0,7,4,1,4,0,272,2,1,0,0,1,0,0,1,4,2,1,20,0,1,1,0,7,0,3,4,5,2,0,4,3,8,1,6,4,0,5,3,4,2,0,4,11,8,5,7,1,8,8,1,6,4,2,3,8,3,0,5,6,1,9,13,0,0,2,1,2,11,0,1,2,10,5,12,9,6,5,4,6,0,1,2,0,1,0,6,0,1,3,0,0,5,1,0,2,0,0,1,1,0,2,3,6,2,3,0,8,7,2,6,4,2,1,6,0,7,9,1,2,2,0,0,5,3,5,2,0,0,0,1,3,2,5,0,1,4,0,1,10,3,0,0,11,4,0,2,0,5,3,6,0,4,1,3,2,2,9,3,1,1,6,0,0,2,2,5,6,2,1,0,3,0,10,0,0,4,5,46,0,9,9,8,2,2,2,0,9,0,1,2,12,3,5,5,1,2,5,1,1,0,5,1,2,2,0,0,2,2,7,5,2,0,1,15,4,14,4,0,0,0,3,9,5,0,0,0,1,1,9,0,4,1,18,4,10,2,3,4,0,0,4,3,10,0,1,0,4,3,6,1,1,0,21,5,4,2,0,3,0,0,11,2,2,3,2,4,3,0,5,39,3,1,2,1,7,6,6,2,3,6,7,1,4,3,1,6,4,3,1,3,0,3,10,1,8,5,0,0,3,5,2,10,2,4,16,2,3,5,4,2,3,1,7,1,2,4,7,2,0,2,3,0,1,1,7,3,4,6,11,1,0,1,1,3,5,5,0,9,6,3,3,0,0,9,0,0,2,0,2,8,4,4,4,2,1,1,1,0,12,0,0,0,3,0,0,6,0,6,3,1,1,5,2,4,0,2,2,3,2,7,6,6,0,6,6,2,0,2,36,0,1,1,0,12,1,2,0,3,13,5,0,0,2,2,0,2,3,0,0,0,1,0,7,1,3,1,4,1,0,0,3,0,3,0,2,17,2,0,1,3,0,1,8,0,7,4,1,0,24,2,5,2,0,0,2,0,2,0,41,4,1,2,0,0,1,2,2,3,0,0,2,4,0,9,0,3,0,3,6,16,21,1,2,2,0,2,0,5,0,6,3,5,1,0,3,3,5,2,0,7,4,1,7,3,9,3,2,0,1,3,3,3,0,1,1,0,0,7,2,14,0,4,0,2,0,2,10,1,0,1,0,10,3,5,2,0,1,0,0,0,0,6,5,5,1,4,3,0,1,1,0,1,5,2,3,0,4,2,2,4,1,0,6,7,4,0,3,1,1,7,12,2,1,1,24,14,2,2,2,0,2,2,0,9,2,3,4,1,5,7,4,0,1,0,2,0,4,1,0,0,5,1,3,0,2,2,2,0,4,5,0,1,2,28,2,4,0,4,0,0,2,0,1,0,2,2,6,16,0,1,6,0,7,0,9,6,3,1,1,5,4,0,0,7,4,7,0,4,2,0,5,2,2,7,166,0,3,0,1,0,0,0,0,1,11,5,1,1,5,5,5,0,0,1,72,2,1,0,7,1,0,2,1,1,16,6,0,3,2,1,3,2,3,4,0,8,4,0,0,2,1,2,3,0,0,2,0,1,5,1,6,6,0,2,5,2,1,1,6,0,1,4,1,2,2,0,240,0,2,2,3,1,1,1,1,1,11,1,2,9,1,0,0,2,1,2,1,0,40,0,1,3,0,0,0,6,0,1,4,2,0,0,3,4,14,4,3,5,1,3,12,6,5,1,8,1,0,1,0,0,4,0,3,0,1,1,8,5,5,11,2,0,2,11,5,1,11,0,4,3,4,7,5,2,2,5,0,2,0,3,1,4,2,4,1,5,0,2,2,2,5,2,13,2,0,4,8,4,0,8,0,7,0,3,2,0,7,3,0,3,2,0,6,210,2,0,1,0,0,7,1,5,1,3,1,2,6,8,0,11,0,5,0,0,6,2,3,2,0,1,0,0,0,4,4,3,0,1,1,2,1,21,15,0,1,0,3,5,4,2,3,1,6,1,1,2,4,0,6,2,2,6,1,0,5,4,0,1,0,6,3,1,1,0,4,0,8,0,2,0,1,1,0,0,3,4,8,0,0,11,6,3,0,7,3,2,0,0,2,2,2,1,4,1,1,2,1,0,2,0,3,1,2,3,0,9,4,1,0,0,3,3,3,0,2,0,4,4,6,4,4,3,8,1,0,1,5,4,0,0,1,1,1,0,2,1,5,0,0,2,2,4,10,0,0,3,2,2,0,2,0,0,9,0,0,0,1,1,0,3,6,1,31,3,5,6,8,1,0,2,2,3,2,3,2,9,4,6,2,2,4,5,0,0,3,4,1,3,0,1,4,0,1,6,0,2,2,3,0,0,0,0,2,3,1,4,0,13,6,0,4,0,10,5,4,2,7,3,6,3,6,1,4,1,0,1,4,1,0,0,0,0,0,2,0,1,4,1,0,2,37,0,2,1,8,1,3,0,1,5,5,2,0,0,7,1,2,11,1,0,6,5,4,1,6,13,0,0,1,0,3,8,3,17,6,4,1,1,1,5,0,0,2,5,3,0,6,4,11,5,7,2,1,0,2,0,0,1,4,0,4,7,11,24,2,1,4,0,0,21,6,1,0,2,12,1,0,1,0,2,2,5,0,2,0,0,11,0,4,1,0,0,0,0,0,0,1,4,10,0,1,0,50,0,0,1,0,0,0,0,0,0,0,0,0,2,0,0,0,0,0,3,1,0,6,0,0,0,0,0,0,1,0,0,0,0,0,0,0,0,0,0,0,0,0,0,0,0,0,0,0,0
"1990 Rice, Anne, The Witching Hour",pop,25633,15874,12024,7485,9841,7315,6942,7192,7449,6545,5021,3263,6160,6977,6988,2956,4185,3356,3068,2261,2741,2997,3046,2439,1578,2083,2379,2025,1404,1940,1776,1122,2170,1599,2540,1894,1583,2264,1046,1239,1337,1070,1786,1459,1371,1542,1220,1491,1222,1267,979,1031,1377,966,820,1076,1282,1469,1333,831,782,893,1223,1175,674,871,627,845,860,1128,414,434,770,952,181,790,345,630,512,726,400,537,830,471,488,432,373,654,787,463,413,673,841,634,511,496,427,512,332,652,808,801,485,496,465,871,332,852,629,483,701,1004,362,371,553,309,539,507,489,450,377,468,645,646,452,556,498,367,629,607,655,587,317,392,425,431,356,422,278,418,878,543,365,298,348,294,387,297,373,262,299,752,252,323,472,127,362,313,157,234,528,372,312,541,182,508,291,137,511,204,99,447,523,227,102,547,390,283,342,111,390,378,441,206,299,293,261,286,192,235,221,150,165,274,306,407,427,171,550,377,203,457,228,373,337,126,81,240,314,154,445,195,172,128,338,130,199,3,509,224,199,230,155,87,251,332,256,214,126,381,257,222,226,276,385,311,328,195,388,295,306,153,137,236,220,99,95,251,151,259,132,129,130,117,152,193,251,106,125,234,143,38,226,131,221,309,207,256,102,233,199,89,266,122,244,130,152,167,224,255,157,178,213,208,267,446,165,228,160,138,73,53,92,292,181,138,204,117,154,143,64,166,0,96,161,92,118,201,145,147,279,149,259,160,471,135,39,119,118,55,451,66,74,92,195,107,221,173,195,106,83,250,104,92,48,67,172,141,119,203,150,134,152,36,191,195,177,39,226,57,78,83,118,54,123,504,86,123,93,137,78,60,134,131,113,63,147,179,71,167,120,46,64,76,86,126,239,67,87,106,82,90,39,90,122,41,0,120,84,127,1,144,186,56,63,91,171,145,89,135,148,122,127,118,151,104,104,90,115,138,82,217,173,76,144,229,138,56,108,178,74,0,283,46,117,30,157,214,102,49,101,136,102,141,43,127,43,219,146,77,51,97,31,223,52,66,191,212,94,71,130,124,99,67,107,77,78,61,138,40,133,58,14,95,156,29,127,156,94,92,99,159,90,5,49,187,39,31,0,83,84,116,49,18,273,57,52,101,41,47,78,70,82,80,51,101,78,55,29,55,112,76,43,53,85,36,62,121,105,89,126,125,94,144,79,122,0,65,103,28,47,281,50,67,101,56,61,117,80,122,6,55,42,78,88,417,106,181,43,104,117,86,95,67,39,100,0,18,54,0,88,93,47,7,75,94,105,63,92,20,19,56,75,15,33,47,57,107,157,22,114,29,47,89,105,14,95,115,63,84,84,60,74,56,4,70,179,19,70,27,107,63,48,77,49,43,71,39,111,32,110,94,16,121,33,0,0,112,14,21,125,38,90,80,134,60,25,42,101,93,89,57,231,67,74,7,41,31,73,42,55,102,138,47,36,7,101,56,81,85,48,259,71,43,11,34,30,56,232,59,0,66,88,89,97,74,44,70,31,27,11,74,48,51,108,33,117,66,31,100,110,72,99,93,59,27,56,118,39,38,75,38,57,66,29,42,66,101,69,37,73,39,22,44,76,32,29,2,99,18,41,52,22,41,74,108,166,28,15,111,10,42,55,76,55,26,43,109,27,50,8,4,41,72,104,32,33,45,48,34,88,20,59,26,0,83,59,23,19,41,38,59,121,39,3,2,9,136,35,30,34,82,121,81,106,99,25,58,152,3,26,77,41,11,85,11,46,72,39,114,57,29,2,67,1027,94,69,111,44,21,164,31,80,100,241,41,33,53,13,56,32,35,1,23,35,107,0,50,3,47,38,68,32,32,238,71,1,64,20,84,29,103,78,121,54,36,63,2,40,44,45,59,42,82,37,23,81,34,28,36,33,84,8,26,6,41,61,61,10,25,29,27,27,126,30,76,37,0,22,17,121,42,38,53,57,67,7,31,34,72,18,64,46,37,20,41,69,0,5,78,51,29,69,48,2,34,24,58,88,28,129,60,36,18,26,18,18,50,32,40,26,47,55,14,42,89,220,0,50,101,40,12,50,59,40,0,54,15,87,9,18,0,49,0,42,2,82,39,48,23,44,39,31,62,71,62,153,2,23,82,0,17,73,5,64,49,34,40,50,36,35,0,22,12,30,8,22,78,74,22,58,24,25,18,124,54,108,34,121,1,0,70,51,0,39,57,49,22,21,6,44,1,88,47,128,19,35,5,45,7,5,32,29,54,2,0,42,0,8,17,61,82,26,28,57,20,20,40,14,0,39,1,16,0,40,38,0,0,9,32,54,24,26,48,31,24,17,0,8,34,3,20,7,3,9,79,18,34,14,40,36,32,85,63,34,44,42,55,17,67,66,46,17,52,21,100,15,8,9,21,82,23,24,36,49,0,13,42,116,69,18,8,0,9,8,12,28,28,0,0,0,14,60,83,53,51,39,0,17,20,7,34,42,44,12,87,8,60,6,59,30,0,23,26,25,26,48,43,26,12,18,14,29,41,40,80,26,61,18,74,23,67,34,54,0,30,71,33,46,98,137,7,7,20,30,38,24,10,30,48,7,7,38,29,47,74,55,10,15,23,69,21,49,31,37,9,76,22,19,32,11,5,50,25,40,33,9,31,24,62,84,101,46,12,0,22,27,122,11,0,0,10,77,49,41,34,5,32,15,0,49,5,4,60,20,5,1,20,26,0,21,28,0,41,30,27,45,5,0,31,61,0,24,17,12,0,1,43,27,44,73,61,37,43,27,0,0,40,6,21,24,12,2,56,28,6,23,8,92,40,24,20,11,19,14,0,46,41,14,17,31,57,3,0,13,10,0,9,12,11,21,56,21,17,0,44,14,45,1,15,5,0,24,25,0,12,35,5,18,45,6,10,5,37,0,8,15,32,0,21,7,17,7,56,69,27,3,21,14,68,0,19,11,10,9,24,14,78,1,6,24,57,18,31,21,20,10,5,45,20,186,37,33,28,22,35,8,105,76,13,63,19,3,19,20,47,40,10,22,18,6,50,16,15,15,72,40,5,1,15,13,20,30,0,79,1,10,9,10,8,25,4,21,14,24,134,108,13,14,27,16,62,21,4,40,12,17,8,10,23,15,68,34,7,11,0,1237,54,0,5,0,0,15,48,35,44,21,10,1,7,79,101,50,4,83,50,60,120,53,1,3,1,0,34,106,55,13,0,23,25,44,21,39,29,1,15,73,5,39,58,11,7,40,18,18,33,19,18,12,41,10,44,0,0,19,16,13,12,22,63,28,21,40,2,0,45,4,9,31,29,22,50,0,20,48,0,45,3,16,67,23,22,27,0,24,25,16,0,7,10,33,36,35,22,136,0,31,5,28,8,16,26,10,16,3,22,61,26,61,24,17,33,9,7,13,59,0,0,12,15,30,0,2,0,0,19,0,13,17,169,19,35,57,64,42,2,9,0,2,67,1,12,54,10,36,162,14,6,4,15,25,29,4,19,12,0,19,24,49,15,19,33,18,22,13,33,26,0,55,14,32,11,23,29,6,41,104,7,34,17,3,26,49,74,18,14,1,0,56,8,58,48,43,0,58,58,25,1,31,5,33,15,11,7,31,19,26,2,143,38,0,32,70,1,45,11,11,0,24,9,3,2,0,10,82,42,53,10,45,33,41,16,18,15,74,51,0,33,0,7,6,16,32,0,16,32,27,100,20,57,42,15,7,20,86,52,58,9,11,22,26,6,15,12,0,3,8,45,21,0,8,38,92,5,23,11,8,19,16,7,18,55,29,19,33,83,8,0,20,2,0,111,9,7,40,10,2,8,11,24,10,23,14,3,3,105,4,37,9,23,42,0,2,33,8,1,15,0,8,28,50,138,25,23,5,20,57,22,28,17,1,25,0,0,11,33,14,14,0,10,9,29,8,2,42,4,10,14,10,32,4,9,38,1,17,50,15,7,46,4,21,5,29,11,0,1,15,30,9,2,17,10,137,6,95,21,0,10,52,15,16,7,13,17,21,11,6,12,11,0,14,2,0,15,20,26,45,19,12,43,54,17,11,23,10,23,24,56,7,38,28,44,4,32,8,1,21,9,6,4,3,40,9,25,76,8,30,28,12,27,40,10,26,17,19,1,21,0,1,28,8,13,0,0,10,29,0,22,0,0,58,34,30,5,2,25,6,7,0,44,100,8,0,55,2,79,12,12,14,52,28,5,20,14,9,68,49,47,19,26,16,64,6,1,37,24,17,11,12,46,8,24,1,10,7,12,10,9,101,3,1,9,16,25,9,19,18,69,15,25,7,18,0,2,2,1,0,16,18,22,0,30,8,8,0,14,11,8,0,33,0,9,29,0,9,13,6,16,29,25,21,2,10,4,51,0,63,34,11,18,0,2,0,11,4,0,18,16,0,21,58,51,0,43,0,57,2,90,10,0,32,6,0,35,6,0,0,20,16,18,10,4,22,24,12,26,17,4,5,18,27,67,4,0,30,9,23,7,30,17,1,9,30,5,4,16,11,17,21,14,1,11,8,11,67,8,7,0,64,28,30,0,18,8,16,2,1,7,23,62,41,5,6,26,7,30,7,51,10,12,8,0,17,13,23,0,37,51,20,0,8,40,5,7,5,7,13,5,41,13,45,23,5,0,5,18,1,5,8,4,6,23,12,28,12,39,18,0,26,8,11,12,45,14,26,14,17,6,7,5,0,4,15,21,951,3,4,42,7,97,0,11,3,28,63,21,4,0,1,17,17,6,2,17,19,26,5,0,1,28,5,26,8,16,5,39,0,2,34,14,39,18,7,42,8,3,3,10,0,0,5,0,22,25,0,0,8,6,13,20,22,19,20,3,0,8,15,21,2,11,25,11,17,0,77,28,0,5,0,10,0,10,2,0,14,0,21,15,42,20,0,16,67,29,2,19,7,4,20,9,1,10,5,120,6,2,0,26,5,38,20,0,4,12,5,14,20,15,15,9,10,17,20,8,6,34,5,12,0,27,263,50,31,12,16,6,0,0,20,3,7,19,17,10,6,0,5,20,15,1,33,33,31,2,69,4,23,13,13,2,27,31,5,4,30,3,38,2,13,0,9,12,21,5,10,20,42,11,7,2,7,25,2,13,10,33,15,17,20,7,31,0,17,14,3,30,15,7,13,44,6,0,8,10,1,5,6,10,10,40,43,29,2,17,10,39,10,4,2,15,10,7,9,27,14,9,3,17,16,12,7,15,8,21,17,17,3,43,2,8,41,13,2,15,12,25,22,6,9,5,3,16,0,3,6,6,10,54,17,36,26,15,7,18,1,2,18,6,17,52,8,47,9,9,2,8,30,15,20,3,34,35,0,5,0,4,3,12,11,8,6,14,7,7,0,6,5,11,1,9,22,7,12,1,8,0,28,2,10,16,175,23,0,7,3,96,14,0,9,31,41,8,17,22,6,82,87,119,25,10,6,23,8,0,0,28,20,52,7,3,23,3,12,11,2,3,20,11,0,2,13,3,6,14,0,0,1,11,7,0,12,3,7,1,9,14,14,97,6,13,0,9,28,0,9,0,5,9,7,2,19,77,36,8,1,10,9,4,6,39,18,14,40,3,8,6,8,9,12,5,0,0,10,17,10,8,1,30,13,22,2,3,0,2,1,15,8,0,9,10,10,3,17,24,16,16,40,10,7,40,15,10,6,0,3,26,0,452,19,0,17,19,0,5,0,9,7,18,53,4,0,4,4,5,5,35,6,18,13,7,18,8,3,7,10,9,9,15,10,0,15,0,4,12,20,11,11,13,14,11,22,2,0,4,20,26,36,5,0,8,14,27,20,1,7,2,6,3,13,22,4,535,0,7,0,0,1,6,0,0,5,45,15,14,9,22,5,12,11,19,6,7,9,3,9,15,1,24,15,0,7,0,18,13,13,3,42,13,24,1,12,6,15,4,18,2,18,3,17,15,11,15,5,27,1,8,6,13,2,13,0,23,0,1,23,10,0,6,19,0,24,0,1,38,6,0,13,4,0,0,0,23,1,3,21,2,17,2,10,5,3,37,8,15,9,4,2,22,53,1,4,51,4,0,4,14,6,2,12,0,2,23,27,3,1,12,0,23,65,27,4,0,20,16,13,0,6,2,23,20,3,8,14,14,23,23,8,7,52,13,4,5,1,4,4,23,45,20,11,1,9,12,10,11,10,11,3,1,1,9,1,0,37,3,6,0,2,8,2,0,3,0,10,10,21,2,6,7,22,3,0,0,8,18,22,23,13,0,4,4,6,7,16,6,0,2,7,4,10,27,10,14,0,2,10,0,25,12,5,17,15,4,22,8,16,14,5,16,7,6,13,14,1,24,1,3,8,7,6,5,13,13,2,1,0,0,28,7,2,5,2,6,9,2,7,12,17,1,10,1,11,9,22,12,12,5,0,33,10,11,14,11,21,8,24,18,6,16,3,0,7,10,8,15,7,9,3,27,36,40,0,0,9,2,6,11,10,5,12,2,12,6,11,35,0,13,0,3,3,29,6,2,60,8,4,17,0,0,1,196,1,9,44,3,26,7,44,20,1,392,10,29,1,0,16,8,15,8,3,7,19,21,23,0,0,3,0,0,25,2,22,4,4,33,0,2,5,3,1,6,0,38,14,42,358,8,0,9,3,6,0,15,6,5,18,16,25,24,17,11,0,5,16,9,9,1,36,6,27,122,4,4,7,0,3,2,11,14,5,5,15,1,9,1,1,4,0,7,13,0,244,12,7,2,15,33,11,1,0,11,0,0,10,2,16,5,41,12,1,9,3,0,116,12,2,11,7,12,0,18,13,0,0,10,8,9,2,0,16,14,18,12,5,4,1,18,0,6,6,6,4,11,4,13,1,14,3,7,21,16,0,68,0,3,16,16,22,3,5,8,18,0,1,18,25,0,34,8,3,20,3,19,8,5,3,10,10,11,0,23,3,6,0,13,4,18,6,8,5,6,10,0,3,7,3,15,6,14,0,27,0,0,1,3,2,19,0,2,20,3,10,0,17,14,34,16,12,13,21,6,18,7,3,7,7,9,0,3,19,7,26,8,10,9,0,6,9,17,6,6,8,12,4,1,2,3,1,15,12,0,0,12,0,22,11,2,5,0,0,1,20,7,12,2,0,0,2,33,33,54,23,9,13,2,5,0,0,27,1,2,40,7,5,4,0,1,1,6,7,1,15,8,0,9,12,15,13,3,7,0,13,9,16,8,3,1,19,0,12,7,11,8,35,19,16,0,53,4,18,14,0,0,5,5,6,14,7,5,14,2,12,8,14,10,3,28,2,0,13,0,12,5,5,0,1,16,20,7,30,12,7,0,0,13,12,4,9,3,31,0,46,1,3,42,2,4,26,7,11,9,0,2,0,0,0,1,10,6,3,9,8,9,5,6,6,12,18,8,2,2,7,16,1,5,3,5,4,4,17,15,9,6,1,12,5,15,20,4,9,25,0,3,5,2,25,1,1,4,3,7,7,15,16,19,11,5,9,1,0,1,0,7,0,3,18,20,10,4,5,0,20,8,9,10,8,3,0,2,15,4,7,0,3,4,0,1,9,33,5,2,21,6,4,13,10,4,0,0,13,3,6,14,2,8,14,17,18,16,4,14,4,1,9,10,8,5,5,9,6,0,3,7,4,6,4,29,11,7,3,37,60,5,4,1,6,7,0,5,42,7,4,6,8,0,7,4,7,12,9,30,10,10,20,16,6,4,7,6,1,1,2,7,3,23,6,0,7,5,8,5,4,0,25,0,5,2,0,1,9,0,2,9,3,0,16,12,4,7,12,0,7,14,1,50,7,0,21,57,15,3,0,0,2,4,9,8,5,0,7,1,1,4,18,0,6,17,6,1,26,14,0,28,3,13,10,21,5,22,0,1,1,5,4,2,13,16,3,2,10,16,27,24,4,1,16,1,0,5,0,5,8,0,0,4,3,6,2,0,4,0,7,4,10,28,0,11,5,4,8,6,2,14,18,0,2,0,35,0,10,12,11,10,9,4,17,41,1,1,15,16,0,2,9,10,3,4,1,0,8,20,3,0,37,19,6,1,3,21,3,18,9,9,22,29,7,1,5,8,0,1,0,13,3,6,2,1,7,1,13,1,16,3,9,0,1,5,1,0,15,0,11,24,19,4,19,2,7,2,4,0,18,1,6,2,1,3,0,4,0,5,0,0,5,18,13,11,18,9,3,30,5,14,4,12,1,10,22,0,7,15,0,21,1,19,13,3,2,1,0,11,1,2,31,18,0,87,3,22,11,1,5,2,17,11,7,6,17,18,1,0,5,29,6,29,5,3,2,9,2,5,5,3,18,0,10,6,1,17,5,26,2,3,6,2,37,18,3,37,11,2,2,1,0,0,0,13,0,15,11,6,4,5,2,6,5,0,9,16,5,3,0,1,15,1,27,6,4,12,27,24,5,3,19,5,12,0,10,5,5,8,18,8,14,3,3,5,2,47,3,2,32,18,11,0,8,2,0,5,5,11,5,3,16,5,4,21,0,2,0,0,10,16,7,0,0,18,4,0,0,16,7,4,0,0,6,4,0,0,8,61,0,4,0,5,12,92,0,22,177,0,1,1,4,5,1,0,1,3,5,5,3,3,3,0,42,5,5,0,4,12,1,17,4,7,1,2,10,0,15,5,44,4,6,10,0,13,10,17,3,25,8,0,5,2,34,2,49,11,24,5,8,10,5,13,5,21,6,0,7,1,0,17,7,5,0,15,38,54,2,47,1,0,10,4,0,7,1,0,1,16,6,1,1,8,7,7,3,0,1,6,0,2,5,17,1,13,3,2,2,0,10,5,21,19,0,0,0,6,0,5,0,0,6,28,0,3,3,19,0,0,1,26,0,1,5,10,1,24,0,3,1,9,2,14,5,24,6,6,1,0,0,3,34,1,6,7,1,0,0,0,6,0,1,25,9,6,7,2,5,3,30,1,10,1,10,20,0,2,10,3,12,6,0,2,2,9,6,2,4,5,8,27,6,0,12,1,2,4,7,0,14,0,1,3,0,0,0,1,15,2,1,11,7,0,12,23,10,10,4,0,5,2,1,6,18,0,8,2,0,4,40,5,7,0,8,6,13,2,9,0,5,7,4,4,2,14,5,0,4,6,4,15,0,0,15,2,11,10,1,9,20,0,18,9,12,4,1,15,5,23,3,3,1,7,9,9,19,1,0,1,8,0,1,1,21,0,9,2,10,0,1,18,7,16,2,5,6,8,10,5,17,3,1,13,3,31,4,4,3,0,2,3,18,1,21,0,0,5,2,4,7,0,18,4,0,0,3,8,4,2,82,1,7,3,19,0,1,9,2,3,26,14,16,15,32,0,21,0,2,0,2,8,0,6,134,6,5,1,7,5,1,1,2,7,4,37,10,0,8,1,10,5,5,6,0,3,0,2,2,3,0,17,2,2,1,11,21,7,1,0,4,12,0,4,10,0,39,0,17,0,1,2,4,4,9,6,0,3,0,1,3,16,1,8,8,0,6,4,4,0,1,3,6,1,2,0,8,8,5,1,7,0,9,0,4,24,1,4,1,6,0,12,16,39,1,2,7,5,6,10,3,2,4,1,6,2,6,4,0,9,8,3,0,10,1,10,14,14,3,13,23,0,0,3,2,28,0,3,8,11,0,3,2,7,1,1,8,13,7,4,0,5,5,40,2,3,11,14,6,3,16,1,0,15,4,3,0,13,10,10,1,16,2,0,11,9,1,0,40,12,8,18,8,14,0,1,37,2,18,2,33,7,4,0,3,2,18,14,0,3,8,6,1,7,5,3,0,0,7,2,10,33,6,1,2,6,10,7,0,3,21,5,7,7,3,2,8,4,18,0,2,2,5,0,0,3,15,27,6,38,1,5,11,18,8,3,13,5,18,14,2,3,13,0,5,9,1,18,1,13,9,5,0,24,10,1,1,12,5,0,5,0,6,1,18,1,5,1,3,5,0,3,4,1,6,4,6,2,15,0,6,2,0,0,5,2,5,0,0,0,5,2,6,14,10,27,0,5,3,0,1,0,0,7,3,0,3,5,9,9,12,4,2,1,0,1,11,7,19,2,5,9,3,2,0,20,1,7,5,8,7,8,5,6,0,3,12,9,6,10,16,8,6,0,7,0,9,0,0,1,2,0,7,2,0,14,8,1,1,2,4,7,16,14,11,0,4,3,4,1,0,6,4,6,7,10,24,18,4,25,1,0,0,22,0,0,1,2,1,0,10,6,0,6,3,0,9,7,1,3,2,13,10,5,3,8,1,20,29,4,21,13,2,3,9,2,11,4,4,0,4,1,41,4,0,1,7,7,18,22,4,16,4,0,0,1,86,1,6,9,4,0,6,10,0,17,12,17,12,7,4,6,1,9,0,8,6,2,0,3,0,0,6,9,5,2,3,4,28,11,0,0,4,5,9,4,0,8,2,32,6,0,9,2,0,0,1,26,4,3,0,4,0,27,15,3,3,1,0,3,0,5,3,4,0,2,1,5,1,4,1,15,3,27,65,25,6,5,4,4,3,6,7,6,5,7,11,2,1,0,2,0,1,3,4,4,5,35,9,24,0,3,0,10,8,1,5,0,43,21,0,2,1,14,2,1,0,4,6,2,0,1,18,2,2,0,7,5,2,7,12,24,5,2,2,56,15,5,1,2,6,6,8,17,13,6,1,6,16,9,2,13,13,0,1,8,16,22,22,8,5,7,0,28,36,10,4,1,19,23,0,0,0,5,1,0,0,10,5,7,6,443,27,30,6,58,3,17,8,38,8,5,0,12,8,3,1,12,8,3,6,17,6,16,14,3,0,17,0,28,0,8,5,6,16,3,35,28,2,42,12,4,5,3,1,21,20,5,3,0,2,11,44,1,8,25,3,0,2,4,5,1,7,5,9,15,8,8,1,2,3,5,27,0,5,10,16,1,12,0,5,9,13,12,2,4,13,6,20,6,1,10,0,17,5,19,341,14,0,1,9,5,9,3,28,6,20,14,3,39,0,0,26,1,5,6,2,27,1,14,26,44,7,12,67,0,0,0,4,2,0,1,8,9,12,6,6,4,188,13,5,2,13,28,2,5,9,0,0,0,59,9,3,1,0,3,0,0,24,17,20,0,6,20,7,0,0,0,14,6,0,1,7,0,0,3,0,1,8,1,7,6,0,17,16,0,4,26,1,0,0,0,0,0,15,66,33,211,8,0,113,0,1,0,1,0,0,0,0,0,0,0,56,0,0,0,92,0,0,68,43,0,0,0,247,0,0,96,84,0,0,0,0,88,101,247,240,0,0,0,0,85,0,153,160,90,93,0,166,173
"1991 Grafton, Sue, H Is for Homicide",pop,4806,1775,2056,2305,1721,2592,861,1329,1407,678,670,782,586,604,681,751,477,862,499,349,558,339,385,322,840,188,560,160,478,179,320,536,272,222,245,273,296,224,274,245,208,275,222,194,214,143,133,176,102,128,238,111,264,228,277,256,190,118,161,161,208,157,109,98,102,143,55,126,79,103,157,162,104,144,162,61,135,155,169,115,173,110,45,139,114,100,134,117,50,82,35,65,59,146,62,82,92,99,64,60,62,85,121,55,68,143,78,80,88,58,56,28,129,136,94,139,87,64,89,52,52,13,76,103,99,28,58,93,65,49,40,50,74,92,107,56,52,124,101,96,15,71,83,63,44,59,54,56,66,44,37,27,124,47,42,47,27,44,64,34,16,57,64,40,61,28,37,93,17,57,165,30,37,50,169,33,44,72,36,46,19,29,7,42,49,45,51,56,72,38,99,32,36,56,63,61,10,60,64,26,48,135,30,47,62,9,49,57,69,48,15,56,14,35,71,21,35,65,39,54,68,31,44,75,51,32,20,46,24,56,39,30,18,29,38,49,80,61,65,18,35,44,13,17,40,41,42,26,36,28,38,23,50,28,51,25,17,34,52,7,34,33,62,55,13,18,29,34,34,39,47,37,31,23,43,35,22,38,19,35,49,53,30,15,20,50,42,31,28,47,79,18,49,8,28,19,33,47,45,19,28,33,20,49,64,30,23,13,63,11,24,118,10,27,22,38,28,35,48,30,25,73,27,4,27,37,30,24,16,32,42,35,41,13,21,27,35,2,20,13,21,21,18,63,21,41,14,57,22,68,19,26,7,22,33,10,31,28,10,13,20,4,11,29,39,18,26,18,8,22,15,19,29,36,39,49,21,3,19,28,55,41,18,28,15,33,0,27,16,27,53,9,13,28,20,20,26,13,11,25,15,17,24,21,22,11,34,11,22,26,19,9,15,9,8,16,20,38,26,20,21,4,8,44,20,26,13,30,20,30,19,22,33,21,5,5,33,10,15,17,21,25,23,29,21,44,19,11,17,18,42,28,4,20,13,16,2,5,39,20,22,13,0,10,8,19,20,6,4,22,12,2,19,3,17,21,9,17,0,13,7,22,23,33,6,22,22,10,28,23,17,9,21,9,11,26,13,45,2,11,54,16,34,14,21,37,25,11,10,19,11,20,16,11,15,6,0,14,7,23,37,5,9,22,13,7,4,13,10,11,1,18,23,14,8,26,12,15,11,7,4,10,28,27,19,22,0,2,16,24,21,10,14,0,38,2,13,8,8,47,17,41,9,1,14,15,24,7,13,29,3,11,6,20,4,37,9,1,5,5,21,3,10,20,13,13,6,12,15,2,19,24,15,17,12,19,13,4,7,14,10,6,7,7,11,0,0,1,29,18,16,35,4,12,1,11,14,6,13,16,21,20,5,9,16,21,13,19,6,22,18,10,17,3,14,0,16,25,9,20,5,3,9,26,33,20,14,15,14,30,0,17,11,8,4,17,6,9,14,1,16,11,21,14,15,17,16,17,14,21,16,2,21,8,8,9,10,9,38,16,24,4,9,6,11,5,0,4,18,9,4,10,4,14,24,11,18,0,7,7,7,23,18,16,4,1,2,28,5,7,10,10,0,13,7,8,21,8,13,8,24,3,11,2,11,18,11,5,7,17,4,24,23,2,0,11,5,10,5,5,13,11,0,13,0,1,18,8,7,4,7,8,7,4,28,1,24,17,16,5,16,10,10,12,26,3,6,8,6,3,9,31,6,12,0,11,9,9,6,5,14,16,15,8,4,6,19,9,9,4,8,11,0,14,3,1,0,10,0,27,8,22,3,5,9,6,0,5,7,22,1,4,2,2,12,10,7,0,19,2,4,2,13,5,7,14,14,8,13,10,10,2,0,21,45,5,12,9,0,28,7,5,11,11,13,5,8,0,35,24,2,12,5,3,9,14,22,3,4,10,19,9,3,5,2,11,6,0,13,15,9,9,8,13,0,24,15,16,5,37,4,8,13,12,3,13,10,14,8,10,12,1,3,31,12,1,2,0,0,3,5,2,6,6,7,12,8,33,11,12,5,0,5,0,1,2,7,13,0,9,3,0,11,17,8,7,4,0,1,14,5,6,21,24,9,7,8,6,5,3,4,1,29,20,13,3,7,4,6,17,3,13,15,22,4,3,2,6,6,3,0,4,4,0,16,5,3,1,3,10,12,0,7,17,8,9,14,21,18,3,0,11,8,9,29,15,6,0,5,4,15,5,6,9,2,22,0,13,2,0,8,0,17,15,4,3,0,0,1,5,11,1,5,0,19,8,8,0,4,12,7,14,24,3,8,27,1,5,12,8,9,7,2,0,11,12,7,5,9,9,2,10,12,7,10,2,17,9,9,17,2,5,0,13,4,0,3,11,3,2,10,7,0,17,28,14,2,9,0,0,0,6,3,14,14,5,18,0,8,1,7,3,8,5,2,7,4,7,10,1,4,0,8,5,3,12,6,3,3,10,16,7,26,4,5,23,10,1,14,6,5,5,2,1,0,0,1,15,6,7,8,1,5,9,8,1,10,3,4,2,8,4,15,1,7,3,12,4,2,1,4,17,13,5,8,4,5,7,5,10,8,0,2,16,5,7,0,6,2,2,3,11,22,18,0,6,0,6,1,0,0,2,2,4,1,4,2,0,9,0,6,28,1,7,13,8,0,3,4,0,6,0,0,15,2,11,8,4,4,17,17,0,9,3,2,0,1,2,4,10,2,17,2,3,4,0,0,14,16,6,6,23,5,13,4,3,5,3,1,21,3,3,2,7,10,0,8,7,8,3,4,7,2,0,2,3,0,5,8,3,14,35,7,12,0,7,1,20,1,4,8,0,15,5,0,41,2,1,8,0,0,8,34,19,0,1,14,19,0,1,5,2,1,2,11,4,6,13,6,4,0,7,14,4,12,7,5,7,0,40,5,14,9,4,15,16,0,2,8,5,2,2,3,1,1,12,10,3,0,5,0,12,1,0,12,3,5,15,0,6,3,6,6,2,6,4,3,0,9,9,6,5,4,0,13,3,3,0,12,2,2,0,6,18,3,1,12,8,8,3,12,2,12,0,5,1,19,11,10,3,16,5,15,19,6,369,0,4,0,37,0,0,4,1,2,1,2,3,2,1,0,3,18,1,1,0,6,0,1,0,0,0,0,6,0,2,2,0,4,24,0,8,2,6,0,3,5,18,10,2,6,18,6,5,0,1,31,5,3,2,7,4,0,0,13,5,28,18,9,2,9,9,13,3,0,9,6,9,1,5,2,9,0,1,3,0,2,24,2,6,0,8,7,0,4,1,11,0,12,5,13,4,14,2,0,2,2,3,7,7,6,7,0,1,6,3,2,0,8,0,6,5,8,9,6,3,0,0,0,8,8,1,0,0,0,1,0,5,8,7,4,4,7,9,0,3,6,0,2,19,4,8,0,10,2,1,1,15,12,9,14,13,3,15,3,0,3,2,2,0,3,4,2,2,9,16,0,1,0,6,8,8,7,5,2,9,0,1,5,1,6,12,3,6,7,0,3,4,2,1,3,3,3,0,0,2,4,0,8,6,2,2,11,10,6,3,3,6,3,2,0,5,2,0,0,9,3,0,6,7,0,7,0,5,7,4,2,4,8,2,2,0,15,0,2,10,0,4,1,6,8,6,5,0,2,7,4,2,9,4,8,14,3,14,5,12,2,0,1,5,1,0,8,6,18,1,0,15,9,5,8,2,6,3,5,6,1,4,2,3,7,2,3,0,3,0,6,0,2,3,7,1,12,16,3,9,3,2,1,6,8,11,4,0,2,4,0,4,4,2,4,0,1,5,0,0,7,1,3,4,3,0,4,8,1,6,4,0,1,3,13,5,7,6,1,4,0,1,0,7,7,1,7,4,15,0,8,1,7,3,2,9,1,0,3,3,4,1,4,8,4,1,2,3,0,4,1,15,6,0,1,7,0,12,4,5,0,5,3,3,6,2,13,1,1,5,4,2,5,0,6,0,0,4,6,2,1,3,4,6,13,2,8,3,23,4,2,7,6,6,2,5,0,0,2,5,3,1,6,1,1,4,3,1,1,3,7,9,6,8,3,18,1,3,6,2,6,0,4,0,2,1,0,0,10,9,0,0,0,0,2,3,0,1,1,8,2,3,0,1,31,6,0,7,0,7,2,0,0,1,3,0,17,1,2,1,7,7,4,0,7,4,1,1,1,3,0,5,1,0,2,9,0,4,2,3,2,9,1,1,0,1,1,5,0,4,2,0,3,1,4,10,0,2,2,1,4,1,0,2,0,0,17,3,0,6,6,2,0,5,0,4,5,0,1,15,5,0,1,4,2,1,0,3,1,10,1,6,2,9,6,2,0,5,9,0,4,5,0,10,6,3,0,2,2,1,21,10,3,4,4,3,5,7,2,5,0,6,10,1,8,11,0,7,15,1,2,4,6,2,6,7,4,281,4,0,6,7,7,8,2,0,2,3,3,2,2,2,16,5,6,2,6,2,5,3,2,0,6,9,1,0,5,3,3,4,6,35,2,6,8,2,1,2,14,3,2,18,4,1,7,0,6,5,15,0,3,6,11,0,9,1,2,4,0,2,3,2,1,5,4,5,0,0,1,8,12,2,3,7,4,6,15,3,3,5,2,1,2,0,16,3,4,1,8,6,2,4,0,3,0,0,1,4,0,1,4,6,4,3,4,5,14,13,1,1,0,0,2,9,1,6,12,3,1,3,3,0,8,3,0,0,5,3,2,4,0,0,3,3,4,0,3,2,1,2,0,1,0,0,2,0,2,5,0,0,4,1,5,4,0,1,6,0,0,1,5,1,18,4,6,15,1,0,1,6,19,0,0,3,0,0,0,0,3,0,5,0,2,3,0,6,0,0,0,10,1,0,3,6,5,2,1,0,2,0,0,2,0,0,2,1,0,17,1,1,4,12,27,0,8,9,3,1,3,0,5,9,7,1,1,2,0,1,13,21,0,0,5,7,2,3,0,2,4,1,1,1,0,0,0,0,3,0,0,0,14,1,4,3,0,2,3,8,3,4,0,0,6,0,1,4,3,0,2,2,0,7,1,8,3,1,0,9,2,0,0,4,3,2,2,2,2,2,7,6,8,6,4,0,10,0,5,0,0,1,0,6,16,8,0,1,11,2,4,3,5,1,1,6,3,3,1,10,6,2,2,0,3,0,4,1,9,0,2,5,2,4,7,4,1,2,12,0,2,0,2,2,4,1,2,5,0,2,2,1,6,3,2,1,0,2,3,6,2,0,10,7,9,4,3,4,7,2,0,8,0,0,0,2,2,1,3,2,1,2,50,3,4,3,4,1,2,7,4,0,7,4,1,1,3,1,13,1,0,0,1,12,11,4,0,0,3,1,0,0,2,6,3,0,7,4,1,4,6,1,2,0,2,7,4,4,1,0,0,3,1,0,0,0,4,0,4,8,9,3,1,1,0,0,2,0,2,0,5,0,1,2,2,0,5,0,5,17,3,8,10,0,3,1,0,3,3,0,2,0,19,4,2,6,2,1,5,2,0,5,5,0,5,1,3,0,0,5,0,8,62,0,1,0,0,6,1,0,1,5,0,0,0,1,4,4,8,5,0,3,3,0,1,1,0,0,2,1,4,5,3,1,2,0,1,3,3,2,1,1,0,0,0,0,3,4,0,2,0,0,2,1,5,8,0,1,4,8,2,2,4,1,4,2,8,1,7,3,1,1,2,2,3,5,0,0,5,7,1,0,5,4,3,9,0,1,0,0,1,2,0,6,0,13,6,4,1,3,10,3,0,0,5,0,5,0,0,2,0,0,5,3,1,4,0,2,4,4,3,3,3,11,1,9,0,5,1,4,1,2,2,5,1,1,1,3,5,3,4,1,1,0,1,0,2,0,0,0,2,3,2,0,1,5,5,4,8,1,2,0,3,1,1,1,2,3,10,7,2,2,0,1,2,0,1,13,5,4,1,0,2,4,0,0,1,0,6,4,3,13,1,1,1,8,9,2,2,2,2,4,3,3,3,10,3,0,0,5,3,0,0,2,6,0,9,1,3,1,0,5,0,1,1,4,2,0,2,3,4,0,12,4,2,2,4,1,1,1,1,1,1,3,2,3,4,1,4,5,7,2,0,1,4,2,2,3,2,4,0,0,5,5,1,0,0,147,1,0,0,0,5,9,5,0,1,0,0,3,0,0,2,3,6,2,0,0,0,0,0,1,2,0,4,0,1,3,0,5,0,0,0,0,1,3,3,2,0,2,1,0,2,0,1,0,0,8,6,5,0,2,2,0,0,0,2,5,2,0,0,0,2,3,0,0,0,0,4,1,0,0,3,3,6,4,1,0,1,2,3,0,2,11,0,8,0,2,2,1,2,3,0,3,2,2,5,0,0,16,3,7,5,0,6,0,0,8,0,1,0,7,2,0,2,0,0,0,3,2,1,4,1,1,0,2,1,2,8,0,0,0,0,4,5,1,3,2,0,2,4,4,9,0,1,0,0,0,2,2,1,1,3,0,6,0,8,0,0,1,3,2,0,2,2,4,3,1,5,0,0,1,0,0,1,0,4,0,7,2,0,4,5,3,1,0,1,1,2,1,0,3,1,0,0,4,0,2,4,3,0,6,0,0,0,1,0,6,1,3,4,14,1,1,0,0,0,1,0,0,0,1,0,4,5,0,0,0,0,0,8,2,0,1,1,5,1,6,0,1,0,0,2,1,0,9,12,0,2,3,0,0,0,2,0,2,1,0,1,0,2,3,1,2,0,2,0,0,0,2,3,1,0,1,0,1,5,2,2,2,0,0,0,6,9,2,5,3,5,2,0,0,1,1,1,0,0,0,0,8,1,0,1,4,1,0,3,6,7,0,0,5,4,2,11,5,2,0,4,2,0,7,0,3,1,3,0,2,0,2,1,1,0,1,1,2,0,0,1,2,17,8,0,1,8,0,39,1,0,1,0,3,0,0,0,0,16,0,7,8,0,1,2,0,3,0,5,2,1,1,4,1,1,3,0,4,0,1,0,2,0,1,4,1,2,2,5,6,3,6,2,0,0,0,3,1,0,0,0,0,2,0,0,1,0,7,0,6,4,3,2,4,2,3,2,1,4,4,0,0,1,1,0,1,0,1,0,5,3,2,1,1,0,2,5,2,2,2,0,0,0,1,2,1,2,3,1,0,0,1,1,2,2,0,0,2,1,0,2,2,0,0,1,5,4,7,3,0,1,14,1,0,3,6,4,1,1,3,3,0,4,1,0,0,3,0,2,1,3,2,0,2,3,1,3,0,5,0,1,6,14,2,2,2,2,0,7,0,0,3,3,1,2,4,1,3,0,3,0,0,0,2,6,1,0,2,1,3,14,1,0,0,1,16,1,4,11,3,9,0,6,3,0,0,0,1,5,3,1,3,2,2,0,1,1,2,1,0,0,3,2,1,0,0,2,5,3,8,7,2,4,4,5,1,0,0,0,4,0,3,0,7,6,3,1,0,2,1,3,2,3,0,0,2,1,4,0,2,3,5,0,1,1,1,0,1,7,0,2,0,1,3,0,0,0,4,4,1,5,3,1,0,2,0,2,0,0,0,1,4,5,1,5,3,2,0,0,15,2,2,5,0,0,0,0,1,4,0,0,0,6,3,0,3,0,3,4,4,6,0,0,2,0,0,10,2,0,0,0,2,2,0,1,0,0,0,4,0,5,0,0,2,0,4,1,6,0,0,1,1,0,0,0,1,2,0,4,0,1,2,1,0,0,4,3,0,0,0,7,0,7,0,0,1,2,12,0,0,0,0,1,0,6,0,2,0,2,0,1,0,3,2,3,7,0,1,0,2,0,5,0,20,2,0,24,0,6,2,0,1,2,2,0,1,0,5,4,0,4,4,4,1,5,3,0,2,2,0,0,0,0,1,4,0,8,0,2,1,4,3,1,0,1,2,2,1,0,2,2,2,0,2,0,1,1,0,0,2,2,0,0,1,2,0,2,1,0,0,13,4,0,6,16,0,0,0,0,0,0,4,9,0,0,0,0,2,3,2,0,1,1,2,1,1,2,0,3,4,0,4,0,0,5,2,9,1,2,1,0,1,2,1,3,0,1,0,0,1,3,0,0,3,3,4,1,1,0,5,5,0,0,0,0,1,4,0,5,0,1,0,3,4,2,0,2,1,1,2,3,0,0,1,0,0,7,0,0,4,0,4,0,6,1,3,1,1,0,0,1,0,0,1,8,3,1,1,3,6,2,1,3,5,0,2,2,1,0,0,0,1,0,0,8,0,5,1,0,1,0,1,0,3,3,2,4,1,0,1,8,5,0,1,7,1,2,0,4,6,0,0,0,0,5,1,4,2,0,2,9,0,1,1,1,0,4,9,1,0,1,0,7,0,2,6,0,0,0,5,4,1,0,0,0,3,0,0,0,4,3,4,7,0,2,1,0,3,0,0,1,0,3,1,0,0,1,1,1,9,1,4,2,3,8,1,0,0,1,0,1,0,0,0,4,0,4,2,3,2,0,0,0,6,0,0,0,3,2,3,4,2,1,0,0,1,0,0,2,0,2,2,0,0,0,5,0,0,0,5,5,0,0,3,1,11,0,0,4,2,0,0,0,1,3,0,1,5,0,33,3,3,0,1,2,0,1,9,0,2,1,0,1,2,1,2,2,0,6,6,2,0,1,0,0,0,2,4,1,2,3,1,9,0,0,1,0,5,1,5,0,0,0,2,1,0,0,0,4,2,0,0,5,0,1,2,0,7,1,8,2,3,0,1,1,8,3,0,0,1,0,0,0,1,0,0,0,1,2,0,5,6,0,0,2,1,0,0,0,1,0,1,0,1,2,0,1,2,1,2,5,2,7,0,4,1,0,0,0,1,1,2,5,3,2,1,6,0,2,0,1,7,0,0,0,4,1,8,0,0,8,0,0,0,3,0,3,2,0,0,12,0,1,0,2,6,2,0,1,1,4,0,1,3,0,0,0,0,6,2,0,1,1,1,0,3,3,1,3,0,1,0,1,4,1,0,3,2,0,2,0,1,0,2,1,1,0,3,4,0,2,0,0,2,2,3,0,0,0,6,3,1,0,1,0,0,1,1,4,0,0,0,0,1,2,3,7,0,1,1,0,0,1,0,3,0,1,0,3,4,2,0,3,1,3,3,0,2,0,0,3,2,1,0,2,4,1,4,0,1,0,1,1,2,3,3,0,1,0,0,3,6,5,3,0,0,1,0,0,7,0,2,2,0,0,6,5,2,3,1,1,2,1,1,0,1,1,4,0,1,0,0,2,0,3,2,4,0,0,6,2,1,1,0,0,0,0,0,1,1,0,0,0,0,2,1,4,0,3,0,0,1,2,3,0,7,0,0,0,3,3,2,0,6,0,0,1,3,0,1,0,0,1,0,1,0,0,0,1,8,0,1,6,0,2,0,0,0,0,1,3,0,2,3,0,2,2,1,0,0,2,2,2,0,1,1,3,0,2,0,1,0,2,0,5,8,2,7,4,0,2,0,2,0,0,1,1,0,0,5,1,0,1,3,2,0,4,5,0,2,1,7,0,1,0,5,0,0,0,0,0,1,0,3,0,3,2,3,2,0,1,1,4,1,0,1,3,0,0,5,1,0,1,0,0,2,3,0,0,0,0,1,0,1,1,0,1,0,1,4,1,1,1,1,1,2,1,0,1,0,0,1,1,0,0,0,0,0,3,4,2,6,1,1,1,0,0,0,0,0,3,0,0,5,1,0,0,1,0,1,3,0,0,1,3,1,0,2,1,0,0,1,1,0,0,1,2,1,0,2,4,0,0,5,2,1,0,0,0,1,0,0,0,1,0,6,0,0,0,1,6,0,5,0,0,3,1,0,0,0,0,0,1,1,3,1,2,1,0,2,0,0,6,0,15,0,6,1,1,0,0,7,1,2,4,3,0,0,0,1,0,2,1,0,2,0,1,3,3,3,0,0,2,0,0,0,0,0,0,0,0,0,0,1,1,0,2,2,1,0,0,2,2,2,4,0,1,1,8,1,0,1,3,1,1,0,3,0,0,0,2,1,0,0,5,1,1,1,0,0,0,2,0,9,0,1,5,3,0,1,2,1,0,0,0,3,0,3,0,1,1,1,0,1,4,0,1,1,0,1,0,1,1,4,1,5,0,0,0,0,0,0,3,4,0,0,0,0,1,0,0,1,1,0,0,1,2,0,1,1,0,3,0,0,1,0,2,1,6,1,2,1,4,1,0,0,1,0,4,0,0,0,0,0,1,3,0,0,0,1,0,1,1,3,0,3,4,0,0,0,3,0,0,0,1,0,2,0,0,0,1,0,2,2,1,0,0,0,3,2,2,1,6,0,1,1,0,1,0,3,2,2,1,1,0,0,1,0,0,0,8,2,1,0,0,2,0,1,2,0,0,1,4,2,1,0,0,1,0,0,0,0,0,2,0,3,0,2,0,1,1,3,0,0,1,0,0,2,3,0,0,1,6,2,2,2,3,3,0,4,2,4,2,1,3,0,1,0,0,0,1,4,0,0,2,0,1,1,0,0,2,1,1,3,3,0,2,1,0,0,0,1,2,1,0,2,0,0,0,2,3,2,0,0,3,0,1,0,1,1,6,0,0,0,2,0,0,2,3,0,1,0,1,1,1,2,3,1,2,1,0,0,0,0,0,1,1,1,3,2,0,0,1,0,1,0,0,1,0,0,0,1,1,0,0,2,1,0,5,0,1,0,3,0,0,1,0,0,0,1,0,2,1,0,2,2,3,0,0,0,0,0,2,3,0,0,1,2,0,0,0,2,0,0,3,1,3,1,1,0,0,2,0,0,0,0,0,0,2,0,1,0,5,0,0,0,1,1,2,0,1,1,0,1,0,1,0,1,0,1,0,9,1,0,0,6,0,1,4,3,0,0,1,2,1,1,1,0,0,5,0,0,3,2,0,1,0,2,0,0,2,0,1,3,0,0,0,0,0,1,0,0,0,3,0,0,0,2,0,0,6,0,0,0,0,0,2,0,2,8,0,0,1,0,0,1,0,0,2,3,3,0,1,0,0,0,3,0,2,0,0,2,0,1,0,0,3,1,2,0,1,1,2,0,0,0,1,0,0,0,4,0,0,1,0,0,2,0,1,0,0,0,3,0,1,0,0,0,0,0,0,0,2,0,0,0,0,0,0,0,2,0,0,0,0,0,0,0,2,0,1,0,0,0,0,0,0,2,1,0,0,0,0,0,0,0,2,0,0,0,0,1,0,0,0,0,0,0,0,0,0,0,0,0,0,0,0,0
"1991 Grisham, John, The Firm",pop,8164,5196,2746,3681,2309,1378,2583,2096,1680,1427,1581,1168,588,947,641,1147,669,964,1014,644,1036,701,508,540,240,595,393,1026,298,475,530,284,387,545,445,384,513,409,637,497,376,274,360,512,454,290,286,354,398,292,169,361,256,263,391,299,271,332,345,284,205,357,212,254,332,215,209,154,340,194,310,292,239,162,219,145,437,82,188,256,108,359,168,142,86,172,224,207,53,102,105,150,95,190,200,177,255,186,195,125,117,167,61,91,144,58,57,123,162,94,78,86,119,77,205,258,162,90,87,78,321,227,80,107,195,123,122,101,87,134,65,43,209,114,69,189,174,71,161,101,72,148,20,147,73,42,94,38,122,91,150,247,82,134,160,198,89,124,275,95,144,35,13,23,117,45,32,74,66,53,34,183,79,141,87,76,46,86,118,106,65,79,164,122,39,104,42,50,48,138,114,122,65,51,82,53,16,182,52,20,109,27,91,59,43,161,185,110,28,72,34,90,60,86,13,148,80,43,59,171,63,112,61,94,99,39,45,114,129,55,44,194,80,36,58,5,49,43,101,66,123,136,48,78,89,48,168,37,41,40,43,74,71,202,65,52,46,84,66,14,37,120,21,67,40,27,58,36,131,32,20,17,88,102,27,47,88,30,49,34,144,138,35,45,79,83,34,70,34,22,59,43,111,36,34,31,51,25,55,43,39,38,108,31,78,74,173,32,58,31,22,10,21,32,27,47,139,64,51,105,83,60,37,23,13,68,6,95,40,76,39,53,89,82,28,25,28,26,44,39,45,40,71,196,38,21,20,46,58,79,54,129,14,71,17,48,25,5,34,113,124,56,46,30,37,122,34,29,130,6,45,31,147,15,96,26,14,93,15,31,83,9,134,41,164,22,0,34,70,37,24,16,24,93,14,18,9,18,43,47,59,8,51,8,17,8,21,40,80,17,50,30,33,64,21,28,50,43,102,30,35,0,6,63,43,26,39,23,38,51,15,31,34,3,7,14,34,28,0,34,61,16,132,11,50,83,33,31,26,52,24,51,16,34,4,17,38,26,29,28,56,31,1,53,9,42,13,14,30,22,15,76,54,35,31,17,10,80,0,36,20,57,15,24,3,20,18,6,34,39,20,50,33,25,34,82,62,35,3,23,45,32,96,62,16,25,12,5,33,79,45,8,16,13,28,9,0,46,6,33,17,15,13,66,18,22,87,47,6,40,3,37,39,57,46,9,39,26,70,28,21,21,7,56,35,34,0,2,113,0,11,40,108,39,16,32,36,33,6,18,11,47,22,14,18,51,27,11,16,0,21,74,36,50,15,65,3,3,24,24,22,6,17,22,5,29,27,11,18,44,9,93,86,67,9,17,16,24,11,13,10,9,6,7,34,0,0,15,41,18,43,50,7,41,11,20,29,11,52,14,23,37,6,15,9,11,22,14,20,105,35,3,30,58,7,0,19,30,11,25,23,25,31,63,38,5,22,32,4,19,2,9,10,14,6,6,15,5,18,7,33,23,36,14,10,34,16,12,15,21,16,45,23,29,51,25,48,3,8,56,32,30,34,46,31,9,45,28,39,121,24,29,4,21,19,59,7,14,45,49,6,7,12,26,10,2,6,21,6,39,0,14,33,47,32,18,11,9,21,32,4,29,21,32,19,11,16,21,15,10,6,62,12,3,0,16,3,27,17,12,11,14,27,38,11,0,14,15,62,7,8,10,9,12,17,5,43,14,18,9,49,38,14,0,25,21,17,10,5,22,42,17,18,22,0,12,8,13,4,18,9,4,46,4,24,13,15,12,17,17,14,31,0,17,6,13,79,15,4,11,20,12,9,8,12,18,12,44,77,43,21,20,7,21,4,26,20,4,9,9,24,9,14,8,34,14,23,14,51,61,17,14,3,23,1,13,13,50,0,8,17,14,11,25,9,18,25,0,10,16,15,13,133,11,26,4,14,6,11,14,3,5,36,25,17,23,11,0,35,4,15,46,1,84,0,20,44,9,7,28,12,28,26,8,6,10,12,19,16,10,51,24,12,42,13,7,8,22,1,2,15,12,40,22,12,23,5,34,7,23,8,0,30,0,8,3,13,57,26,33,7,4,45,7,9,6,6,0,1,14,0,5,6,1,20,8,21,24,19,17,11,0,25,4,26,41,9,10,14,15,6,24,8,3,9,7,3,4,8,1,0,8,5,12,18,15,6,1,14,31,23,20,3,9,15,7,14,17,52,15,0,4,14,12,42,8,34,1,30,44,6,23,9,13,4,9,0,20,13,0,5,0,24,0,5,19,991,0,0,34,23,25,3,5,4,3,1,0,6,4,22,12,49,2,11,81,2,6,10,20,20,32,15,22,7,22,3,6,19,5,2,30,4,39,5,6,51,5,38,41,1,22,0,10,6,0,44,13,2,4,23,7,0,3,39,1,21,3,0,0,0,45,23,26,16,2,9,0,12,11,20,5,48,15,74,9,37,15,13,13,6,0,23,43,35,57,8,24,15,11,6,21,11,15,18,51,10,10,7,4,5,15,10,3,2,0,39,27,11,5,2,1,14,24,7,31,7,33,50,0,30,12,9,0,4,0,7,8,12,9,9,1,20,10,3,9,0,48,13,2,9,30,7,21,6,22,3,7,10,7,42,11,8,5,0,11,1,6,0,1,5,4,7,9,2,3,2,2,4,0,18,12,10,11,3,9,0,14,6,0,13,12,1,0,13,4,15,15,150,12,23,0,30,5,9,9,1,8,13,28,0,19,11,5,10,0,0,14,38,22,11,14,2,38,3,7,15,7,1,6,8,5,0,13,10,0,6,4,31,27,6,11,19,11,7,3,0,8,4,33,16,3,14,5,0,0,3,15,4,11,16,0,33,31,0,41,7,39,7,28,0,19,10,29,0,10,2,4,0,2,10,3,18,7,15,3,6,21,16,20,0,21,1,9,14,10,11,22,0,5,14,0,27,5,2,6,23,1,12,6,4,7,1,7,0,2,19,5,12,13,8,1,14,13,16,14,7,0,11,9,0,9,9,15,12,0,4,2,12,15,13,12,10,0,12,4,124,5,3,33,1,0,12,2,13,11,2,4,10,71,15,25,9,0,2,17,6,4,4,15,18,4,4,19,10,1,0,11,0,25,1,0,12,4,9,6,1,15,12,6,1,10,4,1,28,28,41,0,2,11,0,0,0,9,1,3,5,0,15,11,3,10,2,9,0,3,30,0,5,20,6,38,284,8,8,3,6,24,2,2,11,10,0,0,4,6,3,9,5,6,9,5,2,12,0,7,56,10,5,3,6,5,0,8,15,0,9,7,3,13,1,21,3,0,14,16,6,0,5,2,0,3,19,5,0,1,6,0,16,28,21,20,3,8,3,5,2,1,2,0,5,2,11,6,5,3,0,0,2,12,2,1,1,0,0,1,0,22,21,11,12,6,7,4,0,34,6,258,4,14,11,7,13,2,4,8,7,0,1,5,14,40,4,17,14,0,2,6,12,14,12,14,11,7,13,7,30,0,1,25,8,5,28,11,0,10,4,2,2,11,18,0,4,33,5,5,5,20,7,19,20,2,5,0,1,7,10,0,1,6,5,2,1,1,7,21,10,4,0,3,0,12,16,10,0,3,2,0,5,30,2,1,0,21,2,12,5,9,1,2,1,10,17,6,2,11,0,0,0,12,9,28,7,0,17,11,5,2,6,7,6,116,1,7,2,12,0,4,7,5,15,3,1,3,0,20,0,5,4,1,37,10,0,23,1,0,1,8,6,0,12,11,4,5,11,8,6,0,9,1,14,6,3,1,9,14,15,4,4,6,14,5,6,1,0,1,19,1,6,1,10,0,3,40,7,0,2,1,7,21,4,1,19,8,12,15,0,26,4,26,1,2,15,20,25,6,5,19,0,6,5,5,5,11,8,0,27,1,9,0,8,8,2,0,3,21,11,13,4,22,4,2,0,3,0,6,4,6,12,18,16,2,3,2,8,7,0,10,0,3,4,5,2,12,13,9,15,1,17,0,10,1,2,6,8,18,20,3,25,14,18,35,1,2,7,8,9,3,12,7,1,3,0,1,10,0,2,3,2,6,2,12,12,2,14,15,3,12,6,18,8,3,14,8,15,26,16,1,6,3,2,3,0,0,1,1,0,2,0,0,0,5,0,11,0,9,6,7,0,8,0,19,1,2,0,4,4,43,10,4,3,5,21,0,6,20,4,15,21,3,4,4,1,4,1,17,5,3,2,0,2,3,1,6,2,2,5,22,0,6,0,4,0,6,9,0,3,2,0,4,0,12,0,8,4,4,5,6,11,5,0,19,4,9,0,2,3,3,1,2,0,15,5,2,22,12,19,2,16,2,6,17,0,10,24,3,3,3,8,5,0,8,0,5,6,0,24,3,0,6,64,9,0,4,4,1,12,3,17,2,21,8,3,0,0,0,0,13,0,1,2,6,1,14,1,18,10,16,23,2,20,7,0,0,15,9,24,2,2,4,0,7,3,8,3,6,0,0,2,0,1,14,5,3,1,27,1,0,5,10,10,1,7,2,5,8,10,5,2,5,4,10,1,2,15,20,5,1,2,13,3,0,9,5,7,0,8,0,5,0,8,5,2,2,0,3,7,0,3,22,7,5,0,1,0,8,5,69,10,6,4,9,13,2,5,7,6,7,6,4,1,7,7,5,0,0,3,2,5,0,0,1,3,1,0,0,3,9,3,2,14,6,11,19,2,9,0,0,0,3,3,18,7,8,6,5,0,0,0,7,6,0,0,4,3,1,0,5,2,9,7,6,5,4,15,2,3,8,0,1,2,0,4,0,0,0,13,9,2,1,14,4,2,3,0,8,2,9,20,3,2,3,3,1,0,5,3,6,0,12,0,5,3,0,4,0,2,0,2,1,0,2,1,15,1,3,9,2,1,6,0,2,6,0,0,0,0,1,4,5,0,0,1,4,2,8,9,9,0,15,6,4,0,4,8,0,6,5,15,3,5,4,2,1,2,0,0,0,3,5,4,4,15,11,5,0,2,0,1,7,2,9,5,2,0,14,8,4,3,12,0,0,4,6,6,4,16,0,7,0,6,3,0,11,12,0,5,7,0,8,4,7,0,2,5,1,0,0,2,6,1,0,3,8,4,8,4,2,3,1,2,0,16,3,0,9,5,5,7,10,3,5,13,2,2,2,3,12,2,6,2,35,2,0,13,2,1,11,4,5,7,8,2,12,9,4,0,34,2,1,2,4,0,5,2,3,15,2,1,0,4,10,0,5,4,1,8,4,1,7,0,0,11,0,24,34,9,39,18,6,2,3,8,7,2,8,8,3,3,5,1,0,2,1,3,4,6,8,0,5,3,7,8,12,26,6,7,30,5,0,3,0,4,2,1,0,0,1,1,0,1,5,6,2,3,0,4,3,0,0,3,19,13,2,3,4,2,0,5,9,5,3,3,0,0,2,0,0,8,5,5,7,7,0,0,2,3,1,0,13,4,0,5,1,12,0,0,3,7,0,9,2,1,23,1,1,0,0,4,5,0,0,21,0,3,0,5,1,18,0,3,3,3,17,4,1,3,1,8,20,3,3,0,11,0,6,0,5,6,1,0,0,0,3,3,4,0,17,3,5,8,0,3,2,36,1,1,0,11,0,2,0,5,11,3,4,3,7,1,0,6,7,0,8,0,2,0,0,0,0,1,6,0,9,0,1,4,1,1,5,14,3,4,4,13,2,2,12,11,5,7,6,1,2,2,1,2,7,19,8,17,0,4,5,3,3,16,1,3,0,6,6,0,0,4,2,16,18,0,3,6,1,1,0,1,2,0,2,16,0,8,0,0,2,0,0,0,2,0,2,1,2,9,2,13,0,0,4,0,9,11,5,6,2,1,6,1,0,2,3,5,5,1,13,0,1,1,5,4,0,14,2,5,0,1,4,2,2,3,24,0,0,3,3,0,2,18,11,0,0,1,4,0,5,0,8,0,7,10,65,3,0,6,11,2,0,14,1,3,0,0,2,2,13,5,9,0,1,17,8,17,5,2,3,10,11,1,3,5,10,0,1,5,12,2,53,0,0,1,12,12,1,5,5,0,7,9,7,1,7,3,0,4,6,3,0,4,23,0,4,2,3,5,0,1,0,31,1,21,8,11,1,4,4,0,1,0,3,3,2,3,0,2,0,3,3,6,3,2,4,0,5,3,2,11,0,4,7,3,0,1,0,1,4,2,0,2,29,7,6,0,0,0,6,2,92,3,31,9,1,2,0,5,10,5,2,1,2,4,1,9,7,0,6,0,0,2,2,2,4,1,15,3,3,13,1,21,2,8,0,4,9,0,1,2,0,21,0,1,1,0,2,0,1,0,0,2,10,1,5,4,1,2,1,9,0,1,1,4,12,0,6,2,2,12,4,3,10,1,4,8,25,3,0,4,3,15,8,2,298,2,2,0,1,0,4,14,22,7,0,40,1,2,11,1,3,2,1,34,2,4,0,3,3,0,1,0,2,3,1,0,2,3,6,4,5,2,0,0,0,4,13,5,4,6,0,0,6,4,11,0,4,2,2,3,1,3,1,7,1,8,4,10,207,0,10,0,0,2,3,4,0,0,2,2,9,6,8,7,0,0,5,2,0,0,3,0,5,1,2,0,7,17,1,1,3,3,4,8,0,0,2,5,2,0,41,5,14,0,0,2,1,5,1,0,4,3,1,3,1,1,0,0,0,7,5,0,1,20,6,0,3,5,0,1,3,3,0,0,8,0,0,0,38,5,2,3,6,11,0,2,0,1,1,3,0,0,5,3,5,0,0,0,10,1,1,0,0,2,10,12,12,2,21,0,14,0,4,3,1,1,4,12,2,1,0,2,2,1,4,0,19,15,4,1,1,0,0,4,2,38,5,1,7,1,2,4,5,5,1,2,6,3,11,1,0,0,3,0,0,3,2,0,4,2,1,12,1,9,5,1,0,7,2,0,4,7,1,3,1,1,6,1,28,0,1,0,1,0,0,22,0,1,16,0,5,65,0,4,0,1,2,0,10,1,9,0,1,1,7,3,3,0,0,0,0,5,1,5,3,3,5,0,0,4,0,0,4,38,1,0,1,0,3,1,1,2,0,0,5,1,1,1,1,1,6,4,0,1,0,0,20,1,0,18,20,0,2,0,32,0,0,7,5,0,3,2,9,2,5,1,0,0,13,3,3,1,2,1,2,1,0,0,3,2,2,0,0,2,1,0,3,2,18,3,3,0,0,3,6,14,0,0,0,8,2,1,3,3,1,8,4,2,0,2,2,1,0,1,0,7,7,0,0,34,2,4,24,1,2,3,0,8,4,11,4,1,5,2,0,2,0,1,2,0,3,3,14,1,0,0,2,3,0,0,0,3,0,1,2,5,9,5,2,3,0,3,0,5,8,0,0,0,3,2,6,0,10,10,1,2,1,0,10,4,0,3,2,7,0,2,1,1,3,2,3,3,0,4,2,7,1,6,0,0,5,0,6,0,8,0,13,0,0,3,3,1,4,0,0,4,2,3,0,7,3,0,1,8,1,5,0,5,0,4,0,5,5,0,4,2,16,2,0,6,1,0,0,0,0,2,2,7,4,2,4,10,2,4,3,5,0,0,3,3,10,12,0,20,0,0,8,4,1,14,2,0,3,13,1,6,1,2,0,11,6,0,2,1,7,1,3,1,0,3,3,3,3,3,0,96,2,2,2,3,0,9,8,0,4,0,0,0,0,9,0,4,2,0,3,15,0,6,1,1,0,0,12,4,0,0,0,0,4,3,2,8,4,11,0,2,2,3,5,0,0,0,5,3,21,0,0,0,1,0,1,1,0,2,0,1,1,2,0,2,3,3,0,0,0,0,1,2,2,8,0,2,18,0,3,11,3,2,4,2,1,3,1,0,1,1,0,1,1,1,0,12,3,0,6,2,0,0,0,7,3,5,0,1,2,0,0,7,2,0,10,3,9,2,9,12,3,1,1,1,2,0,4,1,5,7,2,2,1,5,0,7,0,1,0,0,1,2,1,1,4,12,0,0,0,5,0,0,1,1,2,5,0,0,5,0,5,0,2,2,0,2,1,21,0,5,1,1,5,1,0,1,0,6,4,0,3,1,0,54,6,22,0,1,0,1,1,3,1,4,2,1,1,0,2,2,6,13,1,3,0,0,0,0,1,3,0,2,5,0,3,5,2,9,0,0,2,3,18,0,0,0,0,1,0,0,7,0,4,6,3,1,2,4,1,0,0,1,2,136,1,1,11,1,2,13,3,2,0,0,5,4,2,2,5,4,2,0,0,4,16,3,0,0,0,3,14,0,0,0,1,0,3,11,0,1,6,1,2,1,0,0,2,1,9,2,3,0,0,0,3,2,1,2,2,4,1,3,1,2,0,0,2,5,2,36,0,1,0,0,2,0,1,5,0,0,1,6,0,0,0,0,0,1,1,1,2,0,14,1,1,0,3,0,4,2,0,3,0,3,1,22,11,0,1,0,2,4,0,1,6,0,3,3,0,3,3,2,2,0,0,0,0,0,6,4,0,0,0,1,13,12,0,1,0,8,5,0,0,8,1,0,0,0,0,0,6,3,1,0,0,0,1,0,0,2,0,0,0,0,6,2,6,0,8,5,3,27,2,0,4,3,1,4,3,0,4,0,1,13,1,4,0,6,0,2,3,0,0,0,0,1,5,0,23,0,1,5,1,3,0,3,0,0,16,0,3,1,3,6,0,1,0,4,1,2,1,5,1,0,3,0,0,8,2,1,3,8,1,2,5,2,4,0,1,1,8,1,7,4,1,0,3,73,0,0,1,1,0,5,3,0,4,3,1,2,0,0,1,0,2,1,0,0,0,1,2,0,1,0,0,0,2,1,8,9,5,0,4,7,1,8,4,3,0,0,1,4,0,0,7,3,5,6,0,0,0,19,3,3,9,0,2,2,1,5,0,0,10,1,6,2,0,3,2,2,2,0,1,6,3,2,4,3,0,2,0,3,0,3,2,2,2,2,0,1,9,1,0,0,2,193,0,0,1,2,0,1,0,12,1,2,2,1,6,0,0,2,1,0,0,0,0,1,3,0,0,7,0,2,1,1,1,4,0,2,3,0,10,0,1,5,0,0,3,0,1,0,0,3,1,0,0,0,4,0,0,0,2,5,1,4,2,3,1,0,1,0,1,1,1,1,4,0,1,2,13,4,1,0,0,6,1,7,7,1,5,0,3,3,9,1,0,8,13,1,14,1,1,2,2,6,1,6,0,0,3,6,5,2,0,0,0,4,0,2,6,2,1,1,0,3,2,1,1,1,1,3,0,0,0,11,0,2,0,1,4,1,4,5,0,0,0,0,0,0,1,0,3,0,0,2,0,3,0,4,2,1,2,3,3,1,5,0,0,4,1,2,1,0,0,1,0,3,1,0,1,2,0,0,1,1,3,0,0,11,2,1,9,1,0,0,0,2,0,0,0,7,2,1,8,0,0,2,0,5,2,0,10,2,0,0,2,21,2,4,0,3,0,0,0,1,2,9,1,2,0,0,0,0,4,0,0,2,11,0,0,0,0,1,0,3,0,1,2,0,0,0,0,1,3,5,7,0,2,3,18,0,4,0,0,1,0,3,1,0,0,1,5,0,5,0,4,0,3,0,1,3,2,3,2,32,0,1,4,0,0,10,1,1,13,0,2,3,4,5,2,0,8,1,0,1,0,2,0,1,2,0,0,4,1,2,0,0,0,4,3,0,0,17,2,1,0,2,1,0,4,1,0,8,13,2,0,0,1,3,3,10,0,0,5,5,0,6,0,2,3,15,16,0,0,3,3,2,2,0,0,15,3,10,0,2,2,2,0,2,1,0,0,6,1,0,8,1,0,1,0,0,0,2,7,1,1,3,1,5,1,1,3,1,0,2,4,0,0,0,0,1,2,0,7,1,2,3,0,1,0,5,1,0,0,0,7,2,1,0,0,0,1,0,6,3,1,1,0,0,1,0,0,1,0,1,1,0,0,0,1,3,0,1,0,8,0,10,59,1,0,0,5,2,3,1,1,8,9,3,8,6,3,0,1,0,1,2,1,1,0,3,0,0,1,5,0,3,0,0,0,0,1,161,8,3,1,1,0,3,6,2,4,3,0,1,1,0,0,9,5,0,1,0,1,3,2,4,2,0,3,3,1,4,0,6,0,2,1,0,5,0,0,2,0,0,0,0,0,4,0,0,0,0,0,5,3,13,0,1,0,7,4,0,2,0,1,3,2,0,0,1,1,4,0,2,0,0,2,2,0,3,5,2,0,0,4,3,0,1,1,0,0,1,1,0,6,0,1,4,1,0,6,0,2,1,0,0,3,1,1,2,24,0,6,1,0,1,1,7,3,5,3,0,2,0,1,0,0,0,3,4,2,2,1,0,0,0,8,2,0,3,4,0,16,0,0,2,0,0,1,7,3,0,0,0,0,2,1,0,3,0,0,1,1,0,20,0,0,0,3,2,9,0,1,2,1,2,0,9,0,0,17,0,0,0,4,0,1,1,0,9,6,1,4,0,2,1,0,3,0,0,3,0,1,1,0,0,6,1,1,2,2,0,1,0,0,1,0,0,0,3,0,2,2,0,1,0,6,2,1,1,3,0,0,4,1,2,8,0,0,2,1,21,0,1,3,4,0,3,4,3,0,1,0,0,3,0,0,2,2,1,0,0,2,1,3,0,0,1,0,0,2,0,0,5,0,0,0,36,0,3,2,0,0,0,1,1,2,1,0,0,1,1,0,0,0,4,1,2,3,0,0,3,0,1,0,3,3,1,4,5,0,2,1,0,0,0,3,2,4,2,0,0,1,0,2,6,0,5,0,0,4,16,2,3,1,2,0,0,0,0,2,1,0,0,0,4,10,2,0,1,9,3,0,0,0,0,0,1,3,4,2,1,0,0,0,0,2,3,9,2,1,1,5,2,2,3,3,0,2,0,0,1,2,2,0,0,1,0,0,0,0,4,0,0,0,2,1,0,7,4,1,1,0,2,0,1,0,2,0,2,0,0,0,0,0,0,1,1,19,0,0,2,0,1,3,0,2,0,1,1,0,6,0,0,0,0,2,1,7,0,3,0,1,0,0,0,4,1,0,1,0,0,0,0,0,4,0,0,0,1,0,0,6,0,0,0,0,1,0,0,14,0,0,2,1,0,0,0,0,0,0,3,0,1,0,2,0,0,0,3,0,3,0,0,0,1,0,1,0,0,0,0,0,0,0,2,0,0,0,0,0,0,0,0,7,0,0,0,0,0,0,0,0,0,0,0,0,0,0,0,0,0,0,0,0,0,0
"1992 Cornwell, Patricia, All That Remains",pop,4753,2345,2605,2205,1701,3315,1237,1525,1631,1098,1283,625,940,969,949,754,882,660,636,696,529,443,628,331,666,677,651,338,507,430,349,410,580,417,449,561,481,213,357,271,442,228,304,316,419,454,367,262,354,283,227,257,237,194,210,262,444,369,217,176,111,319,178,104,220,168,169,158,215,344,176,330,148,158,255,162,133,171,136,150,198,220,53,166,112,115,176,162,101,109,63,84,77,121,178,140,132,197,98,165,145,64,187,118,121,91,70,100,132,148,97,51,97,54,88,77,79,108,98,96,230,86,166,91,73,110,107,73,90,107,50,71,139,53,44,87,71,78,133,125,74,139,14,142,123,64,105,157,78,153,59,118,72,56,91,96,125,93,30,26,45,40,114,72,36,32,39,71,74,84,53,69,35,47,183,103,39,60,105,110,59,69,55,177,36,73,94,54,32,51,71,19,58,67,63,59,21,42,29,33,93,31,75,24,92,33,59,29,45,31,38,49,8,94,30,68,88,16,58,29,59,41,50,30,51,32,38,27,58,56,29,33,11,46,50,8,37,34,63,31,50,100,138,31,56,65,39,44,126,46,53,14,39,45,28,41,40,27,24,17,20,116,32,38,49,20,62,31,52,50,49,10,27,54,24,68,29,30,81,29,30,52,36,58,35,20,33,29,58,13,28,15,52,31,19,34,35,56,62,52,41,38,6,33,71,57,21,15,32,82,35,42,29,26,29,10,25,47,27,37,16,70,14,6,21,31,26,36,44,39,38,43,25,32,45,67,9,4,42,75,42,32,28,46,61,37,64,20,19,39,48,26,32,33,20,34,51,13,9,43,17,24,30,45,53,17,13,32,26,13,31,58,26,40,23,8,43,21,18,52,14,19,20,22,26,98,0,20,31,27,42,33,39,55,31,57,12,18,23,49,13,67,11,21,23,39,23,23,22,17,9,18,18,18,18,33,45,24,28,30,38,0,7,25,11,10,40,18,19,71,16,31,28,37,4,9,52,20,36,25,12,31,15,24,41,48,29,30,26,57,37,28,6,42,31,18,14,36,21,24,19,8,0,16,39,11,7,22,8,20,68,11,42,26,5,18,8,17,0,16,25,10,11,38,7,10,12,21,31,40,6,19,14,16,21,43,13,29,4,4,22,32,25,31,13,22,5,9,23,60,8,10,24,3,22,16,0,15,4,25,8,16,12,19,41,22,9,30,30,27,2,12,14,48,7,6,19,26,10,34,6,40,12,16,14,10,0,1,20,24,11,29,33,3,14,26,32,37,12,23,32,30,37,80,26,23,20,21,1,1,11,15,14,14,8,25,6,13,8,8,18,12,14,13,35,16,14,13,11,8,18,32,22,27,6,13,4,10,21,16,13,12,5,23,2,0,0,21,13,13,9,26,24,26,13,11,10,5,51,26,21,36,7,14,9,9,15,4,14,40,35,10,21,3,24,0,16,17,18,25,21,3,16,28,8,21,17,10,2,25,0,3,21,23,7,4,15,13,9,6,35,11,12,20,3,24,6,13,17,28,7,5,16,14,21,5,12,4,25,14,8,7,42,14,19,18,2,10,20,6,11,22,2,22,16,15,15,4,27,18,18,10,10,7,21,9,47,13,25,7,95,6,9,9,16,3,14,14,4,16,8,11,5,2,22,9,23,9,5,10,31,15,28,2,0,9,13,18,10,5,14,10,11,10,11,0,8,12,17,6,3,2,21,6,43,21,12,10,25,9,25,7,5,7,21,22,17,4,1,18,5,11,4,2,3,21,5,9,10,47,4,10,19,10,9,20,6,13,28,13,11,6,1,9,16,10,61,11,1,9,40,0,3,24,16,28,0,22,25,10,14,9,20,2,24,18,9,0,4,16,7,5,19,9,9,8,16,4,12,7,23,3,55,17,20,6,11,16,0,9,15,6,6,3,14,5,32,0,9,45,20,8,15,6,11,3,5,6,22,7,5,12,14,12,19,3,10,0,4,10,10,18,2,17,0,29,20,4,22,4,13,19,9,8,17,13,1,11,9,18,11,20,9,11,9,10,14,0,5,0,18,5,8,21,29,13,9,13,8,16,13,0,11,0,13,13,4,11,6,7,18,1,15,4,16,0,10,0,41,6,0,1,9,3,11,4,9,3,14,11,21,1,38,6,11,16,11,8,11,25,8,11,1,11,0,13,7,9,21,3,0,4,5,1,22,15,5,3,4,14,15,0,4,6,5,7,1,10,10,23,0,24,2,46,26,11,12,0,2,22,4,4,14,7,3,5,0,5,9,332,6,0,10,0,12,7,0,0,6,3,6,5,27,8,9,5,3,1,29,12,7,14,42,18,94,14,10,7,9,11,21,8,5,30,12,18,14,7,18,13,15,18,1,6,32,12,3,5,8,4,3,4,2,20,4,0,1,12,0,2,11,4,0,39,13,28,19,8,0,0,0,9,26,7,49,9,21,0,9,0,12,1,9,8,4,4,8,24,8,2,14,0,6,5,6,15,7,17,7,6,12,3,2,23,10,2,3,7,7,8,3,3,5,16,0,1,31,2,7,4,6,2,5,4,5,3,3,5,4,0,1,0,10,7,4,6,9,10,9,2,5,0,7,10,4,3,2,6,10,5,14,32,3,8,6,7,12,4,2,6,17,6,6,4,0,16,0,7,0,6,0,6,6,10,9,6,36,0,2,0,3,18,4,4,10,6,0,11,5,0,29,14,0,3,92,3,16,5,3,5,32,0,14,8,1,3,2,4,4,5,1,17,6,3,3,0,0,10,3,11,8,15,7,12,6,8,11,13,6,8,7,20,1,4,14,0,35,3,12,10,6,2,20,0,3,4,0,6,5,6,22,18,2,11,1,5,0,3,35,8,4,0,12,16,0,3,3,2,3,7,1,15,9,19,0,2,2,7,0,0,7,2,4,3,6,5,14,12,12,11,0,10,8,3,7,10,5,5,0,13,6,12,36,5,10,33,7,2,5,1,3,1,0,2,4,5,5,3,3,5,2,3,5,0,7,5,4,2,9,3,2,24,10,2,19,6,10,5,2,6,8,1,3,0,5,6,2,1,6,0,3,10,29,7,4,2,10,11,7,5,9,0,2,0,17,3,6,4,1,6,10,6,30,10,3,0,0,15,0,22,5,0,9,5,0,7,1,6,5,8,10,1,3,1,7,12,5,0,1,2,0,1,0,1,0,6,0,0,9,14,20,8,5,4,17,23,2,13,5,4,6,12,9,5,12,9,4,0,8,4,0,6,0,0,10,0,2,6,2,10,5,102,31,11,0,5,6,3,4,2,2,4,0,11,7,24,7,23,0,2,4,1,20,0,12,7,2,0,11,2,5,24,14,4,0,0,1,1,4,2,8,2,1,6,4,16,9,4,0,1,2,4,4,5,8,3,73,0,2,37,3,0,0,0,0,4,0,7,5,0,15,4,3,0,1,8,0,234,7,12,6,1,11,5,3,2,1,6,18,8,10,5,8,3,2,0,11,2,5,8,1,2,15,2,5,2,5,0,3,2,4,3,7,15,4,3,3,0,2,4,4,8,4,11,5,7,4,1,2,1,5,4,22,0,4,2,4,72,10,13,2,2,5,2,8,5,20,0,2,2,0,0,7,0,12,14,8,2,9,8,0,13,0,4,7,8,17,13,7,1,1,2,5,3,2,0,0,2,0,2,7,27,3,0,5,4,5,3,1,4,8,6,1,1,5,2,6,1,3,22,4,7,5,6,3,18,0,5,1,5,5,5,6,0,1,1,6,5,19,7,7,4,1,6,2,3,1,0,5,2,11,0,7,9,18,7,20,4,0,1,12,2,6,6,1,0,0,5,8,6,12,0,6,1,54,2,1,18,2,25,2,0,3,12,0,2,2,5,2,9,2,2,4,4,2,2,49,5,0,4,3,3,1,2,4,4,15,0,1,30,6,1,3,0,2,7,5,5,3,0,27,4,1,3,0,1,5,0,0,3,11,12,0,41,0,1,0,3,1,3,0,18,0,1,6,4,8,2,12,0,11,9,0,5,2,10,2,1,3,13,2,14,4,1,4,8,2,7,11,3,7,2,0,0,21,127,4,2,2,3,4,29,3,4,5,5,2,7,3,1,10,6,7,2,5,0,10,1,3,2,1,6,0,0,3,5,0,4,1,0,0,1,2,1,6,3,3,8,0,5,3,0,0,0,0,2,0,1,7,0,1,3,4,5,5,3,0,4,1,1,9,5,3,0,0,2,1,2,2,6,3,5,1,9,0,2,4,0,7,10,0,0,4,37,0,4,7,3,4,11,1,7,0,3,4,2,1,2,4,8,0,1,5,7,0,2,13,7,1,9,0,2,7,0,6,2,4,2,1,4,2,6,0,3,2,0,6,20,4,0,2,1,0,2,7,0,4,4,0,8,10,7,0,4,2,2,25,1,6,2,6,2,2,3,2,7,0,12,16,2,2,3,3,5,5,6,4,7,24,2,5,4,2,0,8,8,9,3,12,8,0,4,3,13,21,5,2,5,0,7,5,4,15,40,1,7,3,3,6,9,5,39,0,0,21,3,9,6,5,4,4,6,1,5,0,7,9,6,2,2,7,0,0,2,1,0,3,1,4,0,1,5,1,2,4,11,5,13,5,7,2,2,0,81,3,3,3,4,1,0,1,3,3,6,6,1,8,3,4,3,5,4,0,1,5,6,5,2,2,6,0,3,5,8,0,3,7,2,4,0,8,1,28,3,2,1,0,0,14,3,0,1,0,0,3,4,0,0,1,6,1,0,3,3,5,1,0,4,11,0,9,3,0,7,1,5,1,0,0,0,4,0,13,16,0,0,10,6,2,5,0,4,2,0,0,4,15,6,3,5,7,12,4,1,0,3,6,0,0,9,0,2,27,0,2,1,2,10,5,4,0,1,1,3,0,2,1,1,23,5,1,0,3,0,5,0,0,3,0,0,2,8,0,0,0,2,7,5,1,0,11,4,13,4,6,0,1,4,2,2,0,1,3,1,9,1,0,0,2,1,8,1,2,2,2,2,0,5,25,4,7,8,0,1,10,1,5,1,6,3,2,7,2,1,16,0,8,19,0,0,1,1,1,1,4,2,1,9,5,6,2,2,4,5,3,2,1,0,4,1,0,1,3,3,6,5,1,2,9,1,1,0,3,1,0,6,14,2,1,5,3,3,1,3,1,18,11,3,2,3,7,1,5,1,6,2,0,0,1,4,2,3,5,7,0,2,7,5,4,3,1,2,1,4,8,4,4,12,1,1,13,1,0,6,2,3,1,2,9,6,0,3,5,6,21,0,1,4,4,4,1,9,7,6,12,9,2,2,1,15,1,5,2,1,0,3,3,1,0,1,0,5,9,5,3,2,2,17,11,2,4,2,1,0,1,0,0,5,4,1,4,0,0,3,1,0,15,0,18,1,3,2,10,2,2,19,1,1,4,4,15,8,4,0,0,0,1,0,3,0,5,0,21,10,1,20,1,0,0,1,5,7,8,1,3,0,1,5,13,0,9,5,2,0,2,1,1,0,2,7,0,0,0,92,6,0,0,2,2,6,3,0,6,3,214,13,2,0,0,3,6,3,0,7,0,2,1,4,24,0,0,2,1,1,8,3,0,5,1,6,0,0,1,2,0,5,2,0,1,2,3,0,2,2,1,5,2,1,7,1,4,4,6,2,3,3,0,0,3,0,5,8,0,8,0,2,0,1,1,0,4,2,3,4,1,0,18,6,0,11,6,1,7,2,7,2,6,1,3,2,1,0,2,2,0,1,4,4,3,1,7,1,0,0,9,1,4,1,0,4,2,0,2,1,4,8,0,3,7,0,1,0,0,2,0,0,10,2,0,3,6,0,0,0,2,3,1,17,7,1,1,1,5,2,3,3,2,3,0,0,5,0,2,1,0,1,2,1,1,14,3,0,5,2,1,7,3,3,2,14,4,6,3,10,0,1,2,3,18,2,2,5,0,3,1,4,0,1,3,0,23,0,9,6,2,0,2,0,0,0,0,0,4,0,0,0,0,0,1,0,3,3,1,2,1,5,2,5,5,1,1,0,5,7,1,11,2,2,3,0,3,4,0,2,0,12,0,7,2,3,1,0,6,6,2,0,7,1,0,6,1,2,4,1,1,3,12,3,5,3,1,1,4,8,3,2,0,2,2,1,2,0,2,3,0,1,3,5,0,9,1,0,3,0,1,0,11,6,2,0,2,0,1,7,3,0,3,0,0,5,0,0,0,3,0,3,0,1,3,1,1,1,6,14,0,2,0,0,5,0,0,6,0,0,6,0,1,1,0,2,2,2,1,15,1,5,3,0,3,0,2,7,15,0,4,1,4,2,2,6,1,3,0,3,0,0,2,0,5,2,16,4,2,1,1,6,12,16,1,11,0,15,0,1,0,1,0,3,4,8,2,0,4,0,3,2,3,5,6,0,9,2,2,8,0,3,0,5,2,15,100,2,10,2,3,0,3,2,0,3,3,1,5,1,0,6,0,1,6,1,0,0,4,1,2,4,1,0,2,0,0,2,1,2,10,0,5,3,0,0,0,2,2,0,1,6,13,0,2,1,1,1,5,0,0,1,0,0,3,0,7,0,5,0,2,1,7,1,4,3,0,1,1,4,0,0,1,2,1,1,0,3,9,2,1,0,4,2,2,3,0,2,2,2,1,5,2,2,0,0,3,2,13,2,0,0,0,2,6,0,0,0,1,20,4,5,0,0,4,1,133,4,4,1,11,0,0,0,0,4,0,0,2,7,5,1,1,5,12,2,1,0,0,3,0,5,1,2,0,0,0,0,0,2,9,2,2,0,1,3,10,3,2,18,0,1,0,0,0,16,10,3,5,3,1,2,5,0,4,1,0,1,0,1,5,2,1,6,1,1,12,1,1,5,4,1,0,2,2,3,0,2,0,0,3,5,4,2,3,7,2,4,0,3,2,0,1,0,2,3,0,0,1,0,9,3,1,3,0,3,0,0,2,2,1,2,0,0,0,0,6,0,5,5,1,6,1,4,4,5,3,3,3,0,0,0,4,1,5,4,2,6,0,6,0,2,1,0,0,3,1,1,1,5,10,0,2,3,7,0,0,2,0,1,0,0,6,0,0,1,2,0,3,3,1,4,1,0,1,1,2,3,2,0,1,2,0,4,0,4,0,0,5,1,2,1,1,4,0,0,4,1,0,0,1,1,4,1,10,1,2,0,0,0,6,2,2,0,3,5,5,3,0,1,1,4,0,2,2,3,7,0,2,1,1,4,1,3,2,25,2,0,3,14,4,0,2,0,7,5,2,2,2,2,4,5,12,3,1,1,3,162,6,9,0,0,4,0,2,0,2,0,3,0,2,3,0,1,2,3,0,2,0,0,0,2,0,1,2,0,1,13,2,2,1,61,6,0,15,1,5,1,0,1,0,1,0,1,7,2,0,2,0,1,9,0,0,1,5,4,1,0,0,3,0,0,2,1,1,1,5,3,2,0,1,6,3,3,1,1,0,2,0,3,0,3,1,6,1,0,3,6,2,1,1,2,68,0,3,6,2,0,7,5,0,1,4,2,2,6,2,5,0,0,9,0,0,0,1,1,1,3,2,2,2,0,0,1,5,10,3,0,2,0,1,3,3,6,0,0,0,4,1,4,6,4,2,0,1,0,3,0,1,1,2,1,0,2,0,1,3,1,7,0,12,3,1,2,0,4,0,1,1,3,1,1,4,7,1,0,2,0,2,7,5,3,1,1,1,2,0,0,4,3,4,32,0,0,1,1,2,0,2,3,5,5,0,7,1,1,18,2,0,0,0,0,1,0,3,4,0,5,0,2,0,0,2,0,1,0,0,0,3,0,3,2,1,5,0,0,0,1,6,3,2,1,7,0,0,1,0,4,0,0,1,1,4,4,1,3,0,1,2,8,2,0,0,4,0,2,3,0,0,5,0,2,5,0,9,0,0,0,1,5,5,1,0,2,1,3,1,1,0,5,0,0,3,0,3,2,1,4,27,0,0,0,1,1,1,0,1,0,5,2,3,3,2,0,1,5,0,0,0,2,5,1,1,3,1,1,1,1,3,2,1,1,0,2,7,34,1,1,0,0,1,0,8,0,4,0,1,9,0,0,0,0,2,1,0,0,1,0,0,0,1,4,1,3,0,0,2,2,2,0,2,0,0,0,0,0,3,0,1,0,2,8,1,1,2,0,0,2,0,1,0,0,0,0,3,0,0,4,1,2,1,0,1,1,1,3,0,0,4,3,0,0,3,0,5,6,0,6,1,70,3,7,0,5,0,1,0,4,39,0,1,1,5,0,0,3,0,0,0,0,2,2,3,5,15,0,0,3,2,2,0,1,0,1,1,1,0,6,0,9,0,2,1,3,3,3,3,4,1,0,0,1,0,3,1,2,2,0,4,2,4,1,2,3,0,0,1,0,1,0,0,0,11,3,1,1,1,0,0,1,3,4,0,0,0,1,1,2,3,2,2,0,2,4,1,1,0,0,1,0,4,2,7,3,0,0,1,0,1,1,0,0,0,0,3,1,3,0,0,0,2,12,4,0,3,6,2,0,4,2,4,0,0,0,0,0,3,0,1,7,0,0,0,6,6,1,7,1,1,0,0,2,2,0,20,1,2,0,2,2,0,3,1,2,5,5,4,3,0,0,15,13,1,1,2,0,2,1,3,5,1,5,1,2,4,3,0,3,3,3,0,2,4,0,0,2,5,0,1,2,0,1,3,0,0,0,0,0,7,0,0,0,1,0,0,4,3,11,1,2,5,1,3,2,0,0,0,2,0,6,4,0,2,2,1,0,8,5,0,0,3,4,0,1,2,1,4,0,0,0,0,7,1,1,0,0,1,0,0,5,0,1,1,0,3,0,3,3,2,1,1,0,0,2,0,0,0,0,1,0,0,3,0,5,0,0,2,0,2,0,0,0,3,1,1,1,2,0,1,1,0,1,5,0,5,0,1,1,2,2,0,0,2,5,3,0,1,0,2,0,0,1,3,1,0,0,2,1,0,2,0,0,0,0,2,0,2,0,1,0,6,0,0,2,1,0,0,0,0,3,0,0,3,0,0,1,0,0,1,0,0,0,4,1,0,0,0,4,4,4,1,1,1,0,1,3,1,2,4,3,1,1,5,0,0,0,9,0,2,3,1,1,1,0,4,0,1,0,4,1,4,0,1,0,0,0,1,0,0,0,0,0,0,0,3,1,4,1,2,0,0,7,4,4,1,3,6,0,6,4,6,0,0,1,0,0,0,6,17,0,1,1,0,1,2,0,0,0,2,1,2,1,1,1,1,3,2,2,1,1,0,0,4,6,4,0,6,1,1,2,1,0,3,0,0,0,1,11,0,0,0,0,3,0,3,1,6,1,0,1,1,0,2,3,3,0,0,1,3,1,0,1,0,0,0,1,0,0,1,3,0,3,1,0,0,0,4,0,0,0,3,0,0,0,13,0,2,6,1,7,1,0,0,0,2,0,1,2,0,4,1,0,4,3,2,0,0,0,3,0,0,0,0,0,0,1,0,0,3,0,2,8,1,0,1,0,0,1,1,0,6,0,1,0,2,2,0,0,0,5,1,6,2,1,0,6,0,2,0,6,3,0,0,3,2,1,0,0,4,1,0,1,0,1,0,1,0,0,1,3,1,1,0,0,1,1,0,2,0,0,1,1,1,0,3,10,0,0,0,1,2,0,0,2,2,3,1,2,0,0,1,1,1,0,0,2,3,4,0,1,5,1,0,1,1,0,2,2,0,0,2,1,0,4,0,0,0,0,6,0,2,0,1,2,3,0,0,0,5,0,0,1,0,0,5,2,0,1,0,3,3,14,1,1,1,0,1,0,2,0,0,0,2,2,0,3,1,0,3,3,6,3,1,1,2,2,2,0,0,0,5,0,3,1,0,1,7,0,0,2,0,1,2,1,2,1,0,0,2,0,2,1,1,5,1,1,0,2,4,0,3,0,1,0,1,5,1,4,5,0,1,0,0,0,0,0,0,1,0,0,0,0,1,1,0,0,0,14,0,1,0,0,2,1,4,1,6,0,0,8,5,3,4,2,0,2,3,2,0,2,2,1,0,5,1,1,3,5,6,0,0,2,0,0,0,1,0,1,0,4,1,0,0,1,0,4,5,1,1,0,0,0,0,0,6,1,0,1,3,3,0,0,8,2,0,0,0,0,0,1,0,5,0,0,0,4,1,0,1,5,0,0,0,0,6,0,0,0,1,3,1,4,2,0,1,1,1,1,0,3,2,2,1,0,1,4,0,1,2,6,0,0,1,0,3,0,0,2,0,0,1,1,10,2,4,2,6,3,1,0,0,0,2,0,1,0,0,0,5,0,0,1,2,1,1,3,3,4,1,5,0,5,0,1,0,6,0,0,3,0,0,1,0,2,2,0,0,0,9,1,1,9,0,1,0,0,4,12,0,0,0,0,0,0,5,0,0,2,1,1,2,1,4,2,0,0,0,0,1,1,0,0,3,0,0,0,1,2,0,1,0,0,1,0,1,2,3,0,1,1,1,1,3,0,0,1,1,0,0,0,1,0,0,0,0,1,0,2,2,1,0,0,8,0,0,0,0,0,0,0,1,0,0,2,1,1,0,0,5,0,0,0,1,0,0,3,1,2,1,1,0,0,2,0,0,4,4,2,1,0,0,2,0,4,0,0,4,0,0,0,0,0,0,0,2,1,1,2,0,3,0,0,6,3,1,2,0,0,9,2,3,0,0,1,0,1,0,0,2,0,4,0,0,1,0,1,1,0,0,0,3,1,0,1,2,0,0,2,2,0,2,1,0,0,3,1,0,2,2,4,1,1,0,1,8,10,16,3,3,1,0,0,1,1,1,0,0,0,1,2,4,0,4,0,4,1,0,4,0,0,0,1,2,3,0,0,0,0,1,6,0,0,0,4,1,0,2,4,0,1,1,1,0,0,6,1,0,1,0,0,0,0,0,4,0,0,0,2,0,0,0,1,0,0,2,0,0,3,3,4,1,0,1,1,1,3,1,3,2,0,0,0,0,0,2,1,0,1,1,0,0,0,1,0,0,5,0,6,0,0,1,0,0,0,0,0,6,3,0,0,0,1,0,0,0,0,0,4,2,3,0,0,0,0,1,0,0,0,0,0,0,2,0,0,0,0,0,6,0,0,0,0,0,0,0,0,0,0,0,0,6,0,0,0,0,0,0,0,0,0,1,0,0,0,0,0,0,0,0,0,0,0,0,0,0,1,0,0,3,0,0,0,0,0,0,0,0,0,0,0,0,0,0,0,0,0,0,0,0,0,0,0,0,0,0,0
"1994 Folsom, Allan, The Day After Tomorrow",pop,12875,6715,5254,5340,4073,1051,4695,3614,4499,3033,1452,2663,2013,1265,1383,1548,2765,1393,1486,891,1775,984,1435,1711,162,733,306,1083,1014,590,1045,971,1027,915,402,756,915,547,280,542,885,352,791,750,405,508,725,345,1060,1069,842,587,656,607,654,628,1086,423,463,332,484,241,453,349,198,478,206,422,236,368,287,175,293,292,221,411,360,275,200,219,393,170,492,300,308,443,453,136,284,171,131,255,338,327,185,315,248,276,106,271,187,179,263,294,188,134,304,217,142,252,300,119,57,181,270,437,229,123,214,160,190,181,250,192,393,163,177,126,240,182,277,314,101,167,314,139,66,146,331,162,65,278,734,91,252,177,193,196,179,192,176,164,283,158,263,115,94,135,179,190,132,154,151,144,189,158,137,103,84,195,28,139,60,45,191,45,100,134,143,101,47,160,172,211,131,100,98,144,143,100,184,67,120,284,93,95,104,121,119,41,41,103,118,137,109,104,127,108,86,35,23,174,117,160,142,85,146,191,94,136,115,138,125,184,146,138,116,142,48,35,235,146,157,104,158,224,89,132,140,45,57,32,154,129,268,64,182,150,124,99,52,62,83,151,95,75,47,49,102,72,109,25,16,135,58,64,136,43,140,142,55,105,59,113,69,86,76,84,92,161,120,107,54,43,126,145,119,81,79,84,145,10,134,66,98,48,93,96,36,62,40,66,28,91,48,21,12,26,83,41,71,8,54,60,33,87,190,68,64,42,37,56,59,33,36,115,40,39,27,139,132,40,123,120,41,77,54,15,57,137,92,43,56,77,83,98,48,27,53,42,65,71,58,44,67,55,52,113,125,51,127,63,33,20,71,128,33,96,20,36,25,112,101,28,97,24,83,50,13,19,51,60,72,40,117,409,0,36,36,50,28,33,35,21,67,110,41,72,43,98,41,50,120,50,149,42,44,5,101,47,69,104,61,21,75,46,31,91,90,38,69,0,7,66,34,84,64,80,39,15,82,39,55,31,51,86,53,24,39,63,51,102,8,64,39,76,215,87,37,62,105,69,30,117,11,34,44,9,56,47,16,23,0,66,33,30,52,81,19,59,54,60,34,0,75,49,35,95,0,64,43,52,59,100,20,16,54,22,21,93,35,60,42,22,57,73,65,98,24,8,55,77,70,87,51,33,138,82,69,54,59,32,71,42,46,36,0,41,15,42,25,15,40,9,52,46,10,26,34,8,18,22,66,17,20,9,20,24,110,29,33,48,17,52,23,58,0,3,97,2,50,81,29,31,27,27,76,31,13,129,23,35,78,2,19,31,35,53,12,75,28,25,20,41,11,43,21,14,21,6,43,48,27,66,1,17,18,36,10,30,68,49,44,25,22,7,31,71,28,27,33,22,55,21,7,0,2,48,44,7,14,76,59,43,15,39,22,11,21,45,33,29,19,24,23,2,37,20,22,32,27,83,17,14,25,0,55,52,56,50,24,16,58,14,5,29,35,23,159,17,0,14,49,33,19,6,64,30,54,95,30,46,66,54,58,65,12,13,39,30,35,17,32,80,18,7,6,39,20,41,42,35,56,11,10,21,1,49,33,30,25,44,20,50,35,68,9,20,21,30,15,36,9,46,22,15,4,18,11,55,3,25,52,40,43,5,23,60,21,53,6,21,18,6,39,20,10,9,7,25,22,16,44,32,0,28,57,6,14,39,31,17,48,13,3,7,131,26,28,22,45,30,24,28,64,38,25,16,62,23,19,21,32,21,44,9,4,109,43,10,35,50,8,67,0,14,3,39,9,12,13,11,73,25,13,16,14,17,15,25,19,28,134,27,39,6,10,36,1,35,18,15,19,21,22,29,8,40,17,3,39,47,20,185,81,14,10,0,13,6,24,7,30,48,39,10,24,32,45,43,40,4,7,33,23,14,6,23,0,6,19,23,15,27,29,15,8,0,72,44,26,7,8,19,26,1,4,30,9,31,20,15,35,25,18,49,4,0,17,34,15,33,7,14,0,33,46,9,6,19,5,15,4,16,14,34,21,8,24,9,47,120,11,35,14,25,20,0,10,23,33,50,55,21,13,1,39,9,17,23,30,0,26,0,13,10,10,21,6,23,23,78,36,28,27,14,23,0,21,30,9,15,9,0,86,6,25,16,17,26,50,3,27,15,29,22,74,34,14,29,25,20,18,78,133,17,3,32,11,6,0,25,4,0,33,37,14,234,12,23,14,0,19,16,27,7,16,14,27,34,0,11,12,22,32,2,22,2,51,8,39,64,20,10,14,13,264,34,4,0,14,2,15,9,18,32,0,0,4,7,22,22,70,51,36,30,17,0,21,35,79,25,9,96,13,39,44,20,34,17,15,33,8,19,14,24,23,3,11,16,5,32,4,26,22,7,9,8,9,6,25,3,28,11,10,0,8,53,6,2,3,34,0,19,36,22,8,31,29,0,0,20,45,10,29,33,41,0,20,21,15,6,7,18,24,2,23,15,17,11,12,0,14,25,33,9,11,57,4,18,41,1,24,6,8,10,23,13,33,7,23,35,17,25,0,9,7,29,22,17,2,6,6,10,22,13,10,45,47,1,18,0,35,1,9,11,19,13,3,11,13,23,11,7,7,3,6,19,22,5,23,14,6,16,6,57,22,24,39,13,12,63,7,5,0,8,10,25,0,1,0,20,23,14,85,4,2,2,21,0,3,14,2,20,12,23,0,20,28,0,39,13,0,20,39,0,9,5,1,11,47,0,17,9,37,21,6,16,10,17,0,17,6,5,23,0,0,23,47,62,48,13,9,22,10,8,13,5,11,35,13,16,1,9,10,0,30,7,16,19,30,5,26,0,22,13,157,33,14,8,26,8,14,43,8,14,6,15,0,7,13,0,50,16,0,21,9,5,21,15,0,21,31,11,0,11,42,3,0,3,17,17,1,9,11,24,13,22,17,8,1253,1,20,8,8,5,12,7,0,62,8,7,25,7,16,12,3,4,11,8,8,3,6,7,10,13,16,17,4,23,3,10,18,3,6,6,18,3,25,15,2,15,11,20,4,22,14,17,26,18,9,9,11,0,7,13,12,17,11,12,18,2,3,19,15,5,16,21,14,8,19,21,16,1,9,39,30,22,18,13,15,17,24,1,23,1,0,15,0,11,1,0,11,11,7,6,6,24,1,24,7,10,14,17,6,22,20,0,10,11,0,0,0,11,0,6,1,1152,6,12,2,36,3,7,0,3,6,19,5,9,19,16,8,3,26,32,22,3,25,28,7,12,0,0,1,4,9,16,8,29,14,7,47,17,0,7,5,8,22,20,10,1,0,5,10,0,3,19,7,78,7,19,32,0,19,0,5,0,11,4,18,8,11,7,0,8,5,14,10,7,8,0,3,6,14,12,30,17,4,0,2,5,8,11,6,7,0,4,0,7,6,0,0,0,0,0,0,14,12,28,15,3,7,8,9,18,11,0,13,13,27,6,27,6,13,3,11,12,7,7,18,12,35,12,19,0,26,1,18,3,2,10,12,19,14,17,6,0,7,24,14,14,5,24,16,11,2,6,11,8,5,12,8,2,9,14,6,15,13,1,34,13,30,180,12,4,17,25,20,18,6,3,11,2,6,9,29,3,4,14,0,5,28,4,9,15,48,1,6,21,0,10,0,13,18,33,11,9,8,8,2,18,27,2,16,8,0,15,1,2,35,31,9,0,0,7,18,1,6,8,20,10,2,6,15,6,13,6,29,8,14,13,10,30,0,9,8,29,9,10,1,9,7,7,0,29,5,13,11,15,18,2,5,2,5,4,7,0,11,30,5,0,9,3,25,19,24,2,6,18,12,6,3,7,1,2,25,4,5,13,23,0,5,16,0,1,11,17,11,5,13,1,5,14,22,13,7,3,0,49,3,12,12,3,5,17,25,2,0,8,17,2,5,4,8,8,20,0,13,3,9,8,28,561,2,1,16,14,14,1,23,4,19,9,0,7,8,6,7,1,8,15,6,4,12,4,0,2,1,7,1,35,6,10,5,10,12,16,6,0,17,17,1,8,3,59,16,24,18,6,9,30,15,11,22,9,13,3,11,8,13,6,0,8,14,0,16,0,22,12,23,21,6,11,0,14,13,11,2,3,3,19,36,15,7,2,21,0,2,11,7,9,0,0,3,5,0,12,0,0,0,16,6,4,16,10,10,11,0,10,20,5,0,0,3,11,6,11,0,2,17,15,18,3,1,6,2,19,8,7,14,12,4,5,0,2,123,11,3,22,9,26,3,32,10,11,1,24,6,15,0,0,3,9,10,9,2,19,7,16,2,14,0,3,12,29,1,1,4,10,10,1,4,13,0,3,14,14,0,42,0,16,2,1,4,6,7,9,2,10,3,0,0,4,20,26,15,14,14,13,19,41,0,30,12,0,9,4,0,8,10,9,0,13,3,7,7,7,4,3,13,7,9,17,0,42,1,16,2,12,4,12,4,8,10,3,9,0,19,1,8,4,5,0,7,28,1,15,7,3,3,11,4,3,15,18,6,6,19,10,19,43,11,27,8,11,3,1,2,14,16,1,16,9,4,3,10,17,4,21,2,17,30,6,5,7,16,16,10,4,14,1,7,13,9,0,2,4,8,0,7,5,2,3,0,20,15,5,8,9,13,2,27,0,2,11,9,6,1,3,3,3,15,10,5,7,11,22,13,5,11,20,6,2,15,4,2,13,3,3,11,0,0,8,4,0,0,11,7,10,10,1,15,13,10,30,0,1,9,3,3,11,8,8,3,22,2,1,1,32,2,0,9,2,17,6,0,1,25,11,0,10,0,18,15,4,0,4,0,0,4,0,8,6,0,0,27,6,4,7,5,5,12,3,0,7,38,9,5,3,4,1,9,0,0,24,7,3,0,16,1,4,0,0,11,0,11,3,6,30,0,7,117,6,5,7,15,3,10,11,17,0,3,2,1,5,0,4,4,9,2,0,1,1,3,5,12,15,1,1,14,14,9,21,6,6,22,2,3,3,0,2,6,1,7,27,0,0,19,10,11,2,3,1,7,6,5,3,1,10,13,17,4,10,5,6,6,11,3,27,1,6,15,25,2,12,5,0,1,0,0,41,3,2,5,5,7,1,5,4,14,13,2,8,2,9,0,4,8,6,4,6,4,0,10,9,1,7,4,9,48,1,16,15,0,8,10,5,9,10,9,2,7,12,3,8,4,11,5,2,6,16,3,7,7,23,0,8,6,6,6,7,7,4,0,6,0,7,6,13,0,2,2,6,3,4,1,6,5,9,10,9,0,0,5,0,1,2,46,12,1,1,3,12,0,8,16,3,9,4,15,21,25,10,8,7,8,2,18,5,29,7,8,10,0,3,5,9,3,7,76,10,5,6,2,3,11,17,4,5,2,2,18,11,0,0,7,3,6,15,2,6,0,7,14,0,1,1,13,6,4,11,3,27,12,7,13,1,11,3,3,7,6,0,26,5,21,7,7,2,1,4,6,4,2,2,3,1,0,8,7,15,3,1,1,0,0,4,2,0,3,6,3,22,12,7,12,2,13,6,0,2,24,5,2,0,15,7,6,9,8,14,12,5,0,6,8,0,6,22,16,0,1,1,2,4,0,16,35,0,0,7,0,0,5,0,0,11,4,1,3,1,13,4,0,9,11,0,0,3,13,1,7,11,17,11,10,0,0,4,4,7,3,9,5,6,0,9,6,0,22,23,0,1,0,1,2,8,11,3,2,1,5,11,4,8,4,17,9,6,10,33,10,1,9,3,2,3,0,2,8,0,17,6,9,6,19,5,8,4,10,14,0,4,2,2,4,2,0,14,7,1,2,3,1,3,7,5,7,5,3,0,0,10,3,0,5,2,0,2,4,4,4,1,7,4,1,13,46,23,1,1,19,11,4,9,2,3,7,2,8,0,8,6,6,4,1,9,7,0,7,16,11,1,3,2,0,2,14,27,1,0,4,7,4,3,2,5,0,11,0,8,0,12,13,4,0,12,5,0,13,1,2,8,4,0,5,0,1,0,0,7,0,0,4,5,6,0,11,17,5,2,6,17,2,5,7,8,5,15,5,27,8,1,14,4,3,2,2,0,2,10,4,12,0,3,0,5,1,10,2,0,12,3,8,0,8,4,4,0,1,17,1,7,0,3,12,0,3,11,10,11,3,17,4,3,0,4,7,2,3,2,5,0,3,0,3,4,1,1,0,0,6,2,4,1,13,10,20,2,4,0,3,2,12,0,0,6,4,11,0,0,1,5,1,11,11,0,40,5,14,13,30,5,0,2,1,3,15,9,20,9,0,8,2,495,4,4,3,1,1,5,6,2,1,11,5,1,14,32,1,2,0,53,2,2,5,1,8,1,1,10,1,4,0,0,4,5,1,3,1,3,3,0,2,9,6,31,3,6,0,2,3,1,4,2,10,11,0,14,3,2,3,44,5,8,7,6,7,0,2,3,1,3,3,12,2,9,3,0,0,0,4,9,7,5,9,4,18,4,2,33,16,4,0,0,0,10,3,1,7,5,1,4,4,15,8,0,0,0,12,13,4,1,11,0,1,8,1,0,2,4,2,2,4,5,4,2,2,2,7,2,8,0,0,2,0,0,10,2,3,26,10,7,11,4,11,3,59,7,0,11,1,5,0,4,3,7,4,2,0,2,21,10,2,5,0,6,14,3,0,2,1,5,13,1,8,4,3,0,10,3,3,1,0,5,14,12,11,0,2,0,0,0,10,4,0,0,5,0,0,9,7,1,5,1,1,14,5,3,399,0,18,6,13,0,2,4,0,9,1,0,0,22,1,18,1,15,0,13,1,0,0,7,7,4,0,0,3,3,9,1,2,4,0,0,0,8,9,2,6,14,1,2,1,1,2,8,3,5,0,19,3,4,6,13,9,6,4,8,6,0,0,5,4,5,5,5,5,5,0,1,0,1,2,13,2,17,1,3,2,9,0,10,10,7,2,1,3,3,5,0,9,14,15,10,1,3,2,2,8,31,35,6,13,9,0,229,6,0,4,0,2,10,9,14,7,3,12,2,2,7,1,3,6,0,16,7,10,5,19,10,0,8,0,4,19,7,3,4,11,6,5,8,15,1,0,3,0,4,0,3,3,3,2,0,2,1,0,6,2,5,9,4,0,7,0,0,1,3,5,9,2,0,2,5,0,7,2,15,0,2,1,0,0,6,0,5,6,6,7,8,0,4,6,17,2,4,2,2,9,3,0,6,3,0,5,0,2,3,0,0,7,8,3,1,5,3,7,6,2,0,2,0,8,12,1,5,4,0,0,4,0,1,0,3,2,0,7,0,1,2,3,1,2,13,29,1,9,4,13,0,4,1,1,3,6,8,9,0,8,1,2,0,1,4,4,3,3,2,0,1,4,0,2,1,6,0,8,0,0,14,2,7,3,4,6,43,4,6,5,15,6,0,7,10,0,43,2,9,8,3,22,10,3,10,0,0,8,5,2,0,3,0,3,3,2,2,3,4,3,11,4,5,7,0,29,2,19,2,0,0,0,3,3,4,4,12,5,0,4,3,4,3,13,5,0,8,6,2,7,0,4,2,0,1,9,6,10,20,2,3,5,4,13,0,1,0,5,5,1,2,3,1,16,8,8,3,2,2,5,2,14,26,6,4,7,4,4,0,1,4,1,1,5,9,2,2,3,1,10,5,5,0,4,2,0,3,6,1,3,2,7,0,2,3,0,0,2,8,1,6,9,11,3,2,1,14,19,0,2,0,4,5,4,2,4,9,12,3,1,0,3,1,1,12,0,6,0,0,9,3,1,13,8,3,3,0,3,5,2,12,2,4,0,0,4,1,2,5,0,0,0,1,1,4,0,0,0,1,7,32,7,0,0,2,6,2,12,3,1,3,2,10,6,1,2,4,0,1,0,4,7,12,0,4,7,7,8,3,6,16,4,0,6,1,1,1,0,4,4,0,0,1,0,11,5,0,1,0,1,1,8,2,1,13,3,5,0,3,2,1,1,2,0,0,3,9,4,3,13,1,6,15,1,5,8,1,18,8,9,7,8,1,1,10,20,0,0,6,7,0,2,3,14,8,0,1,0,2,0,13,0,5,1,0,0,0,9,12,0,1,0,2,0,0,2,0,3,0,3,7,6,0,3,1,1,0,3,0,3,2,10,0,3,2,3,8,2,4,4,3,8,89,0,23,0,2,4,4,4,0,0,12,2,11,28,6,10,2,6,3,3,1,0,2,1,0,2,7,0,10,0,7,2,2,11,14,6,2,1,0,0,6,0,0,0,45,7,5,0,3,1,0,3,2,25,2,1,0,0,4,1,3,2,1,9,84,5,0,4,0,3,0,7,4,0,6,9,0,4,5,6,6,6,2,2,7,2,6,3,2,0,24,0,5,1,13,17,11,0,3,0,15,5,5,6,6,10,2,0,0,3,11,2,0,9,4,0,2,0,1,4,6,1,0,18,6,4,5,2,2,6,3,4,3,2,2,0,0,0,0,1,1,2,4,7,9,2,3,1,2,10,2,0,3,15,3,0,0,7,5,4,0,0,1,2,0,3,0,1,2,0,0,2,13,0,0,2,1,30,7,6,1,1,7,0,1,0,0,5,0,1,1,1,0,81,1,1,9,5,15,1,0,7,3,9,0,0,1,5,2,9,9,0,1,4,0,12,1,0,0,0,11,9,4,10,0,1,18,2,1,1,1,6,2,0,2,8,11,1,4,2,0,4,5,2,0,3,1,0,0,1,3,1,2,3,1,0,2,2,3,8,2,0,4,12,0,3,2,5,0,0,3,3,5,5,15,0,6,2,3,0,7,1,4,3,1,4,0,6,4,0,5,4,9,1,1,2,4,1,0,3,2,0,65,0,3,0,0,1,4,0,0,3,2,3,2,1,0,3,4,0,1,10,1,7,3,0,0,0,0,4,4,3,1,17,7,2,317,5,0,18,3,2,4,1,4,0,1,4,0,3,1,7,8,3,10,1,3,2,3,0,1,5,0,3,3,5,2,1,3,2,0,0,2,0,4,4,0,5,1,6,6,2,18,0,3,3,0,2,0,3,0,4,0,1,0,7,5,0,1,0,9,0,2,2,1,6,6,10,0,5,0,2,5,10,5,6,0,8,3,0,0,1,27,0,0,10,5,6,0,0,6,6,0,3,4,4,1,5,0,0,3,0,5,0,2,1,0,13,5,2,4,3,0,4,0,303,1,2,0,11,2,0,0,6,1,4,1,5,2,0,8,1,9,0,7,3,4,2,1,19,9,1,5,0,4,1,0,0,3,4,2,3,2,2,2,6,0,3,4,2,7,4,0,0,9,23,3,0,2,5,0,6,0,2,9,2,3,10,1,2,0,4,0,0,0,0,0,2,12,0,1,0,3,3,3,3,1,2,4,11,5,3,2,1,4,2,5,11,1,4,16,0,2,3,2,6,3,0,0,2,0,0,3,10,0,0,0,8,0,3,0,9,0,1,0,1,0,1,2,4,2,3,12,0,10,3,1,5,3,2,5,1,0,1,0,2,4,5,46,2,2,2,0,34,2,4,5,1,4,3,26,4,1,0,1,2,4,0,3,8,1,4,3,4,0,20,12,0,3,5,5,3,3,7,2,1,2,5,1,0,2,0,7,0,26,5,2,1,2,0,5,7,4,0,7,1,2,0,4,1,0,1,0,2,1,5,6,0,2,0,1,3,3,4,3,13,2,2,1,0,1,0,0,15,1,7,0,0,5,0,0,2,0,1,0,0,0,8,10,1,3,2,1,3,0,4,2,0,7,6,0,3,1,3,3,0,2,3,4,0,0,0,2,4,3,1,0,2,1,16,2,2,2,2,0,2,4,0,9,15,1,0,1,0,4,9,0,2,1,1,0,0,0,2,13,0,3,1,0,9,2,1,25,6,4,3,7,3,0,3,4,1,1,6,5,2,11,2,6,0,0,0,0,33,1,4,0,0,0,0,0,1,3,2,3,4,1,0,5,5,1,3,2,1,4,1,6,2,4,7,0,4,2,4,0,0,0,3,3,1,0,1,2,0,3,1,0,0,3,0,7,0,0,1,0,4,0,1,6,0,0,2,2,11,5,11,2,2,1,0,2,0,1,0,1,4,5,14,1,3,0,0,5,7,11,5,4,4,1,1,1,1,0,2,3,0,2,4,3,3,6,0,1,4,8,4,1,1,4,10,12,1,19,3,5,0,2,0,19,0,0,1,1,0,0,2,0,1,0,2,0,2,1,0,0,7,0,1,7,0,0,0,2,2,0,3,1,2,0,9,0,5,3,0,0,0,3,5,1,4,1,1,0,5,8,0,0,1,9,2,2,2,1,0,5,3,4,4,3,0,6,8,4,0,0,3,2,1,2,14,0,0,3,0,1,4,5,5,4,6,9,0,2,1,0,0,3,0,1,0,4,2,0,0,2,0,1,3,0,1,9,4,0,0,3,1,3,1,0,0,19,2,0,0,1,3,8,0,5,0,3,7,4,1,2,0,5,0,3,5,14,1,1,3,0,3,4,1,3,1,2,1,6,0,0,2,3,8,1,3,2,0,1,4,7,0,2,7,0,0,3,0,1,3,2,6,3,0,2,6,4,2,2,4,0,1,1,0,5,10,1,10,2,0,0,0,8,0,0,3,4,2,0,3,3,2,6,2,1,0,0,11,0,5,1,2,6,1,2,4,0,1,0,0,8,9,0,8,2,3,0,28,3,4,0,2,2,1,3,238,5,0,11,6,1,0,2,1,0,0,7,12,0,0,1,6,1,1,0,4,1,2,1,0,7,6,10,8,1,0,3,0,5,49,4,5,8,31,0,10,2,3,2,0,0,2,1,6,1,3,1,3,2,0,1,3,2,5,9,1,0,4,1,6,4,2,25,1,2,2,5,2,0,0,0,16,0,14,4,1,2,1,0,2,1,4,1,0,3,2,1,0,0,7,7,1,4,8,2,2,20,4,1,3,2,4,5,18,1,0,5,6,1,0,16,0,6,4,3,3,4,0,12,2,1,9,0,0,3,6,0,2,2,16,4,0,6,0,5,1,2,0,220,1,0,6,4,0,8,0,1,6,7,1,5,0,5,2,17,6,1,11,3,3,0,0,1,4,4,8,0,212,2,0,0,2,4,5,0,13,8,1,0,0,0,0,3,0,0,2,1,0,4,0,1,1,0,0,10,0,0,0,0,3,0,2,0,0,193,0,0,1,0,1,0,48,90,0,0,1,0,0,0,1,0,4,0,0,0,0,3,0,0,0,0,0,2,0,158,0,0,4,0,0,2,2,0,0,0,0,11,0,0,0,0,0,0,0,2,0,0,0,0,0,0,1,0
"1994 Rice, Anne, Taltos",pop,10172,6280,5004,3169,4267,2672,2827,2559,2759,2720,2652,1453,2363,1932,2065,1078,2072,1313,1284,1406,1021,1283,1186,898,601,1069,808,1114,635,842,777,490,916,796,1389,906,859,947,962,671,704,440,741,696,456,529,712,643,677,594,378,707,666,407,267,376,611,695,587,382,367,516,586,716,367,323,392,296,498,470,186,269,334,395,106,323,149,334,278,345,170,277,292,311,275,267,188,302,273,289,177,330,373,178,267,117,175,278,146,216,372,427,218,222,230,322,163,371,284,221,369,237,372,165,143,101,191,240,237,265,245,320,146,364,129,189,246,238,249,285,191,261,195,117,180,146,398,216,113,197,134,228,131,202,124,130,205,155,179,105,74,402,136,185,148,48,134,88,66,123,172,113,123,160,56,193,195,54,267,136,35,99,301,93,110,282,148,122,142,103,201,135,235,75,187,93,112,112,82,94,49,72,74,88,168,176,69,34,154,133,132,131,76,152,124,39,32,64,118,108,107,78,155,79,134,80,78,0,205,82,130,84,130,46,84,114,138,99,73,183,111,148,123,160,117,132,202,66,139,174,107,99,70,133,45,47,55,125,58,128,46,58,58,59,96,83,132,59,51,135,53,11,140,42,34,187,79,165,29,88,64,98,133,34,92,48,54,75,96,79,55,71,93,104,124,52,59,88,66,41,27,18,42,130,83,41,57,39,65,59,30,106,24,45,71,64,22,86,64,67,74,43,113,62,153,41,29,75,67,54,198,41,41,32,77,52,195,50,53,54,38,65,47,67,20,24,59,44,48,107,56,76,73,20,64,67,81,3,95,40,40,30,52,38,82,107,20,51,45,31,36,40,52,123,48,26,83,75,36,60,87,21,15,23,26,52,86,15,53,45,39,41,28,30,43,0,0,49,54,34,5,51,59,77,27,49,93,66,45,47,12,71,61,37,65,49,75,39,31,54,25,77,81,25,73,250,40,27,30,37,22,0,24,8,37,20,62,94,41,26,44,53,62,38,9,49,16,113,18,53,26,43,38,74,21,27,109,79,38,40,79,58,50,27,45,13,35,44,37,31,42,9,0,14,40,2,54,117,6,90,25,82,20,1,11,85,18,22,0,34,51,54,29,19,106,20,36,41,14,13,61,15,50,48,34,36,36,23,20,31,45,93,31,26,28,14,45,45,62,11,54,64,53,56,35,59,0,56,50,20,15,55,26,18,43,24,44,60,49,56,1,27,14,59,60,451,47,32,57,20,54,10,41,21,33,48,0,7,18,1,44,46,5,60,42,27,67,35,53,4,4,16,38,0,28,20,24,52,127,15,13,39,28,20,24,18,34,3,33,22,41,14,50,31,13,30,87,11,11,18,43,12,9,11,29,14,43,26,63,10,73,44,7,185,19,0,1,40,9,12,44,8,40,28,28,16,16,39,34,27,32,26,81,22,31,17,13,17,18,2,11,53,30,5,17,0,19,28,29,40,27,82,31,16,5,11,10,32,39,35,0,38,37,42,40,64,20,32,24,4,12,18,19,18,13,15,50,38,19,38,61,42,18,51,22,24,17,50,16,27,32,14,26,16,17,19,25,46,32,23,49,6,22,10,26,16,16,0,41,9,21,32,21,26,39,73,29,14,6,54,30,20,8,34,16,16,14,30,11,25,19,7,10,26,55,24,7,7,33,3,21,17,17,41,0,19,12,11,11,23,28,27,29,21,0,1,1,49,6,4,34,37,68,36,9,77,4,7,44,0,17,37,27,12,49,0,16,88,18,66,24,12,2,25,468,74,26,24,21,5,93,19,72,35,79,13,20,15,6,26,3,25,0,11,24,21,0,35,0,27,16,32,83,15,40,20,0,39,24,6,9,43,42,23,27,6,35,0,36,11,8,16,18,27,7,18,32,9,8,4,24,2,10,17,0,17,28,30,0,21,12,8,26,57,9,32,25,0,11,5,40,34,0,20,20,49,13,5,25,19,21,41,8,31,2,14,25,0,9,16,18,4,29,6,0,36,6,27,22,21,52,44,22,20,8,9,0,33,36,25,10,38,3,2,28,34,119,0,56,52,15,17,16,19,6,0,19,8,39,4,16,0,25,0,31,3,19,9,41,9,7,4,10,33,17,42,25,418,11,15,0,12,20,0,16,18,18,16,21,7,17,0,10,10,4,1,3,58,23,9,25,15,14,16,18,32,18,18,11,1,0,30,28,0,13,30,5,1,20,0,10,0,18,8,52,24,20,2,10,31,0,17,19,15,2,0,23,0,6,1,31,37,15,18,10,18,4,7,4,0,34,0,6,0,31,15,0,0,2,15,20,26,15,29,9,12,16,1,2,34,3,20,2,1,6,14,7,3,2,15,12,17,33,16,9,18,28,16,26,29,26,27,1,16,4,35,9,3,5,9,15,10,1,19,8,0,14,27,38,41,17,7,0,2,8,1,6,3,0,0,0,0,11,47,7,35,9,0,7,18,6,11,3,18,4,9,0,22,10,5,11,0,9,13,15,7,13,27,21,13,3,14,4,23,11,52,12,37,8,31,10,52,24,16,0,10,11,15,27,7,35,4,1,10,27,14,10,7,30,2,11,0,17,15,31,25,35,7,3,10,54,5,30,22,15,5,44,14,19,23,1,1,49,6,14,12,1,10,15,24,11,59,21,11,0,4,7,37,4,1,1,9,20,10,18,19,0,19,9,0,9,8,4,28,10,8,0,8,14,0,14,12,0,21,23,14,12,5,0,5,15,0,13,31,9,0,0,18,13,11,3,33,26,3,2,0,0,11,9,18,9,4,7,7,18,5,6,9,75,12,11,19,10,14,23,0,11,26,7,4,2,31,2,0,1,3,0,9,8,10,1,24,4,10,0,17,15,14,0,10,8,0,8,13,0,4,23,14,5,11,18,2,4,12,0,12,13,26,0,3,2,10,9,17,34,10,2,8,8,17,0,5,12,11,10,14,4,12,1,10,12,28,10,8,11,4,0,4,18,13,34,25,16,16,3,14,7,62,41,6,29,9,2,1,9,21,17,15,7,12,0,14,1,5,1,31,3,3,1,4,8,22,0,0,19,7,4,20,7,0,6,16,3,5,16,34,14,5,13,3,1,31,12,1,8,5,9,4,4,19,7,27,7,0,5,0,490,30,0,0,6,0,2,23,28,27,25,1,3,7,25,30,10,9,9,22,15,16,13,0,0,0,0,15,0,24,0,0,2,10,9,11,40,2,0,9,39,1,9,24,19,9,18,9,3,3,2,1,16,35,1,13,0,0,15,9,10,7,7,13,7,3,12,2,0,18,2,3,24,4,17,14,0,28,10,0,26,0,24,7,8,26,12,0,2,12,4,0,6,1,10,9,13,11,91,0,8,3,9,3,21,16,21,5,4,6,17,67,8,16,20,18,1,4,1,33,0,176,3,7,1,0,1,0,0,11,0,6,3,38,14,11,16,5,23,1,0,0,1,9,2,6,34,15,17,91,2,4,1,6,18,5,0,1,15,0,12,9,12,3,9,13,6,4,5,5,4,0,16,3,9,4,6,9,0,7,35,25,96,10,2,2,9,15,7,15,9,0,14,3,28,20,23,0,6,28,24,7,26,2,6,14,5,14,11,14,6,1,25,9,0,20,7,9,16,9,3,0,5,10,0,0,0,4,24,10,22,2,11,22,13,6,3,3,22,19,0,15,0,9,6,1,9,0,5,8,12,34,3,0,31,8,7,0,12,8,23,3,4,8,26,4,9,10,160,0,3,17,8,1,4,10,29,2,31,4,0,12,8,12,9,19,10,3,9,39,2,0,8,3,0,51,1,9,22,4,0,14,6,20,3,13,17,19,4,16,1,9,7,8,8,0,0,10,0,1,11,2,9,3,12,22,6,47,10,16,29,12,45,10,0,50,0,0,3,8,1,15,0,4,2,11,48,3,8,0,5,3,14,21,1,2,19,0,5,12,2,10,9,7,13,22,6,4,0,5,7,41,4,2,5,2,28,2,4,7,0,13,24,6,6,2,5,8,6,12,1,1,3,0,7,0,0,8,16,12,12,12,6,7,14,0,7,1,0,5,1,12,0,9,16,21,4,26,4,0,11,1,3,1,15,5,8,10,26,5,10,19,21,2,16,12,6,13,14,0,4,0,2,6,4,5,0,0,8,18,0,19,0,10,0,22,15,10,0,11,2,2,0,6,9,2,0,14,1,31,8,8,4,27,10,4,8,10,7,21,23,9,2,16,8,9,1,4,0,11,4,5,8,24,8,15,0,6,3,12,6,1,24,4,1,31,14,1,21,1,7,10,5,7,70,6,0,1,4,0,1,1,2,18,0,16,7,1,0,3,8,7,1,10,0,8,12,0,12,5,4,4,12,18,5,0,626,2,17,0,24,2,3,1,0,2,0,11,0,0,7,4,0,6,22,22,0,16,0,13,1,16,5,8,8,5,0,10,3,0,0,7,52,5,6,2,12,9,3,0,2,1,3,1,7,12,0,0,4,2,11,3,2,10,1,1,6,5,11,3,3,8,6,9,2,6,3,11,10,9,17,0,13,61,12,0,15,10,1,4,0,3,7,11,5,5,3,12,0,6,4,21,3,3,8,2,5,7,10,4,5,10,9,0,2,30,7,7,0,4,14,8,7,3,2,8,2,0,419,6,2,2,13,3,4,5,2,3,4,19,3,0,11,6,3,6,72,6,10,6,16,5,8,3,0,0,8,7,206,0,2,44,0,36,0,0,1,3,12,3,0,3,0,3,3,3,0,7,15,6,1,0,5,6,1,2,6,6,4,21,0,0,9,4,9,3,0,18,0,1,0,3,0,0,4,0,1,7,0,0,1,1,8,5,4,3,8,0,0,4,5,4,0,5,4,0,3,1,22,10,0,5,0,0,0,3,0,0,7,0,9,2,15,11,0,2,34,5,12,7,6,2,5,3,2,5,0,3,6,0,0,8,0,4,26,0,0,2,0,10,7,5,7,9,2,2,4,3,5,42,4,6,2,6,32,5,1,13,9,13,0,0,2,8,6,8,4,10,0,0,3,3,5,2,11,3,16,2,16,4,12,3,2,3,32,7,2,2,8,1,5,0,16,0,4,0,12,1,4,17,5,3,0,1,9,15,0,2,2,13,2,9,10,4,4,0,23,6,0,20,11,2,3,9,2,0,2,7,2,4,7,1,12,2,15,11,1,4,8,11,3,5,0,5,4,5,7,16,3,10,1,22,12,2,2,0,5,3,10,4,2,2,4,2,16,2,0,6,6,15,9,4,8,6,6,2,0,0,3,8,1,6,19,10,2,9,1,11,1,0,1,1,6,31,10,17,5,2,1,0,21,0,21,0,22,1,0,5,0,3,0,5,2,1,2,8,5,14,4,1,6,3,4,9,15,2,5,0,1,12,10,5,0,7,0,13,0,1,33,0,4,1,1,15,7,6,6,10,1,8,42,11,10,5,5,10,2,0,0,11,8,49,3,11,3,0,2,2,0,5,0,2,0,2,8,0,2,8,4,0,1,18,1,129,4,1,3,2,4,6,1,10,3,3,0,15,3,0,4,0,1,11,3,2,9,16,19,1,0,2,7,0,3,10,6,9,21,5,0,1,0,0,4,6,0,3,2,5,3,8,0,4,21,7,4,0,3,2,3,3,9,0,3,2,6,0,3,10,10,13,24,6,10,40,7,8,1,1,0,8,0,3,12,0,0,7,0,0,0,3,2,13,9,0,0,13,2,1,1,4,0,0,8,9,3,0,3,2,5,2,5,10,5,0,4,0,2,2,15,9,7,1,8,5,4,3,0,3,3,8,16,2,0,0,6,10,0,4,1,2,25,1,1,3,0,4,0,3,2,0,1,4,0,0,6,9,9,1,2,16,1,4,0,5,2,7,0,1,9,2,0,14,2,0,5,0,6,4,1,8,16,6,9,0,3,4,5,0,11,1,4,0,8,0,10,5,4,5,0,3,11,12,3,6,0,2,0,3,24,6,0,3,10,0,4,0,0,3,4,0,7,8,0,0,0,7,0,3,8,0,3,0,2,1,2,18,5,7,3,2,2,7,5,4,1,10,2,0,5,1,0,8,4,0,1,7,10,5,0,4,0,19,8,9,3,0,0,4,5,0,0,1,7,17,2,0,7,9,7,21,0,3,3,2,3,2,5,1,1,31,3,4,2,12,3,16,11,19,0,0,3,3,2,0,4,0,6,7,0,0,1,6,0,0,9,0,0,1,6,0,0,6,6,2,0,0,74,4,11,2,7,0,3,6,7,4,3,3,0,3,5,1,6,11,10,2,0,0,4,0,3,6,7,13,6,0,3,3,1,2,1,9,2,5,5,5,1,2,3,0,3,3,11,10,8,5,1,0,0,0,3,0,0,1,3,10,8,4,7,1,3,0,7,2,2,1,16,4,8,2,1,8,2,7,14,6,0,3,5,3,3,4,0,0,4,8,6,4,1,2,6,23,6,4,0,0,6,2,5,1,3,2,6,0,3,2,5,4,0,0,0,0,2,45,5,0,6,1,2,6,2,0,0,90,2,3,20,0,3,5,9,5,0,178,4,25,1,0,6,4,4,4,4,3,4,13,2,0,2,0,0,0,4,0,5,18,0,20,0,3,6,2,0,0,0,4,4,7,0,12,2,0,0,2,1,6,0,7,4,6,4,9,14,7,377,0,2,3,6,1,14,4,3,295,5,13,1,30,0,0,9,1,2,0,12,0,5,0,3,3,0,0,5,0,0,3,3,2,9,12,8,0,0,6,1,0,7,3,10,3,24,6,0,5,0,0,5,10,10,1,2,3,0,3,3,0,0,9,5,11,1,0,1,0,5,9,2,0,0,2,0,4,4,4,0,2,9,5,1,6,1,1,9,3,0,5,0,0,6,2,5,1,0,10,0,1,0,9,7,0,6,9,3,24,3,18,0,13,0,0,5,5,0,8,3,12,0,8,4,0,5,5,0,4,7,0,7,2,2,7,0,4,0,10,0,0,0,0,3,0,0,4,6,0,2,0,5,5,16,2,7,3,3,3,6,4,0,2,5,1,0,0,4,6,7,1,0,1,362,1,2,7,1,2,4,13,7,1,0,0,1,4,2,2,0,3,0,17,6,1,2,0,0,2,6,0,1,0,0,3,12,34,36,13,4,2,0,0,0,0,0,8,3,2,1,0,2,4,0,1,1,8,1,1,3,2,0,7,6,2,1,4,5,3,1,0,10,1,2,10,7,0,4,39,3,9,4,1,5,3,22,7,34,3,4,0,3,0,5,5,1,1,3,2,0,1,10,0,2,11,1,0,4,0,4,3,1,2,1,4,6,4,6,10,3,0,1,3,3,0,1,0,4,0,19,0,0,11,2,7,0,1,1,1,0,4,0,0,0,0,0,13,0,23,3,0,11,5,3,0,9,3,2,2,2,10,5,0,1,4,0,1,1,3,0,1,0,3,6,4,12,5,10,8,0,0,2,2,7,2,2,14,1,3,0,5,3,13,5,2,1,0,0,0,0,5,0,4,8,1,1,1,3,0,9,1,6,3,1,3,0,1,1,2,6,0,10,0,0,0,7,6,3,0,11,0,8,0,2,1,0,0,1,2,4,2,0,2,4,3,4,10,0,1,2,0,1,1,1,5,0,3,0,0,0,4,0,4,2,14,0,0,3,46,1,7,2,0,1,0,1,1,11,4,3,1,6,0,6,3,6,0,1,7,1,2,3,5,1,3,2,0,1,0,2,13,1,2,6,0,1,0,3,3,3,0,6,0,1,0,0,1,4,0,2,5,2,0,11,1,9,2,7,5,0,6,2,15,1,0,0,17,2,6,0,0,2,0,21,3,6,0,3,0,1,0,4,0,3,5,9,1,10,3,0,16,2,0,2,6,4,2,0,0,1,4,3,3,11,1,1,0,0,9,11,7,8,2,4,2,0,3,0,2,1,0,0,1,4,6,3,0,1,0,0,4,1,3,2,8,10,2,1,1,0,3,13,1,0,2,10,0,1,2,7,0,2,0,5,11,4,7,0,8,0,0,1,5,0,1,0,0,1,9,1,0,1,16,1,9,2,6,4,0,5,5,12,24,0,0,0,4,11,2,0,2,3,0,3,0,9,1,4,0,4,4,3,7,0,2,1,0,8,0,6,4,4,4,1,0,2,2,0,5,9,0,0,17,2,1,0,13,4,7,2,0,3,1,4,0,0,16,3,1,0,3,1,2,0,3,2,1,5,4,0,5,2,5,9,1,2,2,0,2,4,1,0,6,0,5,0,0,4,0,3,2,12,1,3,0,2,8,0,0,2,6,7,11,4,0,2,0,3,1,9,0,7,1,10,5,2,11,0,11,0,4,8,6,5,8,2,22,2,0,0,0,0,0,0,3,0,4,3,5,3,1,0,0,4,1,4,3,0,0,0,1,6,0,10,1,4,6,0,8,1,4,1,2,7,0,10,1,3,3,9,0,8,1,3,1,0,6,0,1,6,5,2,0,10,0,0,2,0,4,0,0,3,0,0,1,1,3,0,0,1,4,5,0,0,3,4,0,0,10,2,1,0,0,2,3,0,0,3,4,0,6,0,4,6,4,0,4,128,0,2,1,1,0,3,0,0,0,0,0,2,0,0,0,4,1,2,0,0,5,1,5,3,6,0,0,16,0,6,2,57,3,1,10,0,6,0,2,0,5,2,4,3,0,21,1,10,6,2,2,3,4,0,2,4,6,2,0,2,0,1,1,1,1,0,19,16,10,6,2,0,1,9,8,0,5,4,0,0,2,2,0,1,1,0,5,0,1,2,0,0,0,1,6,1,13,1,0,0,0,6,1,2,1,0,0,0,3,0,1,0,0,2,10,0,1,0,9,0,0,3,13,0,2,0,6,1,4,1,0,4,9,1,8,3,16,3,1,1,0,0,0,5,2,0,2,0,1,3,0,1,0,0,3,3,0,2,2,2,1,2,2,3,1,12,11,0,2,5,0,3,6,0,1,2,0,0,0,2,3,1,6,7,0,17,3,1,1,5,0,3,0,2,4,0,2,0,2,11,1,2,0,2,0,9,11,1,3,1,0,5,1,0,3,2,0,0,1,1,3,13,0,1,0,0,2,6,3,5,0,5,1,1,1,0,5,2,0,12,2,3,7,4,2,2,0,6,5,1,1,2,0,7,0,0,3,1,0,1,19,3,0,1,4,1,7,4,0,0,6,14,0,2,4,3,0,0,3,1,0,1,2,0,8,2,0,0,4,2,1,2,0,1,3,1,1,3,0,0,0,2,4,9,1,3,1,2,0,0,0,2,5,3,3,0,0,2,4,4,3,8,1,5,1,9,0,0,4,2,0,15,2,6,4,6,0,8,0,0,0,1,5,0,1,68,1,1,1,6,0,0,1,1,3,3,6,4,1,1,0,8,3,5,4,0,0,0,2,1,2,0,10,0,0,0,4,14,5,0,0,1,1,2,6,0,0,24,0,1,0,0,1,0,1,2,6,0,4,10,0,0,2,2,5,1,2,0,2,0,0,4,2,1,1,1,0,2,4,6,1,0,2,1,1,0,0,0,1,3,1,0,2,1,5,2,0,0,0,5,5,1,0,0,0,7,3,7,2,0,1,0,0,0,11,0,1,2,1,1,4,7,0,0,9,0,8,0,6,2,5,11,4,1,1,1,0,5,5,0,3,0,3,2,6,4,0,4,1,4,1,5,0,0,6,6,4,1,2,4,4,2,9,6,0,14,0,1,0,12,4,4,6,3,3,0,0,3,0,6,1,7,1,0,0,2,0,9,3,0,3,5,8,3,0,3,0,1,2,3,2,4,9,3,0,0,4,1,0,6,4,23,1,1,4,2,1,4,0,11,0,2,2,5,0,4,6,10,1,3,5,4,13,3,6,4,0,9,3,10,0,3,0,2,3,0,6,1,10,0,2,0,10,0,3,4,0,0,3,1,0,2,0,2,1,12,1,0,1,3,5,0,0,2,1,5,1,1,0,1,0,1,4,0,0,6,0,1,0,0,0,1,1,8,7,10,4,1,4,1,0,1,0,0,6,12,0,0,9,1,6,0,1,2,0,0,1,4,1,6,2,1,4,1,3,3,4,0,1,2,1,1,6,0,2,0,1,11,2,3,5,13,1,2,1,2,0,3,4,0,0,1,3,4,2,0,4,4,0,2,0,6,2,0,2,3,0,2,2,0,1,0,1,1,0,0,0,7,5,5,0,4,0,1,5,0,1,0,1,0,0,12,18,0,2,5,0,6,0,2,2,0,1,3,4,3,4,0,0,36,3,3,4,2,1,2,42,1,2,1,0,2,1,32,3,1,1,1,2,1,8,0,0,3,0,0,0,0,0,1,3,1,0,0,0,0,1,44,4,7,2,0,0,4,0,1,3,1,3,0,3,0,1,2,8,0,2,0,2,2,6,0,0,1,1,5,0,0,3,2,2,2,0,0,3,0,0,0,9,17,0,0,1,0,8,5,6,2,1,0,1,0,3,0,2,0,1,1,5,2,5,1,2,0,0,1,10,17,2,0,2,0,0,3,1,1,2,3,0,0,1,1,0,1,3,3,0,1,8,4,7,0,1,2,3,3,0,0,0,12,2,0,0,0,11,0,2,0,0,3,2,0,2,3,2,1,0,5,0,1,3,5,4,4,0,8,21,6,0,2,0,2,5,9,1,3,0,1,1,2,4,0,1,9,0,0,1,9,7,0,2,3,2,0,7,6,4,2,0,15,0,0,0,0,0,0,0,0,8,2,1,1,21,2,8,0,6,2,3,2,5,7,0,0,1,0,0,0,6,1,9,0,5,1,13,4,1,0,0,0,20,1,8,2,3,3,1,2,19,0,2,1,3,6,5,0,9,2,0,4,0,1,9,15,0,2,0,1,0,1,1,3,2,8,4,2,6,1,0,0,0,4,1,1,0,2,18,1,2,7,1,0,1,4,1,1,6,12,1,3,2,0,4,0,31,2,0,2,1,0,0,2,6,1,0,8,3,3,2,2,15,0,9,5,2,1,3,2,8,0,8,13,3,6,3,0,0,1,0,2,0,1,0,2,6,3,5,0,1,107,2,2,1,2,87,0,13,3,0,0,0,2,7,3,0,0,4,0,0,1,2,6,0,1,1,3,0,0,0,3,6,172,0,1,0,0,5,1,1,6,2,8,2,0,2,6,0,13,1,0,0,0,0,0,0,7,3,13,74,2,0,33,4,0,0,0,0,0,0,0,0,102,0,4,0,0,0,0,0,0,4,4,0,0,0,0,0,0,4,4,0,0,0,0,0,46,0,2,0,0,0,0,0,0,26,20,48,35,0,2,0
"1997 Patterson, James, Cat and Mouse",pop,4477,2096,2150,1972,1619,2676,1704,1385,2054,959,734,827,850,511,514,667,1026,529,562,327,635,371,546,346,605,261,556,222,363,270,372,289,363,369,388,250,481,270,461,292,229,305,271,255,295,138,208,286,192,213,203,128,304,164,226,117,274,138,180,234,181,121,132,227,139,186,76,144,123,132,119,177,134,165,108,155,139,177,96,221,110,105,84,165,174,147,106,90,162,153,45,84,84,78,100,60,123,74,161,90,107,125,132,105,120,74,157,146,101,101,72,84,178,133,115,82,93,71,101,78,91,42,59,132,108,90,86,87,158,82,71,70,76,62,42,105,111,71,88,92,151,117,97,88,31,39,67,67,33,118,63,93,42,91,72,124,57,97,49,71,109,107,117,46,34,25,58,25,33,60,69,75,32,31,56,33,59,65,33,65,88,126,35,42,73,73,62,47,58,50,76,68,29,37,51,36,24,53,33,60,42,79,87,43,60,163,43,59,138,39,13,48,12,27,46,26,39,67,61,18,29,52,58,44,28,25,32,41,24,61,33,57,23,59,45,19,36,45,52,33,44,29,111,106,13,58,22,32,41,29,42,9,34,44,23,18,16,27,24,44,40,35,32,42,71,48,49,24,30,50,59,35,24,85,22,26,32,31,67,35,73,24,48,32,79,76,42,40,82,17,32,7,14,20,36,43,38,33,23,32,38,34,33,36,37,23,7,30,25,10,47,68,32,53,17,37,27,34,62,35,19,38,47,38,23,16,41,27,25,24,52,52,44,38,12,36,45,25,12,40,52,45,22,18,28,64,49,9,21,27,46,29,42,21,42,48,72,40,31,17,28,32,23,6,25,31,15,94,13,31,23,27,24,25,38,32,32,15,37,18,20,28,18,43,25,95,0,25,16,34,3,19,10,18,19,31,27,29,50,87,66,60,9,16,24,18,13,30,29,51,27,29,16,29,26,12,20,19,28,11,13,0,11,7,19,20,25,6,20,32,19,19,7,37,8,20,27,24,52,22,13,21,9,16,30,8,42,16,13,25,23,38,20,24,20,26,13,12,18,20,23,6,0,55,22,12,11,16,7,39,31,31,24,1,20,19,6,23,0,28,16,39,21,8,9,22,18,12,23,37,15,28,23,25,16,17,22,14,6,12,30,23,12,14,12,11,6,7,20,11,22,11,16,9,25,11,0,9,29,17,24,12,12,46,21,45,5,16,17,9,42,19,5,11,20,1,13,19,8,18,10,21,59,19,21,21,0,7,26,14,27,32,6,0,13,31,15,12,11,44,20,5,17,3,14,17,12,4,17,31,14,15,37,11,35,7,9,3,5,9,16,17,9,8,2,25,8,33,13,7,14,9,16,7,18,9,5,6,21,12,31,5,2,31,10,2,0,39,12,17,23,11,7,29,2,15,8,10,24,29,14,8,60,10,22,5,1,7,8,13,19,8,8,4,31,0,7,20,34,9,16,51,16,6,6,13,11,26,21,12,2,18,31,6,1,16,6,25,28,9,10,4,11,17,38,19,17,7,7,7,15,16,9,16,3,6,14,6,10,19,20,23,21,9,18,22,2,16,11,7,32,25,198,6,46,14,5,0,6,11,3,25,10,18,17,28,6,21,33,5,2,13,6,12,14,6,14,17,9,7,3,4,8,1,20,13,11,3,10,15,7,4,6,21,0,26,7,21,7,18,22,12,63,10,4,1,92,11,5,8,5,6,4,8,14,5,7,0,11,18,9,17,19,25,14,61,7,19,9,8,14,5,0,19,8,11,12,4,4,4,19,7,6,11,51,18,6,6,10,11,7,19,0,11,8,7,77,16,1,13,21,8,2,17,10,35,2,19,7,6,7,3,8,15,3,9,20,1,8,14,23,5,34,24,7,17,10,15,8,16,24,2,11,8,4,13,11,10,1,18,9,11,6,6,13,28,11,0,8,23,16,7,28,12,2,18,10,0,0,6,7,4,8,16,6,5,5,0,8,2,11,9,14,3,0,10,9,12,13,12,20,13,6,3,3,10,6,8,16,5,2,7,1,12,4,20,8,0,9,7,16,13,13,7,1,11,8,25,15,3,11,0,8,0,7,4,6,7,10,4,21,16,27,1,9,5,10,1,18,1,6,9,5,131,8,7,4,10,6,27,6,3,14,22,4,14,3,10,2,2,4,3,10,1,21,5,19,15,9,1,0,6,10,1,6,12,26,71,5,4,0,0,23,0,7,1,16,17,11,10,150,11,26,15,12,1,8,0,8,9,9,7,10,4,4,3,22,10,11,0,17,0,7,3,3,14,0,0,23,4,13,19,48,0,0,6,5,0,17,7,3,9,5,65,0,1,3,10,6,2,8,18,3,5,17,3,4,1,7,7,18,12,2,11,2,13,14,4,3,6,2,18,0,11,3,0,3,14,1,7,19,3,0,56,7,14,2,4,0,0,1,19,8,17,3,1,8,0,13,17,7,4,1,6,1,6,4,6,10,0,29,0,14,8,3,0,8,4,2,7,6,7,1,5,11,4,4,5,9,4,9,20,12,16,0,6,4,24,8,8,21,17,3,4,8,11,4,16,5,0,5,0,4,1,2,14,3,8,7,0,12,1,3,6,23,1,13,2,3,0,1,49,11,2,5,21,5,9,6,6,7,10,3,4,0,5,4,13,0,1,0,7,10,12,9,9,1,2,9,0,5,14,3,3,14,3,0,4,8,0,9,10,12,5,10,6,7,1,1,11,0,0,8,2,3,7,0,4,2,7,2,7,9,4,9,216,0,13,8,12,17,1,5,11,7,2,2,4,2,6,7,2,1,8,4,0,17,7,14,15,7,1,8,0,7,11,0,3,6,7,1,4,10,5,9,1,7,2,5,2,16,0,18,10,0,9,5,0,3,5,15,2,8,3,0,5,1,6,0,0,1,1,2,6,10,2,1,7,19,13,0,7,6,2,18,4,4,1,1,0,4,0,10,2,1,2,9,5,3,10,10,1,9,5,5,8,3,6,11,19,11,8,4,0,6,2,33,4,4,16,0,1,7,23,7,2,13,1,6,20,7,8,2,0,13,9,1,2,11,30,10,1,5,2,6,1,2,3,0,2,5,3,5,0,4,8,8,3,6,12,22,5,9,0,2,0,0,17,0,16,3,4,6,6,4,6,2,6,2,0,11,5,6,1,3,4,4,302,4,2,0,2,0,1,0,11,0,0,4,0,10,7,1,5,1,22,8,19,2,20,0,0,3,2,1,6,0,15,6,8,7,11,0,0,17,4,1,10,7,2,7,6,13,10,8,15,0,3,6,3,2,5,0,4,11,0,4,1,8,18,8,11,1,1,0,2,0,0,1,1,21,3,1,4,0,20,3,7,3,3,5,9,0,4,2,5,11,8,0,14,17,12,11,8,8,3,0,0,0,8,6,0,0,0,0,1,0,2,5,19,11,1,17,0,7,4,2,0,1,5,5,13,13,7,7,1,3,5,8,3,16,5,27,0,8,1,4,2,6,12,5,1,2,4,3,4,4,0,5,4,8,2,4,4,22,9,7,3,13,4,5,1,4,1,3,6,3,20,10,1,4,1,4,0,5,9,2,33,1,9,21,2,8,5,5,8,5,6,1,7,0,3,11,7,2,1,8,191,5,0,0,3,0,11,8,4,19,2,4,3,1,3,6,7,2,6,0,4,0,0,4,13,3,0,0,6,5,3,9,2,2,4,0,17,1,3,5,1,3,1,4,2,5,3,1,25,1,3,3,0,0,9,3,2,9,4,1,6,5,6,4,11,8,0,5,5,2,359,5,8,2,2,5,5,8,1,3,3,0,10,3,6,5,3,0,0,14,6,3,3,1,0,2,13,3,15,2,1,4,1,2,3,1,1,3,7,1,2,6,5,1,3,3,2,4,2,0,2,0,6,2,5,6,2,1,9,3,0,1,6,1,4,3,0,2,5,3,4,5,1,13,1,2,3,0,6,6,22,3,7,5,2,1,2,5,6,0,2,8,6,3,9,8,2,3,7,1,3,5,0,9,3,2,5,0,12,5,7,7,4,1,7,2,3,1,8,1,5,3,7,1,5,0,1,8,1,3,2,1,17,0,1,5,7,3,2,8,6,3,3,3,4,8,2,2,0,4,5,2,4,17,1,0,0,8,10,0,6,0,1,1,21,1,0,0,1,5,7,0,5,14,0,0,4,0,16,4,5,0,0,2,2,4,0,0,0,3,5,9,5,3,4,3,1,16,1,1,2,0,9,0,2,206,6,2,3,2,4,4,15,0,0,0,2,2,3,3,3,2,9,2,4,1,1,1,0,3,5,9,6,0,2,4,11,0,8,6,1,0,8,0,6,3,1,8,0,6,0,3,1,2,1,0,3,5,1,10,14,6,6,10,0,0,9,1,0,3,1,0,0,1,3,0,6,0,3,2,1,1,0,13,5,1,9,0,2,0,1,3,5,2,5,9,1,0,4,1,1,6,1,9,2,18,0,4,7,2,1,4,1,0,3,4,2,5,3,2,11,4,2,5,13,2,28,8,0,4,0,0,2,1,0,9,2,1,3,6,2,1,23,1,8,2,3,6,8,0,1,6,7,7,3,2,1,4,0,0,5,1,0,2,7,3,0,0,1,0,3,2,1,5,1,12,1,3,2,2,16,3,3,5,1,0,3,5,1,1,6,1,1,1,4,0,1,1,3,0,1,1,0,0,1,1,2,0,1,7,8,5,1,4,2,3,1,6,4,1,0,5,4,3,5,0,3,1,3,23,1,0,3,0,1,6,0,18,4,0,0,5,1,2,4,0,3,4,0,0,1,0,0,10,0,0,6,0,0,2,7,0,1,3,5,5,2,0,1,5,12,5,3,4,20,3,0,3,4,2,3,0,5,1,4,5,0,5,0,3,39,2,2,0,2,17,1,6,3,2,0,2,4,4,1,2,0,3,0,0,2,11,3,1,0,0,4,1,0,0,6,0,0,17,3,6,3,3,4,1,0,2,4,0,0,11,1,5,7,0,0,0,4,0,1,5,1,2,0,3,4,0,1,1,6,1,2,5,1,1,3,1,1,2,19,2,3,8,0,1,1,6,0,7,0,1,1,3,1,6,3,0,4,3,2,0,1,0,2,0,1,0,1,5,8,1,1,3,6,2,2,3,11,4,1,3,2,0,2,11,0,4,2,2,2,1,12,2,7,4,0,12,4,1,1,11,2,5,3,0,2,11,10,2,0,3,6,3,8,0,0,0,1,6,2,1,2,0,4,4,0,1,3,9,2,0,1,1,2,5,2,0,3,0,0,6,2,1,3,3,3,0,4,2,4,1,1,2,1,6,3,2,13,4,0,5,3,0,0,0,1,3,0,2,3,1,2,1,3,2,1,3,0,1,0,1,3,5,0,3,2,7,2,0,3,0,2,10,0,3,2,18,4,1,9,9,7,10,5,5,2,3,2,4,3,2,0,0,3,2,2,2,0,1,4,8,7,4,1,11,3,0,1,2,1,1,7,1,0,1,8,0,1,3,2,4,1,9,2,2,3,0,1,0,3,2,0,1,0,1,4,4,1,6,1,1,4,0,0,0,0,4,0,2,9,6,2,0,1,1,12,3,3,0,5,0,1,3,2,0,0,2,3,2,3,0,6,0,1,0,0,16,2,1,0,6,3,5,0,2,1,1,2,2,8,4,4,4,1,0,0,12,0,3,7,0,2,0,3,3,2,8,0,0,1,4,1,0,1,0,1,2,6,3,1,0,1,4,5,3,0,5,0,3,0,4,5,1,1,3,3,3,10,3,4,0,3,2,2,3,3,0,1,1,0,2,0,0,1,0,5,0,1,3,0,0,4,0,0,3,0,0,4,5,2,3,2,3,0,1,1,20,0,8,7,1,5,2,1,0,2,0,2,3,7,3,0,0,2,1,7,5,0,1,0,4,0,8,4,3,11,10,0,8,1,2,4,0,6,6,3,0,4,2,3,0,4,3,8,196,1,1,0,10,1,6,2,0,0,13,3,0,0,1,2,5,4,1,1,3,5,8,1,3,0,4,10,2,0,2,2,1,3,7,11,2,0,2,0,1,0,2,0,1,4,1,3,0,1,0,5,0,1,1,0,1,1,0,0,0,4,3,7,2,2,6,4,0,2,5,1,2,1,2,2,3,3,0,6,0,5,9,0,3,1,3,3,1,3,1,2,1,1,4,0,0,2,4,0,3,7,5,1,1,0,1,1,2,0,0,17,1,1,0,0,5,1,0,1,7,0,4,2,6,5,1,1,0,0,2,2,3,0,2,3,0,2,4,0,1,4,2,0,6,9,1,1,1,0,2,2,3,4,2,3,0,9,0,0,4,3,1,3,1,6,2,2,0,0,2,1,3,0,1,5,1,2,0,5,5,20,3,1,1,10,0,1,3,2,8,0,2,0,4,0,5,1,2,1,2,3,5,0,7,0,0,1,0,2,0,0,2,0,0,0,0,0,3,0,0,2,1,4,0,0,7,10,0,2,0,1,1,0,4,0,0,0,0,0,3,0,2,1,0,4,2,3,4,9,2,4,0,0,0,4,1,0,3,12,0,2,0,1,2,4,1,0,0,2,0,0,1,2,1,1,0,1,23,2,1,0,5,4,1,4,5,2,0,2,1,0,2,0,0,3,0,1,0,2,1,7,15,2,0,3,2,1,6,0,1,1,2,2,0,2,0,0,1,0,1,2,6,1,2,1,1,0,0,1,0,0,1,6,0,3,3,3,4,4,5,5,0,1,0,0,2,1,5,3,2,2,2,1,0,0,0,4,1,2,4,1,0,4,1,1,0,0,2,2,0,0,7,7,9,0,1,2,0,2,0,1,2,1,1,0,0,1,1,4,4,2,2,0,0,6,1,3,1,0,5,3,2,1,0,0,0,2,1,4,8,3,2,1,1,1,2,2,1,2,1,3,2,2,0,1,0,3,0,3,0,0,0,1,1,0,2,0,2,1,2,7,3,5,0,0,3,2,7,2,0,0,1,0,0,0,0,2,2,4,0,3,7,1,1,2,3,0,0,1,4,5,0,2,6,1,0,3,0,10,2,0,9,3,2,0,3,3,0,25,3,1,2,0,0,13,0,3,0,0,2,0,0,3,0,1,7,0,1,0,1,1,0,2,3,1,4,0,0,13,0,2,0,0,146,1,0,0,0,0,0,1,3,5,2,2,0,31,0,5,5,0,0,2,6,0,6,1,1,2,2,0,0,4,1,2,0,1,2,0,5,1,3,0,4,0,2,0,1,1,2,0,1,16,0,0,2,4,1,0,3,0,3,0,2,4,1,2,0,1,2,4,1,1,2,0,1,0,2,1,1,3,5,157,2,0,2,4,2,1,0,1,2,0,0,2,0,0,0,0,5,3,1,1,2,0,3,1,3,1,6,1,2,0,0,0,0,2,1,1,0,3,1,7,0,1,9,1,6,3,0,1,1,0,0,0,4,1,0,3,1,0,4,0,0,11,0,1,1,2,0,0,4,8,0,0,0,0,10,1,2,0,8,0,0,0,2,0,1,1,0,0,1,0,3,2,2,1,0,1,1,2,1,0,5,0,1,0,4,2,0,63,0,1,0,0,1,5,1,0,5,2,1,1,4,8,0,0,3,1,0,3,0,54,1,1,3,1,3,0,0,1,0,0,0,0,4,0,6,2,0,1,4,1,0,6,7,1,2,2,3,0,5,2,1,1,2,2,1,21,3,0,0,0,2,3,1,4,9,0,7,0,3,3,0,0,0,1,0,0,0,0,2,0,1,3,0,5,0,0,0,0,0,1,7,0,2,1,0,75,0,2,0,1,0,0,4,0,0,6,1,0,0,1,0,0,3,0,1,0,1,2,7,0,0,0,0,2,5,0,3,0,0,2,0,3,1,2,1,1,6,1,0,1,0,0,1,0,0,1,0,0,0,1,2,0,0,1,1,2,0,0,1,0,2,2,1,1,4,2,0,1,9,0,0,2,0,0,0,0,1,2,1,3,4,0,1,1,1,2,14,0,3,0,0,2,0,2,0,1,3,0,0,2,2,0,1,2,2,2,3,0,0,0,0,0,2,1,4,0,2,0,2,31,1,1,2,2,3,1,2,1,0,4,3,1,1,0,0,0,3,0,2,0,1,0,0,0,2,0,0,1,1,5,5,0,2,11,0,3,0,0,2,2,3,0,0,4,7,2,5,3,0,2,0,0,1,4,26,3,3,1,1,1,0,4,1,4,3,0,6,0,0,2,0,2,1,0,0,0,0,0,1,0,2,1,0,1,4,1,0,2,1,0,1,1,0,4,1,1,2,0,0,1,1,0,0,0,2,1,1,0,6,0,2,3,0,4,0,2,1,5,0,3,2,1,0,0,0,1,0,0,5,2,5,2,2,0,3,1,0,3,1,1,0,0,1,0,2,2,0,0,0,2,5,0,6,0,1,0,2,0,2,0,1,0,1,8,15,0,0,1,6,2,2,4,1,0,1,4,0,0,3,0,1,1,0,4,0,3,1,1,1,0,1,0,3,4,0,6,2,0,0,2,0,1,0,0,0,0,0,0,1,1,1,0,5,2,0,3,0,0,0,0,2,2,1,0,4,20,0,3,1,0,0,1,0,0,1,4,1,0,0,3,2,1,2,4,3,0,2,0,2,2,1,0,2,1,0,2,2,0,0,1,0,1,3,2,0,3,1,2,2,1,1,0,1,5,1,3,0,0,1,1,0,0,0,6,0,6,0,0,0,2,2,0,0,2,0,1,0,0,0,2,0,0,0,4,0,0,3,1,1,1,0,0,3,6,1,1,1,0,0,6,1,1,1,3,0,1,0,0,3,0,1,0,1,1,0,1,0,1,0,0,6,0,1,1,0,1,1,1,0,0,4,0,0,3,3,0,1,1,0,0,0,5,2,2,1,1,1,2,2,0,4,0,1,0,0,1,5,1,2,3,6,3,2,6,1,9,0,6,1,0,4,1,0,0,1,0,0,1,0,2,1,2,2,0,0,0,1,6,0,0,0,1,0,3,3,0,0,0,0,3,1,0,1,0,1,0,0,4,2,1,1,0,1,0,3,2,0,0,1,2,0,0,4,0,0,1,1,2,4,0,5,4,0,3,0,1,0,0,2,4,0,2,0,0,1,0,2,1,3,0,1,2,1,0,3,3,2,2,0,2,3,2,1,3,0,0,0,1,0,2,1,0,0,0,1,0,0,1,0,5,2,4,0,7,0,0,0,1,0,1,1,2,1,0,0,5,2,0,3,0,0,7,2,0,1,1,3,0,0,1,1,0,1,2,5,0,0,0,3,1,3,1,3,0,2,0,0,0,0,0,0,1,1,6,4,0,0,0,0,0,0,0,0,1,0,2,0,0,2,1,1,1,0,4,1,2,0,3,1,1,0,4,1,1,0,0,0,0,0,2,0,0,1,2,0,3,2,6,0,0,2,0,0,1,0,0,4,0,1,0,6,12,0,0,1,0,0,0,1,0,2,1,0,6,0,0,1,2,0,2,1,0,0,0,1,0,9,2,0,0,0,51,2,0,10,1,3,1,3,0,0,1,0,0,0,0,3,0,1,1,0,1,0,0,0,0,9,2,0,0,0,7,2,0,0,3,4,1,2,0,2,12,1,0,1,0,0,3,1,1,1,0,1,2,2,7,9,0,0,3,0,1,0,0,0,0,2,6,2,0,2,0,0,0,0,0,1,0,0,0,0,0,0,0,1,0,2,0,1,1,1,1,0,0,3,6,0,0,2,0,1,4,4,0,9,2,2,1,0,0,1,1,1,0,2,1,2,3,0,1,1,4,1,0,0,2,2,1,0,1,0,2,1,3,0,0,4,1,3,0,1,2,2,0,0,0,1,4,0,8,2,0,0,1,3,0,0,1,0,0,1,0,1,3,2,0,1,1,4,1,0,2,0,1,2,0,2,2,2,0,0,0,1,2,1,0,0,3,2,1,1,3,3,0,7,3,0,0,1,1,1,0,0,0,4,4,0,0,0,0,1,0,0,0,0,1,2,1,0,0,0,5,0,0,0,0,2,2,2,0,0,7,0,1,0,3,1,2,0,0,2,0,0,3,1,3,1,0,1,1,1,1,0,0,0,0,1,7,0,0,0,0,0,0,0,0,1,3,1,1,3,1,1,1,0,1,0,1,2,0,3,2,1,1,1,0,1,2,1,0,0,0,0,6,1,4,1,0,0,1,0,0,0,3,0,0,0,2,0,0,3,7,0,0,0,1,0,2,2,2,1,0,1,1,0,0,0,0,0,5,0,2,0,0,4,0,2,0,3,0,0,1,1,0,1,1,0,1,0,0,0,0,0,0,0,0,0,1,2,0,0,1,3,10,9,0,0,0,1,2,6,1,1,1,1,0,2,1,0,6,0,4,0,1,1,0,0,0,3,1,1,0,1,1,2,0,1,3,0,6,5,1,0,4,2,5,0,2,2,1,2,4,0,0,0,0,0,2,0,1,0,0,0,0,0,0,0,1,2,0,0,0,0,1,0,0,2,2,1,0,0,0,0,0,4,2,3,0,1,3,1,0,0,0,0,16,0,1,2,4,0,0,1,1,0,2,0,0,2,0,0,1,0,0,0,0,0,1,3,1,0,1,1,0,0,0,1,0,1,0,3,1,1,2,0,2,1,2,0,0,2,0,0,2,0,3,1,0,0,0,0,0,0,0,23,0,1,0,2,2,2,1,0,0,1,0,1,0,0,0,0,0,0,2,2,0,2,1,0,0,0,0,1,0,0,0,4,0,1,0,0,1,0,7,2,0,1,2,0,0,6,2,8,1,3,0,0,0,0,0,0,2,0,0,2,0,0,1,2,0,6,1,0,0,1,0,3,2,0,0,0,0,0,4,1,0,0,0,0,2,0,0,0,3,1,0,2,1,0,2,3,0,1,0,0,1,2,0,2,1,1,1,2,1,0,4,1,0,2,2,0,1,0,0,0,0,1,3,0,0,4,0,2,0,3,0,8,2,4,5,0,0,0,0,1,1,2,0,0,1,0,0,0,5,0,0,2,0,0,3,0,1,1,1,0,1,0,0,0,0,0,0,0,0,0,1,0,0,0,1,3,2,0,0,0,1,0,0,0,0,0,0,0,0,1,0,0,0,0,0,0,0,0,0,0,0,0,0,2,0,2,1,0,0,1,0,1,2,0,0,0,0,0,0,0,2,1,0,0,13,0,0,0,0,0,0,1,0,0,0,0,0,0,0,0,0,0,0,0,1,0,0,1,0,0,0,0,0,1,0,0,0,0,0,0,0,0,0,0,0,0,0,0,0,0,0,0,0,0,0
"1998 Clancy, Tom, Rainbow six",pop,18762,8141,8496,7026,5664,2077,3865,4505,4557,3808,2275,3749,4338,475,663,2369,2685,2112,2541,832,1576,2226,1838,1088,364,1447,438,2047,1078,1058,1217,914,1213,1679,1599,1530,1443,1279,1214,1374,791,807,1138,755,934,417,767,1164,1216,915,638,1378,704,684,796,692,899,680,979,753,613,230,575,722,410,607,1143,601,587,498,552,172,613,461,385,620,697,553,616,610,534,324,457,559,494,281,369,485,455,431,201,277,394,264,310,297,288,359,681,337,323,410,268,507,636,592,301,189,215,371,247,108,323,234,370,258,271,840,318,915,624,436,295,216,224,463,213,231,338,190,306,246,303,259,180,384,246,161,271,279,119,215,849,112,196,100,321,302,249,278,197,378,252,334,210,170,147,139,393,376,300,67,299,246,130,189,236,173,297,214,34,213,304,101,162,200,190,225,150,255,170,137,393,138,128,104,228,82,212,190,108,340,309,253,99,118,44,253,45,325,109,120,204,210,151,130,270,102,154,105,35,124,228,150,111,54,86,67,164,78,152,240,274,88,197,72,112,194,239,260,123,70,77,149,129,69,36,129,45,179,98,100,171,89,191,156,211,77,89,106,213,48,124,200,103,120,123,134,59,266,101,141,173,127,193,35,174,111,204,162,51,44,117,183,74,127,58,95,81,227,78,50,56,84,127,59,72,53,133,143,94,42,214,51,105,169,69,195,27,83,238,51,435,174,14,78,159,41,81,40,213,26,82,251,168,76,256,58,160,136,94,272,57,47,27,55,37,188,70,64,150,49,124,93,49,118,62,98,66,79,51,71,53,166,59,120,71,198,70,122,125,65,64,115,31,34,193,182,147,48,145,151,88,56,126,39,118,60,149,77,37,98,204,25,253,18,64,97,29,66,70,48,173,82,106,236,0,47,49,43,15,22,41,249,86,74,25,49,138,227,33,54,51,36,94,86,48,215,60,30,55,30,32,32,26,127,67,53,91,97,80,7,16,135,84,128,83,48,82,35,61,63,47,34,44,66,23,33,150,66,107,94,82,89,17,176,17,92,169,99,47,22,90,90,70,76,39,22,28,60,71,4,0,69,59,158,5,147,34,154,53,40,41,40,52,122,74,212,0,72,91,95,43,89,51,38,86,19,71,115,38,138,53,77,107,9,62,41,31,62,46,124,112,60,93,56,318,75,48,63,108,16,58,15,84,62,0,50,19,75,43,20,74,92,80,113,20,38,48,128,681,27,34,21,26,59,71,123,75,24,11,57,76,69,22,20,0,68,111,76,102,67,63,187,11,72,49,85,74,29,48,49,59,18,35,88,39,35,33,54,38,71,94,35,44,95,53,3,24,20,17,69,43,14,6,27,34,95,44,113,50,61,19,49,81,16,7,15,37,29,67,6,55,69,48,11,1,21,30,61,42,0,22,47,2,50,27,41,44,12,31,50,16,70,21,99,34,42,23,47,30,27,58,20,113,0,29,30,45,26,104,22,60,26,174,45,108,59,58,18,0,14,24,42,25,3,24,59,39,156,92,32,34,58,103,41,8,13,22,17,50,27,69,21,67,41,24,43,32,42,61,87,99,24,102,47,2,39,40,65,67,29,19,41,8,48,96,68,47,79,26,72,6,46,65,36,42,23,104,11,38,18,12,34,39,26,27,25,11,38,48,100,35,18,33,41,73,16,53,58,40,17,14,23,0,13,22,13,41,40,20,33,99,4,10,10,35,17,60,158,17,31,15,41,176,2,68,23,16,63,86,20,38,18,44,57,31,25,33,91,35,83,22,16,0,52,16,16,20,75,7,20,37,33,13,44,14,37,23,54,6,17,50,16,36,19,162,49,3,43,49,8,48,42,65,17,1,109,45,41,36,22,12,42,50,16,32,8,14,4,29,7,116,50,43,58,45,56,72,61,77,43,21,19,156,28,19,36,0,13,11,11,6,9,5,21,50,0,10,85,13,4,2,101,31,9,13,45,3,16,23,18,50,25,77,23,6,4,16,20,37,31,15,58,3,9,35,28,15,29,31,10,15,31,31,20,15,24,34,19,67,50,15,79,14,28,38,67,38,8,147,116,30,66,70,39,32,93,13,55,46,0,11,0,37,26,23,42,93,17,24,25,41,58,44,12,21,3,74,22,35,22,14,39,32,5,32,0,23,17,17,54,38,12,44,41,75,26,34,38,46,26,19,11,73,4,0,13,19,18,0,17,8,34,35,10,16,38,37,50,23,12,33,31,70,17,23,45,28,127,2,7,34,24,31,58,15,115,103,8,11,19,26,19,6,22,19,32,9,0,36,0,30,27,28,11,0,2,56,4,43,75,53,0,15,81,33,0,35,25,172,72,37,15,247,35,23,6,123,35,26,25,10,11,51,18,35,1,45,9,9,30,42,40,17,14,14,5,42,61,32,34,4,31,18,0,29,17,30,2,89,23,0,34,30,13,23,35,0,0,0,104,21,32,31,13,50,0,38,46,34,3,29,8,85,12,39,39,48,10,23,0,54,21,23,18,31,43,10,34,19,12,16,11,35,14,15,20,47,26,12,40,14,10,0,1,66,16,6,11,5,9,174,18,46,9,12,9,40,61,29,5,24,1,9,30,14,65,16,14,4,122,27,34,46,11,8,43,16,112,8,37,26,27,17,25,77,56,84,32,30,41,22,7,0,20,1,17,3,12,6,52,18,6,26,2,5,5,47,0,6,17,10,28,13,8,0,16,11,0,37,123,0,24,18,9,11,4,3,42,6,0,69,32,7,51,2,19,12,17,0,13,19,1,50,0,0,4,13,40,50,9,58,5,14,3,16,25,5,11,26,35,23,32,8,0,24,54,14,37,19,72,24,0,127,421,0,38,33,24,55,3,19,24,35,9,12,14,70,9,12,0,31,37,1,28,12,5,32,16,0,10,58,21,0,14,26,4,0,6,20,12,15,41,34,15,30,14,38,17,0,30,49,7,57,17,8,6,4,25,9,13,19,79,48,10,28,18,1,38,4,2,14,26,15,36,14,5,11,18,14,22,34,0,27,6,13,3,53,26,1,9,33,39,20,7,111,99,12,21,27,0,6,59,8,164,51,16,39,36,6,55,9,2,5,31,5,35,44,20,29,11,22,0,30,164,60,141,7,20,24,12,5,3,13,0,0,11,0,65,70,0,37,3,15,27,23,33,12,59,52,4,9,1,4,7,17,94,7,74,0,7,0,6,0,15,8,0,15,2,43,12,4,38,0,53,2,55,71,6,4,11,8,19,29,15,16,29,53,29,46,11,0,0,31,10,1,46,8,55,24,31,55,24,8,2,42,13,54,38,27,6,0,6,8,0,6,13,2,0,8,45,13,0,0,15,13,0,8,8,67,26,11,23,0,144,5,20,7,9,17,26,5,2,3,10,8,19,3,3,32,23,9,13,4,7,0,2,10,26,28,0,149,0,0,27,0,13,37,3,19,1,13,15,5,27,53,0,51,34,8,13,6,2,12,46,5,15,77,11,24,14,34,21,10,60,27,5,22,10,31,14,6,17,5,9,9,1,5,44,19,24,7,26,3,7,6,15,10,6,26,9,17,50,16,83,59,0,20,30,7,14,14,0,11,14,12,25,12,26,8,13,18,21,17,57,17,15,0,10,0,12,2,54,18,11,32,0,5,37,23,40,0,8,40,9,9,25,11,14,23,49,10,0,30,6,0,16,0,5,29,26,5,0,15,22,10,1,25,9,8,19,2,4,16,1,18,13,34,8,35,121,7,23,3,56,14,3,29,54,20,21,3,2,3,23,5,15,6,86,11,15,12,4,5,26,13,0,8,5,12,30,15,3,7,13,30,12,14,11,0,9,37,13,23,1,10,11,16,10,16,0,9,7,2,23,7,59,6,0,10,2,4,20,15,18,11,34,0,65,15,10,1,61,9,5,37,9,51,24,26,13,1,2,7,98,19,2,8,3,55,2,17,3,9,10,4,29,7,10,25,9,8,5,0,36,11,4,9,7,18,35,11,19,2,7,0,7,4,10,7,8,18,12,15,2,4,7,21,0,12,87,1,10,1,16,1,42,25,21,6,0,13,9,4,8,6,23,20,7,17,4,2,20,29,16,14,9,15,23,1,11,13,43,6,25,3,22,1,7,17,1,9,27,30,19,12,1,6,10,4,17,0,0,12,10,16,9,0,0,3,12,10,4,41,4,31,9,0,10,10,2,3,38,3,0,25,11,8,1,8,12,16,2,163,8,2,22,20,23,3,5,21,12,8,9,59,6,0,16,15,47,11,34,9,13,4,9,4,7,0,4,5,2,6,9,25,15,16,3,3,5,0,8,16,8,17,162,0,15,0,94,7,14,0,11,27,139,15,41,0,11,1,0,15,27,6,16,9,31,3,7,0,28,4,16,18,23,7,62,1,4,0,11,20,0,20,7,0,0,23,81,11,20,146,16,5,1,5,1,24,25,39,12,15,6,0,14,0,10,12,36,5,6,32,15,6,91,6,7,13,6,22,0,2,23,0,1,11,8,9,16,15,3,40,6,4,6,23,61,68,18,5,16,20,14,6,6,39,27,4,60,10,6,41,13,10,13,2,10,6,4,23,12,15,18,9,30,10,9,19,9,16,4,3,0,11,2,15,0,9,17,36,2,0,48,1,125,3,5,16,36,5,0,1,5,46,11,1,14,21,6,12,4,48,2,12,6,5,8,13,32,6,5,22,5,14,14,4,3,32,0,14,32,0,1,0,1,1,45,12,6,7,27,9,2,11,0,28,3,3,5,1,7,26,3,3,2,5,15,158,0,10,2,38,26,0,8,11,14,0,20,4,13,14,6,4,23,0,0,40,0,13,3,0,0,38,28,8,3,15,15,3,1,0,42,16,16,27,13,7,24,2,2,1,1,14,1,0,18,1,9,10,0,4,0,3,6,2,17,0,9,57,21,22,20,5,1,7,29,6,1,49,0,6,5,0,3,0,150,11,0,0,74,2,9,4,31,2,3,10,17,17,32,4,0,84,10,10,31,2,10,22,9,7,17,0,4,13,7,5,5,21,7,7,155,19,8,9,36,14,33,5,44,3,30,18,36,7,13,1,8,109,41,11,6,5,0,3,0,11,1,5,2,3,13,4,6,6,6,25,18,8,4,25,2,1,2,12,4,2,88,5,54,30,11,8,21,19,2,4,644,17,7,0,22,19,5,0,9,0,11,6,14,19,15,10,18,10,3,4,11,2,5,16,16,1,0,7,13,3,17,14,4,4,18,9,22,1,15,5,3,8,5,3,13,19,19,1,12,5,2,0,0,5,4,5,2,22,16,0,4,3,0,2,9,27,7,7,3,26,3,6,46,51,16,7,11,44,23,4,16,1,4,2,36,1,7,8,10,6,20,4,1,34,2,7,8,0,22,0,0,2,34,0,0,2,10,11,11,0,16,1,16,8,0,22,1,20,6,8,25,21,3,21,8,6,39,2,3,2,2,8,0,5,1,1,20,7,3,14,7,2,19,9,9,2,1,0,4,32,71,33,2,4,0,1,4,6,0,13,3,2,4,8,4,5,3,8,30,0,1,16,7,47,0,1,4,23,10,6,4,26,8,0,6,5,2,14,39,3,2,4,5,0,13,15,1,6,13,0,8,10,5,12,1,2,14,3,9,16,0,16,14,0,11,1,0,0,7,2,1,2,8,12,13,1,21,2,2,74,3,3,9,42,5,0,0,40,1,12,14,1,15,0,3,4,5,7,12,6,0,21,10,18,8,0,2,8,27,7,39,5,6,23,1,5,3,4,12,9,0,17,14,10,3,3,8,7,1,48,38,0,8,7,12,5,1,0,16,9,1,13,7,6,23,13,19,42,80,5,0,0,10,0,0,1,6,0,33,24,0,18,8,7,3,13,7,0,11,17,10,23,3,2,20,1,2,7,8,2,0,1,7,12,4,1,14,13,4,5,1,5,11,8,24,9,5,6,2,8,30,17,2,19,3,13,0,18,4,21,13,0,9,15,11,11,22,9,0,10,12,0,2,2,1,4,12,38,0,1,19,1,15,8,2,0,3,19,12,9,5,14,5,2,12,7,3,43,20,1,41,27,8,9,38,5,4,7,0,0,4,57,8,0,2,0,10,0,3,6,0,23,11,7,0,15,4,2,0,0,4,32,9,2,10,57,18,4,3,24,21,21,5,0,5,0,11,12,0,28,5,5,0,5,2,5,0,0,0,6,0,9,21,7,24,12,23,24,4,7,1,68,14,20,0,3,10,0,2,0,0,12,21,0,9,1,0,11,6,29,13,4,9,0,4,2,33,7,1,11,3,0,17,5,0,14,2,4,2,14,30,2,10,3,38,21,1,25,18,10,13,3,14,11,1,20,2,1,9,19,5,1,0,0,0,0,51,5,7,23,5,29,2,7,9,4,1,2,3,2,8,4,16,5,5,8,4,6,10,13,5,4,5,2,5,18,7,3,0,11,9,2,52,11,5,0,26,2,0,2,0,7,45,6,3,10,23,17,42,159,7,30,8,0,38,0,5,18,1,23,7,2,2,2,9,10,0,6,0,26,12,2,3,2,0,8,4,3,1,0,13,43,106,11,2,2,5,15,1,26,3,9,0,13,4,0,0,19,44,4,2,16,14,8,22,28,27,22,5,0,2,4,5,0,8,3,3,2,12,0,6,3,41,7,1,4,5,0,1,0,3,21,10,8,2,10,6,11,0,1,0,29,0,2,12,118,17,6,0,42,0,4,0,11,4,0,2,6,15,0,6,10,2,2,1,6,3,95,4,0,587,2,9,8,0,9,10,0,6,0,0,0,8,3,4,6,8,0,11,7,0,0,1,27,27,4,0,42,8,0,3,5,13,9,1,0,12,14,2,20,7,21,3,0,12,2,7,3,1,0,5,34,13,9,11,1,13,18,12,1,0,4,3,16,1,3,20,2,2,1,5,9,1,0,15,6,14,4,17,0,9,0,6,6,0,2,17,4,0,13,0,10,10,4,10,22,7,19,5,2,13,47,12,31,5,0,5,8,84,1,0,12,3,1,20,15,26,11,17,4,9,0,24,7,3,23,1,29,27,16,3,0,0,0,4,9,7,4,7,3,3,8,6,20,5,0,6,0,4,0,4,0,23,10,13,7,1,0,5,4,12,0,40,6,2,0,1,8,2,13,2,5,1,6,31,0,1,1,23,0,13,14,1,7,12,1,3,18,40,3,0,0,17,12,4,0,15,1,10,4,0,9,12,0,6,0,0,2,2,0,7,10,0,3,22,0,4,11,8,6,562,9,4,4,0,10,0,37,1,5,1,37,17,5,6,1,0,2,25,18,2,0,49,26,2,0,9,2,14,33,0,1,2,7,13,8,6,5,0,1,2,2,0,0,27,2,35,2,1,0,9,0,0,24,10,5,21,9,1,7,6,37,1,3,0,5,5,2,7,1,11,4,3,22,5,27,80,0,2,2,5,3,12,4,1,0,0,0,4,0,1,2,3,1,4,5,7,12,16,4,1,10,1,11,7,20,2,4,17,0,2,112,2,3,0,4,8,7,0,10,6,14,3,7,2,1,17,2,9,6,8,0,9,0,10,5,11,5,20,10,4,21,3,10,3,0,0,1,5,0,2,9,3,22,10,6,9,4,10,12,0,7,2,2,4,4,1,3,0,16,5,7,5,5,15,1,3,11,0,4,1,0,3,4,6,6,2,0,0,1,0,17,48,6,2,8,26,0,2,2,13,10,12,16,8,0,10,47,1,1,2,11,5,5,1,10,9,5,5,72,0,10,33,3,7,1,5,2,1,18,3,8,12,1,0,6,15,0,2,23,59,0,0,1,0,32,2,1,16,19,0,2,5,13,11,1,0,2,0,1,38,5,0,5,22,10,1,4,5,1,5,3,8,2,0,16,11,0,1,3,11,37,2,3,14,6,125,8,4,0,9,0,19,4,6,2,1,0,14,5,0,0,9,10,7,1,0,11,0,5,0,15,2,19,4,7,16,3,23,3,15,0,1,3,6,13,8,18,9,3,8,6,14,9,9,15,15,2,5,0,9,4,4,1,20,2,0,2,8,9,0,0,3,1,49,7,2,3,2,4,10,14,13,15,5,3,13,24,5,15,7,0,9,2,0,4,1,2,3,6,2,8,4,3,0,3,1,4,0,5,10,5,1,1,5,7,4,18,4,4,0,1,14,1,9,0,21,2,5,14,0,1,27,4,3,11,2,3,3,8,4,4,3,0,2,9,0,1,4,0,6,3,1,0,12,16,7,0,0,0,6,1,4,0,0,10,8,2,7,14,12,4,3,15,28,0,0,7,1,13,4,5,0,2,12,16,0,7,1,5,1,1,0,11,3,4,2,22,0,0,5,5,24,1,13,2,4,1,3,5,10,0,0,0,5,0,33,2,13,1,18,0,24,9,6,6,8,7,4,3,0,6,7,5,4,0,2,11,5,5,3,4,7,1,0,7,53,1,5,0,1,1,6,18,3,5,0,3,0,2,3,2,17,1,12,6,8,2,1,0,1,29,6,2,1,15,3,3,0,7,3,5,2,0,2,2,0,17,0,6,9,26,19,3,8,0,0,5,4,0,4,20,0,14,11,0,4,0,103,13,9,2,5,58,8,0,13,3,17,1,6,4,1,0,4,5,7,5,10,2,3,0,9,4,2,1,0,21,1,5,1,4,2,0,14,7,2,8,3,1,20,4,9,4,12,1,3,4,7,7,3,3,1,8,0,0,0,7,5,0,2,0,1,0,5,3,2,23,2,30,1,5,3,0,7,0,0,46,5,0,3,21,0,6,8,0,5,13,7,4,6,0,13,16,9,3,5,4,0,2,9,2,11,17,8,58,1,4,6,1,0,2,0,0,1,11,9,3,0,3,1,0,5,2,1,0,2,2,4,23,5,0,40,9,6,9,2,88,0,3,2,1,1,0,19,11,6,29,0,6,0,0,1,1,3,9,0,6,1,3,11,5,2,0,0,18,2,2,5,2,6,43,3,1,3,15,13,7,5,25,2,0,0,1,5,1,6,9,0,2,0,13,8,0,3,0,5,3,0,2,0,8,0,4,24,0,5,9,2,18,2,29,6,4,2,2,2,4,3,2,1,13,0,6,2,9,4,0,0,5,4,1,2,17,3,1,0,5,12,2,2,0,0,1,2,1,5,2,7,7,0,3,0,1,17,3,14,6,0,11,16,0,13,3,4,3,1,0,3,1,1,6,5,0,1,7,1,4,1,2,1,0,6,0,6,4,7,2,2,5,1,11,2,1,13,3,8,0,1,2,10,6,4,8,4,0,4,3,0,3,8,1,20,7,0,0,5,1,0,1,21,0,2,7,0,8,1,4,4,4,14,3,0,4,0,2,2,0,0,68,0,0,1,0,1,2,0,1,1,8,19,0,5,7,1,5,0,1,1,2,1,12,22,0,5,0,8,6,12,0,6,1,3,0,3,0,4,0,55,2,1,5,5,29,0,0,0,7,0,1,9,42,0,3,3,15,6,2,3,3,0,4,5,13,0,55,0,4,1,0,12,9,2,6,0,17,0,7,1,2,2,5,0,3,5,2,0,5,16,0,4,21,0,4,6,0,87,1,10,1,4,43,4,2,6,1,0,2,15,4,1,7,1,0,2,0,2,1,1,0,3,2,6,4,18,0,5,4,3,0,9,2,2,6,3,0,3,3,5,4,3,3,1,10,12,4,3,9,5,2,0,333,10,3,7,1,6,1,5,2,6,0,0,2,0,6,0,0,1,7,23,22,0,1,12,2,0,1,2,2,7,26,0,14,1,7,0,0,0,4,1,4,0,1,17,2,8,10,0,7,2,7,7,0,0,0,1,0,0,5,2,2,7,13,10,7,2,1,0,4,0,5,0,20,2,18,3,1,1,11,1,5,2,1,64,2,0,5,1,9,16,2,19,8,2,18,4,0,5,2,10,0,4,1,6,0,1,4,2,4,0,8,1,9,8,5,22,13,1,4,3,3,8,2,3,6,8,10,38,6,2,0,0,2,3,1,0,0,0,4,1,0,1,11,2,6,0,6,2,3,0,0,0,0,13,12,9,9,4,0,13,4,7,5,0,1,8,5,12,0,7,2,10,3,0,0,2,0,3,11,24,43,4,0,5,1,2,4,6,2,3,4,1,0,0,8,0,0,3,6,5,5,3,0,1,1,1,5,4,1,22,7,3,3,8,8,2,2,1,0,2,3,8,2,2,0,2,1,0,1,0,17,0,4,0,68,0,10,0,4,4,3,4,1,3,0,1,5,0,8,16,3,5,11,6,1,132,5,4,3,4,9,22,3,1,4,1,6,0,0,5,5,1,21,12,4,1,1,0,0,2,12,3,85,4,0,8,0,2,1,0,5,7,206,0,1,2,4,16,3,0,0,3,0,4,3,1,1,1,0,1,4,5,5,0,2,5,14,0,0,0,8,1,0,12,0,7,5,0,4,0,2,6,35,2,0,1,14,6,15,17,0,0,2,1,4,3,0,2,0,0,12,21,24,1,7,2,2,1,2,0,6,9,0,2,3,9,0,2,2,0,6,3,11,8,0,4,12,12,40,0,2,3,3,56,6,1,0,3,27,4,1,2,7,7,6,0,3,10,0,8,21,3,27,1,24,0,2,4,0,4,5,22,5,0,0,4,35,6,9,3,8,2,1,0,0,5,3,7,14,4,6,5,0,4,13,17,10,2,11,1,0,0,8,9,0,0,4,9,1,2,0,0,0,0,1,52,0,3,15,0,19,13,14,1,0,1,13,9,2,0,7,0,1,3,3,0,4,1,1,7,4,12,0,14,14,9,3,8,17,5,10,1,6,17,0,91,14,7,21,12,3,2,1,7,2,0,10,0,1,2,3,7,2,2,0,2,8,1,13,9,0,7,5,0,0,0,6,5,4,0,6,8,5,1,13,3,0,0,7,3,3,18,3,7,2,8,2,5,26,4,16,21,9,1,7,72,4,11,0,3,0,6,4,8,0,48,0,8,3,0,3,5,1,8,4,4,16,0,0,11,6,1,5,2,3,0,30,2,2,2,3,2,0,0,25,0,7,9,52,0,0,2,3,1,1,12,0,3,11,13,5,1,4,3,5,1,1,7,4,3,9,5,0,10,0,0,3,0,0,13,0,9,9,0,0,1,7,34,0,0,0,2,0,24,0,14,4,5,0,11,0,4,1,11,0,3,0,0,200,0,2,0,14,1,5,0,22,0,0,0,1,0,5,0,0,0,125,0,0,0,0,74,0,228,0,0,0,10,0,0,118,211,0,0,0,0,2,172,184,17,180,0,0,0,0,0,0,0,0,1,139,0,0,0,0,0,0,0
"1998 Folsom, Allan, Day of Confession",pop,10142,5045,3539,3323,3188,768,3286,2447,2877,2045,1044,1990,1109,571,621,1072,1920,899,997,453,1126,646,1123,1239,125,593,211,771,591,402,772,587,684,477,243,401,720,429,170,454,523,248,598,457,236,316,443,208,574,913,596,541,448,432,412,377,599,300,321,241,275,157,389,306,222,333,189,274,238,300,189,95,181,244,77,332,247,144,113,164,271,101,276,215,251,327,429,90,176,124,57,171,247,226,96,153,153,188,51,206,97,107,177,210,92,91,265,228,91,176,236,61,68,124,154,233,198,79,160,146,74,152,163,194,181,116,121,97,231,117,240,246,41,144,180,93,22,83,253,87,47,180,217,42,196,103,84,127,106,103,74,87,249,140,173,52,73,58,104,167,64,118,71,78,217,131,105,71,67,142,8,75,56,23,123,18,87,76,92,43,28,98,150,95,101,70,55,96,106,62,170,52,76,248,84,77,383,84,69,23,31,53,72,107,89,152,88,122,46,19,61,111,116,98,122,54,65,216,66,89,86,106,119,143,102,123,70,50,42,18,181,112,115,138,89,68,51,116,111,45,65,17,137,84,120,34,78,114,96,74,22,161,85,118,73,67,26,46,91,53,65,13,6,85,37,21,96,14,62,111,52,237,27,80,38,47,29,93,65,78,53,55,42,25,82,90,96,53,55,44,82,4,127,43,87,42,59,75,3,30,12,36,23,59,36,13,23,0,97,18,72,7,52,57,17,54,69,38,52,23,25,31,60,6,25,80,48,25,16,88,69,28,77,100,63,47,33,27,46,78,96,30,52,55,51,74,60,7,33,21,35,80,24,25,82,40,21,44,84,27,80,51,40,19,25,67,18,88,13,23,31,33,52,24,45,38,40,37,5,11,108,14,54,19,77,260,0,40,14,47,11,32,29,3,65,62,27,56,33,55,11,32,69,23,88,14,54,1,57,49,36,88,15,18,47,35,22,72,34,10,31,0,1,49,49,37,43,43,21,12,32,25,40,20,33,61,52,29,0,37,50,80,6,44,27,75,188,46,21,51,56,54,17,59,11,20,31,5,47,36,1,184,0,65,42,30,63,71,6,56,28,96,40,0,58,31,41,55,0,46,23,22,26,47,5,15,85,17,6,23,43,44,37,23,19,75,86,52,11,10,40,57,29,41,38,21,36,31,22,23,58,25,53,17,24,24,0,27,7,28,39,11,19,1,27,47,9,27,21,5,4,23,50,5,31,2,33,11,106,10,15,28,8,33,56,49,0,3,53,2,77,19,9,4,21,24,36,19,11,72,26,21,55,0,15,13,9,28,7,35,14,5,11,14,8,44,18,46,19,3,41,21,29,20,0,11,14,22,9,26,50,36,45,12,12,1,22,63,15,23,3,9,30,12,7,0,1197,21,27,3,19,83,41,49,64,23,15,5,16,30,14,22,12,22,25,2,16,25,25,8,26,32,12,8,27,0,27,58,25,30,14,5,52,12,0,22,12,8,2,25,0,7,32,34,10,10,42,7,44,43,11,32,32,36,46,42,6,16,19,41,12,7,25,70,8,7,8,43,10,27,25,16,25,7,15,10,39,56,15,35,22,6,25,34,21,35,20,5,11,6,7,11,5,33,25,11,4,11,22,38,1,18,10,38,12,1,18,30,20,43,2,46,23,4,36,15,33,7,14,15,28,7,7,34,0,14,23,3,31,28,34,11,19,24,18,12,80,24,18,14,25,11,8,15,30,31,6,6,34,51,20,14,17,19,26,2,6,15,14,13,22,17,0,39,30,17,3,39,0,7,11,9,25,32,29,18,68,7,3,12,13,29,1,18,26,3,12,24,0,22,6,8,15,13,23,21,1,18,7,7,17,70,14,68,79,5,2,4,17,19,8,3,25,54,24,7,13,16,27,22,30,20,5,22,6,19,2,21,0,4,6,13,15,28,14,41,5,0,56,18,19,4,1,21,21,3,1,27,5,11,13,22,21,36,12,33,3,0,8,11,16,16,4,20,0,8,106,9,6,8,1,6,5,14,5,23,23,6,12,4,25,74,6,11,8,17,10,0,8,8,10,11,42,13,1,1,29,7,11,39,24,0,14,0,16,13,8,12,4,9,12,1,19,26,30,10,9,0,9,18,13,5,9,1,54,2,20,16,11,6,22,6,15,2,41,8,11,13,13,9,11,16,16,62,20,22,0,30,4,0,0,6,1,0,45,21,17,66,23,21,12,0,17,6,18,10,15,3,16,16,143,8,6,25,26,0,13,0,29,9,20,36,13,2,14,6,5,15,2,0,5,0,3,0,6,17,0,0,3,9,14,18,75,1,23,23,16,0,10,13,34,18,3,9,3,1,28,2,36,7,14,14,9,6,17,7,27,4,4,3,5,27,34,21,8,3,5,5,16,4,7,5,12,3,6,0,12,16,2,2,3,9,0,15,26,6,3,31,0,0,0,5,27,3,12,24,37,0,16,27,26,5,4,19,15,2,24,9,21,2,14,0,7,13,14,1,7,48,0,8,15,1,37,4,6,4,9,5,12,15,11,28,14,13,0,1,6,26,13,26,3,7,2,9,18,9,5,33,35,0,8,1,27,1,5,3,14,11,5,12,13,3,13,9,4,3,8,27,10,6,3,4,3,6,1,31,30,26,15,8,11,39,6,5,0,4,1,9,0,0,0,11,19,4,70,3,1,2,17,0,4,3,0,4,5,37,0,10,17,0,11,10,0,14,7,1,19,3,0,9,37,0,7,2,27,40,0,17,7,7,0,5,4,7,7,0,0,38,32,51,35,3,5,20,8,4,22,4,6,26,6,4,2,14,7,0,14,2,20,12,23,2,21,0,26,5,0,5,12,5,8,7,16,33,2,16,8,11,0,18,3,0,33,9,0,15,8,1,11,8,0,35,6,7,0,10,15,2,0,1,50,14,1,10,17,19,1,7,8,3,0,6,21,3,0,1,6,3,0,35,9,5,10,8,12,10,2,1,12,8,2,0,5,11,5,7,18,6,1,5,3,3,19,0,2,4,20,2,21,9,1,7,3,3,2,3,8,33,4,5,9,20,10,0,10,13,22,28,16,93,10,3,0,3,12,8,22,14,4,7,54,2,1,0,5,12,23,12,45,12,5,22,21,0,6,0,0,4,0,2,13,0,8,8,1,4,2,27,0,15,2,5,12,75,6,6,11,1,6,25,0,0,0,9,0,2,2,0,3,5,2,22,2,2,0,2,7,5,6,3,8,10,8,4,11,36,3,9,24,4,16,10,0,0,0,6,24,6,8,15,6,2,12,3,0,5,6,4,16,6,10,0,0,0,8,0,3,9,5,38,0,15,47,0,19,0,1,0,7,2,14,8,3,12,0,8,1,8,5,3,11,1,62,0,3,1,15,20,3,0,0,3,3,8,3,10,0,0,4,4,3,0,1,0,0,1,0,4,14,41,6,25,13,11,2,11,6,0,7,4,5,1,18,14,9,7,2,15,9,11,8,7,1,13,15,0,17,1,3,3,4,6,5,5,4,12,3,390,11,11,3,13,6,8,2,31,3,4,12,11,2,12,7,1,2,5,4,19,5,1,29,5,7,0,7,0,4,18,11,10,4,0,5,0,7,12,16,2,0,12,0,8,9,0,5,10,15,0,1,14,0,4,0,3,9,14,7,4,14,4,4,3,4,4,10,12,0,26,0,5,25,13,2,0,2,9,25,3,6,3,6,5,3,5,13,0,6,2,7,2,5,5,5,22,0,3,1,22,4,15,1,3,4,2,0,14,7,15,7,2,11,2,2,2,5,9,1,0,9,30,2,0,2,3,12,9,0,6,1,26,11,4,5,3,2,118,0,1,4,10,8,0,1,11,0,11,11,10,5,4,8,6,4,26,3,12,11,3,0,13,4,3,5,3,5,14,2,0,0,7,8,8,36,1,4,25,13,3,4,0,9,8,13,0,4,0,9,8,7,2,11,4,27,14,0,2,13,4,4,0,10,13,1,4,26,2,0,2,2,3,4,8,4,4,8,19,19,16,1,0,13,4,0,22,0,30,0,8,8,2,1,13,4,4,5,2,9,29,7,5,9,6,0,5,2,0,12,0,11,11,1,7,10,5,1,3,6,7,4,1,3,23,11,15,15,0,4,0,2,2,2,5,0,0,4,4,0,2,0,0,143,7,3,2,3,6,4,6,0,6,14,4,0,4,0,6,3,3,0,0,12,15,16,8,4,5,0,7,7,5,4,10,7,0,0,5,0,18,0,14,2,19,0,21,11,7,0,15,4,7,0,0,5,7,17,6,1,11,2,3,0,6,0,1,7,36,0,4,2,8,0,0,0,11,0,4,11,11,0,12,0,14,7,0,2,16,1,4,4,5,0,0,0,6,11,13,12,12,5,9,1,6,0,33,2,0,4,3,0,1,9,12,0,20,0,19,17,23,4,2,5,3,5,5,0,34,0,5,4,13,4,6,6,1,8,3,4,4,15,3,5,7,1,0,1,15,2,8,0,5,0,5,6,4,3,11,4,13,6,11,12,5,4,12,29,8,4,0,4,5,16,4,12,0,0,4,11,10,3,5,2,9,3,9,5,5,6,13,6,4,14,0,4,12,9,0,2,3,6,0,5,8,7,8,1,10,0,1,6,0,7,8,23,0,1,9,1,9,0,3,0,0,10,14,2,0,8,15,1,4,12,4,3,6,15,6,1,6,1,2,2,12,2,8,0,0,0,6,7,10,1,0,8,11,14,18,3,0,2,0,2,7,4,8,5,15,0,0,2,18,3,0,2,1,26,2,0,0,7,10,0,1,0,9,7,0,2,4,0,1,0,0,5,2,0,0,12,3,1,5,3,3,1,1,0,2,17,3,1,1,6,0,10,4,1,6,17,7,0,8,0,4,0,0,6,0,0,1,2,22,0,1,2,4,5,3,8,2,16,10,9,64,7,0,2,0,0,2,3,6,3,0,0,15,1,3,10,6,1,6,7,4,3,5,1,6,3,4,0,1,0,1,12,4,10,16,0,0,21,3,9,2,4,2,2,2,9,0,1,4,5,7,4,2,1,5,9,8,0,4,1,6,10,5,8,13,8,0,0,0,1,1,1,0,3,7,2,2,1,6,15,12,0,4,3,3,1,1,6,117,1,9,0,1,3,9,1,0,2,1,18,0,6,5,0,1,14,5,3,8,7,5,6,19,5,7,1,6,3,8,13,4,1,6,1,30,1,1,9,3,4,1,7,5,0,3,13,6,8,7,0,5,0,7,1,5,0,2,3,2,0,8,0,3,2,7,3,8,20,13,1,2,2,7,0,3,11,0,7,6,8,1,43,24,7,2,9,7,0,5,36,3,3,10,0,0,0,3,7,4,116,25,0,2,1,2,1,2,4,1,2,1,6,4,0,0,2,2,1,8,0,7,0,2,49,0,12,6,6,0,3,1,3,9,6,6,12,1,9,3,3,7,3,0,49,0,2,0,3,0,3,7,5,3,1,6,4,3,0,21,5,12,0,1,1,0,0,1,0,0,7,10,3,8,6,13,16,0,6,11,0,2,2,0,2,0,5,2,3,2,11,21,9,9,1,2,7,0,8,15,11,2,2,11,7,4,0,2,9,6,0,1,0,0,8,1,0,2,4,2,3,3,9,6,0,4,2,0,6,0,10,0,1,17,13,10,9,1,7,4,0,10,7,4,2,6,0,0,2,0,2,11,0,3,0,0,1,3,2,2,1,1,9,5,6,8,0,4,10,5,5,3,3,1,9,4,4,4,1,0,5,0,16,8,0,4,14,6,6,4,8,5,0,3,0,4,2,7,0,11,15,8,2,3,1,3,3,8,2,0,1,0,0,5,0,0,3,5,0,3,6,8,8,0,1,2,0,6,9,3,25,1,7,3,1,3,2,2,2,1,4,0,4,4,0,5,0,9,5,0,7,9,7,0,5,2,3,0,4,16,2,2,3,4,0,6,2,1,6,8,2,9,0,8,2,5,0,4,4,0,6,0,10,1,1,0,7,0,2,0,0,3,3,0,1,2,0,2,5,13,0,3,9,8,1,4,2,4,3,6,1,9,8,3,2,19,4,0,4,0,0,2,6,6,0,5,0,7,1,9,2,0,4,1,7,0,8,4,4,0,1,4,0,6,1,4,17,4,1,6,9,2,1,2,0,3,0,3,6,0,0,0,3,3,3,0,3,1,0,65,0,0,9,7,7,1,14,12,12,1,2,1,0,2,9,0,2,7,1,6,0,0,0,4,11,2,5,0,11,1,10,9,9,7,0,1,0,1,7,4,3,7,332,8,22,0,2,0,4,81,2,5,4,3,0,10,3,8,2,46,1,20,0,5,0,11,5,0,3,1,2,6,1,4,358,0,1,1,5,0,0,3,3,0,0,1,3,5,7,2,1,11,3,0,3,3,12,3,0,14,0,3,2,17,1,6,2,4,0,0,2,0,3,8,2,7,1,3,5,3,0,1,6,7,9,0,7,3,11,6,0,31,2,0,0,0,0,6,0,0,2,12,4,2,3,11,5,0,0,0,8,10,1,2,7,1,0,4,1,0,1,5,0,3,6,0,1,5,7,0,4,3,1,0,0,0,0,0,8,1,0,1,3,4,0,5,5,8,13,2,0,2,0,11,0,0,8,5,0,1,0,1,16,12,2,2,2,3,8,10,0,0,2,7,9,0,6,3,16,0,9,4,1,29,0,13,4,4,6,0,5,0,1,1,4,1,4,0,0,3,0,3,10,0,20,0,2,35,1,0,0,0,6,0,10,0,2,2,1,10,0,0,1,12,4,1,1,3,0,20,1,0,0,6,4,3,1,0,2,2,1,0,0,3,0,2,0,7,2,1,6,1,2,2,1,3,1,7,6,1,0,4,3,0,4,8,3,7,1,2,12,0,0,7,0,1,5,9,5,3,2,1,1,4,0,4,1,6,0,1,2,8,0,5,4,33,3,6,2,10,4,0,3,2,3,1,2,1,1,1,9,0,16,11,14,7,0,2,15,0,2,0,5,4,1,15,2,13,9,1,9,13,0,5,2,0,30,3,9,10,14,1,2,11,0,2,15,0,0,1,4,2,3,1,6,0,4,2,0,0,0,3,0,0,3,0,2,0,0,2,0,10,3,2,0,6,0,0,0,2,2,8,3,0,0,9,0,1,0,6,0,2,3,0,1,2,0,4,2,1,0,7,0,3,7,7,2,2,1,10,7,0,2,7,3,0,2,0,0,2,0,2,22,3,2,1,1,4,3,2,0,0,4,0,3,10,0,2,2,0,0,3,0,6,3,3,0,0,4,0,1,0,4,2,0,5,28,1,3,1,4,0,1,0,2,1,2,5,1,0,5,2,0,0,2,1,0,4,7,2,0,0,0,0,20,0,0,0,7,0,1,11,2,5,3,0,6,17,1,6,5,4,3,1,5,3,0,11,3,7,1,4,13,3,8,10,3,2,9,3,22,0,2,1,11,2,0,1,3,3,1,8,1,5,0,0,12,0,0,0,0,0,0,4,8,8,3,3,5,0,2,8,0,3,3,13,0,1,2,2,10,0,3,0,0,0,2,7,3,4,0,0,1,1,10,0,0,0,0,5,1,1,2,2,5,3,4,3,1,1,2,2,4,29,1,1,1,1,3,0,3,2,0,2,3,2,1,4,0,2,1,1,6,0,2,1,0,1,5,0,1,3,6,0,1,0,3,0,0,2,3,6,4,4,1,0,0,7,1,0,1,199,4,2,3,0,9,3,5,1,2,0,5,6,0,0,0,15,1,0,2,1,0,17,3,1,6,0,8,0,3,9,2,0,1,0,3,1,6,3,0,0,0,12,1,4,1,0,1,2,0,28,8,0,1,1,1,3,3,2,0,3,0,8,5,1,2,1,0,0,1,5,2,4,0,4,3,2,2,4,5,9,3,1,2,2,0,2,0,2,2,0,270,2,0,3,0,0,3,0,0,1,2,4,7,3,1,4,1,0,0,0,8,4,0,1,1,0,1,0,2,3,7,2,1,3,0,0,2,3,214,5,2,0,0,13,12,0,1,3,1,0,0,1,12,6,3,0,1,6,4,7,0,1,0,0,0,1,4,5,1,3,1,0,5,0,2,0,5,0,2,5,5,1,14,0,5,2,0,0,5,0,13,0,0,0,1,7,9,4,4,0,10,2,4,21,0,0,5,4,2,0,0,0,1,8,0,0,0,0,1,0,4,1,0,1,1,0,3,2,0,3,1,8,5,0,7,2,5,4,1,0,0,2,0,1,0,4,5,1,3,2,5,2,2,0,0,2,0,0,1,6,1,0,2,5,1,0,2,10,3,0,3,0,6,3,2,3,3,0,0,2,4,2,5,0,0,14,3,6,0,1,0,0,0,1,0,1,9,3,0,4,0,5,1,1,4,2,1,1,1,0,1,8,2,0,2,3,3,3,0,0,0,6,0,0,17,3,0,1,2,2,3,0,2,0,2,0,4,1,1,17,2,1,2,9,4,5,0,1,1,1,9,2,3,0,3,1,4,0,5,5,1,0,0,3,0,0,0,0,2,0,0,0,1,1,0,0,0,0,2,2,8,0,1,2,0,2,0,0,1,0,0,1,2,0,0,1,2,12,2,3,2,0,4,1,3,1,1,5,0,1,6,4,1,3,1,0,6,3,1,0,3,9,12,2,6,0,2,7,2,3,2,0,2,1,9,0,2,11,0,2,0,4,1,5,5,0,2,0,0,0,0,0,0,0,2,0,0,2,0,2,5,0,0,5,17,0,6,1,1,1,0,1,2,2,1,13,1,1,7,1,0,6,0,1,0,0,0,0,2,3,0,4,5,6,0,0,1,1,1,0,7,0,0,0,1,9,0,0,0,2,0,5,0,0,0,0,3,0,1,2,0,3,3,0,5,2,3,0,0,2,4,2,1,1,0,2,1,0,4,0,13,2,0,0,1,8,0,2,0,0,2,1,2,4,10,7,1,3,2,5,0,1,1,0,6,2,1,1,9,4,0,0,1,3,0,5,3,0,2,2,0,0,0,1,0,0,0,0,1,0,0,0,4,0,2,0,10,0,2,1,0,1,0,1,1,0,1,9,4,0,5,0,0,4,3,1,3,0,1,1,0,0,0,3,2,0,1,1,1,0,0,0,1,0,0,1,2,1,2,0,0,2,5,0,0,2,1,1,4,2,0,0,2,0,2,5,0,1,1,0,3,0,5,0,1,1,0,0,4,0,0,8,0,3,2,8,5,4,2,0,3,3,1,2,0,5,3,0,1,0,11,1,2,1,4,4,2,0,2,38,4,6,0,1,5,2,3,2,0,0,0,0,5,0,1,4,0,5,22,1,1,1,1,0,4,0,202,0,7,2,0,1,0,6,2,0,2,0,0,8,0,9,3,3,0,4,0,12,0,2,7,6,0,2,0,1,0,1,0,0,4,0,0,0,6,2,0,0,4,0,4,0,1,0,0,0,2,0,1,6,9,0,8,1,0,3,1,5,7,1,0,4,1,31,3,0,0,2,3,10,0,1,0,0,16,1,4,6,2,2,2,0,2,0,0,2,3,0,0,5,6,0,1,1,0,0,9,3,0,2,4,0,1,0,2,0,0,0,3,0,1,4,0,5,0,7,1,2,6,8,0,1,0,1,0,3,1,4,0,4,4,1,1,0,0,0,3,3,1,2,1,0,0,0,2,3,6,5,1,0,0,3,0,0,0,0,2,0,0,2,0,0,1,0,3,0,0,0,2,4,0,5,12,0,2,0,0,0,0,3,10,0,0,0,6,0,0,0,6,3,0,0,1,2,2,2,2,1,2,3,6,0,0,0,0,1,2,2,1,1,1,0,1,2,0,3,12,0,1,0,3,0,0,0,1,4,1,1,0,0,1,4,0,35,1,2,6,1,1,3,21,0,1,0,2,2,0,6,1,4,1,0,0,0,7,1,6,0,1,0,2,0,1,1,4,0,3,1,1,2,2,2,2,2,0,1,0,0,1,2,0,0,1,0,75,0,0,196,2,2,0,0,0,1,0,4,2,0,2,0,0,5,1,0,1,0,3,0,3,3,4,0,1,0,5,3,4,1,0,1,0,4,0,4,0,0,0,2,0,0,1,0,0,6,2,11,3,3,2,0,2,1,0,0,1,5,0,1,2,1,2,4,0,0,6,0,0,7,3,8,1,7,0,7,5,0,0,0,0,10,0,1,2,0,0,0,7,0,2,188,0,1,1,1,0,0,1,0,0,2,0,3,4,11,1,0,3,2,4,1,4,3,4,0,0,0,0,1,1,1,2,2,2,0,5,4,0,1,2,0,2,4,2,1,1,3,3,1,0,6,4,3,15,2,0,0,1,2,0,0,0,3,0,2,3,1,24,2,1,3,2,1,2,2,3,0,0,0,0,4,1,3,0,1,175,0,1,1,5,0,0,1,0,0,0,1,1,0,0,2,1,8,5,2,0,1,2,1,0,0,0,0,0,3,0,0,0,7,0,1,4,8,3,3,1,5,1,1,0,6,0,0,1,3,1,0,5,5,3,0,1,2,4,0,2,3,0,3,2,0,3,2,4,1,1,2,7,2,0,2,0,1,0,2,1,0,3,0,0,64,4,1,0,0,13,0,0,0,0,1,0,2,2,0,4,4,0,3,2,0,9,0,1,1,5,7,1,3,0,0,2,1,0,0,0,2,0,2,1,0,2,0,6,1,4,0,2,3,0,0,0,6,16,7,2,0,18,1,0,0,1,1,2,0,0,0,1,1,0,0,3,0,1,1,1,1,10,3,19,1,0,0,0,4,1,0,2,1,22,2,8,0,1,0,0,0,1,1,1,2,7,0,4,0,0,4,3,0,3,3,1,1,4,0,7,1,6,0,2,0,0,4,2,0,0,0,9,2,3,0,1,0,0,0,2,3,59,0,0,0,1,0,1,1,8,2,2,0,1,3,2,5,6,0,2,0,0,1,0,5,0,6,0,3,0,1,0,3,7,5,4,1,0,8,3,2,6,0,0,1,2,1,1,3,6,0,2,1,1,1,6,6,1,0,1,0,1,2,0,0,0,0,0,4,5,2,0,6,0,14,6,0,7,0,0,0,1,2,10,6,0,2,0,7,0,0,1,0,1,0,2,0,3,0,0,110,1,6,0,1,0,1,0,0,0,0,2,0,1,0,0,0,0,11,1,1,0,142,0,0,0,0,3,0,8,0,2,9,0,0,0,0,2,0,0,0,7,0,0,0,3,1,0,0,0,0,0,0,2,0,1,0,0,0,0,1,0,0,0,0,0,0,0,0,0,0,0,0,0,0,0,0,0,0,0,0,0,0
"1998 Koontz, Dean, Lightning",pop,8866,3747,3435,3009,3251,913,2233,2425,2065,1017,1134,1121,1646,1941,1464,1053,1528,1004,895,803,967,1007,933,690,187,902,301,793,401,258,768,342,322,661,320,498,618,351,209,435,550,242,272,485,305,448,357,437,612,241,305,429,378,338,412,456,428,194,147,275,207,187,200,280,229,383,252,115,167,208,177,160,151,179,171,282,281,87,150,135,170,136,210,132,164,145,225,145,207,159,36,131,302,206,131,227,113,207,138,170,146,85,126,286,99,288,138,140,110,78,137,77,104,83,172,164,162,135,145,64,80,139,113,111,201,72,102,91,121,69,136,93,83,73,93,110,49,96,165,132,136,111,50,122,257,135,123,133,80,103,133,64,83,111,79,84,30,159,147,72,84,72,34,51,118,69,115,90,52,47,49,120,137,83,133,56,143,113,103,74,45,55,89,90,47,69,50,77,117,71,95,131,81,55,71,47,72,74,70,137,77,126,45,61,69,15,62,61,24,80,38,104,84,83,100,57,70,101,51,63,89,59,64,70,25,62,38,40,53,49,66,53,53,37,63,34,44,93,55,56,23,78,42,34,76,59,106,56,38,77,66,28,65,21,96,47,37,45,65,102,77,67,45,92,57,66,29,60,96,67,46,45,55,55,39,53,81,38,20,50,108,56,26,31,55,45,45,109,76,61,51,9,21,35,46,31,47,20,31,33,48,19,30,51,43,38,39,49,50,20,78,26,15,48,78,44,116,35,50,42,52,34,34,89,48,72,61,44,32,70,29,46,79,41,77,16,31,34,16,31,64,58,35,61,17,41,40,29,42,33,50,26,21,32,47,37,26,10,28,71,65,16,21,20,47,31,42,34,47,16,34,65,61,52,56,26,57,13,21,28,44,43,59,16,46,52,0,27,42,48,3,9,44,24,48,45,19,47,36,39,16,39,34,33,54,46,32,17,26,45,37,33,40,5,32,82,57,25,51,63,29,0,22,14,29,21,40,43,28,58,35,21,58,26,5,84,27,21,40,35,16,26,36,32,25,12,41,27,41,30,41,49,14,18,37,26,37,62,37,21,22,7,0,20,22,18,40,17,17,87,17,14,34,1,42,32,41,27,0,25,31,23,60,76,46,24,35,27,17,23,39,22,27,41,66,35,28,15,46,24,12,57,45,35,26,32,28,38,16,10,24,9,8,25,12,26,0,15,25,38,6,38,31,10,30,30,49,6,25,11,4,21,21,62,29,0,23,21,32,42,47,18,19,44,27,42,0,3,53,5,19,14,30,49,15,20,16,15,9,28,6,28,25,37,32,18,29,33,23,29,24,15,22,30,12,38,13,8,9,22,17,68,29,34,27,33,20,30,14,5,24,42,22,33,30,24,14,36,25,40,11,61,49,21,24,0,1,47,17,12,12,20,44,28,10,20,11,8,10,25,27,24,23,26,19,19,33,34,25,7,33,45,53,5,18,0,33,29,12,37,19,34,6,92,15,38,25,20,47,17,0,18,18,10,53,7,29,8,23,6,11,39,29,29,15,12,6,26,30,16,37,30,41,30,27,9,13,14,12,14,27,10,30,14,10,7,8,21,24,30,11,19,11,25,25,20,19,0,8,36,9,1,16,27,13,19,8,13,20,22,10,15,8,26,31,20,21,30,8,24,21,25,24,8,37,33,36,10,16,21,7,9,48,10,0,14,13,11,38,12,21,8,9,36,1,0,11,12,17,11,20,9,19,27,13,17,12,9,20,9,10,20,15,5,19,32,15,21,20,21,23,3,4,23,0,13,8,10,14,2,13,31,44,17,11,26,8,19,4,28,13,11,12,20,20,63,0,10,1,28,17,9,12,30,34,20,24,11,27,3,19,8,8,2,19,5,0,0,5,12,5,14,20,26,62,20,20,14,25,42,17,0,8,8,20,10,14,17,381,5,22,15,6,6,14,28,7,0,12,15,12,18,10,35,50,4,9,3,13,18,13,10,10,17,8,28,16,0,11,19,13,17,13,8,0,18,5,13,8,18,27,10,12,6,24,16,26,20,11,14,26,14,3,6,5,16,29,3,21,15,40,13,11,4,16,3,16,12,21,20,13,0,5,0,13,4,3,7,9,13,10,2,42,17,30,5,15,0,26,125,1,2,26,0,13,6,15,22,16,25,3,0,20,18,14,15,13,26,12,12,13,21,9,17,4,18,17,6,11,0,0,11,3,4,11,26,14,1,10,5,5,1,17,13,18,21,9,18,8,22,3,9,6,7,24,4,5,2,23,22,13,30,6,3,12,21,0,12,12,0,9,0,9,16,8,10,0,0,1,15,9,24,11,73,15,18,10,0,9,12,21,34,17,0,0,10,12,10,7,15,15,14,18,18,20,20,6,5,18,30,0,16,0,8,10,10,10,9,14,4,43,10,18,2,10,0,27,12,4,10,9,1,0,7,20,4,18,23,0,0,3,8,22,8,8,15,9,3,14,12,3,3,9,8,6,10,6,7,7,2,13,0,38,14,14,15,8,7,6,7,15,13,12,11,5,5,4,12,18,10,10,5,8,14,0,4,12,3,9,5,16,12,0,21,8,14,9,11,11,1,4,51,5,2,5,21,18,1,3,6,16,0,6,18,5,1,12,8,2,14,33,1,8,18,9,31,1,13,7,12,0,16,6,6,0,2,0,4,1,68,0,20,11,5,17,1,1,0,10,0,3,17,20,9,12,23,0,4,10,0,8,17,761,16,18,4,9,44,7,13,1,0,13,9,14,7,5,112,9,25,0,4,4,9,4,0,0,21,15,21,29,15,12,17,11,1,1,7,18,15,2,17,0,20,6,0,12,34,10,28,6,20,9,0,18,8,21,10,10,10,8,20,11,9,1,3,8,5,8,5,4,0,12,5,0,35,6,5,5,7,1,2,12,4,0,2,10,7,0,6,24,10,8,19,16,18,11,11,7,3,0,6,17,2,10,11,1,8,0,9,8,7,6,15,8,3,5,4,12,8,1,9,5,4,2,3,16,6,6,24,10,5,0,0,14,9,7,6,18,10,3,3,11,13,5,19,8,27,7,9,8,4,3,0,2,5,5,22,11,0,4,17,7,45,7,2,10,5,10,1,15,18,3,0,12,7,11,13,15,7,1,25,25,14,6,0,0,11,0,8,2,0,3,11,3,23,11,37,1,10,6,10,16,6,24,2,16,2,1,14,0,2,0,10,9,10,0,0,11,0,4,9,20,9,0,4,19,12,5,7,6,18,1,9,17,17,5,2,27,23,3,5,0,0,8,18,8,10,10,10,8,7,10,3,0,7,15,13,7,2,15,10,0,4,5,0,11,1,10,10,4,22,11,0,11,12,6,0,6,4,4,5,11,11,0,0,24,25,18,16,7,10,1,9,23,8,9,3,5,10,8,10,16,10,5,4,0,24,1,2,8,1,4,0,0,4,0,5,19,5,6,2,7,4,9,11,0,0,0,4,6,19,7,6,10,11,1,13,21,5,1,9,3,5,9,0,13,4,8,7,7,5,6,8,7,6,11,125,7,3,7,39,9,6,4,18,4,8,8,15,3,10,0,3,4,4,25,1,13,2,5,6,19,0,7,6,4,12,8,9,7,12,5,2,8,5,5,6,11,5,0,5,32,1,13,8,17,0,13,26,0,2,0,4,8,9,3,5,10,5,17,2,15,0,12,4,0,3,0,25,9,28,11,0,4,6,10,3,8,0,13,7,1,7,13,2,13,10,5,5,8,2,11,6,0,12,0,5,2,0,3,7,16,18,2,7,19,9,5,9,11,9,5,1,15,20,12,0,5,0,8,21,6,5,13,5,2,12,1,7,9,1,2,1,1,0,14,0,5,23,13,0,1,4,88,1,8,10,8,1,19,6,3,3,13,8,7,10,7,0,7,9,16,4,3,6,8,4,0,10,7,6,5,7,6,0,22,2,6,6,3,1,7,21,7,4,22,9,9,5,6,4,8,10,0,0,8,0,16,8,5,5,2,4,26,10,0,5,5,4,7,3,1,4,5,4,1,18,3,0,12,3,1,4,1,4,15,7,40,11,3,20,7,4,3,13,6,7,15,6,10,6,0,5,9,0,1,2,11,2,1,1,6,4,12,4,11,2,3,2,4,1,12,26,2,18,12,0,6,4,4,9,0,0,4,9,0,2,0,0,6,5,15,1,2,8,9,2,0,10,20,2,0,10,52,1,20,17,2,0,2,15,4,8,4,11,3,3,11,18,16,5,13,8,10,4,17,2,5,14,19,9,1,5,11,8,3,2,2,32,0,3,7,9,12,9,7,5,12,7,11,7,0,25,8,0,7,10,1,9,0,8,5,8,0,13,23,0,5,6,0,18,4,0,2,3,1,4,15,19,0,0,0,7,7,24,8,3,10,6,1,9,0,4,4,0,8,4,0,1,7,6,0,19,18,7,7,10,5,4,5,5,1,6,2,1,0,7,4,16,2,2,4,10,2,0,1,0,4,3,10,1,2,0,9,1,3,2,1,3,2,4,6,3,21,11,10,6,7,15,17,2,2,4,1,5,7,0,5,1,6,0,18,5,7,3,4,8,2,5,17,6,5,3,9,7,11,5,14,7,1,0,11,2,10,0,0,6,5,0,6,5,43,2,7,0,10,22,3,9,9,2,1,0,0,4,11,3,4,3,0,5,14,8,2,3,1,6,13,2,12,9,5,5,4,1,3,3,7,6,1,0,18,7,0,1,14,2,15,17,9,13,19,10,15,10,0,0,51,1,0,4,2,6,15,12,1,1,4,8,13,1,4,1,0,2,0,2,1,3,3,1,0,17,12,4,2,3,0,0,6,0,5,1,0,0,1,7,9,12,7,10,1,6,0,7,0,11,2,5,14,9,7,0,6,6,16,1,1,7,4,2,1,0,11,0,5,2,6,12,0,5,4,24,12,12,3,12,4,4,6,3,6,0,5,0,0,1,2,2,3,2,1,3,1,10,18,3,3,0,1,3,15,6,4,8,3,7,1,6,1,3,6,9,8,13,0,0,1,1,4,3,5,4,3,0,2,7,2,9,4,7,7,2,3,6,12,1,3,3,5,23,3,10,3,5,6,0,2,0,0,9,5,2,1,4,2,9,4,4,15,3,0,6,3,8,2,10,7,3,3,24,2,7,8,2,4,2,3,2,3,0,3,0,0,1,3,3,4,18,10,6,20,7,19,7,3,8,3,3,4,5,2,1,0,7,0,2,5,4,11,1,15,9,8,7,2,3,0,1,6,5,5,4,12,8,6,7,3,41,5,6,0,2,10,4,3,5,2,8,0,2,15,10,23,4,10,4,11,4,2,8,9,11,5,0,11,2,5,0,7,5,0,1,1,3,1,1,0,0,9,10,4,2,2,2,5,1,6,6,2,2,11,1,15,0,6,7,4,8,0,5,0,2,0,350,10,3,2,13,3,7,11,6,10,3,5,1,8,11,4,14,10,0,0,0,7,25,8,4,4,2,6,4,1,4,0,1,0,5,6,4,4,1,16,0,0,3,6,0,2,5,0,3,1,11,13,3,4,2,0,5,3,1,9,0,1,7,2,5,4,9,14,2,0,19,12,0,8,5,10,26,0,12,5,9,0,0,2,0,0,10,1,2,4,1,0,4,6,2,0,1,3,6,0,7,12,0,1,0,5,0,35,5,2,7,6,4,5,2,2,8,2,14,23,3,0,0,1,0,4,5,0,4,0,3,9,1,2,2,1,1,0,8,7,9,0,2,4,6,7,2,3,4,5,0,9,3,7,0,3,0,5,6,3,2,7,7,5,5,2,0,0,1,6,2,6,7,0,3,7,7,9,15,3,1,2,9,3,1,5,0,0,7,0,0,4,3,0,21,9,3,4,4,2,5,2,3,0,3,2,6,3,1,13,3,1,3,2,1,9,5,1,1,5,4,7,5,2,0,2,0,5,0,4,3,10,5,6,14,12,6,10,6,2,8,4,3,27,3,4,4,0,3,8,0,0,5,7,0,4,2,4,9,1,0,10,1,1,0,0,15,1,6,5,2,16,0,5,7,10,6,8,4,0,3,4,3,10,3,1,7,0,0,4,3,2,0,4,0,1,5,2,3,0,0,0,6,1,5,0,0,3,8,5,0,10,3,3,0,1,3,5,15,2,3,5,3,1,0,3,9,7,4,3,5,0,3,12,8,2,3,6,10,0,3,5,0,2,8,2,0,7,1,4,0,7,12,2,0,6,0,10,3,6,0,2,5,0,3,0,0,0,4,0,0,2,0,2,4,4,10,11,3,0,0,5,0,3,6,3,6,0,3,2,0,14,5,20,2,0,6,7,11,1,9,1,3,11,5,3,11,3,1,2,0,1,2,0,7,5,5,4,10,0,0,1,2,11,11,0,0,6,0,0,1,1,0,6,11,4,10,8,5,3,1,0,8,16,3,11,2,6,5,10,7,4,3,8,0,4,15,90,1,0,9,6,4,5,13,0,0,6,2,4,6,4,16,1,2,2,6,5,5,0,8,0,9,1,1,1,0,0,7,1,9,0,0,0,0,0,3,8,3,0,6,2,4,0,0,2,3,0,0,10,2,6,4,1,1,3,2,3,0,0,3,0,0,11,0,5,0,5,10,1,5,2,3,21,0,0,5,5,4,0,10,0,3,4,8,0,2,7,8,3,7,2,7,5,1,0,6,0,1,13,4,1,4,0,0,8,10,3,0,0,2,6,5,2,0,1,0,8,0,12,1,0,1,1,2,0,7,3,1,2,6,14,0,0,2,0,0,10,4,5,1,6,2,0,4,0,0,0,4,1,1,11,5,274,5,3,0,0,0,10,2,14,0,5,2,13,3,2,3,5,0,0,6,6,10,2,6,12,2,5,4,0,1,5,2,0,5,21,12,4,7,2,7,3,2,0,0,0,7,4,5,11,7,0,3,0,1,5,2,0,1,2,6,3,3,1,4,0,13,2,2,0,6,4,10,4,0,3,2,0,0,1,0,4,5,13,1,0,4,12,6,0,0,9,0,5,0,0,1,1,3,9,1,8,1,6,3,2,4,2,1,4,0,6,6,9,6,0,1,0,1,15,2,8,1,9,2,5,6,2,3,8,8,3,2,0,8,0,2,1,6,2,0,0,3,3,0,5,1,1,2,3,3,5,5,1,1,0,0,0,0,0,10,0,4,0,8,7,1,4,2,0,1,1,6,9,5,0,3,11,1,4,2,9,3,5,0,0,1,14,3,4,0,3,4,8,4,19,2,1,0,0,2,1,0,3,0,5,1,1,4,1,5,8,1,1,6,2,1,2,2,8,0,7,0,3,5,0,6,2,3,3,3,5,7,9,0,5,3,1,0,1,1,6,0,3,0,8,33,1,1,4,3,4,3,0,0,0,0,0,0,0,2,2,2,2,13,4,4,1,0,0,5,5,2,8,5,0,2,2,4,0,0,9,9,3,1,3,1,8,2,4,1,3,0,0,2,3,6,4,1,0,1,4,8,3,2,1,0,4,1,2,0,0,4,0,2,0,1,2,2,2,0,3,0,0,5,5,33,12,4,0,1,5,0,4,2,1,1,0,3,3,13,1,1,2,1,7,5,2,2,0,0,3,3,0,5,6,4,6,3,3,6,1,2,3,2,1,2,2,4,4,5,4,2,1,0,5,4,7,10,0,0,0,0,4,0,2,1,1,2,1,4,6,0,0,2,3,0,1,3,5,4,4,7,0,9,0,7,2,0,5,2,10,2,1,1,11,4,4,2,6,8,7,5,0,0,5,0,1,5,1,3,0,0,4,6,2,0,7,8,3,9,3,3,1,4,1,18,0,0,5,7,1,1,0,0,7,0,6,3,0,0,9,1,4,1,8,0,4,6,4,6,1,6,0,6,2,5,1,5,5,0,0,4,0,1,5,2,3,14,4,0,1,7,7,5,0,7,1,2,0,5,0,3,5,0,0,5,0,6,0,0,4,0,1,5,0,3,0,3,3,7,4,2,3,2,2,1,0,3,7,2,4,4,3,7,1,6,2,2,2,0,2,10,0,2,19,1,6,6,3,0,0,0,0,0,0,3,12,3,1,1,15,3,2,3,4,7,5,0,1,4,0,5,0,3,2,0,1,0,2,0,4,4,5,9,1,0,1,0,9,0,6,0,9,9,1,3,2,1,12,7,2,0,9,5,13,1,1,3,0,5,1,7,4,0,0,1,1,6,1,3,0,0,3,3,0,3,0,0,6,1,2,3,1,2,0,1,2,3,12,6,1,4,1,0,0,2,0,4,2,0,1,8,0,4,3,0,0,2,2,6,0,4,0,7,0,4,3,0,1,0,0,0,2,0,0,0,5,3,0,6,0,16,10,4,6,2,2,3,1,3,43,2,2,0,0,0,0,1,0,3,4,3,2,2,5,22,4,0,5,7,3,1,0,1,1,3,5,4,2,2,0,5,2,5,1,0,2,0,1,1,2,6,4,123,2,3,0,4,0,2,0,0,0,3,6,0,4,2,0,2,2,1,4,4,2,0,1,5,1,2,1,0,4,0,3,4,45,3,2,0,4,1,1,2,2,0,2,1,7,0,3,0,0,35,3,1,0,1,0,2,1,0,2,1,2,7,3,0,0,3,1,4,1,3,4,0,0,2,3,2,0,9,0,2,2,5,0,6,2,1,6,3,1,0,0,1,0,5,1,0,2,0,1,0,1,3,3,1,0,0,1,4,4,1,2,2,0,3,2,1,3,4,2,2,2,0,0,5,14,10,0,1,0,3,1,4,0,0,0,0,2,4,7,4,2,0,1,0,23,4,1,3,0,0,2,4,8,0,3,1,0,1,3,0,5,4,4,1,0,1,2,5,1,11,0,4,0,4,2,0,0,0,0,7,0,10,1,1,2,2,12,1,2,0,1,2,1,5,0,1,1,1,0,10,0,3,0,2,0,0,2,0,7,0,6,1,6,0,3,1,3,12,0,0,3,0,6,4,7,3,6,0,11,4,0,2,5,0,1,0,3,1,6,8,2,0,5,3,1,0,2,0,4,0,1,2,0,0,0,1,3,3,2,0,2,0,2,3,0,2,1,4,0,1,0,3,3,0,1,3,2,0,1,0,6,0,8,3,5,4,0,0,0,0,1,4,4,2,0,0,1,5,8,1,3,1,5,1,3,0,0,1,2,1,3,36,3,3,11,4,1,0,5,3,5,0,1,9,5,14,0,9,1,5,5,0,0,0,10,0,1,1,3,2,0,1,2,0,3,3,0,0,1,0,7,4,2,5,3,4,0,0,0,8,12,3,7,0,0,3,1,0,3,30,1,6,2,3,1,3,1,1,1,1,0,0,1,0,9,0,1,2,0,2,2,0,3,0,1,2,0,0,0,2,0,5,0,1,8,0,0,1,2,1,0,1,5,0,3,0,8,2,4,0,5,8,0,0,0,1,2,0,0,9,3,0,1,3,3,1,0,0,1,2,1,14,4,0,1,0,1,0,1,2,0,6,4,0,0,9,4,0,5,2,3,2,0,0,4,0,2,6,10,5,4,3,5,0,3,1,0,4,0,3,1,0,1,4,0,1,2,0,0,6,2,3,1,4,3,0,0,4,2,1,1,1,2,7,4,0,0,7,3,1,0,2,21,4,1,0,0,5,0,1,0,2,0,1,0,2,4,7,0,0,4,0,1,0,0,2,0,0,0,2,2,2,25,2,6,13,5,2,3,1,2,4,1,0,0,1,2,1,1,2,2,78,0,0,1,0,0,3,2,2,2,1,8,0,2,4,2,106,2,6,4,0,0,0,5,2,0,2,1,5,0,0,1,0,2,1,2,4,2,5,1,6,0,0,5,5,3,5,0,1,2,0,2,3,5,6,7,0,4,1,1,0,0,1,4,0,11,0,0,0,1,1,1,1,0,0,7,0,1,1,0,4,1,4,0,4,0,1,8,1,0,2,8,1,0,3,1,0,0,0,2,1,2,2,0,3,8,0,0,1,2,1,2,6,3,0,3,1,5,2,0,0,1,6,1,0,0,0,2,0,2,0,5,0,2,1,1,0,2,1,0,4,0,5,0,0,2,1,5,5,5,2,1,0,7,4,6,0,1,1,0,1,7,6,0,1,1,2,2,0,1,5,0,3,7,3,0,7,2,1,4,0,0,0,10,3,0,0,2,2,1,1,0,1,0,3,1,4,2,5,7,3,3,1,6,1,0,1,0,0,2,3,5,2,0,0,1,0,1,0,0,1,0,0,0,8,0,0,1,0,1,1,0,3,2,0,0,3,1,5,2,1,2,1,0,0,5,3,2,2,4,4,2,0,3,4,1,0,2,2,4,1,3,2,2,0,3,3,4,0,5,0,0,3,1,2,4,3,2,1,4,0,2,6,2,5,1,5,0,4,1,0,1,1,0,0,0,2,0,0,1,12,1,0,0,3,6,2,1,0,3,0,5,1,0,4,1,3,0,2,2,24,0,0,0,2,1,1,0,3,0,3,10,1,0,2,0,1,0,1,2,0,0,0,5,2,1,3,2,4,9,2,0,0,0,1,0,2,0,0,5,1,2,2,5,0,0,0,1,0,3,0,2,0,0,2,4,6,0,7,1,3,0,0,3,0,0,1,0,0,0,4,0,1,1,2,1,3,0,0,6,4,1,0,0,1,2,2,3,4,0,5,5,0,3,0,2,1,1,1,6,1,9,2,4,1,1,3,1,3,1,0,1,8,2,1,3,1,1,2,0,3,1,0,2,0,1,1,2,0,0,2,1,0,0,1,6,0,2,0,7,1,0,0,1,1,11,2,0,2,0,3,2,3,12,1,1,2,0,3,1,1,4,7,0,0,8,1,3,1,1,2,4,1,0,2,5,1,0,0,1,7,3,9,13,0,1,17,5,1,7,2,2,1,0,0,1,3,1,0,6,0,0,6,1,1,0,0,5,0,0,0,4,2,2,1,2,3,2,6,4,1,4,0,1,0,1,1,0,4,0,0,1,2,0,16,0,0,1,0,3,5,4,3,3,3,8,1,0,2,1,2,3,1,1,2,1,2,3,1,1,1,0,0,4,0,13,1,17,3,1,1,1,2,1,5,0,3,0,2,2,0,1,38,2,0,0,0,0,3,0,0,0,0,0,135,0,3,0,0,3,3,1,0,0,0,0,1,0,1,0,0,0,5,52,12,1,0,0,1,0,0,1,0,0,1,0,0,0,0,0,0,2,0,1,0,1,0,0,0,0,0,1,0,0,0,1,0,0,0,0,1,0,0,0,0,0,0,1,0,0,0,0,0,0,1,0,0,0,0,0,0,0,0,0,0,0,0,0,0,0,0,0,0,0,0,0,0
"1999 Crichton, Michael, Timeline",pop,9438,3408,3204,3077,2575,846,2679,2061,2343,1830,1291,1504,1207,1488,867,974,914,816,654,1670,994,955,666,633,263,585,183,1179,387,780,583,485,506,500,620,406,761,541,535,455,320,275,537,521,272,216,287,462,270,495,536,459,284,356,323,340,262,273,365,289,401,211,162,458,258,217,294,293,373,178,197,132,243,315,112,228,210,180,141,263,171,273,170,230,189,297,244,162,129,139,121,212,154,237,157,102,212,172,106,143,103,84,175,105,183,164,204,206,104,109,153,131,105,187,130,150,215,131,134,106,42,209,116,97,196,42,106,122,106,68,327,164,161,85,152,98,111,115,140,121,7,167,40,70,185,84,112,61,103,68,56,163,222,170,134,53,133,38,114,93,84,137,63,31,148,75,73,50,32,149,12,95,55,44,59,113,33,54,59,82,62,36,204,91,46,13,62,224,152,44,44,76,73,59,68,87,7,65,64,32,80,130,51,61,48,14,80,102,82,50,13,55,139,76,96,86,64,175,59,38,56,52,54,75,38,95,46,23,53,66,98,104,82,56,46,17,34,94,99,99,26,24,92,49,49,46,71,58,22,43,62,142,67,82,200,57,48,36,52,81,66,34,64,30,47,8,35,85,67,100,25,44,72,34,58,32,31,45,25,31,122,69,45,39,88,13,70,25,76,92,57,20,30,38,95,48,49,35,24,20,30,39,94,58,113,64,15,19,85,61,74,11,51,32,21,71,57,54,56,52,65,42,35,125,23,37,24,28,17,37,75,28,77,32,52,32,100,10,31,43,98,36,31,10,34,96,27,170,39,57,38,55,43,29,73,14,27,28,56,33,60,72,42,29,40,37,52,66,70,30,37,22,59,7,51,21,29,22,18,36,150,52,66,57,67,9,0,25,30,30,2,57,7,12,40,27,34,35,16,33,8,47,35,8,30,12,34,32,45,17,105,29,22,93,42,48,27,34,29,39,40,0,14,14,52,42,18,41,31,10,99,14,17,39,41,54,53,20,18,34,25,23,45,21,26,12,44,39,42,23,44,36,33,32,33,43,45,1,39,63,39,15,0,4,32,10,42,67,1,43,60,59,27,0,48,19,121,34,0,18,35,17,49,3,8,31,92,17,12,32,7,19,59,7,19,65,26,22,19,14,26,30,12,26,39,42,15,31,47,4,67,40,16,32,11,46,0,28,12,35,24,32,47,9,41,13,29,27,37,18,12,21,23,11,27,2,26,35,70,22,74,15,35,50,14,83,41,78,31,15,54,19,10,163,25,21,30,56,16,3,10,18,24,1,7,19,17,37,2,19,4,40,28,21,11,18,23,2,12,10,55,23,22,42,0,45,50,32,14,6,9,17,31,8,26,19,34,49,8,28,12,12,22,16,22,0,0,12,26,28,16,38,23,20,34,32,12,14,8,43,38,9,2,21,33,5,0,26,28,16,9,46,22,4,18,0,24,49,17,28,23,14,31,15,7,28,23,11,7,17,0,11,22,26,28,14,61,28,71,5,40,15,20,11,21,21,12,17,21,35,29,14,30,21,7,9,17,33,15,14,12,24,18,10,7,12,26,10,38,18,11,9,11,12,1,19,5,0,5,25,16,19,18,26,12,9,3,17,15,20,5,33,103,48,8,22,26,31,21,18,15,3,9,2,16,27,3,4,15,28,22,11,15,122,0,1,6,27,19,19,31,14,5,42,4,2,1,6,17,93,1,37,16,14,14,84,17,2,49,1,57,28,25,22,27,5,20,12,27,13,16,45,0,34,0,17,9,21,0,13,20,5,27,17,42,18,31,6,6,15,5,22,0,21,19,2,0,11,0,10,21,14,46,24,22,56,16,21,22,6,40,12,15,2,32,18,25,0,19,7,10,5,46,21,22,21,15,59,36,11,19,0,35,7,3,19,5,19,831,3,21,8,14,14,9,101,15,0,15,30,25,26,3,4,26,6,2,27,4,18,33,25,13,23,8,61,2,0,15,23,23,24,7,3,0,6,6,31,10,16,6,3,13,17,15,25,19,19,16,8,11,49,0,7,10,9,16,0,22,1,8,1,13,10,5,1,16,19,7,99,7,0,5,0,9,4,14,18,10,4,7,137,11,10,24,4,39,0,9,25,4,33,26,0,10,50,14,24,6,10,11,5,5,38,36,17,6,27,18,23,29,11,39,5,55,29,0,17,5,0,0,9,10,0,8,15,8,1,5,19,6,3,20,5,4,7,10,12,9,47,0,20,17,7,1,2,11,0,19,7,17,31,10,9,7,22,6,24,3,0,16,0,7,1,23,15,0,0,4,1,3,7,2,1,1,14,17,0,11,13,7,17,4,0,7,2,9,1,35,23,8,54,24,13,12,10,4,0,17,1,11,4,25,20,39,5,40,25,13,10,6,15,4,13,29,0,13,15,18,12,6,19,0,10,10,15,6,8,0,0,0,0,20,9,1,12,9,0,7,29,8,10,5,5,8,17,1,27,11,1,30,0,19,22,52,2,4,13,4,7,19,7,5,14,3,4,29,6,14,26,28,13,28,11,0,2,12,36,5,18,3,14,6,9,12,5,17,23,2,0,18,2,21,189,32,27,28,7,7,5,1,0,5,12,5,2,14,4,4,3,23,6,9,14,28,23,3,12,23,5,14,29,15,1,340,9,3,9,0,29,0,18,2,13,46,11,2,17,10,0,5,48,3,45,5,26,0,9,16,0,8,3,0,44,9,3,7,8,0,19,0,0,7,7,32,4,1,14,4,13,0,10,19,20,3,0,0,37,22,20,13,9,4,2,12,10,3,19,4,16,12,6,61,6,9,857,4,2,7,22,22,4,6,0,8,22,0,2,9,6,5,28,14,12,4,66,22,10,1,8,8,0,0,10,0,12,6,4,7,6,0,4,13,16,0,0,19,15,0,0,5,5,8,37,17,6,5,2,9,1,0,3,22,5,1,9,1,1,0,4,6,4,9,9,11,11,0,6,3,9,4,0,6,6,1,6,6,18,1,13,2,9,13,9,12,2,14,14,33,17,1,6,22,22,16,9,10,3,10,14,11,5,3,0,45,4,12,28,12,1,26,6,6,7,4,18,15,19,7,0,3,6,11,0,6,7,9,4,56,5,0,21,11,0,8,0,0,2,0,0,189,0,8,12,4,4,5,37,1,12,5,2,12,2,1,7,8,0,4,12,0,1,0,6,1,2,1,0,9,2,5,13,2,3,0,9,12,4,2,7,2,10,6,3,4,10,2,0,5,1,12,27,0,0,2,34,2,4,8,10,1,3,3,3,0,6,1,8,28,7,6,2,0,5,6,0,26,4,8,15,4,11,25,0,1,3,17,0,6,1,12,10,7,11,0,0,0,0,4,1,7,1,1,0,0,14,1,2,0,44,5,3,11,12,24,0,0,0,25,5,13,0,0,0,0,15,0,18,6,0,2,0,8,1,0,10,1,0,9,6,13,13,11,2,12,15,35,2,25,2,7,11,8,1,5,0,6,2,8,4,2,2,1,3,5,14,5,0,25,3,12,15,8,6,12,4,2,51,10,9,4,32,1,2,7,0,0,9,7,9,15,15,8,0,16,3,6,0,15,11,6,1,12,2,3,2,6,1,0,0,0,1,13,7,7,7,13,0,23,19,10,0,0,2,6,21,4,6,10,4,15,1,3,22,29,1,0,5,0,2,15,8,2,0,6,13,4,3,9,0,17,0,4,0,24,9,5,9,4,9,3,4,7,3,291,1,42,17,5,16,0,3,9,10,4,12,1,10,10,4,15,13,0,7,0,9,17,0,4,1,33,7,2,11,10,13,0,1,2,9,4,5,17,0,3,6,4,7,11,7,6,0,1,0,0,10,7,10,0,5,7,1,8,6,4,8,18,12,2,1,7,22,0,3,8,13,0,2,0,11,2,7,4,5,21,18,6,2,11,13,14,3,18,0,5,0,1,5,8,9,6,2,5,6,0,4,20,1,5,37,5,6,42,1,0,4,0,2,4,12,1,3,3,17,3,15,1,6,9,0,16,7,0,3,2,5,4,7,4,11,13,0,4,16,3,10,8,4,12,1,4,14,0,3,0,1,20,3,3,20,22,2,23,3,2,6,3,1,13,2,4,10,2,5,19,17,7,0,7,1,7,9,0,0,7,10,1,2,0,0,31,4,9,4,42,12,12,2,0,8,1,2,1,10,21,20,18,4,9,0,10,19,4,2,0,1,5,12,1,3,3,23,0,0,1,0,4,7,1,8,2,4,0,14,2,10,0,0,1,3,0,2,7,1,31,11,5,60,15,0,0,6,0,2,6,10,4,4,6,3,0,2,1,10,0,1,23,1,0,7,0,14,3,0,5,4,5,13,11,3,1,0,0,5,3,22,11,0,6,5,12,5,0,9,2,0,5,2,0,6,4,5,0,17,0,1,0,0,1,1,6,6,1,4,0,7,0,6,0,11,3,6,2,3,5,1,2,0,2,0,4,8,11,0,2,7,0,2,6,23,0,5,5,9,2,5,2,0,10,3,8,0,7,4,6,0,5,0,4,2,4,0,7,7,0,8,13,2,2,0,1,3,68,3,4,2,7,19,4,3,8,0,25,4,9,0,0,7,3,0,14,1,13,1,1,6,9,17,5,10,10,6,9,0,3,7,5,1,4,5,4,9,2,24,8,9,4,9,1,2,4,16,3,8,6,4,23,11,2,1,0,262,8,3,0,0,7,1,0,5,13,2,1,6,13,3,0,0,16,8,8,8,1,13,8,5,16,0,3,0,29,0,11,6,11,6,0,0,2,11,2,5,0,3,7,0,1,0,0,0,10,0,4,3,0,0,1,8,14,3,16,4,11,0,0,10,5,9,7,2,13,2,12,0,0,5,0,15,0,0,0,8,0,0,8,0,3,9,16,3,0,6,6,28,18,4,3,3,0,14,3,0,0,0,10,0,0,22,17,2,1,0,0,2,0,6,8,7,3,2,0,2,1,2,6,9,2,7,1,3,0,1,9,7,15,32,0,0,5,7,1,5,0,7,8,1,65,2,11,3,3,5,1,6,2,4,13,4,29,1,0,23,7,17,1,9,2,0,3,0,1,0,7,4,8,2,11,0,5,6,15,4,0,12,8,10,6,6,3,0,2,7,0,7,1,16,1,0,3,7,1,0,5,7,0,1,4,1,3,2,2,7,0,4,10,9,0,6,0,6,7,5,1,2,3,10,1,2,7,8,5,1,3,5,1,7,3,2,0,4,8,1,1,13,8,2,5,4,8,4,19,0,0,1,7,16,4,4,11,9,0,2,5,2,0,1,1,6,10,1,2,5,10,3,0,3,10,3,14,2,9,1,0,4,0,0,0,11,0,0,14,4,1,1,2,1,8,4,8,2,9,1,0,0,0,0,3,4,5,13,0,11,0,4,21,0,7,0,0,2,27,4,3,5,1,0,5,5,5,7,7,3,9,0,18,1,1,6,5,0,1,2,0,6,3,0,1,1,0,10,5,0,2,0,0,0,1,4,0,0,6,4,6,7,9,7,8,1,6,6,0,1,0,0,8,0,8,0,12,0,5,13,0,4,0,12,7,0,1,1,4,10,5,11,1,6,11,0,5,4,0,1,3,4,5,5,0,1,7,7,5,3,1,1,0,9,7,0,2,0,4,0,2,6,2,1,5,3,1,4,3,11,2,0,1,4,0,0,5,0,3,10,0,0,0,2,3,17,0,1,0,3,1,0,2,8,0,1,4,8,15,6,2,2,11,3,0,5,1,4,4,0,3,3,3,3,6,3,6,13,1,0,0,3,2,8,4,2,0,2,8,0,5,5,6,1,10,4,0,134,0,0,0,2,0,0,20,5,0,2,0,0,20,1,2,5,2,3,0,3,7,6,11,5,2,1,1,0,2,1,6,0,12,10,5,11,17,4,2,0,2,2,3,0,1,2,2,0,8,0,2,7,2,3,0,13,1,6,0,12,0,1,0,6,6,13,0,3,5,198,1,0,3,4,0,0,4,2,0,0,0,6,0,1,7,3,0,5,1,8,5,0,1,4,2,15,1,7,5,2,1,12,3,0,6,0,17,6,2,0,10,0,4,4,8,0,11,15,2,2,2,0,4,6,2,0,8,10,0,1,5,0,1,2,2,3,2,0,0,1,2,3,4,1,0,0,0,0,5,1,3,1,4,1,178,0,3,4,3,0,1,0,6,9,11,0,0,5,3,0,61,0,1,4,9,0,1,2,5,6,0,0,0,4,14,0,2,0,1,4,2,12,14,9,2,1,0,2,4,2,7,9,0,1,4,0,2,0,4,1,5,7,0,7,0,8,4,3,2,4,8,3,1,38,4,0,3,3,3,6,2,2,1,15,0,0,2,0,0,12,3,8,2,0,3,5,6,0,12,0,47,0,3,2,5,1,9,2,4,1,0,3,1,2,7,8,10,2,7,0,8,3,1,0,0,1,0,2,13,0,1,0,2,0,8,3,4,2,2,0,0,4,9,4,0,1,0,7,7,25,1,2,2,10,0,4,3,0,2,1,4,7,4,2,1,2,8,1,0,0,4,32,1,3,1,4,4,3,4,0,13,4,9,0,0,1,0,0,4,4,0,0,1,5,0,10,6,9,3,0,0,2,1,9,0,6,2,2,2,0,0,1,1,9,1,3,0,2,6,17,0,0,3,4,10,5,2,0,2,0,0,0,2,17,2,62,9,6,1,0,12,0,5,0,1,7,0,2,3,5,0,1,8,0,10,0,2,0,0,2,0,4,5,1,3,2,2,2,0,4,0,0,0,4,2,8,0,3,0,7,22,0,0,3,5,5,2,0,3,1,9,5,5,4,0,0,0,9,7,2,2,4,0,6,0,1,0,8,1,0,0,14,5,0,0,6,1,1,0,6,0,0,0,8,2,1,4,2,17,5,2,2,1,0,0,0,3,1,5,5,0,4,0,2,5,0,8,8,1,9,0,0,5,16,0,1,1,2,1,1,0,3,2,1,2,0,0,4,0,0,2,0,3,6,8,5,23,0,2,3,4,4,1,2,6,1,8,3,2,2,4,2,0,5,0,1,3,2,3,2,3,3,3,1,0,0,4,6,3,11,0,0,0,5,2,0,1,0,0,0,1,12,2,1,0,3,0,4,0,2,4,1,4,2,0,0,0,9,11,2,0,3,12,1,0,4,0,0,5,8,0,2,0,0,0,2,1,2,2,7,5,0,0,0,3,0,1,0,5,15,1,1,1,3,3,0,4,10,3,5,4,0,8,4,1,6,0,0,2,2,0,11,5,6,3,2,1,0,0,0,2,1,1,2,0,6,7,2,9,4,4,0,0,0,2,1,4,20,0,0,1,0,2,0,2,3,1,3,4,6,0,7,0,0,0,0,1,0,1,0,0,1,12,5,1,0,0,0,0,1,2,4,4,6,1,6,0,1,1,2,0,3,7,4,8,10,7,2,0,2,0,0,0,8,2,0,0,1,7,1,0,10,0,1,3,39,4,0,3,4,0,3,2,11,2,1,8,1,6,0,4,0,2,1,5,0,0,5,1,0,0,2,5,0,0,5,3,0,1,4,2,2,4,0,5,1,0,0,10,5,1,2,2,6,1,10,0,3,0,3,4,0,2,7,4,1,2,1,1,0,3,5,1,0,2,5,0,8,4,1,0,0,1,0,6,1,0,3,21,2,8,0,3,0,4,0,0,2,0,2,0,4,5,9,3,0,0,3,0,0,1,3,0,3,1,2,6,0,5,4,4,0,2,1,1,0,0,4,7,0,0,1,1,0,1,0,1,2,5,0,4,3,2,0,0,0,3,1,1,2,0,0,45,3,0,7,2,0,10,0,5,2,0,0,10,0,2,2,3,0,1,2,4,2,1,2,0,3,0,0,0,18,4,6,5,3,1,0,0,5,2,5,3,3,4,0,0,7,0,1,2,0,0,5,0,4,0,0,3,0,1,0,1,4,2,3,3,4,0,2,0,0,15,3,0,3,9,0,3,2,3,0,2,2,1,4,4,81,0,2,0,2,0,0,2,0,0,0,3,3,3,0,3,0,5,1,8,0,9,0,2,3,3,8,1,0,8,5,4,1,0,9,2,2,0,0,1,1,0,33,1,0,4,0,1,0,1,0,6,0,8,3,8,1,5,0,5,1,5,0,1,0,0,1,5,5,0,0,1,11,1,0,0,0,1,15,0,3,0,0,2,6,1,0,0,0,3,0,0,18,0,4,4,0,0,0,7,2,0,5,0,37,1,3,0,0,17,0,1,0,2,0,3,3,6,0,0,4,0,0,0,5,0,3,4,5,1,1,2,30,1,0,10,0,0,1,10,0,0,0,0,0,0,13,2,3,1,0,4,6,1,2,0,0,0,0,4,2,0,6,0,1,5,4,7,0,13,0,2,0,0,0,5,0,6,1,6,1,10,0,0,1,0,7,3,0,0,0,2,0,2,0,7,0,0,1,2,4,0,1,0,0,3,2,3,34,1,10,0,6,0,1,2,3,0,0,9,2,0,0,3,0,2,0,0,3,0,0,2,8,1,4,0,0,0,5,0,0,3,9,0,1,0,1,2,0,0,4,0,165,4,1,1,2,2,0,0,11,0,2,0,4,19,0,2,1,1,4,0,1,4,5,7,5,1,0,6,0,1,3,3,4,4,9,0,7,0,0,2,5,6,2,6,4,3,2,3,3,3,7,2,3,0,17,2,7,1,0,4,4,0,1,0,0,0,1,4,2,0,0,0,2,7,1,0,3,0,0,13,1,3,1,0,7,0,2,0,10,0,0,0,2,1,0,0,0,1,1,4,1,1,3,6,2,2,0,0,2,2,5,1,0,4,2,0,0,2,8,0,0,1,17,0,5,0,0,12,1,2,0,0,3,1,2,1,6,0,0,0,0,0,17,2,7,4,1,0,0,3,0,6,0,1,3,1,0,4,0,1,3,0,0,0,2,3,4,0,5,0,18,1,1,0,0,0,0,9,0,1,5,0,2,0,0,2,5,0,0,5,0,5,10,5,2,0,15,0,3,0,0,10,0,6,0,3,5,0,0,3,1,0,2,3,4,2,1,2,0,0,0,1,0,3,0,0,0,3,15,0,0,1,5,6,3,1,2,0,0,0,3,0,0,7,18,0,0,1,10,17,5,1,0,1,0,4,11,4,5,1,19,1,8,0,3,3,0,5,0,0,0,11,0,5,1,61,0,5,17,0,5,1,4,0,6,3,1,3,0,1,1,2,0,2,4,3,0,0,1,6,0,6,2,0,3,1,1,3,0,0,4,0,0,6,10,0,0,7,1,1,1,0,3,3,0,1,0,0,0,2,0,3,3,0,0,2,0,2,0,0,0,3,29,0,0,0,8,2,0,0,1,0,1,0,0,0,0,1,2,3,1,0,3,2,1,0,3,0,1,0,2,0,1,0,0,0,0,4,4,0,0,0,0,0,2,2,0,1,0,0,0,1,0,4,0,3,1,0,7,0,1,3,2,3,5,1,0,0,1,1,4,19,0,1,0,2,0,2,0,1,3,0,2,4,0,3,3,1,0,4,3,1,3,1,7,1,0,0,0,2,4,1,9,12,3,1,0,3,0,0,3,3,2,1,8,0,1,0,0,1,2,2,0,1,2,2,2,0,4,2,0,0,2,6,1,0,0,0,0,9,1,1,1,9,8,0,11,5,2,1,0,1,1,0,5,2,10,2,0,2,4,1,3,1,0,0,0,0,182,0,1,0,2,8,0,0,17,0,2,7,2,0,2,0,0,0,0,4,1,0,0,1,2,1,0,1,1,1,2,3,7,3,0,0,0,0,0,0,0,1,4,3,5,1,0,0,11,7,2,11,0,0,0,0,0,0,4,0,0,3,12,0,1,5,0,1,1,1,1,1,0,1,0,1,7,1,0,1,0,0,2,2,4,0,0,9,1,0,2,1,3,14,0,1,7,2,2,2,3,3,0,0,5,1,3,0,8,3,48,1,6,0,1,0,0,4,1,1,0,0,0,0,3,2,0,1,2,1,3,0,0,2,0,0,4,5,1,4,3,0,1,0,9,0,9,0,3,2,4,1,1,0,2,2,1,0,3,1,0,3,4,1,2,2,1,0,3,10,1,3,6,1,5,2,0,1,0,5,0,0,0,2,0,6,1,0,2,3,6,0,2,0,6,0,0,1,3,1,0,0,1,0,0,2,0,4,0,0,2,1,1,1,0,46,3,0,0,0,1,0,0,1,2,0,0,2,1,5,0,1,11,4,1,4,0,1,1,0,0,2,5,3,5,3,0,2,0,4,0,6,0,0,2,2,2,3,1,1,1,9,14,0,1,3,1,0,1,0,2,0,1,1,0,2,0,0,0,0,2,5,3,1,1,1,0,5,2,1,5,0,0,0,4,3,1,1,2,1,2,2,7,16,0,5,0,10,0,0,11,1,1,1,3,0,0,0,2,0,0,2,10,21,4,0,0,1,1,0,0,0,1,0,7,10,10,0,1,0,1,3,0,0,0,0,6,3,5,0,7,12,3,1,2,0,0,1,4,1,1,4,1,0,0,2,0,1,1,0,0,0,0,0,2,0,0,0,3,9,0,1,0,0,0,2,0,0,4,0,5,0,0,0,1,1,1,9,0,4,1,2,0,2,0,3,0,0,0,3,2,0,0,6,1,0,1,0,1,1,4,0,0,2,1,1,0,0,1,1,0,1,0,7,3,0,2,4,3,0,0,0,1,0,0,0,1,0,0,0,1,1,1,6,0,3,4,1,3,3,4,1,2,0,5,0,0,1,2,1,1,1,5,0,1,0,6,4,23,0,0,0,0,0,3,11,0,7,2,1,0,1,0,4,0,1,0,0,0,0,3,3,0,8,10,0,2,1,5,115,0,2,1,0,4,2,0,0,0,0,0,0,0,3,0,0,0,0,0,2,0,14,4,2,0,1,1,3,0,4,2,7,4,1,5,0,8,0,0,0,1,0,3,12,0,4,0,2,7,0,16,2,3,0,1,1,1,4,0,10,0,1,2,0,1,0,5,0,0,0,0,3,1,0,0,3,2,1,1,10,2,0,1,3,1,0,1,7,0,3,0,0,26,0,0,0,0,0,5,0,0,1,5,1,0,1,11,14,0,0,0,4,0,0,0,0,1,0,4,7,3,1,0,0,0,0,0,0,0,13,1,0,0,0,0,0,0,4,0,0,0,1,0,0,0,1,0,0,0,0,0,0,0,0,0,1,0,0,0,0,0,0,0,0,0,0,0,0,0,0,0,2,0,0,0,0,5,0,0,0,0,0,0,0,1,0,0,0,0,0,0,0,0
"1999 HarrisT, Thomas, Hannibal",pop,8845,3296,2868,3039,2686,941,1866,2543,1400,1312,1523,1713,777,1101,1258,1178,781,1119,778,576,812,383,672,759,168,594,343,431,461,558,701,350,318,349,361,451,367,251,236,282,376,324,319,273,228,357,174,145,364,155,277,248,390,262,368,265,139,230,320,162,231,193,118,225,278,224,176,236,229,271,189,116,122,268,212,121,164,86,213,163,183,158,121,98,106,142,171,238,69,103,84,127,107,191,134,135,136,131,127,197,117,130,76,143,99,50,131,106,188,103,126,99,53,161,139,108,99,100,103,71,66,153,135,112,162,55,122,97,77,104,133,185,74,145,161,103,55,211,94,84,72,45,24,65,59,165,85,100,97,54,74,77,85,54,62,78,121,64,87,81,56,66,14,61,127,148,106,92,53,63,39,93,46,113,94,43,33,95,72,42,43,59,96,88,53,74,66,53,99,42,78,51,76,60,60,94,45,52,46,83,57,41,72,62,34,107,45,53,29,76,22,87,56,64,110,47,79,57,91,33,61,55,47,65,67,115,47,38,63,20,59,73,73,78,43,7,47,78,85,59,44,44,50,25,24,42,57,34,26,80,78,45,69,35,51,68,25,61,66,31,59,58,10,31,23,28,35,35,33,35,37,37,32,28,51,38,32,60,60,33,56,59,58,32,23,50,23,34,20,65,41,28,65,26,75,47,39,33,40,29,19,53,22,40,38,34,68,12,40,54,23,12,15,18,19,83,57,25,62,29,84,13,21,14,51,45,20,16,43,33,28,23,47,40,36,18,55,26,44,16,27,22,43,84,28,55,22,10,27,8,15,37,13,28,42,25,55,7,47,20,14,24,38,19,27,10,28,7,21,24,23,47,18,31,25,41,51,29,40,19,53,46,48,14,17,48,0,14,31,23,9,28,5,6,31,20,37,45,22,18,13,49,30,14,13,17,22,18,27,35,27,23,29,11,47,23,43,39,32,19,16,7,13,28,24,33,15,31,27,27,27,29,28,21,12,43,36,10,640,14,40,36,42,19,25,47,13,36,36,26,22,41,10,15,2,46,27,11,25,45,30,21,0,22,23,38,71,23,4,30,28,11,41,1,14,30,51,38,0,21,8,11,24,37,37,31,25,16,0,23,18,18,11,15,20,6,28,31,8,13,33,39,22,21,32,27,9,9,19,14,25,26,10,21,12,19,0,34,10,19,39,10,43,11,13,16,50,17,23,21,31,36,27,45,36,1,24,15,27,14,81,10,10,35,24,55,0,13,9,11,38,26,12,32,34,9,32,18,26,13,39,25,12,11,10,17,11,12,80,10,13,26,26,27,26,30,30,15,14,12,46,29,29,14,50,23,14,15,14,10,9,12,31,10,37,27,35,6,16,20,9,17,14,7,14,0,0,11,17,18,21,5,9,27,27,23,28,13,14,18,10,25,7,11,31,38,43,21,20,16,20,10,35,4,14,0,18,21,19,7,12,13,17,16,9,23,16,13,97,10,0,22,7,6,12,42,15,19,35,23,10,15,18,20,50,9,23,27,16,22,12,22,23,13,8,36,19,15,12,11,34,25,16,20,7,3,5,3,22,19,12,16,5,39,3,25,9,0,9,12,19,17,34,16,38,13,4,17,22,7,7,40,12,21,8,3,29,11,23,13,14,35,12,7,13,16,30,9,3,18,21,28,9,17,0,4,27,4,5,9,38,15,10,20,1,2,7,11,13,23,12,15,26,5,35,81,12,2,3,32,16,20,43,18,31,6,5,20,7,8,13,6,6,20,1,26,3,15,4,8,16,3,25,12,9,6,8,21,17,10,18,14,24,23,27,15,84,12,0,21,18,5,1,9,16,8,0,12,13,1,9,10,26,5,23,9,6,0,10,1,12,12,18,19,9,15,24,21,10,9,2,75,16,10,21,8,6,10,0,5,11,4,16,15,11,17,11,0,8,26,18,7,2,9,11,36,7,23,9,13,21,13,12,12,5,10,3,0,13,10,9,7,3,18,0,14,13,6,6,16,1,5,9,29,1,10,11,12,5,2,14,7,36,13,12,20,8,0,10,4,36,8,27,7,1,10,2,2,5,40,4,0,7,0,12,8,4,21,13,28,20,23,14,11,7,33,11,1,4,31,8,10,14,102,24,4,17,11,26,9,11,18,17,19,18,8,32,3,13,19,10,11,18,22,12,11,0,11,2,2,0,15,15,1,18,4,4,1,20,13,6,1,7,22,9,14,12,8,16,29,1,12,20,19,16,9,9,0,11,18,13,16,11,13,16,11,8,13,6,0,16,0,6,0,12,3,0,1,11,7,2,4,10,8,8,6,6,0,16,12,23,19,22,3,10,25,11,1,14,14,8,11,6,3,6,9,9,5,2,21,19,10,42,20,9,0,7,7,30,8,0,16,11,13,9,0,14,14,6,5,11,15,0,9,8,27,15,19,5,0,0,57,11,7,11,14,24,0,12,7,34,3,9,20,9,2,22,9,5,8,5,0,5,3,11,11,13,9,3,24,13,18,27,4,12,10,45,16,16,9,20,5,12,9,0,4,9,41,13,12,5,5,6,11,21,7,21,3,19,0,5,2,4,1,2,6,7,9,9,18,11,0,22,10,16,34,3,22,13,5,3,29,13,20,4,7,19,7,7,8,26,9,4,12,0,17,2,6,2,4,22,23,3,24,6,1,7,4,10,0,9,13,5,15,13,14,0,9,10,0,11,5,7,15,6,6,12,8,12,15,7,0,7,4,6,2,0,9,17,8,0,16,6,13,6,0,0,11,9,2,20,7,14,5,20,7,8,16,3,14,15,9,4,8,23,0,5,4,9,2,8,2,13,0,13,12,0,15,5,8,8,11,18,11,4,14,2,4,0,6,6,0,17,17,0,3,13,3,5,2,12,6,3,15,0,6,10,4,0,0,8,3,3,9,10,16,4,7,4,16,0,12,12,5,12,7,7,0,0,39,13,6,11,6,5,8,1,13,11,4,12,2,7,3,2,16,5,0,4,23,3,8,27,0,12,3,4,13,4,8,6,18,7,2,27,11,16,22,0,11,11,6,9,0,6,12,15,5,14,5,7,13,10,10,4,10,14,1,10,7,14,11,9,0,13,1,4,9,16,2,10,13,13,9,9,0,0,5,523,2,1,0,7,11,4,8,4,10,2,17,5,8,3,1,11,7,11,0,5,11,0,1,0,10,1,6,2,0,4,5,10,3,6,3,0,5,0,11,12,4,6,20,5,5,3,13,7,7,11,0,5,10,671,0,4,14,2,14,3,8,9,4,33,0,0,13,14,12,11,17,12,3,0,4,7,0,8,35,16,1,5,12,8,0,5,14,8,0,8,7,1,7,7,7,0,14,4,2,8,13,5,8,10,1,11,17,9,7,2,2,4,7,10,13,10,1,0,0,1,15,4,0,0,0,0,2,0,5,9,12,4,6,3,28,6,5,10,0,3,4,1,9,9,2,5,4,6,3,0,6,12,13,13,14,1,0,8,1,4,7,3,4,2,3,3,8,3,0,6,8,6,4,8,2,20,4,3,25,7,9,8,5,2,3,9,10,9,6,3,4,3,6,6,0,28,8,4,11,0,14,7,4,10,26,3,6,7,4,0,6,0,3,3,0,0,10,7,0,2,11,0,13,0,1,4,15,6,4,7,12,6,10,4,3,7,10,0,9,0,20,27,4,4,0,3,2,10,21,4,0,0,18,4,7,17,18,1,12,13,4,5,21,8,5,0,7,3,2,4,4,0,10,6,2,3,7,9,13,4,13,11,8,5,6,3,11,3,0,5,6,1,1,11,8,4,1,18,6,1,6,0,3,4,2,10,3,14,1,10,9,10,0,11,5,3,24,12,1,8,3,10,3,5,12,4,13,8,2,4,8,5,4,3,2,10,9,12,4,0,10,6,7,14,8,12,14,1,11,8,12,3,16,7,0,9,7,8,4,12,1,18,3,11,3,0,6,6,1,6,2,6,5,1,1,12,0,0,5,9,3,27,6,1,6,7,5,7,7,1,0,8,5,0,0,9,7,3,18,1,7,3,4,8,3,12,5,10,11,2,6,14,0,0,4,3,1,4,7,3,6,2,4,3,9,3,4,8,4,1,2,8,4,4,4,4,13,14,0,10,6,3,15,0,0,6,6,1,7,0,0,0,2,4,9,0,3,6,9,0,0,1,4,318,7,3,7,3,7,13,4,4,4,10,3,2,18,13,9,9,7,8,9,10,3,7,7,5,4,0,4,5,1,0,4,9,2,6,15,7,2,87,2,5,15,3,8,3,10,1,5,1,3,0,0,5,15,7,2,4,4,0,8,2,8,0,1,5,4,0,9,0,8,12,0,5,1,2,5,1,9,1,0,0,3,8,6,12,14,1,7,13,3,0,5,2,0,5,11,0,19,18,7,0,13,0,4,8,7,1,3,6,4,2,2,1,5,0,4,13,17,2,5,11,8,0,2,12,3,6,7,8,4,0,0,2,0,7,17,1,3,1,2,5,5,8,1,0,5,6,3,11,1,2,3,8,16,4,1,2,4,4,1,6,4,8,12,18,5,2,4,4,2,25,5,3,6,21,5,8,4,8,47,3,1,3,0,3,9,14,0,7,6,0,3,1,8,6,10,5,7,4,2,3,0,0,7,8,2,6,6,2,8,7,4,2,2,3,0,11,2,14,3,10,4,2,8,3,3,7,3,0,0,1,7,0,3,1,4,12,0,2,4,5,8,7,5,2,3,13,1,4,5,2,5,16,1,0,0,9,6,3,1,10,8,5,2,0,1,4,9,5,4,3,0,7,0,1,9,0,0,5,0,4,8,0,0,17,8,26,7,4,2,7,0,0,3,3,7,7,5,0,12,0,3,1,3,12,8,0,15,0,4,10,0,8,0,6,3,5,5,0,12,1,3,5,5,10,2,13,15,2,2,3,0,5,0,0,11,8,1,1,0,0,2,5,6,3,7,8,0,11,2,1,10,4,3,1,9,11,8,0,1,9,5,5,11,0,1,1,12,8,8,8,10,7,7,7,1,6,4,3,4,0,0,2,6,9,4,11,5,0,3,4,9,1,8,10,0,4,0,9,0,5,0,5,8,4,0,4,1,5,4,1,3,4,16,3,10,4,43,0,1,0,9,15,3,0,3,1,0,1,0,14,4,0,2,1,1,1,4,6,2,2,7,5,2,7,8,2,9,7,1,2,2,4,8,2,4,13,10,3,6,5,1,0,19,7,2,4,14,5,0,2,7,5,2,4,2,8,4,1,6,0,0,3,2,2,8,3,3,0,6,3,2,3,6,8,2,4,12,0,1,2,8,28,12,4,9,0,34,1,6,1,6,3,4,3,1,4,5,2,6,4,0,3,11,2,10,2,2,7,1,5,6,0,0,2,4,12,4,0,2,0,6,3,0,12,3,7,0,1,5,1,7,3,21,0,0,2,7,5,1,11,0,0,4,4,2,4,1,4,3,4,2,2,28,2,2,0,0,7,8,5,1,11,0,0,5,7,0,13,2,5,3,3,3,3,1,1,3,0,2,0,4,4,0,6,0,1,4,2,8,3,3,1,3,3,1,1,4,3,4,3,10,0,4,0,0,0,0,0,2,3,0,2,7,0,3,1,4,1,12,3,3,0,6,4,0,5,2,3,2,1,4,1,7,5,6,4,5,3,2,11,3,3,4,0,0,23,1,1,3,0,2,0,2,0,2,3,9,2,6,8,4,10,16,0,3,6,1,6,2,6,3,1,0,7,5,8,0,1,0,6,8,5,2,8,2,7,3,2,15,0,2,6,2,6,5,0,2,6,0,0,0,6,11,0,6,1,3,1,0,0,7,0,0,10,4,0,1,1,3,2,4,2,2,3,4,0,3,6,2,3,5,4,11,2,4,1,1,4,0,2,4,14,10,4,0,2,3,5,2,29,0,1,2,6,7,7,10,2,5,12,7,0,8,1,5,3,6,0,3,0,6,3,5,0,3,1,1,6,0,15,3,9,0,0,4,2,0,0,3,2,0,5,1,7,1,1,2,4,5,2,4,4,6,5,8,3,4,7,9,1,17,7,5,3,3,3,0,2,1,1,4,2,4,0,0,7,9,6,308,3,4,4,0,3,2,11,1,3,1,0,0,8,2,29,7,0,4,3,10,5,7,6,2,0,0,2,9,1,1,5,3,4,0,5,1,1,0,3,0,2,5,5,0,14,4,7,1,6,0,1,7,1,0,1,2,1,1,0,0,1,7,2,0,3,0,4,2,3,0,0,2,0,2,1,10,5,9,0,8,0,0,4,0,2,0,1,7,1,5,2,3,0,1,2,5,4,16,4,7,5,1,1,3,4,2,15,10,1,4,3,4,0,0,10,1,6,5,8,0,0,8,4,5,4,1,1,2,0,6,2,2,7,9,0,3,3,14,0,1,7,1,3,7,3,1,3,0,10,2,7,2,6,6,0,1,0,11,0,0,2,12,9,5,0,3,4,4,0,8,1,1,0,6,0,11,0,1,2,2,1,3,2,4,0,0,2,0,3,0,2,6,8,3,8,6,2,2,4,4,7,5,0,3,2,3,1,1,6,2,0,0,0,8,0,0,3,0,3,2,8,6,0,3,4,6,3,9,0,0,1,0,0,3,0,7,0,6,0,3,2,7,4,2,3,2,5,0,0,1,5,5,3,2,5,2,0,0,1,7,1,0,0,4,0,0,1,0,0,1,3,0,5,1,0,1,4,8,0,3,3,2,13,1,0,4,0,3,5,0,1,5,3,2,1,11,2,2,0,0,0,1,2,3,3,6,0,10,4,0,0,2,5,2,2,0,14,2,1,1,0,2,0,0,0,0,7,5,4,3,4,7,3,0,7,2,5,0,0,7,0,4,13,4,1,6,3,12,3,2,0,2,3,8,4,2,4,1,5,2,3,1,8,8,1,5,1,4,0,5,0,5,5,10,2,13,2,2,5,0,1,3,4,0,1,2,9,1,18,1,9,4,3,0,0,0,2,0,6,95,3,4,5,5,1,4,1,1,2,2,1,3,2,1,4,1,3,2,2,3,0,3,0,1,9,3,5,2,0,5,11,14,2,0,0,1,0,18,0,3,0,0,3,0,4,3,0,2,2,5,2,6,0,3,7,0,1,2,5,2,14,0,0,0,0,5,2,1,0,0,6,0,2,7,3,3,2,6,3,0,0,0,5,6,5,4,1,0,2,0,19,5,2,1,1,0,2,0,1,3,0,4,0,8,0,0,12,3,2,0,5,5,2,0,11,1,1,2,0,2,2,1,4,2,6,0,1,0,1,0,4,8,0,2,1,2,1,7,4,0,2,1,1,0,4,1,6,0,4,2,1,3,0,3,1,2,14,4,0,3,0,0,3,4,1,1,5,1,3,5,1,4,3,0,1,1,2,0,1,6,2,0,9,11,0,10,0,10,2,1,1,6,3,2,1,5,4,0,5,1,3,3,0,1,0,2,4,2,3,4,5,5,1,2,3,3,3,2,0,1,0,0,2,0,6,6,1,0,3,4,2,5,4,7,0,25,2,5,3,1,1,10,0,3,7,3,1,8,4,0,1,1,7,1,1,0,1,0,1,0,1,2,4,7,4,1,3,5,2,0,1,0,4,3,5,5,2,0,3,0,3,5,1,3,2,2,0,1,7,5,2,1,3,4,0,1,4,10,1,9,5,2,0,2,1,0,1,2,0,4,5,1,2,1,0,2,0,0,0,6,3,3,0,7,1,13,3,4,1,0,1,5,6,0,0,1,0,0,9,2,2,4,5,0,1,9,7,0,3,4,4,3,0,0,1,0,7,3,0,0,3,0,1,1,3,224,5,0,0,5,7,0,5,1,2,4,0,1,2,0,4,3,0,0,2,9,8,1,1,8,7,8,1,3,0,0,13,1,0,1,1,8,0,0,2,4,0,4,3,0,0,1,0,4,1,0,1,0,1,3,3,4,5,2,1,3,0,3,3,5,1,0,0,0,0,0,2,3,2,2,3,4,7,2,2,1,8,1,1,6,5,2,2,8,1,0,0,1,3,0,0,0,5,0,3,4,2,3,3,2,3,0,7,2,5,0,2,5,2,4,1,4,0,0,4,0,5,1,0,2,1,3,0,4,1,2,4,0,0,3,0,4,4,5,7,5,0,3,2,0,0,0,0,3,0,2,5,7,5,0,1,4,3,2,9,2,1,0,13,5,4,4,0,9,5,0,3,16,0,4,2,2,4,9,5,0,4,2,1,9,0,10,10,1,0,3,6,1,3,0,4,7,1,0,2,6,0,1,18,2,2,0,2,4,1,0,6,5,0,0,3,0,2,3,0,0,6,2,4,0,3,4,3,1,3,7,2,1,5,1,0,0,0,2,1,2,1,2,1,1,1,1,2,2,3,3,0,1,0,0,4,0,5,0,1,6,3,0,2,2,1,1,1,0,1,4,0,1,3,0,1,1,0,6,2,10,4,1,1,0,3,3,1,10,0,3,2,1,1,0,0,3,0,0,2,3,3,0,5,3,3,0,1,11,7,0,0,2,3,8,0,0,4,0,0,0,2,9,14,1,6,1,2,1,0,5,0,0,2,2,2,4,0,0,0,1,7,4,0,4,1,0,1,1,0,2,10,3,4,5,0,0,7,1,1,0,3,3,0,1,1,1,0,4,2,0,4,1,5,0,1,3,3,7,2,0,9,15,7,1,5,1,0,0,7,0,1,1,0,3,2,1,8,1,2,0,2,2,2,6,1,3,0,3,3,0,1,3,1,12,0,1,7,0,13,1,0,4,1,7,6,6,46,3,1,1,3,0,6,3,5,6,2,7,1,1,4,1,1,0,0,4,0,0,7,4,0,0,2,2,0,4,1,0,0,4,4,2,3,1,1,1,3,1,1,0,1,178,2,1,1,0,1,5,1,13,1,0,0,0,2,1,3,0,1,1,4,1,5,0,4,0,3,1,5,3,5,2,0,4,0,1,0,0,2,2,0,3,1,0,5,0,0,4,0,4,2,0,5,4,2,0,0,1,0,4,1,2,0,0,3,0,0,0,0,0,0,1,10,0,14,0,8,1,0,1,1,3,7,0,2,0,1,1,0,2,1,0,3,1,4,7,2,3,1,0,1,3,0,1,0,1,0,4,2,6,1,1,2,0,1,0,0,2,0,8,3,2,1,1,3,4,2,2,3,0,0,4,8,1,4,0,19,164,10,3,3,0,1,1,0,2,2,3,4,1,2,4,5,0,1,1,2,5,3,4,0,0,5,0,1,2,2,6,0,1,1,1,2,1,1,2,2,0,5,1,6,0,0,4,1,2,1,0,3,2,1,0,2,1,5,3,5,0,1,6,0,0,1,0,0,3,1,3,3,2,2,3,1,0,4,1,2,2,2,5,3,5,4,1,4,3,0,0,0,1,8,0,0,0,0,0,1,1,3,1,164,0,1,22,7,5,1,0,1,0,1,0,10,7,8,1,2,1,4,2,0,0,2,13,2,1,1,0,5,0,8,3,0,33,2,1,1,0,1,0,2,0,1,0,3,0,3,0,0,2,5,1,0,1,14,7,3,0,0,1,2,1,6,2,0,5,1,3,4,1,0,1,2,1,9,5,0,2,0,3,0,3,2,0,0,2,3,3,0,0,1,2,2,9,2,1,1,34,13,2,1,8,0,0,3,3,0,2,3,2,0,9,2,2,0,0,0,2,5,2,1,3,1,1,0,1,1,1,1,0,0,1,4,3,0,5,0,3,4,0,6,0,1,1,3,0,0,0,2,3,1,7,2,2,0,0,1,0,7,7,10,2,4,0,1,1,4,2,4,0,0,0,4,0,3,0,2,3,5,3,2,0,0,0,0,0,1,2,3,7,1,1,0,1,5,6,4,8,1,4,1,2,2,0,0,0,6,0,1,2,1,6,1,1,3,0,2,1,0,4,1,64,4,0,1,1,1,1,2,4,1,1,3,2,0,0,1,3,2,0,6,4,1,0,19,0,5,6,23,0,3,0,2,0,3,1,2,0,4,2,3,0,1,0,0,2,3,1,4,2,2,4,1,4,0,2,10,5,3,5,3,0,5,4,3,1,1,0,3,0,0,2,1,3,1,3,0,1,2,6,2,10,4,5,0,1,1,0,4,0,0,1,4,1,0,3,0,4,1,5,2,1,2,0,2,1,0,3,1,11,0,3,0,0,2,0,0,2,1,0,2,0,3,0,9,8,1,1,0,0,2,0,0,0,2,1,1,0,1,2,3,1,1,1,0,1,1,0,0,0,1,0,1,2,1,0,12,0,1,0,1,0,0,2,1,2,0,0,3,5,4,3,0,0,2,1,1,2,0,3,0,0,3,2,2,0,2,1,1,1,1,0,1,5,1,1,0,0,0,7,0,3,0,0,6,4,1,2,0,0,0,3,2,0,3,0,1,3,0,0,0,0,2,0,2,3,1,5,1,2,0,3,3,5,0,0,6,0,1,6,0,5,0,6,3,0,3,1,6,1,1,0,0,2,9,1,10,6,4,3,1,1,4,5,1,3,1,3,4,2,1,1,1,0,5,3,1,0,9,0,2,1,0,6,3,1,4,3,7,0,4,1,0,18,10,1,5,2,0,4,4,4,0,0,1,1,0,0,5,1,1,6,4,2,0,0,4,0,2,13,1,1,0,0,2,1,5,2,0,6,9,1,1,1,4,0,0,3,6,0,1,6,3,0,0,1,3,4,4,1,0,1,0,123,14,3,1,0,0,3,0,1,4,0,5,3,1,5,5,2,11,0,2,3,1,0,2,2,0,4,5,2,2,4,5,5,1,1,0,0,7,1,1,0,0,2,1,2,2,1,2,0,8,1,1,2,1,2,2,3,1,0,0,4,3,0,2,5,0,0,12,2,1,0,3,1,3,0,0,3,0,1,1,2,0,6,1,0,3,3,0,1,1,4,2,3,2,2,1,0,1,1,0,1,0,0,4,1,0,2,0,4,1,1,1,0,3,2,0,2,1,2,0,1,6,4,2,1,0,0,0,2,1,3,2,5,0,0,1,0,2,1,10,0,2,0,4,0,2,1,0,1,0,12,2,0,1,0,5,0,0,0,2,4,11,0,0,4,0,0,1,0,1,0,2,3,2,0,0,0,2,0,0,0,1,0,0,2,0,0,1,0,0,4,0,0,2,4,0,0,0,0,28,0,0,0,0,0,1,0,0,4,0,0,0,0,7,0,0,0,0,0,0,0,0,2,0,0,5,0,0,1,0,0,0,0,0,0,0,0,0,0,0,0,0,0,1,0,0,0,0,0,0,0,0,0,0,0,1,0,0,0
"2000 Coulter, Catherine, Riptide",pop,4131,2497,3042,2085,1614,1650,2362,1408,1951,1435,1862,1239,1499,2133,2185,789,625,577,561,1010,771,767,430,954,322,436,691,288,574,464,302,487,435,446,493,439,319,707,262,306,316,359,516,577,414,314,180,378,319,479,371,256,248,254,216,90,203,410,352,658,284,375,331,513,331,201,65,302,232,236,293,358,184,199,297,223,129,455,159,355,164,301,153,320,100,231,137,157,237,182,123,196,116,118,172,138,151,77,189,117,123,85,215,102,165,41,183,188,248,142,157,146,112,175,81,122,144,151,67,98,32,121,85,131,85,161,101,112,203,164,101,93,172,92,128,114,54,123,107,148,203,228,222,224,126,74,105,41,88,158,37,320,77,105,147,252,55,43,85,62,113,103,174,100,49,35,30,60,71,81,44,77,65,155,86,18,55,46,49,81,73,168,151,97,120,23,166,117,67,32,111,20,77,34,51,80,119,32,89,34,102,24,84,45,42,56,50,63,149,117,111,52,39,121,116,16,77,51,67,50,31,25,78,16,87,54,55,75,66,205,78,72,58,110,48,197,68,40,59,46,57,109,36,81,46,83,40,62,57,120,29,17,10,62,75,56,43,72,36,28,42,59,118,26,60,36,66,28,48,33,32,18,61,23,51,79,30,67,50,52,36,24,49,63,11,21,55,67,43,23,85,13,127,66,64,24,52,52,71,82,46,47,65,34,25,67,10,30,25,6,88,16,35,15,12,45,59,21,77,78,22,88,45,41,53,43,89,66,24,26,27,100,27,25,12,39,32,14,27,36,19,35,45,24,49,23,61,124,12,53,74,42,36,37,34,12,15,83,32,13,41,38,33,18,9,58,53,86,49,25,22,97,33,50,31,52,16,74,9,61,54,70,16,59,34,32,0,38,61,26,21,32,18,104,23,44,63,28,30,54,12,27,45,39,21,12,22,30,25,34,43,48,32,34,62,30,49,44,26,15,22,26,16,17,47,29,64,20,54,39,52,30,22,21,7,31,20,20,16,31,20,13,65,38,71,12,44,34,24,20,7,31,96,25,68,31,58,9,10,30,31,2,0,13,27,16,31,10,18,102,10,119,22,3,19,31,16,10,0,18,24,31,52,57,21,42,16,14,25,12,27,10,15,13,4,41,36,36,6,92,16,84,13,15,25,32,22,13,13,35,17,59,21,16,25,16,0,24,47,36,21,35,41,46,31,20,44,42,29,32,1,23,13,66,19,0,20,34,35,11,32,15,52,12,16,8,0,3,13,17,12,18,9,26,35,20,48,25,4,18,11,11,30,43,17,18,17,20,10,132,43,33,39,14,16,4,23,4,12,13,17,21,19,12,1,30,39,9,9,8,22,20,17,11,52,29,1,16,15,20,61,12,6,7,25,0,0,41,24,21,25,3,26,9,7,19,12,2,4,8,16,13,24,12,38,32,6,18,11,3,18,40,26,10,35,0,11,16,21,16,18,23,15,3,47,29,15,11,10,18,0,21,18,28,15,14,15,17,4,3,20,22,17,22,49,16,4,26,6,18,49,36,4,25,14,10,51,2,11,20,20,13,30,15,18,25,1,7,26,1,16,7,3,30,52,12,6,0,12,9,13,2,18,16,51,26,37,13,10,6,2,28,0,14,6,33,14,16,8,23,43,2,4,2,27,22,6,5,4,9,22,12,13,3,0,28,16,4,6,19,19,5,87,10,1,0,7,16,13,1,1,27,14,11,21,14,17,26,44,2,5,29,24,27,2,5,27,11,9,15,5,5,0,16,0,8,35,17,2,17,17,3,9,12,18,5,20,4,8,36,2,6,1,10,11,5,54,14,1,10,31,1,10,20,14,10,6,21,53,1,3,30,16,4,4,8,3,0,16,12,6,14,26,25,3,12,18,6,12,7,2,3,12,14,1,14,15,18,0,12,6,18,7,0,41,2,25,0,11,5,26,24,1,7,2,3,3,4,5,17,11,8,10,23,13,4,10,0,15,8,7,4,19,12,0,5,2,4,12,9,14,26,9,8,1,26,15,34,12,16,10,16,1,15,7,33,4,0,3,1,10,5,13,6,7,4,26,8,19,9,11,0,18,0,8,5,4,12,6,54,13,2,11,15,7,12,1,1,38,1,1,21,26,0,11,10,1,12,8,6,5,2,8,2,14,3,4,8,9,2,15,5,17,10,1,17,15,20,8,3,0,25,21,200,4,16,0,1,4,12,6,0,6,24,0,6,5,9,11,20,317,17,13,4,3,2,14,0,5,4,16,4,21,3,10,5,0,5,7,0,8,0,15,0,1,18,0,0,8,30,5,12,21,0,20,11,4,576,7,12,13,14,7,48,0,2,3,9,3,8,7,6,5,2,12,3,15,31,27,18,28,13,12,5,25,11,19,10,1,9,19,10,23,5,5,0,28,8,16,7,3,7,203,4,8,29,11,7,0,0,0,67,4,7,2,8,6,23,6,15,5,0,4,15,1,2,3,12,18,2,3,0,6,12,7,5,16,32,18,5,2,6,3,26,3,13,13,14,8,15,3,4,3,6,0,0,0,1,6,7,17,0,1,4,4,9,5,18,5,0,14,34,2,3,7,11,14,0,4,6,1,16,7,3,4,6,9,8,16,1,21,23,4,5,20,1,2,5,1,3,1,6,1,8,0,4,0,9,1,0,127,5,1,7,8,22,0,3,1,1,2,0,5,7,5,4,0,5,37,0,6,10,0,14,3,8,6,8,0,44,7,620,8,5,3,3,0,4,12,5,3,12,16,5,4,0,0,11,2,2,6,6,22,4,5,4,16,5,4,2,7,9,4,17,10,0,25,4,2,4,2,2,11,0,3,3,1,4,5,6,1,0,28,14,11,1,9,22,0,5,8,0,3,15,0,2,25,0,6,6,3,1,8,3,0,11,0,13,0,17,6,15,11,22,3,2,23,2,6,1,0,3,3,8,33,2,7,2,0,2,9,1,13,4,16,9,1,2,3,3,1,0,8,1,0,2,2,5,0,2,14,15,1,0,6,8,15,8,1,22,0,6,14,4,10,9,15,10,4,8,3,8,11,0,9,16,1,6,5,1,13,1,8,8,5,0,10,5,6,2,2,7,4,0,5,11,3,10,5,9,4,4,14,0,4,0,0,15,0,55,2,0,1,9,7,13,1,3,9,5,0,8,3,0,3,5,2,0,8,6,0,0,0,3,0,12,0,0,1,3,6,14,4,5,0,2,2,6,0,33,10,2,3,11,4,24,6,1,8,7,11,7,0,0,6,11,0,15,14,0,6,2,7,9,0,35,2,1,24,2,5,5,0,1,9,0,8,2,7,8,12,15,2,29,0,0,7,0,8,4,7,12,10,9,12,2,18,1,4,1,4,7,0,4,1,11,12,0,3,29,29,4,8,7,10,7,0,18,0,1,6,166,6,0,0,2,0,25,3,1,7,2,3,11,2,9,2,0,13,5,11,14,16,3,4,6,2,8,3,4,9,2,8,3,15,0,11,1,7,3,9,6,3,7,5,3,2,0,10,3,5,8,5,15,5,4,9,1,8,9,30,0,15,2,4,0,4,23,7,6,7,7,5,0,2,18,8,6,6,7,2,12,10,4,14,8,27,18,8,12,0,7,19,0,0,13,1,0,3,14,0,2,0,3,2,5,7,1,11,12,6,4,8,0,3,3,0,2,0,1,4,3,2,0,2,6,0,2,2,2,12,5,0,4,0,1,7,14,6,2,8,15,5,2,36,38,0,4,6,0,3,3,8,1,2,7,0,8,3,8,5,11,3,2,3,4,8,0,3,5,0,14,11,1,6,9,5,3,0,5,24,1,4,5,0,1,49,11,11,9,3,0,0,0,5,1,7,1,10,1,22,0,9,5,3,8,10,11,0,2,6,4,3,1,1,6,11,3,0,6,2,3,7,2,2,1,7,1,5,10,2,8,4,0,0,13,15,2,4,6,5,1,12,3,0,3,0,1,3,12,5,4,2,2,1,9,0,7,3,8,3,5,2,0,3,2,2,9,7,0,2,2,1,1,4,2,0,14,1,2,1,0,2,4,2,6,3,5,7,2,0,12,0,3,0,2,4,4,1,5,1,0,3,7,14,3,11,3,2,12,1,0,2,27,0,12,2,0,3,3,8,4,0,0,0,1,0,2,0,0,0,2,7,3,0,4,13,13,0,1,2,0,0,14,0,7,4,0,3,12,0,3,2,8,0,2,3,2,1,3,2,8,0,0,6,6,3,1,0,4,1,7,0,1,11,4,0,2,7,2,0,3,7,7,3,0,2,2,3,11,0,5,0,0,1,0,11,3,0,1,0,42,13,2,0,1,7,2,0,0,0,8,4,1,5,0,11,1,3,6,7,0,0,4,13,6,7,0,0,5,67,5,0,6,0,0,7,3,0,4,8,1,0,1,0,3,10,3,0,11,0,8,20,11,0,0,0,3,3,7,2,9,1,2,4,0,2,13,1,3,0,9,10,0,3,8,4,2,7,2,0,2,1,4,18,10,7,2,2,4,3,1,3,26,1,0,2,8,2,2,6,26,1,3,3,3,2,3,4,6,5,13,0,7,8,3,4,0,0,4,3,0,3,5,14,0,1,12,3,0,1,6,4,5,0,0,2,0,3,1,0,2,0,0,0,1,1,1,4,3,1,5,5,2,2,8,8,20,1,0,6,0,0,7,6,3,0,1,1,3,2,0,0,6,0,0,8,2,0,3,2,2,5,0,6,7,0,0,0,2,7,2,8,8,2,3,0,0,14,4,0,0,3,2,3,2,0,2,4,6,13,6,0,2,3,0,0,3,0,0,30,0,8,7,0,0,3,0,2,5,1,5,10,3,0,2,2,10,7,3,5,3,2,0,3,4,0,0,0,0,0,2,1,0,0,244,0,0,3,3,0,11,0,3,6,2,5,1,4,4,2,0,1,0,1,0,0,1,1,0,1,23,0,0,0,2,3,3,4,9,2,5,4,8,4,1,1,0,1,5,0,0,2,1,1,7,0,0,5,4,0,6,5,1,8,1,0,1,3,5,1,5,1,0,0,1,1,1,0,4,4,0,4,2,8,1,1,0,2,0,5,0,3,2,12,1,10,3,2,0,7,3,1,5,5,4,1,0,2,1,12,4,4,3,6,4,0,4,13,0,0,0,2,3,0,0,1,1,7,3,5,1,16,7,0,3,2,1,2,0,3,1,4,1,5,0,0,4,1,13,8,1,1,2,1,1,2,2,7,0,4,4,8,1,12,6,3,0,10,4,0,0,0,6,0,2,4,6,0,11,0,3,4,1,1,0,3,4,11,1,2,4,2,1,0,0,1,4,8,6,4,0,0,5,0,0,4,2,0,0,0,4,0,0,5,9,2,0,3,7,2,4,2,6,1,0,0,3,1,6,0,2,0,1,0,0,0,2,1,1,0,2,2,2,7,2,0,0,7,2,1,0,4,0,0,0,2,4,5,0,1,6,1,6,6,4,0,0,0,2,0,1,1,1,0,0,0,1,2,0,0,2,4,17,42,2,2,6,4,2,0,3,0,0,1,0,21,0,8,3,1,0,6,4,0,0,0,0,4,2,1,0,1,3,2,4,1,10,4,0,0,4,0,0,9,1,0,0,2,1,0,2,0,6,0,4,4,0,1,2,2,0,4,2,7,2,1,3,2,0,1,2,0,7,2,4,0,0,1,1,1,1,0,0,0,2,0,3,11,5,6,0,0,6,3,3,31,3,1,3,0,0,2,16,6,1,5,6,5,7,7,0,13,10,2,3,5,5,0,1,9,5,0,4,1,0,7,2,0,1,3,1,1,8,1,2,0,0,0,0,1,0,0,0,0,0,2,5,0,0,3,7,1,3,2,1,2,1,9,2,0,1,2,13,0,3,1,0,2,1,4,1,4,11,6,0,7,0,5,0,4,0,5,0,6,4,3,2,2,0,2,0,1,5,0,1,4,2,12,2,0,3,0,6,1,4,0,0,2,0,2,0,2,1,0,0,14,0,0,0,0,3,3,9,3,9,6,0,1,2,2,1,2,8,5,11,2,3,6,4,1,1,2,0,3,1,1,0,0,0,2,11,0,1,0,3,0,4,7,1,0,0,0,7,7,0,1,2,0,4,9,7,2,9,0,0,14,0,0,2,2,6,3,0,4,7,0,7,0,0,0,7,1,3,0,1,4,1,1,0,0,0,1,5,0,3,0,0,2,2,0,0,0,1,3,0,0,1,1,4,0,0,0,3,2,0,4,0,2,2,1,0,0,2,0,1,9,14,6,5,5,3,0,12,0,0,1,0,1,1,1,5,2,0,0,0,2,0,2,0,0,1,17,0,1,0,1,3,12,1,3,6,5,1,0,0,0,0,1,0,0,6,2,2,3,2,5,0,2,1,3,1,1,0,2,1,0,1,1,1,6,4,2,0,3,0,5,3,1,0,0,0,9,0,0,1,11,0,0,0,0,77,1,3,4,1,4,4,5,1,0,0,1,3,0,0,0,0,4,0,3,0,0,1,0,2,1,0,17,0,0,0,14,1,0,4,0,2,6,0,0,3,21,0,1,2,3,2,0,1,0,1,2,0,0,0,0,0,4,0,0,0,0,4,0,1,1,5,9,0,0,1,6,2,0,0,0,0,0,0,0,2,0,0,0,11,0,0,1,6,0,0,2,0,0,6,2,1,0,0,5,7,2,0,7,0,2,6,3,0,2,0,1,0,2,1,0,0,1,8,0,1,0,0,2,3,2,0,10,0,0,0,1,0,0,5,2,1,0,0,0,0,2,2,0,5,1,2,0,0,1,0,0,0,5,6,0,0,12,1,0,2,1,0,0,0,0,0,2,2,5,0,1,0,0,4,0,1,2,4,0,1,10,0,0,0,2,4,0,0,0,1,8,5,0,7,0,2,1,4,0,1,1,0,2,3,1,0,2,1,0,0,0,0,3,1,0,0,2,3,0,0,6,10,2,0,0,0,10,4,0,0,3,8,4,6,41,0,1,2,1,1,5,1,3,0,1,4,1,3,0,0,0,3,1,1,22,1,1,2,0,1,0,0,0,1,0,2,10,1,13,0,1,0,1,0,7,1,4,3,0,8,0,4,1,0,0,0,0,0,2,1,0,1,0,0,7,0,3,4,2,2,3,0,0,2,0,1,1,6,0,1,1,0,1,1,0,2,1,2,1,0,0,3,0,4,2,1,6,1,2,0,7,0,2,4,0,190,1,1,0,3,2,1,2,0,1,5,0,0,1,0,0,0,0,5,0,0,0,0,1,7,2,6,8,1,1,0,0,0,1,8,1,3,4,0,0,3,0,2,3,0,0,1,2,0,2,2,1,0,0,0,1,0,1,0,2,2,1,6,0,0,0,0,1,1,0,0,0,2,1,0,1,1,6,1,1,0,0,3,0,2,8,0,0,6,0,0,0,1,2,0,0,1,4,5,0,2,3,2,0,0,0,0,0,2,0,1,3,2,0,14,2,0,0,4,0,1,0,0,0,2,0,0,0,0,0,1,3,0,2,1,2,0,0,0,0,5,1,1,0,0,4,0,0,1,0,2,5,1,2,0,0,3,1,5,0,0,0,2,10,1,0,6,0,2,2,1,3,3,4,8,2,2,0,0,0,3,8,0,0,0,9,1,1,0,0,4,0,0,0,0,5,0,5,3,0,2,12,1,0,0,3,0,0,0,6,8,1,2,0,1,1,5,4,1,4,2,0,0,0,0,7,0,6,1,4,0,1,2,9,0,1,2,0,0,0,6,1,0,0,1,3,0,2,0,0,0,4,3,0,0,5,3,0,0,0,0,3,8,0,0,0,2,0,3,2,0,4,0,0,0,1,0,2,2,0,0,7,1,1,1,2,0,4,0,0,0,0,7,0,0,0,2,1,0,4,0,2,3,0,2,1,1,1,1,0,2,0,1,3,0,0,4,0,3,0,0,2,0,3,2,0,2,0,1,0,2,0,3,3,4,1,2,0,2,1,12,1,1,2,1,1,0,0,0,3,1,0,1,0,1,0,9,1,2,3,0,2,4,0,0,0,0,1,1,3,1,0,0,2,1,7,0,1,0,3,0,0,0,0,2,1,0,3,0,0,22,0,0,0,6,1,0,1,0,2,0,0,0,0,0,3,0,4,6,1,1,0,0,0,0,0,0,0,4,0,1,0,4,0,0,6,0,3,1,1,0,2,0,0,1,6,2,0,1,1,0,1,1,0,0,0,2,11,0,0,2,14,2,0,0,0,2,0,0,8,1,8,0,2,0,1,0,6,0,0,1,0,0,0,4,0,2,1,2,1,0,6,1,3,1,1,0,1,0,0,1,1,0,1,1,0,1,2,2,2,0,10,7,5,2,0,1,0,3,3,0,0,1,1,5,3,0,1,0,0,3,2,3,5,0,0,0,0,4,1,0,1,0,7,0,3,6,0,0,2,2,2,0,2,0,1,4,6,0,0,3,0,5,3,1,0,1,0,0,0,0,6,2,0,0,2,0,1,0,0,1,0,0,1,1,5,1,0,6,2,0,2,0,2,1,2,0,0,0,0,0,2,0,0,1,1,0,14,1,0,0,0,0,5,0,0,0,0,0,0,0,1,0,2,3,1,0,0,1,1,2,13,0,0,2,0,0,0,0,1,1,2,4,0,2,0,0,9,0,2,0,3,3,0,0,3,6,0,1,1,5,1,5,2,0,0,1,3,3,6,0,0,0,1,0,1,2,8,6,5,0,5,4,2,3,11,2,10,0,0,0,0,0,2,16,0,0,0,2,2,3,0,0,0,0,1,5,0,0,5,2,1,1,2,3,3,1,0,1,0,1,2,0,0,0,1,0,0,0,3,0,0,13,0,2,0,0,0,0,8,0,0,1,1,0,1,0,0,0,1,1,3,0,2,3,1,2,11,0,0,1,3,0,1,0,2,2,1,0,0,1,1,2,0,0,0,2,0,6,0,1,1,0,4,1,0,1,1,0,0,0,3,1,2,1,2,0,0,2,0,2,3,0,3,1,0,0,0,0,0,0,4,0,0,0,1,0,4,0,2,6,1,1,2,0,0,0,10,0,0,1,1,2,1,0,0,0,0,2,0,4,0,0,4,1,0,5,0,0,0,0,4,2,0,0,15,1,1,0,3,0,0,3,0,0,4,3,3,0,1,0,3,0,0,0,6,1,0,1,0,10,0,0,1,1,0,1,0,0,0,0,0,0,5,1,0,0,0,0,1,0,0,4,5,1,0,0,1,0,0,3,0,0,0,0,1,2,2,1,0,5,4,0,1,0,0,0,2,0,0,1,2,1,0,0,0,2,5,0,1,2,5,0,2,0,1,0,0,0,2,0,0,0,0,4,0,1,0,0,1,1,2,1,11,0,0,0,0,4,2,1,3,1,1,8,4,3,0,0,0,1,0,0,0,1,6,0,0,4,2,1,0,0,1,0,0,0,0,0,1,0,2,0,0,3,4,1,1,0,0,6,0,0,0,0,4,0,0,0,0,3,0,0,1,0,0,0,0,0,0,0,2,1,1,0,6,0,9,2,0,1,3,5,0,1,1,5,0,4,2,1,1,4,0,2,1,14,2,4,2,2,0,1,0,0,5,4,0,0,0,0,0,6,0,0,0,0,0,2,0,2,1,2,0,3,1,9,1,2,0,1,0,0,1,1,1,0,0,0,0,0,6,1,0,0,0,0,2,1,0,1,0,0,0,2,0,0,1,0,1,0,0,2,1,0,1,1,0,2,0,0,1,5,0,2,1,0,1,0,2,3,0,0,3,2,1,0,4,0,0,0,2,5,0,0,1,0,0,1,0,0,2,1,2,4,2,2,0,3,0,4,1,0,0,1,1,0,14,0,2,0,1,0,0,0,0,0,0,0,1,1,4,0,4,0,0,3,0,0,0,1,0,0,1,1,1,0,0,0,2,1,1,0,2,0,1,2,1,0,1,0,3,0,0,2,1,3,0,2,1,4,0,3,1,0,0,0,0,3,1,0,0,0,1,0,2,0,2,2,7,10,2,0,1,0,0,2,2,4,0,0,5,1,2,1,1,5,3,3,2,0,0,2,0,1,4,0,0,0,1,0,2,4,1,2,0,1,0,0,0,1,2,0,8,0,0,1,0,0,6,11,0,4,4,0,1,0,0,0,2,0,0,0,2,2,4,1,2,5,0,0,0,0,0,0,0,0,2,1,1,0,0,0,6,0,0,2,0,1,0,4,3,0,4,1,0,0,2,0,1,0,1,0,1,0,3,0,0,0,0,0,0,3,1,0,0,0,0,0,1,0,1,0,0,1,5,2,0,1,0,1,0,0,0,0,1,0,0,1,1,0,3,1,1,0,0,1,0,2,0,2,0,2,1,0,1,1,2,4,0,2,0,0,0,1,0,2,0,0,0,0,0,9,4,0,0,0,1,0,0,2,6,2,6,2,0,1,1,0,0,1,6,0,0,0,0,0,2,2,2,0,0,4,0,0,1,1,0,0,0,0,2,0,1,0,0,1,2,0,0,0,1,1,0,0,0,2,7,0,0,0,2,0,0,0,3,0,0,0,0,1,1,1,0,0,1,3,0,3,1,0,3,0,0,2,0,1,1,1,0,0,1,0,0,0,0,1,0,0,0,2,1,1,0,2,3,0,2,3,0,0,2,1,0,3,1,0,0,0,2,0,0,0,3,0,3,0,0,0,1,0,1,1,0,1,0,0,1,0,2,0,0,0,1,0,0,1,0,0,0,1,0,1,0,0,1,0,1,0,0,3,2,0,0,1,1,0,3,0,0,4,0,0,0,0,4,0,0,0,0,18,0,0,1,0,0,1,1,1,0,0,0,0,1,2,2,2,0,0,0,2,0,0,1,0,0,2,0,0,0,0,5,0,0,0,0,0,0,0,0,0,0,0,1,1,0,1,1,1,5,0,0,0,0,0,2,0,0,0,2,0,0,0,0,7,0,0,3,0,0,2,0,0,0,0,1,0,4,2,0,1,1,2,0,2,0,0,0,0,1,0,0,2,0,0,2,1,0,0,3,0,1,0,0,2,2,0,0,1,1,1,0,5,0,1,2,0,2,0,0,0,0,0,0,1,0,1,0,1,0,0,1,2,1,0,0,0,0,0,0,0,2,0,0,0,5,0,0,0,0,0,0,1,1,1,0,0,1,0,0,0,0,0,0,0,0,0,0,0,2,0,0,0,0,0,0,0,0,0,0,0,0,0,0,0,0,1,0,0,0,0,0,0,0,0,0,0,0,0,0,0,0,0,0,0,0,0,0,0,0,0,0,0,0,0,0,0,0,0,0,0,0,0
"2000 Evanovich, Janet, Hot Six",pop,3843,2487,2158,2060,1105,3109,821,1219,1271,823,1240,535,520,338,320,715,327,474,529,953,485,337,147,370,1031,267,691,142,486,324,214,298,306,316,377,405,244,202,332,202,232,303,229,286,277,272,86,244,127,189,289,86,190,261,149,97,119,248,246,244,146,316,94,131,231,130,36,181,157,112,267,287,125,119,319,77,102,244,189,173,192,180,78,110,101,211,68,88,56,131,28,176,82,96,153,58,137,68,159,54,51,71,214,42,93,35,77,50,209,81,83,54,69,108,49,243,82,99,44,48,133,37,100,87,78,94,49,134,41,79,48,47,89,114,71,47,46,32,80,95,209,47,49,137,60,100,95,51,96,85,50,45,64,47,59,100,56,46,33,14,42,35,104,67,81,11,20,56,51,73,128,19,39,96,287,25,35,37,40,79,59,65,14,35,63,90,71,32,52,25,97,19,30,25,21,51,28,46,45,3,78,22,40,23,54,17,50,62,36,105,104,42,33,45,28,10,38,13,26,39,30,14,33,26,49,35,72,19,85,38,24,41,28,8,25,18,58,57,43,18,48,74,27,31,32,45,32,35,60,65,55,16,24,53,40,56,39,28,30,14,23,106,45,34,17,16,26,27,19,34,43,39,26,33,109,33,21,24,34,22,57,44,31,17,16,66,30,29,25,17,46,7,66,6,22,28,26,45,37,50,62,28,72,39,0,52,52,7,23,2,12,101,12,21,20,16,44,19,24,59,18,80,10,30,15,59,23,51,15,77,25,16,36,40,20,59,13,4,14,27,26,18,31,74,16,23,28,59,11,63,13,14,47,27,30,34,17,25,16,13,16,8,23,17,16,21,9,11,23,22,13,58,26,62,11,25,13,16,15,28,26,22,11,20,12,27,0,7,15,24,79,8,15,63,20,23,16,9,17,46,13,5,38,32,8,31,19,35,32,27,42,21,13,44,14,1,7,22,19,21,40,1,7,32,17,11,18,12,16,50,26,11,25,38,0,42,38,2,0,22,22,32,5,14,14,24,5,9,22,16,15,4,19,26,62,21,16,2,11,31,31,8,0,4,14,36,10,0,6,28,9,6,11,1,35,10,17,45,0,19,6,22,28,91,1,17,18,4,61,30,24,11,10,22,7,9,32,25,5,4,30,27,20,11,4,31,13,10,23,27,12,12,7,4,18,18,0,24,0,15,17,5,13,49,8,16,13,16,26,31,0,14,24,20,1,1,14,2,3,0,15,8,25,29,53,6,1,3,9,32,10,10,7,0,14,8,2,11,2,67,82,34,8,16,18,16,9,5,10,4,22,8,16,25,5,18,7,5,12,19,13,13,21,28,0,10,1,31,14,11,7,9,9,2,25,23,0,24,12,19,10,25,4,3,21,0,0,19,8,26,14,6,6,11,6,13,20,3,2,14,23,31,4,18,17,15,23,30,5,13,53,10,34,7,10,0,15,14,1,14,12,0,19,16,26,25,11,3,2,14,0,9,12,17,8,9,6,7,9,8,29,8,17,14,4,15,13,17,9,11,5,14,2,0,6,21,13,2,14,6,24,34,10,16,14,15,9,3,4,2,14,16,12,10,20,4,1,8,4,2,13,6,11,10,7,7,12,23,15,1,1,12,3,1,7,10,8,6,22,14,59,6,3,1,8,10,8,14,2,4,4,7,11,1,0,20,4,6,8,7,6,9,3,28,1,1,11,7,47,1,6,28,7,10,11,1,20,21,7,0,4,4,6,6,25,6,10,3,3,4,2,2,70,19,0,1,3,0,6,5,5,9,2,1,4,5,14,5,14,21,8,4,0,27,3,0,0,10,0,7,19,16,3,3,2,4,7,2,3,18,9,1,4,0,4,6,4,0,4,3,7,3,3,5,17,7,12,3,10,7,11,7,0,21,1,6,8,6,0,6,5,7,13,2,3,2,16,288,14,9,3,5,7,0,2,0,12,3,0,10,17,1,21,5,1,1,0,0,28,4,16,10,2,8,0,15,4,12,6,4,16,11,13,14,2,10,5,23,9,8,6,5,4,16,10,4,2,2,2,3,9,10,6,8,13,24,5,13,3,26,9,0,9,0,13,5,2,7,1,8,4,0,6,0,21,1,1,0,9,9,5,6,2,0,2,9,14,18,20,27,5,12,36,12,8,2,4,5,2,7,5,5,6,43,4,2,5,9,4,5,0,5,1,0,13,8,2,2,2,13,7,43,2,3,1,4,0,11,41,3,0,10,12,3,56,0,3,0,5,19,17,2,4,8,4,5,0,6,8,0,5,0,10,3,5,7,0,0,2,5,1,16,9,2,28,5,4,0,13,10,16,6,20,0,0,12,1,9,2,4,30,24,3,5,7,11,3,6,8,1,13,2,14,12,6,5,22,1,5,10,0,10,3,9,1,0,7,8,1,3,8,6,0,14,6,10,8,6,0,0,0,6,20,2,2,6,12,0,4,2,7,2,21,5,0,27,4,1,2,4,9,0,4,6,3,4,9,4,19,10,29,15,9,17,9,7,5,6,2,0,1,3,5,0,0,28,6,2,3,5,3,10,2,7,0,10,17,0,0,2,31,11,1,1,3,0,4,11,5,3,2,4,3,4,2,0,3,13,10,3,9,1,4,5,3,1,0,14,0,4,1,6,1,19,0,15,8,1,0,182,0,7,5,7,6,8,0,4,4,0,1,4,13,2,12,18,0,5,1,0,4,3,0,4,2,19,1,8,0,0,12,0,9,2,1,3,0,6,13,5,0,8,0,0,2,0,0,2,24,4,2,12,25,3,6,9,1,13,2,4,4,3,1,6,17,0,7,4,2,4,2,3,4,0,3,3,0,8,7,7,3,2,12,6,2,18,4,7,0,4,14,0,6,13,0,9,2,3,19,5,1,1,23,2,0,2,16,3,0,1,7,6,15,2,4,6,13,5,9,1,0,1,6,5,9,8,13,3,0,1,9,4,8,0,17,11,2,0,3,1,0,0,3,0,2,8,4,2,3,3,2,16,5,0,5,5,4,3,1,9,1,2,2,5,2,3,1,0,26,6,4,6,3,0,1,5,7,0,3,1,4,1,0,3,3,0,6,1,6,6,24,2,1,0,1,0,6,7,8,0,21,1,0,3,6,0,0,9,0,10,0,0,12,0,4,4,1,4,1,6,0,2,3,0,2,2,5,0,11,1,0,273,0,2,3,1,2,0,3,48,9,5,2,11,2,4,3,8,2,13,27,9,2,14,4,5,14,0,7,18,7,2,0,0,10,1,0,7,10,4,7,1,0,14,0,3,0,12,1,7,3,11,0,3,6,0,0,2,10,1,5,2,2,0,12,2,5,0,8,4,6,1,3,2,0,0,2,3,3,1,9,6,8,1,33,2,0,10,2,6,9,2,16,3,3,3,0,0,0,2,1,0,0,0,0,0,0,1,6,2,2,1,2,1,3,11,0,0,1,1,0,4,0,8,6,0,19,9,2,1,0,4,0,19,9,0,3,4,0,7,5,10,4,3,9,11,4,0,7,3,4,3,1,3,10,4,3,2,0,5,10,2,4,6,5,2,17,40,0,8,4,2,1,0,1,13,3,8,1,4,1,2,8,3,3,1,20,8,1,2,0,2,15,0,0,2,2,0,2,19,0,0,0,7,1,2,2,0,13,1,2,2,1,0,4,3,0,1,0,5,4,5,9,1,3,1,1,0,5,0,1,3,0,14,11,12,1,1,1,2,4,4,1,2,0,0,1,1,5,0,27,0,3,2,1,5,1,26,3,1,16,4,1,1,7,1,8,0,1,2,24,0,7,2,3,9,1,3,0,2,19,12,3,0,0,0,6,1,4,7,2,0,10,2,4,0,4,1,3,1,1,1,2,0,2,4,0,4,1,0,7,0,2,3,17,3,9,1,0,5,0,1,1,27,10,0,1,0,5,1,2,3,2,0,7,2,11,7,1,10,1,4,1,4,0,1,1,0,4,0,11,2,0,2,0,3,0,5,4,5,1,0,2,0,2,3,5,0,10,0,1,0,0,1,4,27,11,2,0,6,1,0,8,5,17,1,1,0,3,1,4,2,217,6,1,3,3,3,7,4,0,0,0,10,1,0,0,2,2,6,3,1,2,0,4,7,2,0,8,5,1,2,0,0,3,5,0,0,0,0,0,0,2,13,1,6,4,4,0,4,3,3,0,2,0,2,3,1,4,5,0,1,3,3,4,0,1,2,4,1,4,0,6,0,1,0,0,4,1,1,0,2,0,3,5,2,5,10,3,8,0,1,1,14,0,7,2,1,3,8,6,4,0,2,0,3,18,2,0,2,0,1,12,1,0,0,5,1,0,1,0,4,0,0,3,2,0,4,2,2,8,0,0,4,0,3,0,4,2,6,1,15,190,4,3,0,1,1,0,2,2,2,0,3,0,2,17,2,6,16,0,10,1,0,0,0,0,2,1,4,6,6,1,7,1,0,1,3,6,2,2,1,0,0,10,2,1,1,2,4,5,0,7,3,9,5,7,3,3,1,1,14,2,0,0,0,8,0,1,1,1,0,5,14,12,2,2,10,1,5,4,7,0,4,0,3,2,2,1,0,1,1,1,1,11,0,4,3,0,0,2,2,0,3,0,0,0,4,1,2,9,3,1,0,0,8,2,2,5,2,3,4,8,0,8,4,4,11,0,2,1,1,2,1,1,1,0,4,1,5,0,1,0,3,0,0,8,2,1,0,12,4,7,1,0,3,0,0,0,5,1,0,10,0,0,2,7,0,0,1,0,0,4,2,1,0,0,0,3,3,6,1,3,1,3,0,0,1,0,0,1,0,2,1,0,0,3,0,6,2,0,6,8,21,0,4,4,2,4,4,3,4,1,0,0,2,1,0,0,0,0,7,0,0,0,0,0,5,2,4,0,4,0,1,1,25,10,7,0,2,3,0,8,2,1,0,0,0,11,1,1,0,0,0,1,0,6,2,1,0,3,4,2,1,0,2,4,1,2,0,0,1,0,0,0,0,0,0,1,3,0,4,3,1,10,0,0,0,1,3,1,3,5,0,1,6,7,3,3,11,3,1,4,1,14,0,0,2,2,0,4,0,2,5,6,1,5,5,0,8,0,1,0,2,4,0,1,3,0,2,6,0,5,4,2,0,4,0,2,0,0,0,4,0,4,2,4,2,4,0,2,2,3,3,0,1,3,2,1,8,4,2,0,4,9,2,0,8,0,0,1,0,5,3,1,3,3,2,9,0,1,1,6,1,2,1,1,5,2,0,2,5,0,0,0,1,1,2,0,0,0,10,3,3,1,0,1,1,4,1,10,0,0,3,1,1,2,2,0,2,0,2,4,1,3,2,7,1,0,0,0,1,3,2,9,14,4,0,0,0,0,0,11,3,0,0,0,15,8,4,0,8,45,9,0,0,1,0,0,4,0,3,1,1,0,1,2,0,0,4,1,0,2,0,0,5,5,2,1,1,0,0,0,1,0,1,0,1,0,1,0,0,7,0,0,0,0,5,1,0,1,3,6,3,4,0,3,2,6,0,0,4,4,0,1,0,0,1,1,6,0,0,1,3,0,1,0,0,3,2,2,4,5,3,0,9,5,1,1,5,0,2,1,0,1,0,0,1,0,5,0,1,10,0,0,5,2,0,2,5,2,0,2,0,5,0,0,3,0,0,0,0,3,7,2,0,0,0,0,0,1,2,0,2,0,3,1,5,1,2,1,1,3,3,1,3,6,0,3,1,3,0,6,10,3,0,13,2,3,11,1,165,1,0,0,8,2,1,0,0,0,1,0,1,0,2,1,5,0,4,1,0,0,4,2,0,0,0,0,0,4,0,0,0,14,0,1,1,0,0,3,3,3,4,0,1,1,8,0,3,1,0,0,0,2,3,0,1,0,0,4,21,4,1,0,0,4,0,1,0,0,0,1,2,1,3,1,0,3,2,1,3,0,1,0,0,2,2,9,2,0,2,0,0,8,0,0,1,0,0,0,5,3,12,0,2,0,0,0,0,0,8,1,4,5,3,1,1,2,2,1,0,0,6,2,1,1,2,0,2,3,0,0,0,0,0,0,1,4,0,2,2,0,4,0,6,0,0,2,3,1,0,2,8,2,0,2,4,0,5,3,2,0,0,1,0,0,2,8,0,2,3,3,0,1,0,0,4,3,4,2,1,1,1,0,0,4,1,1,0,2,0,1,4,0,0,1,1,7,0,0,0,1,2,1,0,9,0,2,2,0,0,0,2,0,0,0,133,2,2,0,0,0,1,0,0,2,0,0,4,1,3,0,3,7,0,3,2,2,1,6,1,0,2,1,0,1,0,0,0,0,3,1,0,0,0,1,4,0,1,0,0,1,1,0,0,1,0,0,2,15,5,1,4,5,1,3,6,3,3,3,0,0,0,1,0,4,2,1,0,0,0,0,0,2,3,0,3,2,0,3,0,0,0,0,2,0,0,1,2,0,0,1,2,1,4,2,2,0,5,1,0,2,5,0,0,0,4,0,1,1,0,3,6,0,0,0,0,2,0,0,0,0,2,1,1,0,5,7,0,0,0,0,0,1,1,2,3,0,3,1,2,1,0,0,4,0,0,1,0,1,0,11,0,12,1,0,0,0,3,0,0,5,0,0,1,1,1,1,1,0,7,0,0,1,4,2,1,5,0,0,2,1,0,4,6,0,2,1,0,1,12,1,1,0,0,0,3,1,9,3,0,0,107,6,7,0,1,1,0,0,3,4,2,0,0,3,1,0,1,0,0,3,0,0,8,0,0,0,2,0,0,1,2,13,1,1,3,0,0,1,0,0,1,1,0,0,0,5,0,0,9,2,0,0,1,0,1,5,1,3,0,4,0,1,3,5,0,0,1,0,0,0,2,2,0,3,0,1,0,1,1,1,1,0,4,0,2,5,1,5,1,5,1,1,1,0,2,4,1,0,0,0,1,0,0,0,1,2,5,4,0,1,2,15,1,3,1,0,1,2,1,0,0,0,4,0,0,5,0,3,83,0,2,7,3,0,0,0,0,2,1,0,0,8,0,0,7,0,1,1,3,0,4,0,3,0,1,3,8,2,1,5,0,8,0,2,1,2,3,0,1,0,1,0,0,3,14,0,4,1,0,0,1,6,0,6,0,0,0,0,1,1,1,1,0,0,1,0,1,0,1,1,2,2,4,0,1,0,1,0,4,0,1,1,5,2,3,0,5,2,0,0,2,2,2,0,0,1,6,0,1,2,0,1,20,0,0,6,1,1,0,2,0,1,0,3,1,0,0,0,0,0,0,0,0,0,0,1,0,0,1,0,0,4,0,1,1,1,4,2,0,2,1,3,5,0,0,0,0,0,0,0,1,1,0,0,0,0,1,0,0,0,0,0,1,0,1,0,0,2,0,0,0,1,0,1,0,0,2,1,0,4,1,1,0,0,3,0,1,3,1,1,2,0,5,0,2,5,0,0,0,0,3,1,2,14,1,0,2,2,0,4,1,0,0,0,0,0,3,0,1,0,2,1,1,1,1,0,0,2,2,2,2,2,0,0,0,0,0,0,6,1,0,0,0,0,0,1,4,3,1,0,16,2,1,0,0,0,4,1,3,3,0,1,4,1,1,1,0,2,0,3,0,1,5,2,0,1,22,1,1,3,1,5,0,1,0,0,0,0,7,1,1,2,4,0,2,2,1,2,0,2,1,2,0,0,0,0,0,0,3,4,1,1,1,5,0,0,1,0,0,11,0,0,2,0,5,0,1,1,0,3,0,0,0,0,3,0,0,2,2,11,0,0,0,0,0,2,1,0,0,3,0,0,0,0,3,2,0,0,0,1,2,0,1,0,0,0,0,0,0,0,0,0,2,3,1,0,0,0,0,2,0,11,0,0,0,0,1,0,3,1,0,1,0,2,0,0,0,0,0,4,0,0,0,0,1,0,2,1,0,0,1,0,0,1,0,0,0,3,0,4,2,3,0,1,5,0,0,4,1,0,1,0,1,0,0,3,3,0,2,0,0,1,0,1,0,0,0,0,1,3,1,0,0,2,0,1,1,3,0,2,0,1,0,1,0,0,1,3,1,0,0,0,0,0,0,0,0,8,1,0,2,3,0,0,0,3,0,0,0,0,0,0,0,1,0,7,0,1,0,4,0,0,0,0,5,0,0,1,1,1,0,0,1,0,0,0,2,2,0,0,0,0,3,0,0,1,0,0,1,1,0,0,0,0,0,1,0,0,1,0,0,0,26,0,2,3,1,0,0,0,0,0,2,3,0,1,0,1,2,3,0,5,0,0,0,0,1,0,0,0,0,1,0,3,0,1,0,1,0,0,0,0,0,0,1,10,0,3,1,2,0,2,1,1,0,1,5,3,1,0,52,0,1,9,3,2,0,3,0,4,0,0,0,0,1,1,1,1,0,0,3,0,0,3,0,1,0,5,1,1,0,0,0,2,0,0,1,0,0,1,0,0,0,4,0,0,1,0,0,0,0,1,5,0,0,5,0,0,0,0,1,0,0,1,0,7,0,0,0,0,1,48,2,6,0,0,0,1,5,0,0,0,1,0,0,1,0,3,1,0,2,0,0,0,0,0,0,2,0,6,0,0,0,0,0,0,0,1,15,4,0,0,1,1,8,0,1,1,1,2,0,0,0,0,0,1,4,1,0,0,0,0,1,0,0,2,0,0,0,0,3,0,5,0,0,0,1,0,1,7,0,1,1,1,0,0,6,0,0,1,0,0,1,1,0,0,0,1,1,1,2,0,5,2,0,1,0,2,8,1,0,0,0,1,4,2,2,0,0,0,0,0,0,3,0,0,0,6,0,3,2,2,2,91,1,1,2,1,0,0,1,0,5,0,1,0,0,2,1,1,0,1,0,2,0,0,0,1,0,0,0,1,0,0,0,0,0,0,0,0,0,8,0,0,0,0,0,0,0,0,2,0,3,13,1,0,0,0,0,1,3,0,0,0,0,2,0,1,0,0,1,1,0,0,4,6,2,0,0,2,0,0,1,0,1,0,0,6,5,0,0,1,1,0,2,0,1,10,0,1,0,0,0,2,5,1,0,0,0,0,3,1,1,1,0,0,1,0,0,0,0,0,0,0,2,0,0,1,0,0,0,6,1,0,1,1,4,0,2,0,0,0,0,3,0,1,0,0,0,3,0,0,1,1,2,0,1,4,1,0,0,0,1,0,7,0,14,1,0,1,0,0,0,0,2,2,6,3,0,0,1,0,0,0,2,3,5,0,0,2,0,0,1,0,0,0,0,0,0,0,0,0,3,3,2,0,1,0,0,0,0,0,0,1,0,0,4,0,0,1,0,2,1,2,3,9,0,0,3,0,5,0,0,0,0,0,0,0,0,0,0,0,1,0,0,6,0,3,2,1,0,1,1,0,3,2,1,1,0,0,2,0,1,0,1,0,0,0,0,1,3,0,0,0,0,0,0,0,0,2,0,1,0,0,0,0,0,3,3,1,25,4,0,0,0,1,0,2,0,2,0,0,0,1,0,0,0,1,0,2,1,0,0,0,3,0,0,0,0,2,0,1,20,0,6,1,1,0,0,0,2,5,4,0,53,0,0,0,0,0,4,1,3,0,1,0,0,0,0,1,2,0,2,0,0,1,0,0,0,2,1,1,0,0,0,0,1,0,0,1,0,1,0,0,0,1,0,0,0,1,0,0,0,1,1,1,1,0,0,0,0,1,2,0,0,0,1,1,0,0,0,0,0,1,0,0,0,0,0,2,0,5,0,0,0,3,1,0,0,1,0,0,7,1,1,1,15,2,4,5,0,0,4,1,0,0,1,1,0,0,0,1,0,0,0,1,3,0,0,2,1,0,2,2,0,1,0,2,3,1,0,9,0,0,0,1,0,1,0,0,0,0,1,1,3,0,0,0,0,0,2,1,0,4,1,0,0,1,1,0,0,1,0,0,0,0,0,1,0,0,3,0,1,1,0,2,0,0,2,2,4,1,0,1,0,0,0,0,5,0,0,0,0,1,0,17,0,0,0,0,0,1,0,0,0,3,2,0,0,0,0,1,1,0,0,0,1,0,4,1,2,5,0,0,6,0,0,1,0,1,1,8,0,0,0,1,6,0,0,0,2,0,0,0,0,0,2,1,0,0,6,0,0,0,3,0,1,0,0,2,0,0,0,1,2,1,1,2,2,2,0,0,2,0,1,0,1,0,0,0,3,0,0,0,0,0,0,3,0,0,0,0,0,0,5,0,0,0,0,2,2,0,0,1,0,0,2,0,3,1,0,3,0,0,0,0,0,0,0,1,0,0,0,2,1,1,0,0,0,0,1,3,0,1,0,2,0,0,0,0,0,0,2,1,0,0,1,5,1,1,0,0,0,0,0,1,1,0,1,2,0,3,3,0,2,0,0,0,4,2,1,0,0,0,0,2,1,0,0,0,2,1,1,0,0,5,0,0,1,0,1,0,0,0,1,0,0,0,0,0,0,1,3,1,0,0,4,0,0,3,0,0,0,2,2,2,0,0,0,0,1,0,0,0,1,2,2,0,0,1,0,0,0,0,0,0,0,1,0,1,0,0,1,0,0,0,3,0,0,1,0,0,0,0,0,0,1,0,0,0,0,0,1,0,0,0,0,0,0,0,0,0,0,0,0,0,0,0,0,0,0,1,0,0,0,4,3,2,4,0,1,0,0,1,0,1,8,2,0,0,0,0,1,0,0,0,0,0,2,0,0,0,3,0,0,0,2,0,0,7,0,0,0,0,1,0,0,2,0,0,0,0,0,1,0,0,0,0,1,0,0,1,1,0,0,1,0,0,0,2,0,0,2,0,0,0,0,3,0,0,1,0,1,0,0,1,3,0,0,0,1,0,0,2,0,0,0,0,0,0,1,0,0,0,0,0,0,0,0,0,6,0,0,0,0,0,0,0,1,0,0,1,0,0,1,0,0,0,1,0,0,2,1,0,0,1,0,0,1,0,0,0,0,0,0,0,0,0,0,0,0,0,0,0,1,0,0,0,0,2,1,0,0,0,0,0,1,0,0,1,0,0,0,0,0,1,2,0,1,0,0,0,0,0,0,0,0,0,0,0,0,1,0,0,0,0,0,0,0,0,0,0,0,0,0,0,0,0,0,2,0,0,0,0,0,3,0,0,0,0,0,0,0,0,1,1,0,1,0,0,0,0,0,0,2,6,0,0,0,0,0,0,0,0,0,0,0,0,0,0,0,0,0,0,0,0,0,0,0,0,1,0,0,0,0,0,1,0,0,0,0,0,0,0,0,1,0,0,0,0,0,0,0,0,0,0,0,0,0,0,0,0,0,0,0,0,0
"2001 Connelly, Michael, A Darkness More Than Night",pop,7878,3212,3039,2497,2157,1381,2861,1678,2032,1673,1610,1363,1334,658,660,1278,1039,724,651,503,902,530,571,605,164,434,324,401,463,462,501,554,646,482,577,391,432,302,396,385,316,196,471,284,490,319,264,284,347,383,433,254,280,306,275,299,321,333,257,283,370,260,210,192,205,281,120,271,218,267,200,207,140,193,260,132,174,254,130,185,161,203,173,192,151,385,134,166,86,119,96,170,95,167,165,173,131,136,101,207,75,69,228,85,138,80,130,130,161,167,140,52,66,127,112,183,105,165,108,90,148,73,185,152,115,128,109,130,191,144,134,150,117,170,96,41,44,93,121,106,106,83,47,92,127,184,88,90,119,77,95,48,138,68,83,70,53,115,94,55,82,56,60,67,74,60,45,121,74,83,27,78,49,112,73,80,55,77,112,73,53,73,134,102,58,87,88,43,94,52,87,82,37,64,28,66,13,103,48,46,45,31,115,62,89,129,96,54,44,37,10,34,34,56,45,50,82,59,44,60,61,66,76,86,123,38,42,96,80,42,95,59,51,40,55,7,46,65,47,33,85,46,52,39,36,24,61,53,41,47,37,41,23,72,16,45,79,33,47,18,43,71,33,35,68,11,59,16,65,31,24,39,18,71,28,26,25,44,42,35,44,128,38,44,43,30,34,44,36,22,78,14,111,15,54,96,44,53,22,36,19,44,90,50,56,34,27,14,69,19,35,10,48,52,20,62,63,15,40,57,12,63,33,21,10,29,22,23,52,87,80,26,46,42,9,41,18,5,57,42,22,49,31,118,56,74,21,62,46,41,31,61,36,27,28,20,240,21,27,32,40,168,31,15,56,42,32,64,33,23,20,26,38,24,42,26,79,17,20,26,36,17,16,55,28,28,819,28,17,24,6,47,40,100,30,31,28,47,21,26,4,38,73,32,47,34,30,14,41,21,13,20,17,10,14,12,26,50,14,17,34,0,3,21,44,50,10,40,26,28,45,15,49,11,0,7,27,32,7,27,58,32,33,19,37,44,16,19,39,21,33,7,5,17,11,27,19,100,25,22,39,13,20,21,24,23,1,16,2,18,32,36,31,4,25,37,3,27,0,24,26,26,14,23,6,5,38,6,51,57,10,46,7,15,18,19,32,37,2,11,20,28,46,25,31,25,8,18,60,18,20,15,12,4,14,15,0,26,7,29,14,4,25,24,15,24,16,14,31,32,9,22,25,18,37,0,11,11,63,76,6,14,22,10,12,17,0,1,21,20,26,56,18,6,55,12,33,20,33,45,17,17,33,3,16,41,6,0,32,6,3,23,36,31,14,36,33,16,17,10,10,34,18,9,16,6,11,28,12,3,17,31,42,15,5,11,5,68,17,13,8,12,16,9,11,5,115,4,52,14,12,32,12,21,10,15,5,10,22,8,10,17,5,16,11,27,52,26,6,27,17,39,6,2,26,0,11,33,25,8,7,11,14,23,28,9,52,23,2,9,0,18,20,19,7,7,10,13,18,0,17,9,20,27,3,13,2,8,6,29,8,21,20,1,19,12,4,6,8,25,27,36,11,7,13,10,108,12,7,3,9,12,22,33,13,20,3,10,16,2,17,23,3,14,21,2,10,11,15,12,4,32,0,10,10,8,13,4,21,20,23,3,3,31,3,8,12,6,7,29,14,11,4,9,20,3,15,35,3,15,2,24,5,13,0,1,17,15,23,8,2,6,5,4,40,17,25,0,11,3,34,6,12,4,19,5,16,5,20,11,27,6,3,11,0,40,0,7,1,12,3,8,14,16,18,5,12,24,11,8,43,6,1,2,18,29,12,20,0,7,8,2,2,8,10,25,2,21,16,28,16,18,13,4,20,16,6,0,22,3,24,20,8,8,16,10,10,31,5,21,3,22,1,9,11,9,2,45,0,4,7,15,4,10,14,9,12,0,8,12,5,5,5,9,6,6,5,21,19,15,10,21,29,9,8,22,6,0,1,8,31,10,6,12,0,0,31,11,0,11,4,11,14,15,20,15,13,16,18,2,19,30,5,30,9,17,14,5,2,2,10,5,17,27,1,4,15,24,7,10,6,0,15,0,7,3,5,11,11,10,10,0,3,10,5,7,9,4,17,7,23,8,1,1,8,3,8,8,11,22,23,21,5,16,5,2,16,3,6,42,20,9,9,17,0,24,5,16,4,4,0,4,2,1,10,7,18,0,8,21,17,1,12,12,2,4,6,22,15,20,3,5,11,59,14,7,7,0,9,3,5,40,16,5,1,4,0,24,5,0,8,0,6,14,0,4,0,0,2,7,14,21,82,1,6,4,1,4,25,16,16,9,21,127,3,39,3,2,1,6,14,11,2,10,2,2,10,2,2,8,12,4,27,6,12,2,21,0,0,21,6,16,0,8,6,0,5,4,2,0,4,2,0,63,11,5,11,11,0,865,0,18,44,8,11,6,15,0,9,5,82,0,25,7,2,1,1,2,5,101,33,0,4,9,1,14,6,7,4,9,4,7,6,8,9,0,8,2,18,6,6,6,9,4,0,1,10,9,8,1,2,13,4,11,7,11,10,4,2,0,7,0,13,0,7,5,9,7,1,0,1,0,4,4,6,11,5,12,5,2,1,0,2,4,5,15,9,2,11,17,1,8,15,1,0,50,1,8,0,1,7,9,17,5,21,2,1,2,4,0,4,2,1,7,2,14,0,10,9,0,11,14,0,14,1,2,8,1,0,2,15,0,3,5,2,0,0,5,4,12,0,10,4,8,3,0,0,4,38,21,3,24,7,35,17,4,12,3,5,4,6,16,2,12,27,0,16,5,48,5,4,4,4,0,5,22,0,28,4,6,23,15,4,10,1,5,1,3,0,8,4,0,6,13,0,22,5,16,13,10,0,4,31,22,0,0,8,1,0,0,11,5,14,9,12,19,6,7,8,9,0,8,31,6,5,3,19,14,2,3,4,2,5,15,9,6,1,1,25,4,15,7,4,0,3,5,5,2,3,6,4,6,23,2,16,8,5,3,12,5,0,0,0,3,3,0,11,2,4,17,8,5,1,0,3,24,0,13,8,1,5,1,12,2,5,1,7,10,2,14,26,1,5,4,21,2,2,32,3,6,60,12,4,15,41,48,0,0,0,13,0,0,13,1,1,3,0,4,2,12,1,5,4,2,5,2,4,0,3,0,0,0,0,16,0,1,2,0,7,17,6,5,8,4,0,7,0,7,10,9,2,11,0,5,3,1,13,2,11,4,9,10,0,0,9,8,5,4,15,20,7,30,11,9,5,5,1,4,4,7,11,3,0,3,5,0,3,25,3,32,8,4,11,0,5,2,2,0,4,4,9,8,2,6,2,0,3,14,8,20,6,1,4,8,11,5,4,1,0,1,2,4,24,24,10,5,0,0,0,22,5,0,0,0,0,11,0,17,13,3,7,2,2,3,0,1,6,0,2,5,2,5,7,7,2,0,8,12,10,8,33,17,8,7,7,3,8,1,13,1,8,5,8,3,12,6,3,0,2,10,9,5,2,12,0,3,18,0,5,2,3,6,3,2,1,0,5,4,1,3,2,5,5,0,13,1,4,40,4,12,1,0,12,1,7,2,1,6,0,10,0,8,8,0,9,12,3,0,8,6,1,7,0,4,4,7,13,4,6,1,11,1,9,0,1,10,0,6,0,17,9,11,2,0,1,6,3,1,15,29,3,19,2,4,0,1,3,1,0,5,6,7,4,5,0,5,72,12,7,6,11,20,1,2,2,14,17,5,6,1,6,2,2,3,0,12,2,0,11,0,16,3,1,16,10,6,2,5,18,6,3,1,2,0,22,3,2,1,5,17,17,0,2,7,0,0,0,0,8,16,2,1,5,2,1,2,3,3,4,2,20,1,0,6,4,2,1,3,0,2,5,5,0,1,5,0,2,0,0,2,15,2,7,0,4,4,2,5,1,4,5,1,2,4,0,3,3,6,5,2,12,6,3,5,2,0,0,4,4,6,3,12,1,1,5,2,3,0,4,0,6,0,2,1,7,9,2,10,0,10,3,10,5,3,8,5,3,0,4,8,2,1,0,2,1,1,11,1,0,7,0,11,26,1,0,5,3,15,0,2,3,2,7,6,2,4,5,0,1,2,1,4,0,0,0,5,0,21,1,0,0,0,9,2,1,1,1,6,0,5,6,4,0,0,1,7,3,9,8,0,8,1,6,10,0,4,5,12,7,0,5,2,2,0,0,1,1,7,0,0,2,10,0,7,0,8,1,4,2,0,0,1,1,10,0,0,1,4,0,1,1,4,0,0,0,22,3,6,3,5,0,2,3,4,0,1,1,2,0,8,0,5,12,0,5,8,3,7,3,2,8,0,0,4,6,8,2,63,3,5,47,0,0,2,2,0,3,1,0,10,19,9,0,0,15,3,12,0,4,1,14,5,37,4,0,3,0,5,2,5,0,6,0,5,3,9,1,1,27,3,4,3,4,0,2,10,1,0,2,4,0,0,5,10,2,7,0,0,7,4,6,0,8,4,2,13,1,0,2,9,3,0,3,5,2,7,9,0,56,4,4,4,4,4,1,13,15,5,8,0,4,2,6,8,9,0,14,4,9,0,3,3,0,2,0,3,0,1,3,9,6,1,5,0,0,2,0,29,1,7,2,7,6,0,2,5,3,0,1,2,5,49,1,7,4,10,1,1,1,2,0,11,2,1,0,0,6,4,0,1,3,2,2,6,3,4,0,0,7,6,1,6,2,7,3,0,3,0,5,2,4,0,1,8,4,3,0,1,8,8,0,4,113,4,0,0,2,4,0,0,0,0,8,2,0,0,6,5,5,11,6,3,2,1,0,4,2,1,8,3,0,3,2,0,0,2,1,10,0,5,0,4,1,0,4,0,2,0,1,5,0,2,0,2,0,15,6,0,12,3,10,1,0,0,4,0,0,2,0,3,0,0,0,2,0,0,5,3,4,8,75,13,5,0,2,0,6,10,2,6,1,0,0,2,4,0,0,0,1,10,4,0,1,3,8,0,4,2,0,12,13,11,0,0,4,1,5,6,4,1,0,4,0,11,1,1,8,0,1,0,2,19,3,6,2,1,2,4,2,0,5,7,0,0,2,7,1,1,1,0,0,6,1,4,4,1,0,2,3,0,19,0,2,0,0,5,1,4,1,9,1,0,1,2,3,11,0,3,0,7,4,1,0,9,3,3,1,6,0,3,2,28,3,6,0,1,0,9,4,3,1,0,2,3,0,3,2,72,3,1,12,21,0,3,6,5,1,0,3,10,14,0,1,1,5,1,4,3,0,1,4,8,10,0,6,22,5,2,0,45,3,2,3,2,0,7,0,1,2,77,9,0,6,0,5,1,1,7,1,1,2,30,4,28,2,0,1,6,11,4,0,1,1,2,3,0,3,0,14,4,8,5,5,2,7,7,2,0,10,4,0,3,5,0,33,0,0,1,2,2,5,1,6,2,15,11,2,0,0,0,2,0,2,0,1,0,0,1,5,0,7,3,7,2,2,5,2,6,2,1,0,0,1,0,3,0,3,0,0,13,2,0,1,6,2,2,1,0,0,2,1,4,3,4,1,11,0,0,4,0,0,2,3,0,6,4,0,0,2,4,5,0,3,0,0,0,5,0,0,0,4,0,0,3,6,13,7,2,14,0,1,2,0,1,0,5,0,0,0,0,4,1,0,0,0,1,0,0,0,3,8,2,7,1,2,0,2,1,3,0,4,1,2,0,4,2,10,2,4,4,1,0,2,6,0,2,2,1,4,2,5,12,0,7,6,3,1,3,0,5,6,0,1,1,4,7,6,1,13,1,2,0,0,2,0,0,3,0,0,6,4,2,4,2,4,0,0,4,14,1,1,1,5,1,3,0,0,1,0,5,3,1,1,2,0,0,0,0,2,1,5,2,1,1,4,3,3,0,5,6,2,3,2,4,7,0,0,2,2,3,0,4,0,14,0,9,0,0,1,0,17,1,1,3,1,0,9,0,0,0,0,4,0,1,4,0,3,0,2,2,1,0,1,6,3,6,7,13,6,8,3,1,5,25,30,4,2,0,4,2,10,14,0,4,0,1,0,2,3,4,1,0,6,4,1,0,12,2,1,0,2,5,3,5,52,1,4,4,5,0,9,14,2,21,0,0,0,0,2,20,2,0,0,0,1,0,4,0,0,1,0,0,0,2,1,0,3,11,15,3,0,0,0,3,4,0,21,6,1,4,0,0,2,5,0,19,0,0,18,1,3,2,0,3,0,3,1,1,6,3,2,3,0,0,7,0,4,0,1,9,7,8,2,1,1,6,5,1,4,1,1,4,3,0,1,9,0,16,4,3,1,12,0,0,0,0,1,5,15,2,8,2,4,0,1,7,6,41,1,0,0,1,1,1,4,4,0,0,5,10,1,1,5,28,6,2,8,5,5,0,5,3,0,5,0,2,0,1,10,1,0,0,8,6,3,2,0,4,1,0,0,7,4,0,0,16,0,5,0,0,2,0,0,0,0,5,0,0,0,0,2,2,0,5,4,1,6,2,3,0,3,2,0,0,5,0,2,1,0,1,3,2,9,0,0,0,0,0,2,6,15,0,9,1,0,17,2,1,1,1,0,0,1,1,0,3,0,0,1,4,0,0,2,1,32,0,1,3,1,2,0,1,4,1,3,1,3,3,1,0,0,0,4,11,0,2,0,2,8,107,0,0,3,0,1,4,0,1,1,2,0,3,3,0,2,1,3,1,0,0,0,0,2,5,4,0,0,1,0,6,1,0,0,1,0,7,2,6,3,0,1,0,0,1,3,1,0,0,1,1,3,0,0,12,224,1,0,5,3,5,2,1,26,0,1,1,2,1,0,2,0,0,0,10,1,8,3,5,8,0,15,0,0,1,0,0,0,5,8,0,1,1,0,1,14,5,2,2,2,1,0,3,0,3,5,1,1,3,2,0,22,0,0,2,2,1,6,1,0,3,3,3,0,5,4,2,2,0,0,0,8,0,3,1,0,3,9,5,1,1,4,1,0,0,4,1,37,0,9,0,4,1,0,1,0,2,2,6,2,5,5,0,3,0,1,0,0,0,6,1,0,4,0,0,4,0,0,0,0,2,2,6,10,1,0,2,3,0,0,0,1,11,14,0,0,0,0,2,2,5,0,1,1,4,0,0,0,5,1,4,0,3,0,0,0,2,0,0,0,1,3,0,5,3,2,3,4,0,0,1,0,0,8,23,1,0,0,1,0,2,5,0,0,0,4,0,0,1,1,0,5,2,1,33,1,0,3,0,4,0,2,1,0,4,2,1,2,2,5,2,7,0,3,1,1,0,1,2,3,0,0,0,2,0,3,3,0,0,2,6,0,0,0,0,0,0,3,4,0,0,0,3,0,17,9,0,8,27,0,1,0,1,1,1,5,0,0,0,2,1,1,3,0,0,2,2,1,5,1,7,2,0,2,1,0,1,0,0,13,4,7,2,1,1,4,4,7,78,0,0,0,4,0,2,1,1,3,4,0,0,2,2,4,0,4,1,0,7,1,10,2,0,1,0,0,0,1,2,3,18,2,2,1,0,6,1,0,0,2,0,8,0,2,1,1,4,0,0,2,0,0,2,2,5,3,6,0,1,4,0,3,0,1,1,6,4,0,1,6,1,9,0,0,0,2,3,2,0,1,1,2,8,24,5,4,1,1,0,8,0,18,2,3,0,1,0,0,3,0,1,0,0,0,1,0,2,2,6,2,0,0,0,1,4,2,0,0,3,0,0,1,0,3,0,1,1,1,2,18,0,27,4,0,0,0,0,1,1,1,2,0,0,0,0,10,1,2,0,3,0,18,0,0,0,0,1,1,3,2,0,0,0,2,0,5,2,0,0,0,1,0,0,0,0,0,0,3,2,5,2,3,0,8,4,7,5,1,6,0,2,1,0,0,0,0,0,0,0,1,0,1,0,2,0,0,2,1,0,2,6,4,0,2,0,0,1,3,8,0,2,1,14,2,0,0,0,1,0,1,6,0,1,1,0,1,9,1,0,0,2,6,0,0,0,1,2,1,0,0,0,0,3,1,1,0,1,2,1,1,5,1,2,0,3,0,0,1,3,1,0,1,0,2,1,6,0,2,0,0,0,3,2,0,1,0,0,1,2,0,2,2,7,2,0,0,1,0,1,0,0,9,0,0,0,2,0,4,0,0,0,0,6,1,0,0,2,0,0,0,0,0,2,0,0,0,0,2,1,1,4,0,0,2,0,0,0,6,3,2,2,0,2,0,0,1,2,1,2,7,0,0,0,0,0,0,0,6,0,0,0,4,0,0,0,0,3,0,3,3,1,0,9,0,2,4,2,0,0,0,2,1,0,0,0,194,4,0,0,1,7,1,7,0,0,2,12,3,1,10,3,0,0,5,55,0,0,0,0,4,5,1,1,11,0,0,0,1,2,2,0,2,0,0,1,3,0,0,0,0,1,1,1,0,0,0,1,7,8,4,1,1,1,6,3,0,0,4,0,0,0,1,1,1,0,0,0,0,0,1,3,5,1,0,0,1,1,4,0,4,0,15,0,1,0,1,0,0,0,0,0,1,0,0,2,0,1,2,1,0,0,3,0,0,0,0,1,1,12,0,1,2,0,0,0,1,2,3,2,0,0,0,0,2,0,0,2,1,0,1,1,1,0,0,0,6,1,0,1,1,0,4,0,0,0,2,0,0,0,2,1,0,0,0,1,22,1,0,2,0,1,3,0,1,1,0,0,0,0,0,2,5,0,0,2,5,1,1,7,0,4,0,6,1,3,0,4,0,1,0,0,2,1,0,0,1,8,0,3,1,1,0,0,0,0,0,1,0,9,0,0,2,0,0,1,0,1,1,1,0,0,2,0,0,2,6,6,3,0,0,1,118,3,0,0,0,3,7,9,8,0,0,0,6,3,0,14,2,0,2,1,0,0,1,5,1,2,2,1,5,0,0,0,2,0,1,2,3,3,1,2,0,0,0,0,0,1,0,0,7,0,2,0,1,2,0,1,0,0,0,1,1,0,0,0,0,0,1,2,0,1,0,0,0,4,0,2,1,0,1,0,2,0,2,0,1,4,0,3,0,0,5,2,0,0,0,2,0,0,0,2,5,3,0,0,1,0,3,0,3,1,3,0,0,8,3,0,2,3,1,6,2,6,1,0,2,1,11,0,0,0,1,0,16,1,0,0,1,0,0,1,2,10,0,0,0,0,0,2,1,1,9,0,2,2,4,0,1,1,3,0,0,1,10,2,0,1,2,0,0,0,0,0,0,0,2,2,0,1,0,2,0,0,1,0,3,0,1,6,2,6,0,4,2,0,2,0,0,0,0,0,5,1,0,2,0,0,0,0,1,1,6,1,0,3,1,0,2,2,0,1,0,1,1,2,0,6,0,0,4,8,0,0,2,0,0,0,0,0,0,0,4,0,14,0,0,0,0,0,2,165,1,11,14,0,0,0,0,0,0,7,2,1,0,0,1,15,7,0,2,0,1,0,0,1,1,0,0,1,1,0,12,0,2,0,6,3,0,1,1,2,0,0,4,0,2,0,1,0,3,1,0,1,0,1,0,1,1,1,0,1,1,1,5,0,2,1,0,4,5,2,0,2,0,0,4,0,0,0,0,1,0,2,2,0,2,0,16,0,3,5,0,1,3,1,0,2,1,0,1,1,2,0,0,0,2,6,6,1,3,2,0,0,0,0,0,0,1,0,0,0,0,4,5,1,6,0,0,0,0,0,0,1,1,0,0,1,1,0,0,10,0,1,2,0,1,1,1,12,0,0,1,1,1,1,0,0,8,0,1,0,0,1,1,8,2,1,0,0,0,0,1,0,0,0,0,2,0,14,0,0,0,0,7,4,0,0,0,4,0,37,0,1,1,1,3,0,1,5,0,1,1,0,0,0,2,2,9,1,2,0,0,0,1,5,0,5,1,2,0,0,3,0,0,0,4,1,3,0,0,0,0,1,0,0,2,0,1,0,0,0,0,2,2,0,7,1,1,2,2,0,0,1,2,2,0,1,0,1,0,4,0,0,0,0,6,2,1,3,3,0,1,2,7,3,2,1,0,0,3,2,2,0,3,0,0,3,0,0,2,1,1,0,1,4,0,0,2,0,0,1,4,1,0,6,0,0,0,1,1,4,5,1,12,3,0,4,6,1,0,0,0,0,5,3,0,4,1,0,0,0,1,0,0,0,0,0,0,2,6,0,1,1,0,1,0,0,0,0,3,0,2,1,1,5,0,2,64,0,0,14,0,1,1,0,2,0,0,0,0,0,13,2,0,0,0,4,4,6,3,0,2,1,5,3,0,0,0,0,0,2,2,0,5,0,0,0,1,0,0,0,2,2,0,9,0,0,2,1,0,13,0,0,0,2,3,0,0,0,1,0,0,0,1,0,0,0,0,0,0,0,2,1,0,1,1,8,0,0,2,1,0,2,0,1,0,2,0,1,0,0,0,0,0,2,1,1,1,1,0,1,9,2,1,1,2,5,0,3,2,1,10,2,0,6,0,0,0,0,4,1,0,0,4,0,0,1,0,0,0,0,0,2,2,1,2,1,0,0,0,0,138,0,12,0,9,0,0,0,2,0,0,0,0,0,0,0,1,1,0,3,0,0,0,0,0,0,0,0,1,3,5,1,1,3,0,1,1,3,1,5,0,1,0,0,0,0,1,0,3,3,0,1,0,0,1,0,4,1,0,6,0,0,11,2,2,0,0,2,4,1,1,0,1,0,0,0,4,0,0,0,1,5,0,0,4,0,0,3,1,0,0,1,4,1,0,1,0,0,0,2,4,0,0,0,0,1,0,0,3,0,19,1,3,9,1,0,1,0,0,0,5,5,0,4,0,0,0,0,11,1,0,3,4,0,0,3,4,0,0,0,1,0,2,0,1,1,1,1,0,1,1,2,1,0,0,5,2,0,6,1,0,0,0,1,0,1,0,0,0,2,2,0,0,0,1,1,0,0,1,1,0,1,2,0,0,0,0,1,0,3,5,1,0,0,6,0,0,0,0,1,1,0,0,1,2,1,0,1,0,6,1,4,0,0,0,2,0,0,0,0,12,0,0,4,0,1,0,0,0,1,0,0,2,1,2,0,0,3,4,1,0,0,0,1,0,1,0,0,4,0,4,1,0,0,0,0,1,5,0,0,0,0,0,0,2,0,0,0,0,0,0,0,0,0,0,0,0,0,0,0,0,0,0,0,0,0,0,0,0,2,0,0,0,0,0,0,0,0,0,0,0,0,0,0,0,0,0,0,0,0,0,0,0,0,0,0,0,0,0,0
"2001 Johansen, Iris, Final Target",pop,3625,1801,2785,1550,1062,1853,1435,951,1182,1241,2300,533,782,1502,1185,586,589,501,532,227,484,610,463,552,331,492,722,163,392,331,289,357,420,613,252,699,239,206,282,234,410,203,213,342,326,249,138,230,255,199,307,145,274,197,156,118,305,315,422,221,212,383,119,219,285,178,33,110,200,157,327,414,202,185,103,136,64,279,90,209,79,277,116,161,139,92,100,189,90,160,56,252,148,97,223,126,98,70,161,111,132,111,277,81,124,34,85,71,259,102,182,39,98,116,75,156,198,97,84,42,48,139,66,125,111,125,85,48,90,146,38,78,116,97,55,106,34,90,55,112,61,176,111,296,74,85,147,116,142,118,18,125,67,48,63,134,76,90,28,26,25,58,114,30,45,9,45,45,34,39,92,49,58,234,36,25,61,65,56,122,81,88,93,51,116,20,116,27,21,48,29,66,96,40,12,36,32,52,27,28,110,24,30,28,59,21,44,11,84,15,11,19,31,148,29,13,57,61,26,47,31,32,42,33,67,21,98,10,106,36,50,17,38,46,34,112,19,60,17,27,64,137,17,41,52,34,28,44,33,35,68,8,23,24,35,81,29,77,18,34,23,17,55,26,23,35,44,39,29,21,55,34,31,22,45,60,28,98,48,36,21,33,26,26,45,10,41,54,46,17,29,14,53,6,58,27,35,52,135,111,47,35,72,37,15,78,55,23,40,83,46,33,34,17,19,16,54,9,55,60,13,55,25,8,41,30,59,19,17,51,49,80,13,38,14,41,14,6,16,38,15,16,56,2,32,17,80,4,9,46,16,25,20,50,13,18,11,63,32,7,13,66,28,8,10,82,45,10,32,7,20,43,13,20,16,15,26,13,24,76,8,9,6,69,33,14,0,25,119,17,0,10,9,5,19,29,28,31,32,83,10,40,38,21,25,28,18,45,23,19,36,20,17,5,25,18,20,15,11,8,15,0,9,26,26,15,39,15,53,15,15,37,42,18,0,9,18,9,9,35,14,29,53,15,29,18,15,22,47,20,22,13,14,32,42,16,60,32,12,30,30,5,0,0,9,20,25,4,4,23,16,22,11,0,6,30,10,5,0,20,28,31,22,28,46,11,15,8,17,18,28,14,8,16,6,33,5,36,3,11,15,38,9,22,26,21,14,12,42,36,2,4,13,8,41,25,0,36,8,19,11,18,4,26,20,24,54,27,14,5,0,8,10,66,6,1,10,9,12,16,12,23,16,9,11,5,0,2,12,16,18,18,8,15,21,10,23,15,8,16,10,3,29,1,34,17,13,13,19,3,18,19,18,1,6,14,24,47,22,10,23,63,34,5,2,13,17,17,5,8,13,14,13,14,8,74,3,16,7,4,65,152,12,2,2,0,0,36,27,3,7,42,16,5,16,13,2,0,12,6,2,8,12,23,15,6,3,7,7,0,3,21,1,1,4,0,4,14,5,6,24,16,5,5,15,4,12,11,19,16,0,3,10,17,11,16,9,0,10,1,24,17,21,53,11,9,45,30,18,16,20,13,5,12,14,11,32,2,11,12,10,5,19,3,16,30,6,17,9,5,35,3,2,10,41,9,3,0,6,9,6,0,11,7,25,17,38,1,7,9,1,5,2,3,15,37,10,2,7,14,0,1,8,4,9,5,10,12,0,6,7,12,3,5,0,16,4,7,5,22,11,10,1,30,1,0,0,13,36,5,5,4,4,7,34,9,20,1,16,6,2,2,6,32,5,6,11,3,3,11,14,9,0,19,57,4,13,5,0,15,13,6,8,18,16,12,1,10,10,68,0,2,2,4,9,17,0,9,0,8,46,0,3,9,9,1,2,10,25,0,8,1,3,4,9,10,1,0,9,1,1,1,14,24,6,10,11,2,4,8,0,55,7,13,1,6,9,7,0,11,4,9,9,1,13,2,29,0,11,13,34,5,18,17,8,0,10,4,4,20,7,7,16,23,0,3,0,507,1,6,26,2,6,3,0,1,14,5,9,5,7,18,11,7,13,12,6,33,1,13,6,4,0,15,6,10,1,0,4,10,1,11,5,2,14,6,0,17,3,0,5,0,15,0,1,0,3,5,6,33,3,3,8,18,0,8,6,0,22,6,0,24,4,3,8,6,6,14,3,34,7,0,1,1,7,1,29,31,12,0,12,7,2,5,8,17,11,0,12,0,0,10,19,1,6,10,1,4,1,10,4,0,3,0,0,6,4,16,5,6,21,1,10,4,2,0,6,0,4,1,7,19,9,0,0,0,24,5,6,0,1,0,11,0,3,3,0,0,6,33,2,6,10,5,17,16,5,0,5,2,22,2,0,0,0,0,1,1,0,27,2,4,8,5,12,2,4,0,15,15,13,23,1,15,45,10,12,0,4,9,3,5,6,0,14,0,16,9,3,8,8,5,0,7,4,5,3,1,0,0,0,3,5,2,3,6,6,0,7,4,2,2,2,0,0,4,6,9,3,3,6,0,13,7,8,6,3,5,11,1,6,1,1,11,12,1,2,3,6,2,3,9,3,3,0,0,0,2,0,3,7,2,0,1,1,12,2,1,7,0,19,7,3,7,1,3,9,2,10,1,6,2,0,3,1,0,20,5,26,7,0,8,7,6,14,3,1,12,6,5,0,9,2,2,0,1,1,8,0,0,0,7,3,4,8,3,2,7,4,0,0,0,0,7,5,0,8,2,5,0,10,3,0,3,3,0,9,1,0,12,0,0,3,5,3,1,0,5,12,2,0,10,6,0,0,0,0,2,2,2,2,0,7,17,6,3,10,3,3,1,2,7,0,23,7,0,19,4,5,5,2,5,3,0,4,9,0,2,10,11,7,1,1,5,3,8,1,6,0,3,5,0,2,4,0,0,4,0,7,0,10,7,0,3,466,4,10,0,0,7,1,12,1,1,3,4,13,1,4,7,0,7,9,11,7,2,8,0,1,2,11,16,4,2,4,3,1,1,3,0,0,0,1,5,4,3,3,1,5,2,6,2,0,0,8,2,2,0,23,9,0,3,1,15,3,15,2,1,4,1,3,6,2,0,2,2,8,16,2,0,4,0,8,0,1,0,12,0,14,1,0,5,3,0,8,2,20,2,6,6,3,1,18,0,5,0,0,2,0,0,0,0,5,3,11,12,1,7,0,10,0,5,6,0,0,20,1,0,1,3,0,0,0,10,0,11,0,0,1,10,26,6,0,7,0,3,9,2,9,3,1,2,0,9,2,3,0,9,6,20,6,4,0,0,3,1,54,2,7,3,5,5,6,18,0,6,5,3,3,1,2,8,0,2,28,0,0,4,2,1,30,15,2,362,0,3,2,0,3,0,19,1,7,7,0,0,4,0,1,0,4,1,3,9,0,6,8,19,0,6,1,6,1,7,1,5,0,0,3,4,4,0,1,0,0,0,0,2,1,13,10,0,2,10,16,1,1,0,40,14,4,9,8,5,5,1,2,8,3,6,1,1,5,2,4,0,11,0,27,2,9,8,5,2,5,1,4,0,8,2,1,2,3,8,2,5,0,9,1,8,4,3,2,7,0,1,3,1,12,2,3,2,2,0,4,3,4,2,0,3,3,1,2,0,7,15,9,3,0,5,0,19,0,3,4,3,4,73,2,5,0,0,0,10,0,0,5,0,8,4,14,4,0,1,11,7,328,4,0,3,3,1,7,0,2,5,2,6,1,1,12,1,0,1,1,1,6,4,3,5,9,0,3,7,0,3,2,1,1,0,0,0,8,3,1,2,0,4,5,5,3,11,5,1,0,1,1,0,5,1,0,2,24,6,9,1,0,3,0,5,1,1,4,3,1,0,4,2,3,13,1,0,2,2,0,6,6,0,15,5,5,1,5,0,2,12,3,4,0,11,0,0,10,0,2,2,4,1,0,4,5,0,4,0,0,30,2,13,1,0,2,0,7,0,1,16,7,11,15,14,3,0,2,5,0,1,2,0,4,17,5,2,3,0,0,0,0,2,4,5,4,5,0,1,6,2,1,10,17,0,1,3,0,5,17,0,1,4,3,1,10,2,9,1,4,5,3,14,3,5,3,4,0,3,0,2,3,3,1,6,0,2,2,6,2,8,2,4,1,2,2,6,0,12,0,1,1,0,2,2,1,4,0,0,5,0,0,13,0,0,0,20,6,1,1,1,11,6,0,3,1,1,0,1,0,5,6,0,5,0,0,1,0,12,6,6,5,4,6,3,2,0,1,0,28,1,0,3,1,8,2,7,2,6,6,4,1,2,2,0,0,0,14,1,12,1,14,3,3,9,0,0,0,0,3,0,1,0,1,4,0,4,7,3,0,2,17,4,1,5,0,0,3,0,14,12,11,1,4,13,4,0,8,0,2,0,2,1,5,3,5,6,0,4,0,0,7,2,0,2,3,1,0,1,0,3,1,1,1,1,0,5,2,2,0,1,0,6,0,1,2,4,0,2,8,1,0,1,0,2,0,3,0,0,0,1,3,0,13,3,0,6,0,5,11,4,0,8,2,0,3,0,1,4,1,2,2,0,0,0,1,43,5,1,3,12,0,4,4,1,7,10,0,2,3,6,2,2,2,1,2,0,1,1,1,0,1,2,0,0,1,4,2,5,0,1,2,0,1,0,0,0,44,0,0,0,2,1,6,3,2,7,0,0,5,1,0,9,4,1,0,3,0,0,6,3,5,2,3,2,0,0,4,8,0,0,5,0,0,4,0,1,2,1,6,2,0,0,3,0,2,3,1,4,1,13,1,0,2,2,5,0,0,4,1,4,0,0,10,2,4,9,1,0,2,0,0,2,0,0,24,0,14,1,0,0,0,1,1,3,0,2,0,4,0,12,5,1,6,0,3,2,19,0,1,9,3,2,0,5,0,2,6,0,0,0,1,15,1,4,0,1,1,3,3,1,2,4,4,3,0,2,2,1,0,0,0,0,1,0,3,0,0,0,1,1,0,4,1,2,2,0,12,2,0,2,4,0,1,2,0,0,4,1,0,0,0,0,2,3,0,1,4,4,4,3,0,2,2,0,5,2,4,1,0,0,2,3,0,2,3,2,0,1,2,2,0,0,0,0,6,0,0,2,2,6,3,5,1,1,5,4,0,0,5,3,0,2,3,4,0,12,0,2,1,3,1,0,9,1,0,0,2,0,0,0,1,1,4,0,7,18,0,4,3,1,0,3,1,0,0,0,11,0,8,1,1,0,14,3,4,0,2,2,0,2,1,4,4,2,3,0,0,2,0,11,3,1,0,3,0,2,0,1,4,0,3,0,2,1,0,2,3,4,0,0,5,2,8,0,5,4,10,1,0,0,0,3,0,0,8,3,3,3,1,3,3,1,0,0,0,1,5,2,8,2,4,0,1,6,0,1,1,0,2,0,3,3,0,3,0,2,0,2,0,0,0,0,1,1,2,2,5,2,2,2,3,0,7,2,1,0,2,0,15,2,2,0,3,0,0,0,2,1,1,4,0,77,0,3,3,0,1,1,1,0,2,1,0,0,3,1,2,0,2,3,8,4,6,0,0,6,0,0,0,0,7,6,2,2,5,0,1,0,0,2,0,0,0,1,4,5,0,1,0,1,2,0,2,2,0,0,1,0,5,3,0,0,9,1,4,1,3,5,0,5,15,0,2,0,4,0,5,0,4,0,0,4,2,0,2,14,0,0,0,2,0,0,0,0,1,5,0,1,0,9,3,1,2,0,0,1,0,2,3,0,0,2,1,1,7,0,2,5,1,1,2,1,3,0,0,0,2,4,0,13,0,7,7,1,0,6,0,2,0,3,4,1,0,5,0,0,1,6,0,1,1,1,0,0,0,0,0,1,0,0,1,1,0,0,15,0,0,0,1,1,3,3,0,3,1,11,4,1,2,0,5,3,6,1,4,0,7,1,8,4,0,2,2,0,0,0,0,0,0,7,3,0,0,0,2,0,3,5,0,0,3,1,4,4,2,5,0,2,4,0,0,0,5,0,1,0,4,3,0,0,2,5,0,0,0,6,1,0,1,2,1,0,0,0,2,1,2,4,1,2,0,0,4,3,1,11,0,0,3,0,3,0,1,0,3,3,0,4,0,0,0,5,2,3,3,0,0,6,4,0,1,1,3,0,1,5,7,13,4,1,0,1,0,4,3,0,0,3,0,0,0,1,2,5,0,6,1,1,1,0,0,2,0,0,0,0,0,0,2,1,1,3,0,0,1,0,0,1,2,171,2,0,4,2,0,0,0,0,1,1,1,0,0,1,4,3,2,0,0,3,5,0,9,2,1,1,0,1,0,0,0,20,2,2,8,0,0,1,0,0,1,0,2,0,1,2,2,2,0,0,1,0,35,4,1,1,1,0,0,0,0,1,0,1,0,4,3,0,1,3,7,0,4,0,0,0,0,2,0,1,0,0,2,1,3,2,1,0,9,1,1,4,7,0,3,4,1,1,1,0,1,2,2,0,0,0,4,3,0,2,1,4,2,0,2,2,2,0,0,1,0,1,0,3,0,0,2,4,0,7,0,0,3,0,4,1,5,2,2,4,0,1,1,0,0,1,1,0,1,2,3,0,0,0,2,3,4,0,0,0,0,0,1,0,0,0,0,3,0,3,1,1,0,0,0,1,1,2,0,2,0,1,0,0,0,1,0,2,3,3,0,2,2,0,0,0,8,4,1,0,2,0,0,5,1,0,1,4,0,1,1,0,2,1,0,141,1,0,1,1,0,0,2,0,0,3,4,0,0,1,3,0,4,1,0,0,1,0,2,2,3,2,0,0,29,158,1,1,1,2,0,0,0,3,2,0,0,2,3,2,1,0,7,2,2,0,2,0,0,11,0,0,0,6,10,1,0,0,0,1,1,7,0,5,0,4,13,1,0,4,6,1,0,0,1,0,0,1,7,1,2,1,7,4,1,5,1,0,0,0,6,4,3,0,7,0,0,0,0,20,0,3,0,1,1,0,7,0,2,1,2,1,4,1,0,0,0,2,4,3,0,0,4,0,0,0,0,1,6,0,2,1,6,0,6,4,0,0,2,0,4,0,1,5,4,4,0,0,0,1,1,2,3,0,1,7,7,0,5,0,0,0,6,0,0,14,0,11,0,0,0,0,0,0,0,0,3,1,1,0,0,0,0,4,5,1,0,0,0,0,0,1,0,0,0,6,1,0,1,2,0,0,1,1,2,4,0,0,1,1,1,5,1,1,7,0,2,0,0,0,1,0,0,2,0,0,0,1,1,0,9,1,0,4,0,0,1,0,0,1,0,1,2,2,0,3,4,0,0,0,0,0,2,0,0,1,0,1,4,1,0,1,2,0,5,0,0,1,1,0,2,0,2,0,2,0,0,1,0,2,0,0,2,0,0,1,0,0,0,0,0,2,0,0,0,0,3,2,1,0,0,0,1,0,1,1,0,1,2,2,0,1,0,7,0,0,0,2,2,1,2,1,1,2,0,0,0,3,1,8,0,0,3,1,2,5,8,0,0,0,1,0,0,6,0,1,0,2,0,2,1,0,22,145,7,3,2,7,0,0,0,1,0,1,0,0,1,0,0,1,2,1,25,2,3,0,3,3,2,0,0,0,2,3,5,2,0,0,4,1,0,0,3,0,0,0,2,2,3,0,0,0,1,0,0,0,2,2,2,2,0,2,0,0,0,2,0,1,3,4,0,7,2,1,1,1,3,0,0,1,0,0,0,3,2,1,1,1,1,1,0,0,1,0,0,4,0,0,2,0,8,1,4,1,0,0,2,0,0,0,0,5,1,0,2,2,6,0,0,0,2,0,1,0,2,0,0,0,12,0,3,1,1,4,0,0,2,0,1,0,6,0,1,1,0,1,1,0,0,6,7,1,0,2,0,1,1,2,14,12,0,0,0,3,0,1,6,1,1,1,2,1,0,2,0,2,2,0,1,0,0,1,0,2,1,0,0,0,0,1,0,0,5,0,0,0,0,3,2,0,2,4,10,1,1,3,0,0,0,1,2,2,0,0,1,0,2,2,0,5,2,0,0,0,4,1,0,2,1,1,0,0,1,1,0,0,0,1,0,2,0,0,3,4,0,0,0,1,2,1,0,0,1,0,0,1,0,0,0,0,0,1,1,0,1,0,0,0,0,0,0,0,1,0,1,0,0,0,0,1,1,3,0,2,7,0,0,1,1,0,0,1,6,2,0,0,0,0,0,1,0,1,4,1,0,0,0,1,0,0,8,1,1,0,0,0,0,1,1,0,0,0,1,0,0,0,0,1,0,0,0,0,2,0,2,3,2,0,2,2,0,4,0,0,0,9,1,3,1,0,1,16,4,0,1,0,1,0,3,3,1,2,3,2,2,0,3,0,0,5,5,1,0,4,0,16,0,0,0,4,0,2,1,2,1,0,1,0,1,0,0,0,0,2,0,0,0,0,1,5,0,0,0,1,4,0,4,2,0,0,3,2,7,5,3,0,5,0,1,0,0,0,0,0,7,0,0,0,2,0,1,0,2,0,0,0,3,0,1,0,0,1,2,0,0,2,0,0,0,2,0,0,2,0,0,0,10,0,0,0,0,0,3,0,0,0,0,2,0,0,0,2,0,0,3,12,1,1,2,0,0,5,0,4,1,0,1,0,1,0,5,0,0,2,1,0,3,0,0,0,1,0,1,0,0,1,3,2,23,0,2,0,0,0,0,0,0,2,0,0,1,5,0,0,1,6,0,0,0,2,0,0,1,0,0,0,2,0,0,2,1,0,4,1,1,0,1,1,0,1,0,0,1,2,0,0,0,3,0,1,0,1,0,1,0,0,0,0,0,0,4,0,0,0,1,0,1,3,1,0,0,0,0,1,0,0,0,3,0,2,1,2,0,0,0,2,0,0,11,0,0,4,0,3,2,0,0,0,3,0,1,0,0,0,0,1,1,0,0,0,0,0,1,0,1,0,0,1,5,0,2,6,1,1,0,0,1,3,3,1,1,2,2,0,1,5,0,1,0,1,1,0,3,4,3,0,1,0,0,0,1,1,1,0,1,2,1,0,0,0,0,0,0,0,0,0,6,0,2,0,0,3,0,0,0,1,0,0,1,0,1,0,0,10,1,0,1,0,2,0,2,0,1,0,0,1,1,1,0,0,0,0,1,2,4,0,4,0,0,0,1,4,3,3,1,0,0,0,3,3,0,0,1,0,0,0,4,0,0,0,3,0,0,0,2,0,0,1,0,0,0,1,3,2,2,1,0,0,0,0,1,3,4,2,0,0,0,1,0,2,1,0,0,0,0,0,0,0,1,0,0,2,5,0,1,2,1,1,1,0,0,0,2,0,3,0,10,1,3,0,1,0,0,0,5,6,0,5,1,0,2,0,1,0,0,0,0,0,0,3,0,0,6,0,1,0,0,2,0,0,0,0,1,0,0,2,1,0,0,0,0,0,1,0,0,2,4,0,1,0,1,1,0,0,0,2,0,0,0,0,0,0,0,0,0,1,0,0,1,2,0,0,0,0,1,1,0,0,0,0,1,4,0,2,1,1,2,0,3,0,0,0,0,2,1,0,1,0,1,1,0,5,1,0,0,3,0,1,1,0,2,0,2,1,0,0,0,2,0,1,1,2,0,1,0,0,6,4,0,0,0,2,1,0,0,0,0,0,0,3,0,0,0,0,5,0,1,1,0,1,0,0,1,0,0,1,0,0,0,0,0,0,4,1,1,0,0,3,0,1,0,1,0,0,1,0,0,0,0,0,0,0,0,0,1,2,1,0,0,1,0,0,0,0,1,0,3,0,0,0,2,1,0,1,0,3,9,0,0,6,0,0,1,1,1,0,0,0,1,1,0,1,5,7,0,0,4,0,1,2,1,0,0,0,1,0,0,0,2,0,0,0,0,1,2,0,0,3,3,6,1,4,2,0,1,0,0,1,1,5,1,0,0,2,9,2,0,1,6,9,0,2,0,0,2,0,0,5,2,0,0,1,0,0,1,0,1,0,1,3,1,1,0,0,2,0,0,0,0,5,3,0,0,0,2,0,1,0,2,1,0,2,0,0,0,1,0,2,1,0,0,6,4,0,0,1,0,1,1,0,2,0,0,2,0,0,0,0,0,0,1,3,1,1,0,1,0,1,0,2,0,0,1,0,1,1,1,1,0,1,6,0,0,0,0,0,1,0,0,1,0,0,1,0,2,1,0,0,0,1,0,0,0,1,0,1,0,0,3,0,0,0,0,0,0,0,0,0,0,0,0,0,2,0,10,1,0,0,0,0,0,0,0,2,3,1,0,0,0,3,0,0,3,1,1,0,0,0,0,0,0,0,0,0,0,9,1,0,0,4,1,0,0,0,0,0,1,0,6,3,0,0,1,2,0,0,1,2,0,1,0,0,4,1,1,1,3,2,0,1,0,0,0,0,0,0,1,4,0,1,0,0,1,1,0,0,0,2,0,0,0,0,1,0,0,0,0,2,0,0,0,1,2,0,0,0,0,0,3,0,0,0,0,0,0,0,2,0,1,3,0,2,0,0,0,2,0,2,2,0,0,3,0,2,0,1,0,0,2,2,0,0,0,0,2,0,0,0,1,0,0,0,2,2,0,0,3,3,0,0,0,0,0,0,0,0,0,0,0,0,0,0,0,0,0,1,0,0,1,0,0,0,3,0,0,0,0,0,0,1,0,0,1,2,2,5,1,0,0,2,0,2,0,0,0,2,0,0,0,0,0,2,0,1,2,0,0,0,0,0,0,0,0,4,2,0,0,1,0,0,0,1,0,0,0,0,1,1,1,0,0,2,0,0,0,0,0,0,0,0,0,1,0,3,0,1,2,0,0,1,0,5,0,0,0,7,0,1,0,0,0,0,0,6,0,2,0,0,0,3,1,0,0,35,0,1,0,0,8,1,1,0,2,0,0,0,0,0,0,0,1,2,0,0,1,0,0,0,3,0,0,2,0,0,1,1,0,0,5,0,3,1,0,1,0,0,0,4,0,0,0,0,0,0,1,0,0,0,1,1,2,0,0,0,0,0,1,0,0,2,0,3,0,0,0,0,0,0,0,0,1,0,0,0,0,0,0,0,1,5,0,2,0,1,0,0,0,0,0,1,2,0,0,0,0,3,0,0,0,1,0,0,0,0,0,2,1,0,0,0,0,0,0,0,0,0,0,0,0,0,0,0,0,1,2,0,0,0,0,0,0,0,0,0,0,0,0,0,0,1,0,0,0,5,1,0,2,0,0,0,0,0,1,0,0,0,0,2,0,0,1,0,0,0,0,0,0,0,0,0,0,15,0,0,0,0,0,0,0,0,0,0,0,0,0,0,0,0,0,0,0,0,0,0
"2002 Koontz, Dean, By the Light of the Moon",pop,7266,2655,3254,3109,3512,616,1879,1957,784,843,837,1456,1356,1151,1091,775,1113,1048,663,638,727,874,1266,518,151,690,248,403,376,239,683,278,372,710,622,480,415,358,259,371,431,281,176,439,224,343,413,223,443,182,211,343,280,351,464,555,430,187,168,212,134,192,160,201,172,212,206,83,107,104,141,172,98,94,96,334,158,286,128,277,167,102,132,214,113,77,170,129,213,158,60,126,138,230,86,128,92,107,91,176,123,104,85,347,77,248,132,109,98,103,126,84,107,133,142,167,113,90,91,74,93,64,56,128,168,55,91,68,95,28,85,71,69,62,158,101,65,137,127,170,121,64,125,97,114,76,100,274,55,124,69,28,86,95,67,81,23,92,110,109,87,101,88,81,98,99,59,79,58,55,31,79,121,30,41,105,89,82,68,64,77,46,27,79,42,19,49,63,88,75,78,51,88,57,64,98,18,74,65,181,52,124,34,120,86,27,42,73,86,67,51,93,50,52,83,67,68,143,55,30,83,73,55,74,35,105,74,51,63,17,75,43,100,66,50,75,27,83,42,46,32,58,32,21,30,56,52,36,26,64,51,25,34,16,112,29,56,36,86,78,53,54,26,87,76,23,24,76,55,86,67,30,36,13,23,22,20,24,61,39,82,48,45,21,59,38,22,47,43,60,27,5,21,41,35,22,39,27,6,59,55,25,49,33,40,34,37,46,39,4,84,12,10,32,62,32,55,42,27,63,41,34,28,43,66,35,25,47,52,38,27,22,69,24,31,16,56,13,6,33,70,29,27,11,42,37,38,30,59,40,57,28,26,30,37,20,25,43,18,35,43,9,20,8,42,11,27,9,41,14,28,27,69,51,33,34,58,2,38,30,70,47,30,26,34,29,0,37,31,38,8,15,10,49,41,64,23,27,29,32,3,50,54,41,21,47,35,24,17,56,7,29,58,21,32,86,59,27,37,50,9,0,5,18,40,20,26,52,9,22,29,22,50,15,4,33,26,61,7,32,18,10,30,33,17,24,11,33,40,17,41,31,13,19,45,19,23,25,34,16,22,104,0,4,17,10,33,16,3,25,8,19,16,3,28,32,12,5,0,11,31,43,26,16,12,22,34,22,14,15,13,18,30,20,77,14,18,10,2,12,11,15,30,36,16,38,5,26,17,13,12,27,22,55,6,17,0,14,3,20,48,9,14,11,69,33,26,4,16,13,1,17,27,35,23,4,23,35,32,33,22,27,23,57,34,38,0,4,26,7,24,25,11,7,15,8,14,28,21,3,19,17,24,6,38,18,22,15,11,19,17,32,10,26,8,24,10,2,17,3,23,58,8,56,10,17,11,26,9,8,26,20,16,5,39,17,15,26,14,7,6,14,76,30,21,0,0,17,8,2,24,18,36,7,50,14,16,36,6,18,18,22,6,29,14,45,15,24,25,8,16,53,52,2,20,0,7,8,15,16,18,13,5,31,26,15,19,7,16,18,0,19,21,5,29,7,23,5,21,7,9,6,21,22,2,15,18,14,19,33,22,26,69,29,4,23,10,23,10,10,11,5,25,23,16,25,2,23,9,17,18,32,9,9,20,14,11,0,11,23,10,3,34,28,6,7,6,8,1,31,5,31,7,11,14,32,33,41,20,27,14,19,23,14,53,26,28,5,11,9,8,7,5,18,10,12,20,10,29,26,15,17,1,28,0,0,13,15,6,6,172,5,21,11,9,9,3,2,21,13,17,16,26,3,24,3,8,10,19,29,17,7,5,19,0,14,15,23,0,12,21,50,31,16,25,38,4,13,5,21,13,17,0,9,11,9,3,6,0,37,18,11,10,21,31,44,113,13,19,33,15,9,9,3,15,6,2,1,16,11,3,0,27,26,30,10,14,15,11,19,8,3,0,7,2,11,5,2,0,7,24,11,6,22,15,27,6,0,23,8,1,16,3,11,20,13,9,5,2,8,14,33,3,10,43,35,1,22,7,14,9,34,8,12,0,32,2,11,9,23,20,17,14,13,16,16,16,22,10,8,10,22,2,9,11,14,51,0,15,18,8,6,8,8,4,22,13,8,18,14,26,0,5,965,7,1,8,7,4,7,8,2,27,7,9,29,2,0,18,11,0,4,17,49,6,5,11,3,6,7,5,0,3,23,23,27,13,8,7,15,8,15,9,4,11,10,15,11,5,0,0,9,6,0,7,20,8,8,2,7,15,0,26,11,14,19,8,16,10,7,0,22,5,10,11,3,17,0,20,3,16,17,7,5,18,31,4,22,4,0,19,0,7,0,22,16,0,0,3,61,5,11,12,9,50,21,5,0,5,2,4,8,26,2,10,2,32,1,8,6,12,9,23,11,18,6,6,14,22,16,13,15,3,13,2,2,10,5,3,4,59,9,1,0,2,0,23,6,1,6,14,4,0,19,7,28,13,28,0,0,0,0,18,15,6,13,6,0,23,6,13,6,11,1,7,2,6,16,8,0,4,0,48,7,0,3,49,14,17,8,7,7,29,24,2,2,7,12,14,15,13,10,11,17,0,5,13,11,15,17,11,7,1,16,4,7,14,3,8,0,4,18,1,4,17,14,12,14,2,11,11,7,2,7,11,1,18,6,0,32,3,0,7,15,12,11,0,3,2,3,13,20,11,12,0,2,2,11,1,0,0,9,8,8,23,0,0,0,28,0,1,3,3,9,8,16,0,1,18,0,6,21,0,20,2,16,15,12,7,5,0,0,8,7,20,3,1,23,5,11,0,7,15,17,3,0,0,13,17,20,2,13,1,7,6,8,3,13,7,14,6,27,2,16,12,0,10,12,21,9,13,11,2,0,2,9,0,8,14,8,5,19,9,3,13,5,12,0,16,5,3,0,21,1,0,5,13,4,5,2,2,2,7,15,0,3,18,3,0,5,16,1,11,26,9,13,7,12,12,4,0,18,14,0,4,8,0,11,0,8,4,21,5,16,3,12,12,3,75,6,0,11,13,11,4,10,15,6,3,1,10,16,1,1,24,3,9,12,13,13,1,8,3,6,0,12,1,10,13,5,8,9,0,0,3,2,7,13,11,0,10,2,7,15,1,0,12,2,8,1,1,10,10,0,11,19,23,6,14,3,2,72,27,1,5,0,0,15,1,14,1,0,6,14,5,12,4,3,4,12,15,4,5,18,6,1,13,0,3,2,0,0,628,20,0,4,1,0,7,0,6,5,2,8,0,19,8,5,9,1,32,18,5,5,6,30,2,6,11,15,9,11,0,614,8,17,26,5,5,20,17,1,8,0,0,2,11,11,24,20,6,8,0,3,10,0,13,2,16,19,1,15,7,0,0,9,2,0,2,2,11,3,13,7,0,22,10,10,5,7,3,7,3,3,11,3,37,0,23,6,17,12,4,13,1,21,0,0,2,5,18,0,1,0,0,25,0,2,2,0,7,14,2,1,6,8,2,0,0,21,11,7,11,13,10,14,1,6,4,7,3,13,4,17,4,0,9,1,13,5,4,3,7,28,9,12,6,0,10,6,16,10,8,14,10,3,28,8,4,2,0,9,0,0,9,2,6,0,14,3,7,10,23,0,18,2,3,31,14,5,8,8,0,10,8,7,5,3,1,6,0,7,3,0,13,4,11,0,22,12,0,1,0,10,15,27,6,30,18,7,3,18,41,1,22,4,0,1,0,9,10,4,4,0,2,8,11,5,5,7,9,3,6,1,7,1,9,4,0,7,10,3,4,7,0,1,7,9,8,0,3,21,8,10,0,7,7,9,6,25,9,3,3,1,4,6,7,0,5,1,3,20,12,12,3,11,3,10,2,1,11,15,7,9,11,8,5,10,7,11,0,0,4,3,0,0,14,0,6,3,16,12,3,1,6,4,17,1,5,1,3,7,9,5,3,18,9,7,0,17,3,10,7,8,11,0,17,1,12,14,3,3,20,1,5,1,10,7,3,35,3,8,17,8,0,0,1,4,7,6,2,6,0,7,5,14,0,1,12,5,8,1,2,3,4,0,3,1,7,0,5,2,0,3,0,2,29,11,33,6,5,4,4,10,1,21,6,7,13,3,29,7,6,1,5,1,4,9,4,7,1,0,2,4,9,0,9,5,1,3,11,5,25,4,0,11,16,1,2,3,6,11,0,0,3,11,1,14,0,0,0,7,1,2,1,4,6,4,0,5,35,0,0,7,46,7,5,8,1,1,9,17,13,17,2,4,3,7,2,20,7,4,12,0,1,4,0,11,3,5,3,21,0,7,1,12,1,5,2,7,0,2,10,15,0,4,3,6,14,14,4,1,0,3,2,0,2,2,0,2,0,2,4,19,0,2,16,2,10,2,0,11,5,0,6,11,3,3,5,15,5,0,0,12,9,7,11,0,5,12,1,0,0,9,7,0,4,5,0,1,4,3,0,11,0,9,7,1,2,12,0,9,3,13,1,1,280,13,7,4,14,1,7,3,7,1,0,2,1,4,5,3,6,0,8,5,4,23,1,1,0,8,5,6,24,4,5,6,20,4,14,0,10,3,5,1,3,1,3,2,6,1,10,4,15,2,1,4,9,15,2,2,2,2,9,7,3,7,5,5,5,0,7,16,4,0,10,6,2,0,14,3,13,6,1,13,3,7,7,6,4,3,34,0,2,1,1,0,9,4,1,1,5,6,9,12,4,1,2,3,6,2,2,9,6,3,2,2,8,13,0,0,4,2,0,0,7,2,1,25,10,4,12,7,4,4,1,0,1,4,3,1,21,17,14,12,0,4,7,16,3,0,13,0,4,5,0,0,8,11,3,1,58,13,1,4,0,1,0,0,16,0,1,5,0,0,7,3,1,5,7,3,4,97,0,4,5,2,0,4,22,7,12,0,13,5,18,0,0,4,4,6,0,0,5,0,14,3,17,10,0,6,1,14,14,12,5,0,2,0,11,4,6,0,13,0,0,10,3,3,2,0,0,1,0,20,1,5,4,1,11,4,5,0,2,8,1,1,1,4,1,10,2,7,12,0,0,0,2,9,3,4,3,0,3,0,1,4,5,4,12,1,3,1,5,6,6,2,3,6,3,12,2,21,5,4,6,0,3,0,7,2,7,1,3,10,2,4,0,11,14,0,0,5,1,1,0,4,8,1,0,5,6,6,6,3,2,2,2,2,0,0,2,2,1,1,7,4,2,2,19,7,10,8,11,10,1,10,4,5,6,8,3,3,3,9,0,1,6,3,5,8,18,12,2,4,10,3,11,5,0,17,10,2,3,6,9,3,6,5,1,6,0,1,6,1,0,10,8,2,0,3,0,2,100,0,2,1,8,1,8,9,10,8,5,1,12,5,1,1,10,11,3,6,4,15,6,4,2,0,10,9,3,1,2,0,3,6,3,2,3,1,7,1,1,0,5,8,3,13,0,4,0,2,5,0,0,8,7,6,4,2,3,9,1,9,7,0,3,9,4,7,10,0,0,1,21,9,5,2,6,16,0,9,1,4,0,2,0,4,8,1,3,2,7,0,3,5,1,0,9,3,0,3,2,6,12,1,0,1,0,3,0,42,1,0,1,6,3,0,2,7,9,3,0,10,12,0,6,4,7,9,5,12,0,8,0,0,6,0,0,4,30,1,11,6,0,0,2,0,3,2,1,11,0,1,3,0,6,4,1,3,11,2,2,10,6,4,3,2,1,10,0,9,17,12,0,0,6,1,1,11,1,1,0,4,1,6,2,0,0,1,4,1,0,10,0,1,3,4,3,23,0,13,1,0,13,3,5,0,6,0,10,2,0,0,3,9,1,7,1,2,0,5,0,5,3,12,0,6,9,3,6,5,6,3,4,4,11,2,3,0,0,3,0,0,13,2,0,19,17,3,7,1,6,4,12,4,0,0,0,2,7,3,4,9,23,4,4,7,10,5,4,0,3,5,6,10,8,0,7,1,17,0,4,3,2,0,1,2,15,9,3,9,0,7,5,6,14,1,2,3,0,11,1,4,0,5,2,0,1,0,0,10,0,0,7,0,0,0,0,9,0,2,5,1,1,19,7,2,4,7,15,3,1,5,2,0,6,8,3,0,3,0,4,0,6,1,5,0,1,5,3,5,0,1,0,8,6,5,0,0,4,3,3,0,4,0,6,1,2,5,1,19,10,15,1,8,0,4,2,9,3,4,5,2,0,2,18,3,6,0,2,8,0,0,10,1,1,1,0,0,0,6,1,0,12,16,2,0,8,0,0,5,6,0,4,3,4,0,0,0,0,1,0,0,4,0,4,0,2,27,11,1,0,2,0,8,15,5,4,6,0,4,3,0,7,8,11,0,2,7,2,12,0,11,0,7,16,1,6,5,7,1,0,5,0,5,1,3,5,13,0,0,0,0,7,5,2,6,20,0,0,1,1,1,5,0,5,8,3,1,4,1,5,1,1,3,10,1,2,2,1,4,6,7,4,6,3,0,7,18,6,3,0,6,1,12,6,1,0,0,9,1,1,5,7,9,7,3,3,10,5,1,0,7,0,8,7,0,1,2,1,7,0,6,2,0,2,0,2,4,1,3,2,3,12,3,10,0,2,5,0,0,12,10,11,8,1,0,8,2,7,0,1,16,0,0,1,1,7,1,0,7,0,3,1,9,2,0,0,1,3,5,0,5,2,2,11,10,0,1,1,1,7,7,5,4,6,4,0,6,4,3,12,3,5,3,1,0,0,8,3,3,0,0,0,4,0,0,2,0,3,0,2,1,0,6,4,3,0,4,3,2,0,2,4,2,0,1,0,0,7,0,0,6,4,4,1,6,0,0,1,2,0,5,2,1,0,4,2,0,0,6,2,1,8,0,2,11,5,3,1,0,0,4,0,11,0,3,2,3,0,2,0,2,0,5,6,7,0,1,20,4,1,3,6,10,2,7,1,2,3,4,3,14,2,23,3,4,9,4,5,0,0,4,2,12,1,1,0,2,0,26,4,3,1,20,0,8,7,0,0,2,16,5,0,1,0,0,9,2,0,0,3,3,2,0,6,0,0,1,3,1,1,2,0,0,11,5,9,2,1,4,14,0,3,0,10,4,5,3,0,3,0,1,14,4,5,1,14,1,7,5,2,0,8,13,5,14,0,4,0,4,1,0,3,1,0,2,1,3,22,2,0,6,6,2,4,7,1,2,0,41,0,0,0,4,0,3,0,3,6,1,1,6,1,4,8,6,4,2,0,1,5,4,10,2,1,0,4,0,3,6,10,3,3,0,6,2,13,2,3,0,5,0,0,7,7,1,7,0,4,4,5,5,0,2,17,3,2,5,1,0,2,0,2,3,6,0,8,2,3,3,1,5,10,4,3,2,1,0,3,10,1,2,4,4,7,0,2,0,8,12,0,1,1,9,5,4,0,2,0,0,0,6,2,2,0,0,2,6,15,4,3,0,0,3,4,9,13,4,1,1,4,6,0,0,2,2,2,5,27,1,14,8,2,4,3,5,28,1,4,1,4,7,0,0,2,7,3,4,9,6,4,16,3,1,0,2,0,2,0,3,1,6,0,8,4,0,1,11,9,16,6,4,0,0,4,2,1,5,1,0,0,9,9,3,5,0,0,0,7,2,3,0,0,1,1,2,0,5,1,2,7,13,1,1,1,0,3,0,3,1,7,3,6,5,2,2,2,0,0,10,0,7,0,0,1,13,0,1,8,0,3,2,0,2,6,3,2,3,3,0,1,1,22,3,2,9,7,4,1,7,5,0,6,4,0,1,2,1,1,0,4,2,6,0,2,3,1,0,4,0,0,0,0,4,1,0,6,2,1,1,6,1,3,2,8,2,0,11,5,20,0,0,7,16,0,2,0,0,4,1,2,5,4,0,6,0,2,0,6,0,1,4,4,4,5,3,0,6,3,5,0,4,3,0,0,2,3,4,3,0,5,11,0,0,24,0,6,12,3,3,10,9,0,5,0,1,0,0,0,0,0,1,1,0,4,0,4,7,0,0,1,14,0,3,47,1,1,4,16,0,2,6,19,5,3,2,2,11,0,1,0,1,0,2,2,10,0,5,15,3,4,1,4,0,1,5,8,0,0,8,5,0,0,3,8,5,0,0,3,5,12,1,5,1,0,0,1,3,5,2,3,0,5,1,2,0,1,8,6,0,0,0,0,0,3,0,6,5,2,1,6,3,2,0,7,0,4,20,0,0,2,3,0,8,2,5,0,0,0,0,4,1,3,0,1,1,2,3,5,2,0,4,0,4,12,3,0,2,0,2,3,6,7,3,0,4,1,4,1,1,0,0,0,0,1,0,0,8,8,0,5,1,1,4,0,2,5,1,4,2,0,6,1,0,1,2,0,0,4,3,6,3,1,5,2,1,9,5,6,0,1,1,3,8,4,0,4,2,0,0,0,3,2,0,12,3,3,0,3,0,6,1,7,35,0,1,1,0,1,2,11,4,2,2,17,0,6,5,1,0,0,0,8,2,7,19,6,0,8,4,5,1,0,14,0,0,4,2,2,0,0,1,1,0,3,2,0,2,4,1,0,3,8,1,0,0,5,5,4,0,3,1,1,0,1,3,0,10,0,0,1,6,0,0,0,8,0,1,0,3,1,1,0,6,2,0,0,0,2,6,4,0,0,0,1,2,7,5,0,0,0,32,2,1,0,4,2,0,4,3,6,4,3,0,4,1,4,1,1,0,0,4,1,24,0,1,0,1,6,8,7,5,3,2,0,1,6,0,2,1,1,1,0,0,2,4,0,0,0,4,0,4,10,27,1,0,5,2,1,0,0,6,0,0,1,3,2,0,0,1,4,1,0,0,3,3,1,1,0,9,0,0,2,4,4,2,0,3,0,2,2,0,0,1,1,6,1,0,0,6,0,5,0,0,0,0,1,9,0,3,0,3,5,1,0,2,0,3,1,4,3,4,1,3,0,0,0,4,1,11,4,2,3,1,1,0,7,0,0,1,0,0,1,0,3,0,1,1,6,1,3,8,7,1,2,0,1,1,0,0,1,1,2,0,0,3,0,4,8,0,1,2,0,0,9,0,9,0,3,15,0,14,0,0,4,2,4,0,8,0,12,20,1,3,3,0,0,3,1,9,3,0,1,1,2,5,3,6,2,0,0,15,3,5,0,0,1,4,1,6,3,0,0,0,0,2,0,2,2,3,3,1,9,2,1,3,0,0,2,0,0,4,4,7,0,0,2,2,8,1,6,3,8,1,0,1,2,3,3,59,1,1,10,2,2,2,1,2,0,2,2,5,5,7,3,2,3,0,3,6,7,1,3,2,1,0,0,8,1,2,4,7,2,2,3,0,1,0,3,0,2,1,3,0,4,1,4,1,15,0,1,0,2,0,0,2,0,0,5,3,6,0,1,0,0,0,0,4,0,4,0,6,4,3,4,28,1,2,1,1,5,0,0,2,1,1,1,1,3,4,0,0,0,1,1,2,0,8,3,1,0,3,3,2,0,0,3,0,0,1,19,0,1,0,2,0,25,2,0,0,2,2,0,9,3,0,9,1,3,0,2,1,3,1,2,2,3,1,2,2,9,0,0,3,2,3,5,5,1,0,3,1,0,2,3,0,0,6,1,5,0,3,9,0,0,1,0,1,0,3,2,1,7,0,0,1,8,1,18,1,0,6,0,1,3,4,0,0,1,1,1,6,0,3,4,3,51,7,2,0,4,0,0,0,3,3,0,0,0,3,4,10,2,3,1,12,3,0,2,12,2,4,0,1,6,1,15,4,0,1,1,0,2,0,0,4,2,5,1,10,3,1,10,1,0,2,3,2,3,0,1,1,6,3,0,0,1,3,2,0,1,2,4,7,1,0,2,0,0,0,1,4,1,0,1,7,9,4,1,4,4,0,2,7,7,0,3,0,0,0,0,12,2,0,3,0,1,1,5,4,6,1,3,5,3,0,2,0,1,1,16,11,1,1,1,10,4,1,68,0,2,1,0,4,10,2,3,0,1,5,1,0,1,4,4,0,2,4,5,2,5,3,8,0,6,3,0,0,0,0,4,1,1,0,0,0,2,1,3,1,4,1,4,4,1,0,7,1,0,3,1,6,2,1,2,1,2,10,0,1,7,2,1,6,5,0,0,1,0,3,10,1,0,5,3,4,3,0,2,2,0,0,3,4,7,6,4,1,0,1,2,0,7,0,0,7,0,4,1,0,0,1,0,0,1,1,1,4,7,12,5,2,7,5,3,0,0,0,0,3,1,5,0,0,5,0,4,0,4,1,0,0,1,3,0,0,2,2,3,3,2,2,7,0,3,3,0,2,3,4,2,0,0,0,1,3,3,0,0,0,3,0,3,8,1,0,0,0,1,1,1,1,0,3,3,0,10,0,5,0,1,4,0,1,2,2,1,1,4,1,1,2,0,5,0,4,1,7,1,0,2,1,7,1,0,5,3,2,1,5,5,1,1,1,6,0,0,0,6,1,1,20,0,4,1,1,0,3,3,1,0,0,0,5,0,1,0,1,0,0,4,1,1,5,0,0,0,2,1,4,1,0,10,3,0,0,7,6,8,2,1,0,2,2,0,2,7,0,7,1,4,3,3,0,0,2,0,0,2,1,0,0,6,0,6,4,0,8,1,2,3,4,6,0,4,8,0,1,0,1,1,1,2,1,4,3,1,0,2,5,1,0,3,2,7,0,4,0,1,3,0,0,0,1,1,1,1,2,4,2,3,0,2,2,0,0,1,5,0,0,0,1,7,8,2,1,1,0,0,5,6,6,3,4,0,5,1,0,12,6,1,1,0,3,3,0,1,0,4,0,3,0,3,2,4,3,2,3,1,4,0,0,0,3,0,5,1,4,1,2,3,8,0,0,2,4,2,1,0,2,1,2,3,5,3,33,1,4,2,2,1,17,4,0,3,0,18,2,9,3,3,5,0,0,4,1,3,0,5,1,0,2,5,3,0,0,5,2,6,0,4,1,3,2,3,2,2,9,7,0,0,0,3,8,9,5,0,2,0,1,1,2,0,5,0,2,5,1,15,0,5,1,3,0,6,1,0,1,1,3,7,2,0,7,0,2,0,1,6,0,0,0,0,0,6,2,0,0,2,0,0,6,0,3,0,2,0,1,6,0,0,7,4,0,2,0,0,1,0,0,0,2,0,0,6,3,13,17,0,1,1,0,0,0,0,0,0,0,1,0,0,2,26,1,0,0,2,1,0,1,0,0,1,1,0,0,0,0,0,0,7,0,1,0,3,0,0,0,0,0,0,0,0,0,0,0,0,0,39,0,0,0,0,0,0,5,0,0,0,0,0,0,0,3,12,0,0,0,0,0,0,0,0,0,0,0,0,0,0,0,0,0,0,0,0,0
"2004 DeMille, Nelson, Night Fall",pop,6942,4617,3565,3382,2081,4814,1107,1630,1982,1409,2262,423,1599,1181,643,1283,680,719,864,1245,960,1023,486,386,920,658,1213,678,524,628,473,498,689,550,1062,604,535,334,649,347,521,382,559,498,669,265,612,499,286,599,302,220,339,334,404,286,252,407,495,203,183,355,391,205,383,259,189,196,310,392,329,389,246,380,308,183,267,411,294,275,235,186,93,313,115,303,258,218,123,149,144,148,105,159,273,137,133,182,281,129,120,144,200,136,218,372,126,133,216,156,129,63,130,54,168,75,69,163,107,287,435,97,171,41,253,120,143,113,107,169,218,103,229,146,76,79,87,42,130,172,45,262,33,196,114,117,126,69,126,197,107,135,141,100,64,62,92,111,94,14,99,28,137,103,45,52,44,102,47,97,182,136,62,156,77,107,50,92,82,109,49,115,128,98,77,83,105,71,51,51,48,218,57,86,41,31,1,87,64,55,81,81,114,39,55,218,69,35,62,72,5,36,27,76,16,56,45,140,60,92,54,66,82,41,160,126,134,115,200,72,72,50,99,42,78,38,24,33,26,75,93,80,18,40,91,45,168,32,67,58,54,68,53,85,56,63,81,69,53,59,42,96,38,52,113,41,73,30,72,45,38,39,49,56,73,51,38,41,44,49,45,46,62,68,38,43,56,25,43,63,44,29,177,20,56,56,34,77,33,47,52,47,179,46,47,48,19,11,19,117,30,55,55,44,26,25,89,33,39,59,45,88,45,11,13,19,20,42,39,46,66,48,59,37,48,64,33,12,76,68,17,57,83,73,47,18,24,168,20,78,47,47,37,22,34,28,223,35,22,37,71,102,37,25,80,109,19,15,54,23,22,18,59,22,44,16,26,85,59,38,25,7,74,25,33,81,0,21,29,15,6,47,36,110,37,33,8,15,26,21,9,6,39,30,29,64,36,17,35,10,44,26,10,16,30,23,71,37,53,52,41,31,18,44,16,30,69,29,32,75,28,20,17,21,9,28,18,23,1,32,41,25,35,33,30,59,8,63,37,14,29,19,52,27,14,46,25,50,31,38,18,1,0,30,45,67,16,14,32,20,12,14,34,0,23,10,14,22,0,23,29,19,19,44,0,18,38,19,31,31,7,56,8,22,22,40,17,25,18,22,32,10,75,65,21,27,51,14,27,55,7,7,37,13,15,22,0,15,55,60,28,8,8,44,18,65,35,14,27,28,113,12,35,38,38,2,49,21,22,16,12,20,122,11,36,12,0,1,55,58,17,47,18,36,0,31,40,20,12,41,20,12,27,67,23,22,21,3,8,17,3,63,14,29,14,27,12,0,10,22,17,14,28,6,55,13,52,28,13,30,21,64,25,23,21,33,9,5,15,21,6,17,9,3,5,0,18,5,13,15,32,53,10,22,9,21,17,8,6,7,13,19,9,16,20,28,15,15,16,45,31,22,27,7,23,0,14,14,8,15,17,18,26,27,63,25,26,37,1,28,16,8,52,33,63,7,8,1,17,20,56,9,25,22,1,18,4,32,23,31,5,12,10,10,14,14,12,12,17,57,38,30,32,17,22,40,25,20,6,29,29,22,5,17,22,32,22,69,32,31,16,7,4,22,46,0,2,48,69,10,48,13,3,6,20,14,20,14,23,18,44,1,26,36,1,9,11,2,11,22,19,27,1,1,0,7,10,31,29,14,16,19,37,1,2,0,23,7,21,7,21,7,8,8,33,3,44,53,10,22,20,1,12,2,15,14,13,6,2,11,23,15,0,14,0,15,7,3,0,131,11,7,37,9,2,7,29,14,22,29,25,2,0,7,12,19,205,16,1,4,4,1,5,19,16,77,2,41,7,14,23,1,11,166,2,21,1,0,4,29,21,13,18,20,15,19,14,56,27,42,8,3,1,18,14,23,8,41,0,13,1,51,7,1,7,1,20,0,11,28,2,4,196,11,27,9,39,59,4,17,2,4,56,13,16,8,1,0,6,2,6,11,3,25,0,7,74,7,10,8,11,22,30,3,15,7,15,13,2,6,27,4,4,42,11,8,1,0,2,6,24,36,2,24,7,23,5,21,8,11,36,0,11,0,13,5,7,15,12,9,13,5,24,5,28,12,1,2,22,10,43,12,0,53,16,80,12,16,6,24,16,38,28,14,18,29,51,21,5,8,2,9,2,10,5,25,1,12,8,3,0,13,4,13,3,10,12,1,4,21,18,4,20,23,10,6,29,22,11,38,2,11,4,90,10,3,5,2,77,7,3,7,19,4,4,7,19,10,10,0,11,0,25,2,7,2,0,0,6,3,23,7,14,0,9,42,2,0,59,11,39,35,25,42,194,29,11,1,27,14,11,25,3,15,3,0,8,0,10,4,9,14,107,42,10,9,9,5,6,40,17,19,0,0,8,0,12,12,4,2,7,0,0,23,9,3,9,40,0,0,0,35,16,10,48,6,15,0,14,25,141,9,11,13,1,8,16,10,4,1,34,0,9,16,33,11,16,1,28,7,3,1,7,8,9,8,10,3,13,15,10,8,13,3,0,0,15,3,3,8,2,25,6,1,7,15,15,14,5,35,7,0,6,0,3,0,5,15,2,2,2,16,10,6,4,5,3,67,7,8,9,15,2,6,2,26,2,2,20,12,39,2,2,8,381,4,0,14,1,0,0,11,8,0,16,1,0,15,25,0,1,10,1,3,11,11,0,9,4,0,18,8,0,9,11,19,8,5,9,3,12,0,7,5,3,5,1,3,4,12,0,3,16,1,13,0,0,2,12,7,18,17,15,2,2,3,25,7,3,8,1,15,1,15,8,0,23,0,6,9,9,8,18,0,9,26,0,9,7,8,36,29,9,5,20,8,6,48,0,4,3,0,18,7,0,21,11,77,15,11,3,50,41,3,0,8,9,2,0,0,17,6,2,4,9,7,6,3,12,1,0,8,11,5,11,10,45,6,0,2,3,6,11,5,7,6,25,1,0,5,1,0,2,0,0,14,2,5,3,24,0,4,105,0,15,3,2,8,14,4,0,4,5,38,19,11,28,2,6,19,5,1,19,0,8,41,6,0,11,0,5,1,20,1,8,1,0,9,13,19,11,9,7,0,10,59,11,3,0,7,27,9,5,28,9,0,0,5,0,46,3,0,18,0,2,5,1,12,1,28,0,4,4,0,1,33,17,0,20,49,0,1,0,17,0,2,3,0,27,10,25,9,1,23,0,12,2,7,15,9,3,7,6,9,5,0,13,3,4,0,5,8,0,0,12,2,1,22,3,17,7,8,2,10,1,3,10,7,2,10,2,9,0,0,12,0,2,19,3,2,12,11,4,2,13,2,7,0,3,5,12,23,10,8,0,2,1,18,6,8,9,12,4,10,10,8,1,3,3,0,20,2,17,10,3,6,0,0,6,10,5,0,0,0,0,2,0,9,10,5,7,2,5,0,1,7,4,0,1,20,25,6,0,6,1,4,12,1,20,3,7,4,4,15,3,2,6,15,3,4,5,20,36,3,4,5,9,0,34,28,12,2,1,12,1,1,2,1,1,10,18,15,2,10,2,10,3,2,4,2,8,2,11,0,12,4,4,2,2,13,0,2,9,1,12,11,11,4,0,7,0,7,7,2,13,2,2,0,7,19,0,8,0,3,7,7,15,17,1,5,2,3,13,2,2,2,0,2,1,10,8,11,4,0,9,3,7,2,3,2,5,30,1,9,1,5,1,4,8,14,10,9,6,7,0,36,10,8,7,6,15,1,0,48,2,6,24,2,8,1,5,2,4,6,5,6,11,0,8,0,14,0,5,9,32,1,58,8,12,2,2,13,7,3,1,1,5,5,3,4,20,0,6,1,21,1,4,21,2,14,2,0,3,6,1,0,35,7,4,38,60,1,6,16,3,5,1,2,0,4,28,6,0,1,8,6,3,0,2,1,5,10,12,0,2,1,2,4,4,6,2,3,3,2,0,4,2,4,11,0,19,7,3,15,1,1,0,4,0,2,1,6,8,4,6,4,4,3,15,0,3,4,31,0,4,14,5,2,4,2,9,8,6,1,6,3,3,1,3,3,2,3,0,3,5,0,10,2,4,13,1,3,3,7,0,12,7,2,1,76,2,1,17,5,2,2,3,0,1,2,14,3,0,0,4,3,1,5,0,0,0,1,2,7,0,1,7,7,0,7,0,1,0,6,6,12,3,4,1,0,7,4,7,0,4,38,1,5,2,0,5,2,11,1,0,36,1,19,0,4,0,6,8,5,87,5,0,2,4,8,0,0,3,1,4,0,4,1,3,3,1,7,0,2,3,71,15,15,2,18,0,2,4,3,0,5,3,15,2,10,0,1,3,0,1,8,1,2,0,14,13,0,0,2,2,0,2,30,9,8,26,0,0,2,0,0,4,4,0,3,19,5,0,4,41,15,7,1,9,1,0,0,6,0,0,11,0,6,0,7,11,12,1,1,2,30,20,10,6,0,3,0,3,0,2,11,2,1,15,4,2,5,6,9,5,10,4,5,2,35,2,28,4,3,5,23,4,0,4,11,0,64,3,3,2,6,22,1,40,6,6,3,7,9,6,6,6,2,8,3,14,1,6,1,4,0,2,2,11,0,4,7,7,2,1,92,2,2,1,2,6,3,6,265,0,2,4,10,2,0,3,5,6,6,3,0,8,0,1,2,1,22,0,9,4,3,1,12,8,0,1,0,2,5,0,4,7,1,2,0,3,9,6,9,1,4,6,0,5,6,4,16,4,1,0,1,0,0,2,6,1,0,0,1,9,3,0,2,2,10,4,4,3,0,5,1,5,0,0,1,1,0,7,0,0,0,18,1,1,3,2,4,0,1,0,7,3,1,9,4,3,8,2,0,0,4,15,0,0,16,0,8,1,0,1,0,1,7,3,2,0,0,4,2,3,3,3,1,4,4,3,5,7,61,6,1,0,0,14,4,2,0,0,1,9,2,1,5,3,13,3,3,13,8,1,5,3,11,5,2,0,2,5,1,5,5,0,0,0,8,2,2,5,0,12,130,8,2,0,2,20,4,3,4,12,6,2,9,1,34,2,5,3,2,4,1,5,0,2,0,1,2,9,5,0,4,4,1,2,4,15,11,6,2,2,0,0,5,0,2,2,13,5,6,23,2,2,2,4,1,1,0,3,2,1,11,7,4,0,8,3,3,12,4,14,5,7,1,6,2,2,1,2,1,9,2,0,0,2,4,5,13,7,10,0,9,3,10,2,12,5,3,7,1,4,3,3,6,1,1,29,1,0,5,3,1,16,15,1,11,0,14,9,1,10,0,4,2,1,1,13,6,5,7,27,12,14,20,1,2,0,1,9,0,0,5,2,2,1,1,0,0,6,1,10,3,2,36,2,5,1,4,1,6,0,0,0,4,2,3,0,4,0,17,22,0,1,0,15,10,2,6,4,1,2,0,0,2,0,1,0,2,9,0,0,1,8,0,1,1,4,0,1,5,28,24,0,6,0,111,4,1,12,0,1,0,0,2,3,1,6,2,9,0,0,0,4,0,2,14,0,0,4,0,2,0,0,0,3,6,7,0,1,11,1,3,10,0,0,1,1,0,0,1,0,7,1,2,11,0,0,6,6,8,2,2,0,15,5,10,8,0,14,7,0,1,0,0,0,1,0,0,1,1,1,2,1,2,3,0,3,3,0,2,0,3,0,0,1,135,1,7,0,7,0,0,1,9,0,7,9,0,22,0,4,3,12,1,0,5,6,25,4,5,3,0,3,2,4,11,2,0,7,17,3,6,5,0,4,0,10,14,0,11,13,3,5,0,0,1,2,1,2,1,2,3,12,1,8,0,1,0,0,0,0,0,0,2,0,1,6,3,4,11,6,0,0,8,15,2,0,3,4,4,0,18,2,0,2,0,3,0,3,1,0,8,0,2,0,0,7,2,0,2,4,5,2,0,9,5,1,11,3,0,2,1,0,1,4,7,101,4,0,12,16,3,0,4,6,2,9,0,0,3,0,0,5,2,7,0,0,4,0,2,1,1,3,2,7,2,3,0,6,0,0,1,0,1,1,5,10,3,5,0,2,1,1,0,5,182,1,1,1,4,1,2,0,2,1,2,1,0,9,7,2,0,9,5,1,0,2,8,6,1,0,0,0,34,3,6,1,8,6,1,2,0,0,0,0,0,11,1,2,2,3,0,0,0,0,41,0,0,1,1,0,0,19,2,8,6,0,0,1,2,1,0,1,5,0,1,0,0,0,5,0,7,2,21,4,2,18,5,1,2,0,3,5,0,5,2,1,0,0,1,11,0,3,1,1,0,3,7,6,3,0,11,20,1,2,1,2,2,4,1,5,3,6,3,1,5,0,2,0,1,0,0,0,20,10,0,0,1,1,2,2,4,12,25,4,1,0,4,2,1,0,0,2,0,2,5,3,0,3,0,1,2,11,7,5,0,6,2,2,1,0,1,0,0,4,0,0,0,14,3,0,0,3,10,1,1,3,0,7,0,0,5,0,5,3,0,2,0,3,1,2,1,7,0,25,0,15,1,3,2,6,5,8,3,0,0,1,4,0,0,5,3,3,63,0,2,4,1,4,0,0,4,0,0,1,1,1,0,3,2,9,3,6,1,2,1,0,5,3,2,0,0,0,0,2,0,2,5,12,10,0,0,3,2,0,0,0,0,0,2,3,16,3,3,1,0,5,0,8,1,0,0,1,0,6,0,1,0,0,0,1,14,0,0,11,10,0,8,1,1,4,0,3,0,0,0,0,0,0,3,1,3,3,4,0,5,0,0,1,0,0,0,9,13,0,5,3,0,0,2,2,2,6,0,4,4,4,6,7,3,0,0,0,2,3,3,1,5,4,1,0,0,1,9,0,2,0,2,0,2,0,8,2,3,5,3,1,0,7,2,2,9,1,3,3,0,1,0,1,0,0,0,4,3,20,5,1,10,0,2,1,1,7,6,2,3,13,0,3,0,5,7,3,0,0,2,1,1,2,2,0,5,2,2,1,1,10,0,3,3,1,8,1,31,1,1,1,0,0,4,13,0,18,7,6,1,2,3,0,0,0,22,0,4,1,5,4,0,2,11,12,0,0,3,6,1,0,1,0,13,1,6,0,0,0,3,0,1,6,3,1,4,3,1,0,7,3,6,1,0,3,10,0,2,11,0,0,1,0,2,0,1,0,0,1,4,0,3,0,2,1,0,0,0,3,0,1,0,0,1,5,0,1,0,10,2,1,2,3,0,3,0,0,1,3,5,2,0,0,0,0,1,0,3,4,0,0,1,8,1,0,7,0,0,1,0,1,3,0,3,12,0,4,3,1,0,4,0,28,7,2,4,1,2,2,0,0,0,0,0,3,10,4,6,2,0,0,7,0,0,9,1,0,3,0,1,2,5,1,3,0,0,1,0,13,0,3,2,4,3,2,1,0,4,3,2,1,0,0,6,1,0,1,0,1,11,0,0,5,0,0,0,2,1,9,4,3,1,2,0,0,0,1,1,0,0,0,3,4,0,1,3,0,0,1,0,2,6,5,1,9,1,0,5,6,7,4,0,1,2,0,2,3,1,0,9,4,5,4,0,7,0,0,0,1,2,3,2,7,0,2,5,6,3,2,0,4,41,0,0,15,2,1,1,4,0,0,3,3,0,6,6,0,0,2,2,1,1,2,20,3,3,0,5,1,0,1,1,1,2,1,0,3,0,3,0,0,4,9,6,3,5,1,30,0,0,0,2,0,19,3,0,26,3,0,1,3,0,9,0,1,0,0,6,6,0,6,0,1,12,2,4,0,2,1,1,5,2,1,0,1,0,0,1,2,0,0,133,3,2,0,0,1,0,0,0,1,3,1,0,0,3,1,2,0,1,8,0,7,2,6,0,3,0,0,1,0,2,2,0,1,3,6,1,1,5,1,4,3,0,1,1,0,1,0,4,4,0,0,0,0,2,3,0,0,0,2,1,11,0,1,1,0,0,2,4,0,0,2,2,2,0,1,4,3,0,0,7,9,5,0,0,1,0,1,2,0,9,0,0,0,7,15,0,0,5,4,0,0,5,2,0,0,1,12,7,1,0,0,1,0,3,2,0,11,3,3,0,3,1,0,0,5,1,0,0,0,6,5,3,1,31,1,0,2,0,2,0,0,1,0,0,0,1,0,10,0,6,6,3,0,0,0,1,3,3,3,0,0,4,1,3,0,1,3,4,0,1,1,1,0,2,0,3,2,3,0,0,0,1,0,0,3,4,3,0,0,0,5,0,0,0,6,15,4,10,2,3,3,2,6,4,0,2,4,0,0,2,1,0,0,1,2,0,3,2,2,5,1,0,2,1,15,1,3,0,0,4,0,5,1,5,0,0,0,4,0,3,0,0,0,1,0,3,1,4,1,0,0,1,1,0,0,2,7,0,1,0,0,0,0,1,0,0,0,2,7,0,53,1,0,0,0,3,0,0,0,1,0,4,7,0,1,4,0,0,0,3,0,1,0,1,0,26,0,0,0,1,6,0,0,22,3,2,1,0,2,0,0,0,0,1,4,0,0,0,0,2,0,0,2,15,0,0,4,0,8,0,10,0,1,1,0,1,0,0,5,7,0,0,4,0,0,1,0,2,2,1,7,0,0,0,0,4,1,0,2,0,0,0,0,2,1,0,4,2,0,3,0,1,0,0,0,0,4,1,1,1,2,5,0,5,0,1,4,4,4,0,0,0,0,0,4,0,0,1,0,0,0,1,0,0,9,0,1,2,2,1,0,3,0,3,1,0,2,0,1,1,1,1,1,0,0,1,1,3,0,0,1,5,0,2,4,2,5,2,2,4,2,14,13,14,1,5,0,1,1,0,0,0,0,1,0,0,0,0,0,0,0,1,0,1,0,15,0,1,3,3,1,0,4,1,5,2,0,0,0,0,2,0,0,5,6,0,2,0,1,0,1,2,0,7,6,13,0,1,1,1,2,2,1,0,8,2,5,3,1,6,0,0,1,8,7,2,2,0,0,4,1,0,0,1,0,1,0,0,0,0,3,0,0,0,0,0,1,0,0,0,3,0,0,3,0,0,0,3,0,0,3,0,0,2,1,0,0,0,0,0,3,0,0,3,3,3,1,0,5,3,1,0,3,0,7,0,1,4,0,1,1,0,2,1,1,7,2,0,5,0,1,1,7,7,2,0,3,0,5,2,0,0,0,0,1,1,0,0,1,6,2,0,1,0,1,0,1,1,1,4,0,1,0,2,0,1,2,11,1,1,3,0,0,0,0,1,2,0,1,9,3,4,4,0,2,1,5,0,2,0,1,3,2,0,0,3,1,0,2,1,0,40,2,0,7,2,1,0,0,2,0,0,0,0,0,1,0,0,2,0,0,1,0,2,0,0,1,2,2,1,0,3,2,3,0,1,0,0,0,0,4,0,0,1,1,3,15,2,0,0,4,0,2,0,2,0,0,0,5,0,110,5,2,0,1,0,2,0,0,1,1,0,1,0,0,1,1,19,5,1,0,0,3,0,3,2,0,2,1,0,1,2,0,0,5,6,1,2,5,3,0,0,6,1,0,1,6,0,0,3,2,2,2,0,2,0,1,1,2,1,0,2,0,2,6,0,0,10,1,1,0,0,0,1,1,0,0,1,0,0,0,5,3,0,0,1,2,0,0,1,2,0,1,0,0,1,1,2,2,1,1,0,0,0,1,2,2,9,0,0,0,2,0,12,10,1,1,1,0,0,1,0,0,1,1,0,0,0,0,6,0,0,4,0,10,2,0,1,2,3,2,0,32,1,2,0,5,2,0,0,0,0,1,5,0,4,0,80,0,1,2,7,0,0,1,1,0,4,0,0,0,21,0,3,1,0,0,167,0,0,0,2,0,0,1,2,0,0,0,6,0,1,3,0,12,2,0,10,0,3,0,1,4,0,0,3,0,1,3,0,1,0,0,0,1,0,2,0,0,0,0,1,0,1,0,0,0,0,6,0,0,0,2,3,1,3,0,2,1,2,0,0,0,4,1,0,0,0,0,3,2,1,1,0,0,0,0,0,1,20,0,2,2,0,6,0,9,1,6,0,0,0,11,0,1,0,5,6,4,0,3,5,0,0,4,3,11,7,2,0,14,0,0,1,6,5,0,1,0,0,1,14,0,1,0,2,0,0,8,0,0,8,0,0,3,0,2,0,2,4,1,1,0,0,11,0,1,0,0,0,1,0,2,2,7,0,0,0,1,0,0,0,6,0,0,2,5,0,0,1,0,0,2,1,0,3,3,1,3,2,0,2,3,3,0,0,0,5,0,0,3,1,0,0,1,3,7,0,0,0,0,1,0,6,3,7,0,0,4,10,5,5,51,3,5,1,0,0,2,0,2,0,0,1,0,2,3,1,2,0,1,8,0,5,0,1,0,4,0,4,0,0,1,0,0,2,0,3,2,0,1,1,1,0,136,0,3,3,1,12,0,3,9,2,0,0,2,2,1,0,0,0,1,0,3,0,0,1,0,0,1,2,4,1,1,3,1,1,2,0,0,1,0,7,0,1,2,1,0,0,3,3,0,2,1,0,18,0,3,0,3,0,0,5,1,0,3,0,0,1,6,1,1,3,1,0,1,3,0,0,3,1,1,0,6,0,0,3,0,0,1,3,0,0,0,3,8,1,1,3,0,1,0,3,0,5,2,3,0,2,0,0,0,6,7,0,2,0,1,0,0,0,1,1,0,0,2,0,1,0,0,3,0,1,5,0,0,3,0,0,3,8,9,0,0,0,1,2,0,0,0,0,0,0,3,0,6,0,1,2,0,1,0,3,1,1,2,0,0,0,0,0,0,1,0,1,0,0,0,4,0,3,1,1,0,0,1,0,0,2,0,0,0,0,10,0,1,0,0,3,0,3,4,0,0,0,5,6,2,17,6,0,0,5,4,2,0,2,0,5,1,3,2,1,0,7,5,2,7,4,4,1,1,0,2,0,2,9,0,0,0,0,0,1,0,0,0,2,0,0,1,1,0,0,0,0,3,0,0,28,15,0,1,0,1,0,0,1,2,4,0,0,0,0,2,0,2,3,0,0,0,0,3,2,3,0,0,5,6,3,0,1,0,0,0,0,3,5,6,0,1,4,0,1,0,0,8,5,0,0,0,9,0,0,0,0,0,1,0,0,0,20,0,2,0,2,0,0,0,13,0,0,0,7,8,1,0,0,0,0,1,2,0,1,0,0,7,0,0,0,0,0,1,0,0,0,15,0,0,0,0,0,0,0,0,0,0,1,0,0,0,0,0,0,0,0,0,0,0,0,0,0,0,0,0,0,0,0,0,0,0,0,0,0,0,0,0,0
"2005 Johansen, Iris, Countdown",pop,4488,2891,4018,2173,1502,2722,2464,1188,1602,1766,2785,978,1465,1833,1266,735,625,746,676,473,666,913,702,1098,358,797,984,298,466,427,403,410,571,849,389,895,312,295,398,266,605,282,329,509,422,328,216,240,311,272,340,268,353,194,249,163,344,422,605,231,242,515,198,214,278,230,65,180,258,257,456,602,238,230,135,183,115,396,73,291,147,405,127,237,196,115,163,284,126,231,69,281,181,147,192,174,123,73,182,153,133,118,394,109,185,21,126,96,351,111,180,42,122,225,88,169,191,117,125,66,85,209,83,75,123,211,100,84,90,226,71,90,196,100,88,131,52,133,75,170,28,221,185,352,118,76,175,147,206,151,38,168,142,79,80,280,117,71,29,45,22,68,163,45,51,11,54,34,37,58,112,120,114,362,81,41,92,68,64,148,92,139,124,84,175,35,138,35,24,75,46,94,117,55,6,53,41,94,56,27,157,39,53,34,91,4,42,15,121,18,22,30,32,147,37,10,75,129,41,35,53,49,32,52,101,21,138,33,116,53,95,21,33,37,52,175,18,43,29,52,98,154,9,86,73,55,18,47,64,35,75,12,23,11,49,140,56,114,21,45,35,36,41,20,19,20,63,67,85,28,88,42,43,24,56,77,43,89,72,55,7,20,29,67,69,21,76,31,42,7,37,17,77,21,50,24,51,88,68,146,48,40,73,37,11,98,47,20,51,131,56,50,51,16,23,26,49,10,61,68,23,83,30,57,51,23,77,21,42,71,94,136,16,46,29,51,16,7,39,36,19,29,62,6,45,27,95,3,13,35,27,34,27,117,12,33,25,43,24,15,23,111,60,18,15,145,58,6,38,10,18,35,16,10,15,14,31,2,41,109,14,23,7,153,41,49,0,38,139,7,9,17,12,3,31,51,11,35,46,133,12,15,34,11,28,32,35,44,36,28,26,28,21,11,23,59,65,11,20,8,31,0,5,10,29,25,78,9,89,14,43,77,52,27,2,9,15,34,0,44,27,29,79,16,51,17,17,42,42,22,48,37,29,26,59,40,63,8,13,22,34,1,0,16,11,51,34,6,0,48,22,40,19,0,4,20,14,5,0,29,34,58,40,24,28,13,17,18,27,33,24,18,4,30,14,46,16,24,3,19,15,48,31,24,29,29,33,23,55,37,8,4,19,7,24,32,0,51,6,21,27,18,10,16,20,33,76,36,17,9,8,8,8,64,8,0,19,16,31,13,12,55,24,21,4,4,0,7,11,13,14,17,7,3,17,13,14,18,5,4,6,11,33,0,35,40,16,15,3,7,29,26,17,6,13,14,22,6,18,11,25,111,25,10,3,11,18,24,1,10,17,32,9,11,15,102,6,11,18,7,80,5,23,9,2,0,1,45,28,10,11,65,23,11,1,13,9,6,16,4,8,17,6,21,31,4,17,9,1,12,1,25,2,2,6,0,6,16,20,9,32,20,9,4,3,1,31,17,7,25,0,0,28,28,4,4,17,1,30,5,27,42,30,83,12,13,73,47,27,7,28,22,10,12,7,7,57,6,25,35,7,13,19,13,30,17,6,20,11,18,51,16,3,13,21,5,3,3,6,12,17,1,9,6,27,42,1,8,8,7,5,15,1,4,8,41,13,8,2,14,4,9,2,15,15,5,10,3,6,14,4,19,0,7,0,16,7,8,7,39,5,10,0,31,1,0,8,23,46,4,2,10,10,6,23,16,18,1,19,19,12,1,1,27,4,9,23,8,9,18,23,7,0,27,0,4,14,15,2,31,13,14,11,37,19,8,6,12,15,51,1,1,24,2,5,5,4,18,0,6,67,1,24,30,12,3,4,41,14,3,10,7,6,6,7,9,1,0,7,1,1,5,33,26,6,18,2,4,2,4,1,1,11,18,0,15,10,28,0,18,0,8,6,3,22,5,39,0,12,10,21,12,0,10,4,0,15,6,0,14,0,14,29,14,0,6,4,0,5,7,25,6,3,4,0,6,1,23,11,10,15,24,6,4,11,17,16,22,6,11,8,4,24,13,1,13,1,0,12,14,11,0,15,7,26,14,4,46,6,1,10,20,22,0,7,1,170,18,3,40,12,1,8,27,7,23,7,440,20,9,0,40,5,0,9,14,3,13,8,34,11,0,2,1,15,3,5,4,13,2,13,4,3,3,0,32,11,0,30,0,0,18,20,2,6,18,1,3,0,17,9,90,5,5,2,2,3,13,5,4,4,7,7,5,9,0,4,0,4,2,14,14,6,1,6,0,2,4,1,0,7,0,19,0,2,6,0,0,1,22,5,10,12,31,10,8,5,0,8,13,34,12,4,3,0,4,3,2,2,31,11,7,6,3,11,0,5,2,16,10,12,35,5,11,61,10,10,5,1,5,0,6,9,0,7,0,28,7,2,9,1,2,0,9,8,1,4,2,0,0,0,1,9,7,3,18,9,0,14,5,7,3,0,2,3,3,20,7,8,3,1,0,11,3,14,4,1,8,12,7,14,1,2,19,21,3,4,5,8,2,4,1,3,36,0,0,1,1,4,13,11,0,0,0,5,4,5,1,2,1,12,1,5,13,1,3,3,0,7,1,11,13,11,5,2,0,28,5,16,12,7,3,14,9,11,11,0,4,1,15,0,10,2,0,0,2,0,14,0,0,0,5,5,10,6,3,7,8,6,0,12,1,0,4,5,6,0,4,3,0,25,9,1,10,1,1,8,1,0,21,0,0,5,11,7,3,0,2,0,2,0,4,1,2,1,0,0,4,3,2,4,5,7,13,4,3,8,5,15,2,2,17,6,13,4,0,22,7,12,6,4,11,13,0,6,4,0,8,16,16,4,1,4,2,0,19,0,2,0,8,6,0,0,28,0,1,1,2,11,1,0,0,10,7,0,0,8,2,0,1,3,3,0,1,5,11,14,4,2,4,0,10,4,10,13,1,19,2,0,6,9,61,31,5,10,7,0,4,2,2,4,1,0,5,0,11,3,2,8,8,14,1,7,0,9,2,2,0,24,7,1,1,5,13,3,7,9,4,1,10,2,4,7,1,2,4,1,3,5,1,3,0,17,8,2,3,15,2,21,2,0,3,5,0,10,6,20,3,7,5,3,1,8,0,5,0,0,0,0,0,2,0,8,6,19,16,4,11,0,19,0,3,7,16,0,33,2,1,2,13,2,0,0,5,3,2,11,0,13,3,36,9,1,2,0,9,6,1,15,3,2,6,1,9,5,7,7,4,16,5,2,8,0,0,7,2,108,0,3,1,1,5,0,14,0,6,6,3,2,15,6,14,553,3,28,0,0,2,2,0,41,14,8,0,0,5,3,0,7,6,11,7,14,7,3,4,4,1,2,6,5,4,0,5,5,4,7,25,0,9,4,8,4,2,5,8,0,0,2,4,5,1,0,0,0,1,0,3,3,0,19,3,6,1,27,3,2,0,1,8,6,13,17,1,6,8,1,7,13,2,2,0,3,9,8,0,21,1,16,4,16,6,8,6,5,3,4,0,8,1,2,2,4,15,3,2,5,0,5,9,2,6,10,1,2,2,2,0,17,3,4,2,6,0,7,2,4,12,2,7,2,3,2,0,9,31,7,7,0,14,0,10,1,0,0,3,1,0,5,8,0,0,0,11,6,1,8,0,5,12,7,2,1,1,11,2,0,21,1,3,4,3,0,0,12,5,4,5,2,3,13,2,3,1,2,0,4,12,2,3,11,0,0,7,0,1,0,10,8,1,0,0,3,3,0,1,1,4,8,6,6,7,7,4,0,5,8,0,16,5,0,4,30,11,16,4,0,8,2,8,3,1,6,2,0,1,0,7,6,9,4,0,5,2,0,2,9,0,5,14,4,2,2,0,10,5,2,3,0,28,0,2,4,0,4,0,4,1,0,20,11,6,17,0,1,43,0,1,0,2,2,0,10,0,3,10,3,11,1,8,1,0,3,17,0,0,9,2,2,36,5,4,7,1,0,1,395,4,5,5,4,7,2,1,7,3,12,16,5,0,1,25,2,3,10,2,1,3,6,8,0,0,4,2,5,21,3,4,3,5,0,13,1,2,5,23,2,4,2,7,1,0,4,16,3,7,7,3,2,0,4,17,1,29,1,0,2,0,0,6,2,7,0,0,3,2,0,4,0,0,1,3,8,5,0,1,18,6,0,9,0,0,0,1,0,7,3,0,5,3,2,8,5,9,6,33,8,5,4,3,1,1,4,0,0,5,0,1,0,8,4,2,0,9,2,4,2,2,1,1,0,0,12,3,12,0,18,2,1,1,0,2,0,0,8,15,2,6,3,5,0,3,21,6,0,3,35,3,1,3,0,0,11,0,13,9,5,0,7,17,2,0,0,0,0,2,5,5,5,13,5,19,0,2,0,0,5,2,0,3,15,0,0,1,3,10,3,10,0,2,0,6,10,2,1,5,0,11,1,1,3,4,4,0,10,0,0,0,3,3,1,6,0,0,1,3,0,3,34,3,3,3,4,2,3,7,1,4,4,0,7,0,0,2,1,0,2,0,3,1,2,28,7,2,5,18,1,3,6,2,1,3,2,1,7,0,2,1,3,8,7,0,1,7,1,0,2,1,0,0,0,5,2,3,0,2,1,7,1,2,1,0,38,0,0,1,1,5,6,6,2,8,7,3,4,2,0,6,4,2,0,5,2,1,7,1,3,4,5,8,0,0,13,25,0,0,7,1,0,1,0,1,3,2,8,0,0,0,0,0,0,4,0,3,0,21,2,0,0,2,3,8,1,2,1,3,20,0,13,0,0,11,0,0,1,0,2,2,0,2,48,0,9,2,0,0,3,0,0,10,0,5,1,0,0,5,0,1,8,5,0,1,0,0,2,6,0,0,0,0,2,4,0,0,0,0,3,19,4,4,0,0,3,7,3,2,5,0,2,2,4,0,0,0,1,0,0,1,0,2,0,0,0,0,4,2,1,3,1,0,5,2,12,2,4,0,12,0,2,4,2,2,5,1,0,3,0,265,0,7,0,1,11,11,6,1,3,2,3,0,7,3,4,1,5,0,3,3,4,2,8,1,9,1,0,0,1,0,1,320,6,0,0,6,0,13,0,4,1,4,1,12,0,2,8,8,1,0,1,4,1,13,1,4,2,3,5,2,8,0,1,1,2,1,1,1,2,0,4,1,1,9,0,4,2,4,0,1,5,0,0,5,20,2,4,7,0,0,1,9,0,1,10,6,0,6,6,0,3,2,3,0,5,4,0,17,4,2,0,2,0,1,0,0,2,9,6,2,7,5,165,0,0,1,2,5,3,0,3,0,9,10,13,0,1,1,2,1,0,3,29,4,0,5,3,0,1,0,1,2,0,1,4,1,5,2,7,1,1,5,0,0,2,8,0,0,2,2,1,2,0,3,0,3,2,0,2,3,2,0,4,3,5,0,1,1,3,1,8,2,1,4,2,0,0,3,2,0,2,0,3,0,0,1,6,1,0,42,295,6,8,2,1,2,1,0,4,1,0,0,1,2,2,0,0,5,12,16,3,1,0,2,2,0,6,0,8,5,4,10,8,0,6,1,0,5,1,0,1,1,1,8,0,0,0,8,1,2,5,0,0,0,0,6,11,1,0,0,10,2,1,0,5,7,0,3,8,0,0,3,3,0,1,1,5,3,0,13,6,1,0,10,0,1,0,4,0,0,0,0,5,9,0,1,0,8,1,4,6,6,1,0,1,2,5,3,0,2,0,0,2,1,0,2,9,0,1,3,2,4,3,0,8,13,1,14,1,7,2,0,0,7,0,1,3,5,13,2,0,8,0,1,1,1,1,2,0,1,1,64,0,0,0,1,0,0,0,0,0,0,15,1,0,0,2,1,8,9,1,10,1,8,3,1,2,1,4,2,11,4,5,0,5,2,0,1,3,5,8,0,1,1,11,0,10,11,9,0,2,0,9,2,1,2,1,1,3,1,1,4,2,3,0,1,8,0,0,2,1,0,2,0,8,0,0,0,2,0,4,0,0,2,0,1,2,1,0,1,1,0,3,3,0,3,0,4,1,0,5,2,3,1,1,0,2,2,1,0,1,0,1,6,2,3,0,0,0,9,2,6,4,0,1,1,1,0,0,0,2,0,2,12,13,3,4,0,1,0,0,3,2,1,2,1,1,8,3,3,2,4,1,5,2,1,2,0,2,0,1,0,0,0,0,0,1,0,4,8,3,0,7,0,90,4,4,0,0,2,3,2,0,0,0,2,4,1,2,0,0,2,3,3,5,0,0,4,6,0,6,1,1,10,0,1,1,0,0,2,1,0,9,0,5,1,1,0,1,1,1,0,1,1,2,0,4,0,3,0,13,6,1,2,1,1,0,0,1,2,0,1,0,4,6,0,0,0,0,0,1,0,0,1,0,2,0,1,0,5,4,1,7,0,3,4,10,2,7,11,5,0,1,1,1,1,0,5,0,1,1,2,0,1,3,7,1,0,2,0,4,1,0,5,0,1,0,0,0,0,0,2,2,5,4,2,0,7,0,0,0,0,6,0,1,4,4,1,0,1,2,0,2,6,0,1,4,0,13,0,2,0,2,10,3,0,0,3,0,236,3,0,3,0,1,1,0,13,3,1,2,0,0,4,2,3,0,2,2,17,1,7,0,0,0,0,2,4,7,6,2,3,0,0,3,4,0,2,1,1,0,0,0,2,1,7,0,31,0,4,2,0,0,0,0,0,10,1,0,0,6,5,0,9,1,1,1,5,7,1,0,0,0,0,3,2,4,0,1,3,1,1,0,0,0,4,1,5,1,2,0,1,2,0,225,1,1,5,2,0,2,3,0,7,4,0,0,34,0,0,1,8,9,4,1,0,1,1,1,3,1,3,0,4,29,0,2,5,6,7,1,1,15,0,0,0,0,0,0,1,3,7,2,0,0,0,0,0,3,11,1,0,0,0,0,0,1,0,1,3,3,0,9,0,6,1,3,1,2,4,0,5,1,3,5,2,7,11,1,1,0,0,0,0,2,0,1,2,9,1,5,1,11,0,2,0,1,0,3,0,4,8,1,2,0,0,0,0,0,3,1,0,5,2,2,0,8,2,0,4,3,0,0,6,0,10,3,0,0,0,0,0,0,0,3,1,0,1,0,0,4,1,4,1,0,1,1,0,0,2,1,1,0,5,1,0,1,1,0,0,8,0,0,8,0,2,0,0,0,6,5,0,5,0,4,2,3,0,2,0,0,1,0,1,1,0,0,0,0,0,2,2,0,0,3,2,0,3,1,4,1,9,3,3,4,0,0,0,0,0,0,0,0,2,0,1,4,1,0,1,4,1,1,0,2,2,2,0,5,2,2,0,6,0,3,4,0,1,0,0,0,1,0,2,1,0,2,4,0,3,1,2,0,0,1,3,0,0,0,4,1,0,0,3,1,0,1,1,0,2,0,5,1,1,0,1,8,1,4,1,3,2,0,1,0,2,0,3,0,0,8,2,5,5,4,1,2,0,2,0,0,4,0,0,0,1,0,1,1,0,13,0,4,9,7,1,1,2,0,0,10,3,3,0,2,0,0,2,3,0,36,0,2,1,1,0,3,0,0,0,7,1,7,0,0,0,2,0,1,0,3,5,2,0,1,2,1,0,2,1,0,0,0,0,2,3,2,4,0,0,0,0,0,0,3,0,2,0,0,4,2,2,11,3,3,0,1,1,3,0,1,1,0,1,7,5,1,1,2,0,0,0,0,2,4,1,4,1,5,0,4,1,0,0,3,1,1,0,0,3,3,0,5,2,3,0,0,0,2,2,2,0,0,1,0,0,6,0,0,0,0,1,0,0,0,4,1,2,5,0,1,1,0,1,1,0,1,4,1,0,7,0,0,5,0,6,13,21,0,0,0,2,3,1,4,1,0,0,2,1,0,2,1,7,1,1,6,0,0,1,0,2,3,21,0,1,0,5,1,0,10,0,2,1,1,4,4,0,5,7,2,4,4,2,0,0,0,1,4,1,1,2,2,0,2,2,1,7,4,4,5,2,0,0,0,3,0,1,0,0,0,3,0,0,0,2,4,4,1,3,0,2,1,1,0,4,2,1,3,5,3,1,0,1,1,0,1,1,0,0,3,1,0,3,1,1,1,0,0,0,2,0,4,2,0,1,1,1,6,2,0,5,7,0,0,0,3,0,0,1,9,1,0,0,0,0,0,1,0,6,0,0,0,3,0,3,0,1,2,0,0,0,0,0,1,0,1,0,1,0,1,0,0,0,0,0,0,0,0,0,0,2,2,0,3,0,5,2,0,3,0,0,1,4,2,0,4,1,0,0,4,2,0,0,0,0,2,1,0,4,1,2,2,1,0,2,5,3,6,0,0,11,1,12,0,0,0,2,0,2,4,11,0,1,1,0,1,0,0,3,0,0,0,0,1,0,1,5,0,0,0,1,2,0,2,2,0,0,2,0,7,3,1,0,1,2,8,3,1,0,1,1,2,1,3,0,5,1,0,0,0,1,0,0,0,0,1,4,0,1,10,0,1,1,1,2,0,2,1,0,2,0,0,0,0,12,9,0,0,0,13,0,0,0,7,1,1,0,0,2,0,0,1,17,1,1,0,5,3,4,0,1,1,3,0,0,11,0,16,0,2,2,0,0,3,1,2,0,0,0,5,0,1,1,4,5,54,1,2,0,0,0,0,1,1,1,0,1,0,9,2,2,0,3,2,0,0,3,3,0,2,1,0,0,1,0,0,2,0,0,0,4,5,0,1,0,0,3,1,0,0,0,0,0,0,0,1,2,0,0,0,0,0,1,0,1,0,6,3,2,0,0,0,3,1,3,1,2,0,2,0,0,1,0,1,10,0,0,0,13,0,0,0,0,0,5,0,0,0,1,0,0,1,0,0,0,0,1,1,1,0,0,1,0,0,1,1,0,3,2,0,0,8,0,0,1,1,2,2,2,8,1,0,2,6,2,0,4,1,1,4,2,0,4,0,2,2,2,1,0,1,1,1,0,5,0,0,1,8,1,1,0,1,3,0,1,0,0,0,0,1,0,1,0,4,0,3,1,0,2,0,0,0,2,0,0,0,1,4,0,0,2,0,0,2,0,0,2,0,0,1,0,0,4,0,0,0,0,0,0,1,1,0,6,7,0,0,0,2,7,0,1,1,0,1,0,0,1,0,0,4,1,0,2,4,2,0,1,4,0,0,0,1,0,0,0,0,0,1,0,1,1,8,0,0,0,0,2,4,5,11,0,2,7,0,1,0,5,1,1,0,0,0,1,0,1,2,2,0,5,3,0,0,0,0,3,1,0,1,1,3,0,0,1,10,1,1,0,1,0,0,3,4,7,0,0,1,0,2,0,0,0,0,4,0,1,0,1,1,0,3,0,0,2,0,3,3,0,2,0,3,1,0,1,2,0,0,0,0,0,3,0,0,3,12,2,0,1,3,1,0,0,0,0,2,0,1,0,0,0,1,0,2,3,10,2,0,1,0,1,3,0,2,1,1,1,0,0,2,7,0,0,1,0,2,1,2,0,0,0,1,3,1,0,1,0,1,3,1,3,5,1,0,2,1,0,2,1,5,0,1,1,1,0,0,3,0,0,0,0,0,0,2,0,3,2,0,0,0,0,1,2,3,1,0,0,0,3,0,1,0,2,1,0,2,11,1,0,2,0,0,1,0,2,7,0,1,0,1,1,4,1,2,3,0,0,0,3,52,2,1,6,0,1,1,0,0,0,17,0,0,5,0,4,1,0,0,0,3,0,2,0,0,0,0,0,0,0,3,0,0,0,0,0,1,0,1,3,1,0,0,1,0,5,0,0,1,0,4,1,2,0,5,1,0,0,1,1,1,0,0,0,0,1,2,0,0,0,2,0,1,1,0,0,1,3,4,0,0,0,1,0,2,0,1,0,1,1,1,0,0,2,3,1,0,4,6,1,0,2,0,1,2,0,0,0,1,0,0,3,4,0,11,0,2,2,3,0,0,1,0,1,1,1,0,0,0,11,11,0,0,0,5,0,0,0,0,1,2,3,0,0,0,2,0,3,0,0,0,8,0,4,1,1,0,3,0,1,4,0,5,0,2,0,0,0,0,1,4,2,0,1,0,4,0,1,0,1,0,0,0,0,1,39,2,2,1,0,0,0,0,1,0,1,4,0,0,0,0,2,2,0,0,4,0,0,6,1,0,5,0,2,0,8,1,1,2,0,0,5,0,0,0,0,2,1,0,0,0,0,7,0,11,2,0,1,0,0,0,0,2,0,1,1,0,0,0,6,0,0,2,0,1,0,3,0,2,0,1,2,0,0,0,3,0,0,0,1,0,0,0,0,0,2,3,0,9,2,0,0,0,3,1,0,4,6,1,0,0,0,8,0,1,0,0,7,0,2,0,1,0,0,0,0,0,1,0,2,0,0,0,1,0,0,2,2,4,0,0,0,2,0,0,3,0,3,0,0,0,3,0,0,2,0,0,0,5,0,0,1,0,2,0,0,1,0,1,2,1,0,0,1,0,0,0,0,2,0,1,0,0,1,7,9,1,0,1,2,0,3,3,2,2,0,0,1,0,1,0,1,1,1,0,2,1,7,0,2,1,0,0,1,0,0,0,1,0,0,0,0,0,1,0,0,0,0,3,0,0,0,6,5,0,0,1,0,0,0,0,0,1,0,0,4,4,2,0,0,0,0,6,0,3,3,1,0,0,1,2,8,1,1,0,0,0,0,0,1,2,1,4,0,1,0,2,0,1,0,0,4,0,0,0,0,0,0,4,2,0,0,9,2,0,1,0,1,3,0,1,1,0,0,0,2,6,0,0,0,0,0,1,0,0,4,0,1,1,0,20,0,0,1,0,2,7,0,0,3,2,3,1,0,0,1,0,0,1,1,0,0,0,0,0,2,1,0,0,1,1,2,4,1,2,0,12,0,0,5,2,2,0,1,1,0,0,0,5,1,1,5,0,2,0,0,0,2,1,0,0,1,0,0,0,0,2,0,0,5,0,1,1,0,0,0,1,2,0,1,2,1,1,1,4,1,1,0,0,0,1,0,1,0,2,0,0,0,0,0,1,1,0,1,0,0,1,0,2,0,0,0,0,0,0,2,0,1,0,0,0,0,0,0,0,0,2,0,7,0,0,0,2,0,0,0,0,0,0,0,0,2,1,0,1,0,0,0,0,3,2,0,0,0,0,0,0,0,0,0,0,0,0,5,0,0,0,0,3,0,0,0,3,0,0,0,0,1,0,0,0,0,0,1,0,0,0,0,0,0,0,0,0,0,0,0,0,0,0,0,0,0,0,0,0,0,0,0,0,0,0,0,0,0
"2006 HarrisC, Charlaine, Definitely dead",pop,4923,2602,2927,2592,1808,3848,1128,1439,2126,1022,956,695,1101,775,750,697,1070,763,668,893,614,685,546,354,1190,400,981,248,422,175,305,360,310,478,308,527,485,304,333,279,421,301,273,225,307,368,250,384,391,195,259,178,326,246,214,208,440,235,211,257,182,156,173,174,178,202,147,196,108,132,190,160,138,164,148,195,125,348,177,124,122,94,74,192,152,227,74,162,155,161,75,152,119,133,165,187,134,130,154,115,95,164,135,120,151,112,93,78,113,143,107,39,87,107,87,112,87,120,110,89,150,75,84,133,84,98,87,123,133,104,52,79,73,85,101,97,93,122,85,131,63,77,145,77,124,79,76,91,92,112,61,165,73,70,42,43,43,96,57,30,130,73,154,57,57,41,76,100,51,72,463,43,41,74,78,36,61,58,52,122,37,86,79,71,75,46,79,71,58,53,75,85,101,57,41,57,29,58,51,132,46,68,66,40,73,67,50,54,132,87,19,40,35,56,57,39,52,15,52,26,40,45,52,35,58,47,61,36,70,79,83,33,30,92,54,110,71,50,60,40,39,49,30,27,26,58,22,41,83,36,67,34,33,26,38,31,22,52,30,28,37,88,103,32,27,24,43,45,19,25,54,82,79,22,61,148,24,60,62,48,47,57,52,27,54,25,75,51,50,19,43,10,49,40,35,34,53,40,39,60,51,32,91,39,72,29,38,30,28,21,15,105,24,33,42,33,20,26,42,21,31,26,33,10,28,16,25,39,38,36,18,24,66,19,23,46,37,14,33,49,29,26,36,22,18,57,15,37,56,21,64,29,42,12,47,28,13,125,36,16,10,43,22,22,23,42,14,36,19,27,15,11,14,31,19,40,19,12,15,12,35,45,12,24,18,31,0,28,23,27,12,22,15,24,19,36,23,21,29,19,41,55,23,27,28,35,18,55,20,23,14,15,11,18,37,13,17,35,9,46,38,0,39,18,14,11,42,24,20,51,37,27,22,39,4,11,22,24,17,21,25,13,20,36,38,10,33,27,16,28,22,3,20,38,11,20,20,8,23,22,10,20,0,15,24,27,19,12,17,27,14,14,9,1,14,42,19,30,0,18,27,61,17,19,14,9,17,12,36,21,14,33,20,14,23,26,13,16,5,56,25,36,5,11,25,42,42,25,25,24,34,27,21,13,30,32,0,19,9,12,8,29,22,30,15,35,14,15,20,17,1,16,22,19,11,1,6,32,15,14,13,42,40,19,21,10,0,0,18,5,21,8,9,5,26,8,10,27,21,62,22,10,18,12,16,18,14,7,9,7,7,8,25,16,23,17,27,12,11,43,25,26,26,17,2,16,18,10,19,7,26,5,12,16,12,19,8,23,16,24,19,6,20,64,17,0,0,7,10,9,12,30,14,9,13,22,13,10,23,8,42,24,18,28,18,30,18,8,13,50,19,35,13,7,45,0,17,11,19,11,28,19,5,10,8,40,19,6,18,29,0,20,15,20,7,32,16,0,11,6,20,15,10,24,21,19,31,6,6,17,26,13,12,2,21,9,11,5,34,15,8,15,14,27,15,21,2,19,25,3,15,7,6,11,20,6,7,0,6,1,5,0,31,3,21,4,14,9,8,24,3,19,1,12,9,4,20,14,6,9,14,19,11,2,12,13,26,9,10,9,15,19,16,2,0,8,32,19,1,10,20,14,2,19,1,1,10,13,5,3,3,9,16,10,9,3,19,16,8,3,11,9,7,1,29,8,7,19,6,12,8,15,5,34,0,10,14,4,4,19,1,10,6,14,7,8,1,11,2,13,2,15,0,7,11,2,0,18,0,7,10,37,4,38,9,13,0,10,12,12,13,21,11,2,9,4,0,0,15,4,6,2,13,5,8,1,14,3,3,1,24,34,32,16,9,8,5,13,0,20,9,10,7,23,12,7,12,0,8,32,18,7,1,16,11,4,41,4,1,12,4,8,14,13,3,9,1,0,12,15,12,3,6,12,0,15,0,3,4,16,17,3,10,6,3,19,8,9,9,15,4,8,5,3,14,11,1,0,2,2,19,4,25,13,8,6,12,2,8,5,8,307,17,0,8,5,9,13,13,7,6,4,8,4,12,7,3,2,49,14,3,17,5,0,5,12,15,11,7,23,12,1,4,11,2,5,5,17,6,12,6,6,4,3,10,17,13,10,9,3,0,7,39,76,9,4,20,2,8,4,18,0,11,7,7,8,6,9,15,7,0,24,10,3,13,11,12,1,11,10,13,4,11,8,17,9,0,9,3,0,2,0,10,4,7,19,0,0,3,13,2,16,3,0,14,10,19,0,13,13,13,6,11,16,0,0,2,13,8,11,5,8,6,9,17,4,11,2,21,15,1,3,14,7,6,4,7,6,2,19,12,14,3,2,9,0,7,5,10,6,13,24,0,6,20,7,0,10,117,0,3,2,10,5,3,10,19,0,7,12,24,3,5,5,8,7,2,7,8,1,11,0,19,12,11,8,33,15,8,9,10,6,12,4,6,9,6,3,7,5,2,5,5,16,0,25,11,10,6,2,3,11,126,4,3,10,5,1,15,28,6,6,7,0,5,8,12,5,4,4,4,32,7,3,14,3,7,2,5,6,4,0,4,14,9,8,0,14,8,1,4,4,24,20,0,4,7,18,0,21,11,10,31,5,5,6,1,4,7,0,1,3,4,4,3,4,0,8,15,0,12,10,0,17,5,9,21,1,0,11,3,0,15,6,2,3,0,0,7,2,0,4,2,1,11,0,0,9,6,6,8,6,2,0,17,9,9,11,6,3,4,3,0,25,3,0,7,4,9,16,8,6,9,0,0,4,0,11,13,13,1,9,8,13,7,0,0,4,0,34,6,0,4,7,0,13,8,0,2,4,0,0,8,2,0,3,8,13,0,2,1,3,3,6,5,11,5,4,5,10,0,3,10,2,6,10,24,1,0,10,4,30,1,5,14,6,7,8,5,7,4,1,3,2,0,7,1,4,4,1,4,3,7,0,4,3,1,5,4,9,1,1,9,19,7,3,6,1,6,4,5,4,3,0,5,2,6,0,10,1,10,4,20,2,4,0,6,3,9,20,6,5,3,0,5,0,11,7,6,6,3,6,7,0,2,0,0,3,0,2,0,0,2,6,4,13,7,3,2,8,3,2,7,0,1,0,3,1,11,1,0,0,0,0,0,1,0,0,2,2,16,3,1,0,0,10,2,0,6,10,4,4,1,6,2,1,2,0,9,14,7,7,0,0,30,1,10,0,10,5,7,3,1,3,0,13,1,7,7,13,3,3,0,3,4,0,2,1,7,1,8,9,8,0,6,9,7,0,8,3,5,2,8,7,0,1,3,4,6,2,4,17,1,5,1,12,11,1,45,11,15,7,39,7,7,0,0,0,0,3,21,0,0,0,0,2,0,8,2,4,10,4,2,3,1,1,2,0,1,2,1,8,11,10,3,3,1,10,4,5,3,1,3,15,5,0,3,5,0,12,10,1,1,10,7,11,8,0,1,3,4,2,3,5,4,10,3,5,6,10,11,9,7,5,18,5,1,10,10,6,6,3,8,0,2,8,4,9,7,6,4,7,11,3,4,9,5,3,1,10,0,6,1,7,2,3,4,0,3,4,2,5,0,8,5,3,3,11,4,10,8,1,1,0,6,12,0,12,1,4,4,1,5,0,6,2,14,3,2,2,5,1,3,3,1,1,7,20,3,5,7,10,8,4,14,0,6,10,8,7,3,11,4,0,2,4,0,2,4,5,5,7,3,2,9,4,4,0,4,1,8,9,5,12,10,10,0,9,2,1,11,6,2,2,0,11,1,9,4,8,3,0,4,3,0,2,18,1,0,5,0,1,4,9,0,2,7,3,2,0,13,9,16,7,2,6,0,14,0,3,6,4,2,4,6,0,1,9,7,8,2,1,8,1,1,19,18,3,7,2,0,0,1,2,0,0,8,11,1,0,3,3,5,1,0,3,0,6,1,8,3,5,1,2,9,5,1,2,4,0,1,0,0,6,3,0,2,10,1,2,3,4,7,11,4,2,0,1,5,6,3,1,0,2,6,1,7,3,5,1,2,2,2,7,11,6,2,6,43,0,7,8,6,1,1,7,3,0,3,1,1,16,0,0,4,5,0,2,0,0,0,5,0,19,0,4,9,11,0,11,0,7,0,9,0,17,8,0,5,29,2,1,3,4,4,0,4,4,2,2,5,5,34,0,0,1,0,5,198,4,0,10,1,3,1,6,6,9,10,2,0,4,5,14,15,9,9,1,3,4,1,7,0,3,2,1,2,0,1,5,0,1,7,3,0,4,0,2,1,4,0,4,15,1,3,3,3,2,6,9,4,0,0,10,5,4,5,2,3,11,0,2,0,7,3,0,4,1,0,1,1,4,0,0,0,6,1,6,4,0,1,4,3,3,0,4,1,9,4,0,12,9,4,2,10,0,0,14,2,1,8,4,0,0,6,4,3,4,8,4,0,3,4,8,1,2,0,6,9,1,3,1,11,5,2,4,2,0,1,4,6,0,3,2,7,3,6,2,0,1,3,3,1,6,2,4,4,1,5,12,7,1,1,7,6,0,1,4,1,0,2,6,5,4,0,0,0,3,1,5,3,0,0,0,1,0,4,12,6,4,1,4,4,1,1,2,3,2,7,1,6,8,2,4,3,3,6,2,4,5,0,0,2,10,0,0,11,2,0,0,10,6,5,4,9,3,0,0,0,5,0,6,1,3,1,2,0,0,10,7,2,2,1,1,2,5,0,1,0,6,4,5,5,1,9,0,2,2,0,2,0,0,4,4,0,0,5,3,0,4,2,6,9,0,0,7,6,7,3,2,7,6,3,0,10,7,5,1,0,5,0,7,0,27,3,0,10,30,6,4,0,2,0,0,4,8,6,1,0,0,2,0,5,7,2,39,0,4,0,1,19,1,0,0,2,4,4,7,2,0,1,5,2,3,7,2,1,1,1,21,53,3,0,0,0,8,0,0,4,4,5,4,9,2,11,0,0,0,1,1,2,7,2,0,3,7,4,3,1,4,1,4,0,2,5,2,7,0,2,0,4,0,1,1,1,0,4,2,2,10,3,3,0,1,4,1,0,4,0,0,5,5,2,5,1,5,6,0,3,1,5,0,2,5,160,2,15,5,8,1,5,5,2,6,14,2,4,5,0,4,1,0,5,6,5,1,2,2,4,1,4,1,0,3,1,3,1,1,10,3,2,4,1,4,14,4,13,2,3,2,2,0,0,0,8,2,4,2,2,5,0,2,6,3,0,0,9,5,2,2,2,0,2,4,2,1,0,2,1,0,4,2,0,2,5,4,7,2,0,0,1,6,7,10,7,2,4,0,11,1,9,0,1,0,0,145,0,3,3,6,0,4,0,0,1,0,1,1,0,1,3,4,3,3,4,1,3,6,3,1,1,13,5,0,1,2,4,3,9,0,1,1,2,4,2,4,0,0,0,1,5,1,3,6,3,0,36,3,4,0,4,5,9,7,0,0,2,0,4,1,0,4,2,0,3,0,6,1,5,3,5,0,1,2,0,5,2,0,2,2,5,8,8,2,0,1,0,0,9,0,0,3,0,0,1,3,0,2,2,8,8,1,3,0,0,22,0,0,0,3,2,0,4,8,6,3,5,1,8,5,3,5,0,0,1,6,0,0,0,0,0,2,0,0,0,2,4,0,1,0,2,2,5,6,3,5,3,7,2,6,2,3,1,4,3,6,7,1,6,4,0,0,3,5,4,6,3,7,2,2,2,0,0,0,0,5,1,1,0,21,4,1,0,3,5,2,0,0,4,1,11,0,0,1,0,0,4,4,0,5,5,3,2,6,0,4,2,8,3,9,1,6,3,3,0,4,2,3,10,0,3,0,5,5,0,4,0,0,3,0,0,0,0,1,7,5,6,0,5,7,4,7,1,1,0,1,2,1,0,0,1,4,0,0,1,1,0,0,1,0,1,0,0,1,0,0,1,0,17,0,0,12,1,7,5,3,2,1,0,1,5,0,6,4,1,0,0,1,0,4,0,0,1,0,2,2,1,8,7,10,0,5,3,6,0,0,0,4,3,3,0,0,5,11,5,0,1,7,1,7,5,3,1,0,0,2,0,2,3,2,1,4,1,1,0,5,0,2,3,3,4,6,4,3,1,1,1,0,1,0,6,0,3,3,6,0,2,6,1,0,2,0,0,3,2,0,1,1,4,1,0,0,25,4,0,0,0,0,1,4,0,2,12,4,0,4,1,0,4,1,12,6,0,4,4,0,4,3,2,1,6,0,3,1,1,1,1,1,4,1,2,4,9,1,0,0,0,3,1,1,5,5,4,4,0,0,1,0,4,2,2,1,4,2,1,1,5,0,0,4,0,0,0,7,2,1,0,0,0,2,5,0,2,0,7,1,4,2,3,0,0,4,1,7,1,6,0,5,7,6,1,3,1,1,0,3,4,5,3,0,4,1,1,1,0,2,0,5,1,2,12,0,1,4,2,2,1,0,1,39,0,0,2,1,4,1,2,6,0,0,0,5,0,0,3,4,3,0,0,2,2,0,7,0,0,2,0,0,6,0,0,0,4,2,0,2,3,5,2,2,0,10,4,1,0,0,3,0,3,3,0,3,0,2,0,2,37,10,1,5,0,2,4,6,0,1,1,2,3,0,2,1,2,1,0,30,0,2,4,12,6,0,1,0,3,0,0,6,1,0,0,4,1,4,2,0,3,0,0,0,0,0,3,0,2,3,3,3,0,3,2,0,0,1,0,6,0,4,0,3,2,0,0,8,3,5,2,0,5,1,0,5,4,6,0,0,0,3,6,2,2,5,1,4,1,2,1,3,0,1,0,5,5,1,3,6,2,1,2,0,0,0,1,0,5,7,3,3,2,2,1,0,2,0,0,7,1,1,0,2,1,3,0,1,3,4,2,1,7,0,4,0,3,3,6,2,6,5,4,3,0,0,12,2,3,7,0,0,0,0,1,0,3,4,4,2,0,0,1,0,2,1,2,0,3,0,0,4,3,4,1,1,0,2,0,0,1,1,1,1,4,3,6,0,0,0,1,1,5,0,0,0,0,4,0,0,1,1,0,9,1,3,1,3,1,3,1,0,0,0,3,2,5,0,1,0,0,2,1,1,0,5,6,0,0,1,1,1,2,2,3,2,0,0,0,2,2,3,2,4,6,0,0,0,0,0,23,0,0,1,1,1,1,2,3,0,0,1,5,0,1,0,0,0,2,3,0,1,2,2,0,4,7,0,1,1,3,0,2,0,0,5,1,2,1,2,2,3,1,3,1,0,5,6,3,0,8,0,2,0,2,0,1,0,0,2,0,0,1,10,0,7,0,0,0,0,7,0,2,0,4,3,1,2,1,0,2,0,3,0,7,1,1,1,5,0,0,0,0,1,2,0,0,7,4,3,4,0,1,2,8,89,5,0,7,0,0,0,0,4,6,0,3,1,0,1,2,0,0,4,0,0,0,2,2,10,2,0,2,0,2,4,0,1,4,3,0,1,2,6,0,0,2,0,0,3,4,2,3,1,4,2,1,0,11,1,0,0,2,2,5,2,2,2,3,5,2,0,2,0,1,0,8,5,2,1,4,0,2,0,0,4,2,1,10,0,0,1,0,0,2,0,0,0,1,0,0,3,3,2,2,0,1,0,5,2,2,1,0,1,4,0,8,2,1,0,1,0,0,0,0,0,0,0,1,2,0,2,1,4,1,0,1,0,0,0,0,2,1,0,2,4,2,1,3,0,8,6,4,0,0,2,0,0,0,0,7,3,4,0,0,0,2,5,4,1,0,0,5,0,0,0,2,0,2,2,1,6,1,3,0,3,1,8,1,5,0,0,0,2,0,2,3,4,2,0,1,0,0,4,0,0,4,1,0,0,4,0,64,1,3,0,0,4,0,2,0,0,4,0,1,2,1,3,1,2,3,5,0,3,2,3,2,0,0,0,1,2,0,3,5,4,4,4,1,1,16,21,10,7,0,2,6,0,0,0,2,0,1,0,0,0,0,0,2,5,1,2,0,2,4,8,0,0,2,0,3,1,2,0,14,2,2,3,8,0,2,0,2,1,2,1,1,3,4,1,0,0,1,0,6,1,0,1,5,1,4,3,2,1,2,2,0,0,2,2,0,1,2,0,0,0,1,4,4,2,1,2,3,0,1,2,0,2,0,0,2,0,1,1,0,2,0,1,1,1,5,0,1,1,2,4,1,4,2,0,0,0,1,0,5,3,1,1,8,7,0,2,0,1,0,5,0,0,1,0,4,0,2,1,0,0,3,0,1,2,0,6,0,3,1,0,1,0,3,9,0,1,4,3,2,0,0,0,0,6,1,3,2,1,0,3,4,1,1,1,1,2,0,2,5,0,1,1,3,1,0,5,1,1,7,2,0,0,5,0,4,0,1,6,0,0,2,4,1,0,4,0,36,0,0,2,1,0,1,1,1,0,1,6,0,9,8,0,1,0,0,1,0,0,3,1,2,1,0,1,6,0,0,0,2,0,0,0,0,2,6,0,4,4,0,1,0,1,0,0,0,2,22,0,2,1,2,1,0,0,0,8,0,4,12,0,4,0,2,3,4,6,0,5,1,3,2,2,0,6,1,0,2,0,2,0,5,6,3,2,1,12,0,2,1,2,0,0,0,7,2,0,0,4,0,2,1,2,2,1,3,1,3,2,0,1,6,0,0,1,7,0,3,0,1,1,3,0,0,3,0,0,0,5,2,0,0,3,1,4,6,1,14,6,0,0,0,0,0,1,4,2,1,0,2,0,7,1,4,0,0,0,3,1,1,0,2,6,0,0,10,2,0,0,0,0,0,1,6,2,0,0,1,1,1,0,2,2,2,0,5,0,1,0,0,2,0,0,2,0,1,0,0,0,0,137,0,5,0,3,0,1,3,5,2,0,0,0,1,7,3,0,5,0,1,1,0,0,0,0,0,0,3,0,3,0,5,0,0,1,1,0,1,0,0,3,2,5,3,1,0,1,2,2,0,0,2,0,4,0,4,1,0,0,0,0,0,0,1,4,0,0,0,0,0,0,3,0,0,0,0,0,2,0,0,3,0,0,2,0,0,0,1,3,2,1,3,0,1,0,2,0,1,5,1,0,3,6,3,0,2,2,1,1,0,1,0,0,2,3,3,2,0,1,5,0,0,2,1,0,4,0,0,5,2,0,0,1,0,3,0,4,6,1,4,0,0,3,0,0,2,0,0,0,0,0,1,1,0,1,0,2,0,0,0,0,1,1,2,0,0,4,2,2,1,2,2,0,1,0,0,2,1,5,2,3,1,2,2,0,0,0,0,0,0,0,0,4,0,0,4,0,0,0,2,0,2,2,3,2,1,0,2,2,5,1,2,1,0,0,0,0,0,0,0,4,0,1,0,0,1,0,0,0,0,2,0,0,4,0,1,0,2,0,2,0,3,0,2,3,1,0,1,0,2,27,4,0,2,0,3,8,0,0,9,0,6,0,3,0,2,7,3,4,0,0,1,0,0,2,0,0,2,2,0,2,1,1,2,6,2,0,5,3,0,0,0,1,0,0,0,0,0,0,14,1,2,2,44,3,9,17,5,3,1,0,0,2,2,0,0,4,4,0,0,0,1,0,0,0,0,3,1,1,0,1,0,0,1,2,0,4,1,1,1,3,1,0,1,0,0,1,0,8,1,4,0,0,3,4,1,0,0,0,0,0,0,1,4,1,2,1,3,1,5,2,0,0,0,0,3,0,0,1,1,3,0,0,1,3,0,0,0,2,4,0,0,2,0,1,0,0,3,2,3,0,0,0,1,1,6,0,1,0,2,0,0,0,4,1,4,0,0,1,0,12,0,3,1,0,3,0,2,0,2,0,2,0,1,0,4,4,1,1,3,0,0,1,3,6,0,3,3,1,3,0,1,1,1,3,1,1,4,0,0,0,0,3,8,1,2,0,2,2,3,1,0,0,1,0,0,0,0,0,1,1,1,0,0,0,1,0,1,44,2,0,0,2,1,3,2,1,2,0,3,0,1,1,1,2,2,2,2,1,1,0,1,0,1,2,0,1,2,0,2,1,2,1,0,2,0,0,1,4,2,0,1,0,0,0,2,0,0,0,0,0,1,0,0,0,0,2,0,3,2,0,0,0,0,0,3,0,0,0,0,0,0,0,2,1,0,0,1,4,1,0,1,0,0,0,0,2,2,0,4,1,0,4,4,0,4,0,1,3,2,0,4,0,1,1,0,0,0,0,2,0,1,1,0,0,1,0,2,0,0,1,0,2,0,1,1,3,0,1,0,4,2,2,0,1,1,0,3,4,2,0,9,0,1,0,0,0,1,0,1,0,0,2,2,2,0,0,0,3,0,0,0,6,0,3,0,1,1,0,0,0,0,3,0,0,0,1,1,0,0,1,0,2,0,0,0,5,0,1,0,1,1,2,3,1,2,0,0,0,0,0,2,0,1,0,1,1,1,1,0,2,1,0,0,1,0,0,0,1,1,1,3,3,1,0,1,0,1,0,2,0,2,0,2,1,0,2,0,0,0,0,1,0,0,0,2,0,1,0,0,0,0,1,0,0,0,0,0,1,2,0,8,1,2,0,0,2,0,1,2,0,1,1,1,2,0,1,2,2,0,1,2,7,9,0,1,1,0,0,1,1,0,0,0,7,1,0,1,5,1,2,0,0,0,2,0,0,8,2,0,4,1,1,3,0,0,1,0,1,2,0,3,2,3,0,1,3,0,1,0,1,0,0,1,0,1,0,0,1,0,1,3,0,0,0,0,0,1,0,0,2,1,2,0,0,0,0,0,2,0,2,0,2,0,1,0,0,1,0,0,3,0,2,0,6,0,0,0,1,0,0,1,0,0,1,5,0,0,3,0,0,0,1,0,0,4,2,0,0,1,1,0,0,4,4,4,0,2,1,0,0,0,2,2,6,0,0,0,1,0,0,1,0,0,6,0,1,1,4,0,0,0,1,6,4,0,1,1,1,1,1,2,0,0,0,0,0,0,1,0,3,2,0,7,2,1,0,0,0,2,0,0,0,2,0,0,0,0,0,1,0,0,0,0,1,0,0,1,0,0,0,0,0,0,0,0,0,0,0,0,0,0,0,0,0,0,0,0,0,5,0,0,2,0,1,0,0,0,0,0,0,0,0,1,0,0,0,2,0,0,0,0,0,0,0,0,0,0,0,2,0,2,1,0,0,0,0,0,1,0,0,1,0,0,0,0,0,0,0,0,0,0,0,0,0,0,0,0,0,0,0,0,0,0,0,0,0,1,0
"2007 Grafton, Sue, T is for Trespass",pop,7239,3357,3235,3196,2451,4226,1195,2006,2306,1077,1206,983,1029,1649,1308,1173,822,878,864,420,793,815,798,595,1162,345,635,157,584,365,453,605,456,462,417,593,425,264,230,374,440,357,364,363,427,390,282,398,258,196,325,175,395,279,376,332,372,229,242,155,272,279,188,171,208,281,118,210,153,203,201,338,185,227,129,136,308,277,111,135,163,162,93,180,193,125,182,225,75,73,80,95,88,182,127,125,119,147,141,179,87,73,93,112,167,327,98,123,121,111,106,135,88,101,125,312,88,187,179,63,85,60,197,64,180,102,111,100,128,84,75,79,169,170,123,155,52,89,175,148,156,109,184,110,104,157,112,158,145,82,129,56,121,77,73,120,75,48,85,45,77,54,155,66,68,46,51,155,33,87,406,102,52,123,187,59,64,138,69,120,42,50,48,82,85,131,92,63,108,36,118,54,75,97,56,61,2,140,128,94,91,53,76,95,79,93,83,47,109,68,12,80,11,54,59,41,78,30,24,62,74,52,57,92,111,51,75,101,71,37,41,57,45,19,80,362,63,59,61,53,86,83,23,42,63,43,55,90,123,29,91,40,66,32,39,64,32,39,67,18,85,58,57,68,54,15,83,72,51,66,52,44,53,82,64,60,68,94,56,77,65,60,52,43,19,109,39,79,60,36,68,24,68,25,37,46,28,59,110,80,48,36,27,111,16,56,39,8,70,36,19,143,19,43,43,53,59,41,66,22,32,85,48,11,71,49,6,35,33,81,38,42,55,28,14,41,40,12,41,18,45,20,32,102,36,18,51,45,27,69,25,38,36,43,52,29,49,82,22,28,38,11,40,19,69,18,45,25,17,18,12,15,57,81,67,28,19,21,17,48,36,37,28,39,29,43,0,45,38,24,13,32,20,11,49,17,20,23,27,15,29,18,45,72,55,43,54,12,21,27,33,16,28,38,14,25,26,34,54,18,37,0,8,62,31,38,50,62,22,30,22,79,36,28,5,14,23,12,6,32,22,50,13,36,53,84,3,28,45,16,58,31,7,42,22,33,21,20,38,35,60,6,0,30,27,61,14,10,17,3,5,7,34,0,25,27,19,39,0,34,10,8,58,14,19,21,24,1,36,35,16,43,19,25,27,21,23,54,4,24,59,9,66,23,39,35,24,39,14,37,26,16,19,14,14,17,0,19,5,16,35,19,16,34,24,34,36,14,15,25,5,20,35,24,22,10,24,27,8,16,12,11,29,45,16,23,0,1,27,22,16,24,60,0,17,10,24,17,16,49,57,39,14,49,34,23,20,9,15,17,17,13,12,49,21,32,9,4,13,45,13,21,22,35,7,27,15,17,25,2,68,32,37,28,10,34,7,20,26,21,18,9,34,7,19,0,1,17,16,18,13,34,8,42,0,33,23,14,40,24,11,23,6,18,20,20,31,15,12,13,29,26,19,9,18,0,23,19,7,31,18,3,16,47,7,15,31,13,29,20,0,10,16,15,11,12,14,6,18,1,44,19,24,35,17,21,14,22,24,13,36,7,35,26,32,16,14,18,36,5,25,11,26,22,16,21,1,4,31,25,13,20,13,16,29,17,16,0,10,15,19,4,12,30,15,6,15,33,11,8,5,11,1,11,22,10,31,16,10,25,10,13,4,2,13,17,23,4,10,31,8,44,6,2,0,5,7,26,5,17,22,11,14,41,0,2,22,16,25,4,11,22,15,36,54,5,52,8,8,2,10,6,13,2,27,21,16,10,10,3,17,37,0,30,0,35,14,2,5,8,15,13,11,44,3,12,7,11,16,13,9,31,0,13,15,12,0,11,0,39,3,4,3,15,11,12,1,3,11,2,4,7,20,28,17,9,2,0,7,1,27,7,12,6,26,10,12,9,11,6,14,20,1,29,21,14,10,35,0,27,12,13,3,48,13,12,29,0,52,31,13,15,16,15,16,2,21,5,3,10,15,8,12,13,4,14,3,0,11,9,14,33,5,18,0,22,25,10,17,49,6,4,12,20,10,17,13,24,2,8,30,2,3,39,20,4,7,0,2,2,5,9,6,11,19,5,5,24,14,27,19,0,9,0,10,3,6,32,9,17,5,2,18,8,9,10,10,0,6,15,2,7,7,0,28,3,21,2,22,2,18,1,25,23,11,8,23,2,8,19,13,19,7,32,6,9,37,6,10,2,0,11,9,0,19,17,2,12,3,12,36,2,9,32,9,12,8,20,33,6,2,14,20,15,42,11,8,0,11,20,11,1,12,16,8,18,0,25,2,0,8,0,19,0,9,3,0,0,4,3,6,13,2,4,29,12,9,0,9,17,8,9,40,5,1,38,10,11,5,10,19,32,1,14,17,20,12,4,28,10,2,9,1,7,19,6,15,3,25,28,3,4,4,5,6,0,8,5,4,10,27,7,0,13,20,3,15,8,0,0,1,8,11,12,27,9,34,0,7,4,16,4,15,15,32,12,4,11,7,8,19,0,13,6,3,19,4,3,5,18,46,9,14,9,26,20,15,0,23,6,22,11,13,1,0,3,13,1,18,8,9,6,8,11,0,25,11,4,13,1,5,10,3,2,8,10,12,2,2,5,7,24,20,3,4,0,1,7,15,17,7,0,3,21,10,7,0,12,3,10,15,4,21,7,0,40,18,6,3,8,0,2,2,7,6,2,0,2,10,0,6,12,3,11,14,12,35,1,11,0,23,8,0,18,0,9,6,7,17,20,5,0,16,8,5,1,0,1,12,8,0,19,13,5,5,0,0,9,15,16,10,31,0,14,9,4,9,14,4,14,1,7,0,22,16,0,2,14,23,15,5,6,2,0,3,0,0,12,6,18,30,20,8,6,1,5,0,47,0,19,1,0,19,12,0,27,7,0,16,3,0,8,8,25,0,11,39,11,0,1,14,13,5,5,15,9,12,14,6,2,0,21,17,7,15,30,6,2,0,11,7,15,11,19,20,15,0,6,21,3,4,0,8,1,7,15,5,2,1,8,0,8,6,0,18,0,3,17,9,7,3,8,13,4,28,7,9,0,10,6,8,3,36,6,21,14,8,17,12,26,4,1,18,11,9,0,5,10,10,5,21,2,9,0,10,6,26,7,10,6,9,8,19,17,21,0,0,5,0,4,0,0,9,4,2,8,4,5,3,1,3,2,7,2,22,1,16,0,3,2,0,0,0,6,0,0,0,0,15,19,7,7,5,9,1,1,0,2,17,0,3,21,5,17,6,1,42,12,1,3,9,8,0,0,12,8,20,7,8,11,13,5,28,4,1,5,20,7,9,13,6,8,0,7,2,0,0,22,4,10,14,3,7,0,6,4,6,0,18,8,2,9,11,3,0,0,0,5,17,6,7,2,0,8,16,21,2,0,1,0,10,4,25,7,6,4,0,0,0,9,5,0,0,0,0,3,0,11,16,10,12,3,6,17,2,6,4,0,3,24,2,6,2,17,4,3,3,44,12,10,17,27,2,15,3,2,5,1,7,9,10,13,21,6,35,19,6,0,5,9,12,8,7,10,17,5,2,2,7,5,8,8,1,33,7,0,8,2,3,3,4,10,6,0,6,0,5,1,3,10,0,1,8,5,13,4,11,11,8,0,0,15,9,0,3,10,2,0,6,9,0,3,0,3,7,3,7,27,6,8,6,8,7,3,13,15,0,8,0,2,9,8,5,0,2,6,13,2,2,2,7,13,2,33,7,8,10,5,2,13,6,5,9,15,0,0,0,5,8,9,1,4,3,4,0,16,5,15,9,2,10,2,2,1,9,3,9,0,4,6,4,8,4,17,3,6,2,1,0,2,9,5,5,2,7,0,3,3,11,0,15,0,1,7,0,1,8,0,7,22,4,2,3,3,0,5,4,8,1,3,3,8,3,9,8,3,7,26,3,5,11,2,2,9,16,0,6,4,5,6,2,2,2,15,12,7,12,17,4,0,4,12,1,3,0,5,0,1,4,4,6,10,2,11,5,2,1,5,1,7,8,3,6,1,13,3,19,3,12,0,13,2,1,2,15,6,12,5,2,11,15,16,13,3,6,4,3,13,4,11,4,4,0,1,15,0,7,6,5,12,0,16,18,2,5,8,8,12,1,5,11,8,15,4,9,2,19,1,9,1,6,8,0,0,13,7,0,7,0,0,0,2,4,3,1,2,4,2,0,11,23,18,0,8,0,8,1,2,18,0,6,1,7,0,9,2,7,8,13,2,5,7,0,170,0,5,1,5,5,1,1,6,4,1,5,12,7,12,2,12,0,0,3,11,0,0,8,2,7,7,15,8,0,5,0,0,2,2,6,5,0,1,15,9,0,10,10,3,0,14,0,8,11,0,7,31,1,3,4,6,1,0,0,10,2,4,1,5,7,7,27,8,0,7,6,0,5,2,0,11,19,1,0,0,0,6,34,3,12,12,2,2,9,3,1,6,0,12,5,3,5,14,3,7,19,12,7,9,4,1,12,1,9,0,16,0,6,15,17,10,3,1,7,7,0,5,2,1,15,7,2,10,14,1,2,18,7,2,15,3,2,0,6,7,9,4,11,31,15,1,27,4,5,3,6,1,4,13,6,2,6,1,4,5,13,0,7,14,24,0,7,2,3,6,4,5,1,1,6,7,6,3,1,0,0,7,9,0,2,14,6,13,15,4,3,1,4,0,2,2,14,8,9,0,1,2,0,7,0,4,0,4,2,17,0,0,3,1,3,0,0,13,28,9,2,2,0,0,4,4,1,8,5,3,19,6,3,0,2,6,3,1,7,2,0,3,0,0,3,6,3,10,0,7,6,0,0,2,0,0,0,0,4,2,0,0,15,3,20,3,6,3,3,1,0,7,9,9,14,4,3,24,0,0,1,8,27,0,0,1,1,5,1,0,3,0,7,2,2,4,0,7,0,1,2,4,14,15,5,6,7,1,4,2,3,0,0,1,1,0,0,0,0,4,3,7,9,21,16,0,3,8,11,1,8,4,4,13,13,10,0,1,1,0,11,10,0,0,8,2,17,2,9,6,5,0,7,3,2,11,4,2,4,0,2,11,12,4,1,3,0,2,4,8,2,4,1,0,0,0,3,0,2,4,11,4,4,8,4,8,9,3,39,9,4,0,0,1,9,0,0,0,6,4,12,2,4,18,10,0,6,0,2,1,0,3,10,3,8,5,4,4,8,4,5,6,16,6,7,5,5,11,6,5,30,4,0,3,2,1,4,7,12,13,4,12,1,9,5,5,1,5,3,0,9,5,10,2,4,1,1,3,0,1,1,0,5,3,3,4,2,0,11,5,1,0,7,3,7,1,4,3,11,6,0,23,2,2,0,0,0,2,0,5,0,14,29,1,5,2,5,0,8,8,7,6,3,14,1,2,1,0,32,3,5,0,5,9,10,5,46,3,0,5,1,0,13,6,1,1,4,6,2,4,1,5,9,1,1,9,8,6,5,0,0,13,2,1,5,0,10,0,13,5,3,1,0,0,0,1,5,0,5,2,4,0,0,6,3,0,3,1,2,8,3,4,21,1,2,0,0,2,0,0,13,0,5,8,3,2,5,2,4,11,0,4,1,0,1,3,3,6,1,1,0,13,1,4,6,0,0,11,3,0,4,14,9,1,0,3,9,0,3,3,0,2,2,0,0,1,3,0,4,4,10,7,2,5,6,1,0,8,1,0,0,5,0,0,0,2,1,12,0,1,326,4,8,4,5,4,2,4,6,14,4,3,1,22,2,3,11,2,2,10,4,2,7,3,5,6,5,0,3,18,3,3,2,8,4,25,2,6,0,12,4,5,0,5,0,5,3,2,0,5,9,1,1,2,5,4,2,0,0,4,0,0,3,3,0,12,4,3,4,19,1,3,2,15,2,14,2,7,2,3,2,8,0,10,5,1,6,0,3,0,1,4,6,5,6,0,1,5,1,0,0,5,0,0,13,20,2,7,0,0,2,1,1,2,0,2,0,5,0,2,2,2,0,6,4,0,5,0,3,14,2,0,3,9,0,0,0,1,6,7,1,11,3,0,4,8,18,1,2,0,1,8,6,4,9,9,1,0,1,3,3,4,4,0,4,0,8,2,12,5,0,6,0,2,0,3,1,0,12,5,3,0,14,1,0,2,5,2,1,0,7,0,2,5,9,0,10,8,8,3,6,0,0,23,4,2,8,8,3,0,0,0,4,3,0,2,3,2,3,4,2,0,4,2,4,0,0,0,0,7,7,0,3,2,4,1,0,0,1,13,0,3,3,0,2,9,1,6,2,4,0,6,2,0,1,2,1,5,0,0,11,0,5,1,1,1,1,3,1,8,0,6,5,1,11,0,5,2,6,0,6,0,8,1,2,4,0,11,4,1,0,0,2,2,1,9,0,2,5,3,1,6,6,2,2,3,2,9,1,2,5,2,0,1,10,3,1,2,0,3,1,6,1,3,6,0,7,6,2,3,0,12,11,0,0,0,0,0,5,6,4,4,5,1,1,2,3,1,11,3,0,3,0,2,10,1,3,2,0,2,2,7,2,0,1,0,1,6,3,1,7,5,3,7,7,0,7,2,1,0,1,3,6,3,0,3,6,1,6,0,0,5,0,0,4,0,5,2,2,1,0,5,3,3,1,0,0,0,1,3,0,7,2,0,1,2,0,5,20,5,21,3,2,1,0,1,0,4,9,11,3,9,0,8,0,0,6,2,1,0,0,1,0,6,6,1,0,0,2,0,9,5,0,2,11,5,0,12,13,1,0,0,2,3,0,25,0,0,4,9,3,2,2,2,0,3,0,0,0,1,5,0,2,11,0,1,2,1,0,7,5,3,1,0,4,1,2,5,6,1,0,1,0,4,7,1,10,6,6,0,0,0,2,7,7,1,0,0,3,0,2,1,0,5,9,0,5,2,0,2,4,7,1,2,5,11,4,1,5,3,1,22,5,3,0,4,0,1,0,5,1,8,3,2,15,1,6,0,5,2,5,6,12,1,13,0,36,0,0,3,2,9,0,2,0,0,9,0,5,18,1,6,14,4,4,0,6,4,0,1,8,0,0,0,1,1,6,6,0,5,0,5,1,1,1,5,4,7,13,7,8,0,0,5,1,0,0,1,0,4,0,1,12,3,0,1,0,3,4,1,1,0,6,0,4,3,5,6,0,1,0,1,0,4,0,2,0,3,3,16,2,3,1,3,7,3,6,1,0,2,0,5,2,12,2,4,4,0,1,1,10,2,1,0,5,2,0,2,4,8,1,0,1,0,9,6,0,0,7,6,5,1,3,6,2,0,1,8,0,1,0,0,10,0,0,0,0,0,4,2,2,3,4,2,5,3,3,0,2,5,4,1,17,2,6,0,4,0,1,2,1,1,1,2,5,1,0,1,0,0,0,4,6,0,0,0,4,4,5,6,1,0,2,3,1,1,5,3,1,3,4,3,181,0,0,2,3,2,0,3,0,2,0,1,10,4,0,1,5,4,5,0,0,0,7,3,12,3,7,4,1,3,9,3,0,2,0,4,0,5,0,3,2,13,2,0,5,0,5,0,3,1,0,3,2,4,4,1,1,1,0,3,8,2,1,6,10,0,5,2,3,4,0,0,0,3,0,3,6,4,2,11,4,0,4,1,2,0,3,1,4,9,5,0,6,0,3,6,3,2,21,4,1,4,0,1,0,4,1,0,4,1,0,1,1,4,4,4,1,0,7,1,2,8,4,4,0,7,0,2,4,0,4,5,0,1,13,0,3,0,1,2,0,7,1,4,9,0,2,1,2,0,0,1,1,0,4,2,4,3,2,0,3,23,4,0,0,2,2,2,1,0,3,1,3,0,0,0,1,4,1,3,9,0,0,0,13,0,12,0,2,2,3,4,1,2,0,4,7,0,2,4,11,0,0,4,1,5,1,4,1,4,0,0,2,4,2,1,4,8,5,1,0,7,0,2,2,0,0,2,0,3,21,0,4,0,1,1,7,5,4,0,0,4,0,3,1,1,0,0,0,4,1,1,0,3,4,3,2,1,5,1,3,0,0,1,0,5,3,2,8,8,5,0,1,3,5,0,8,1,3,0,1,0,2,1,2,2,4,2,7,0,0,4,0,0,0,5,0,6,4,0,5,1,17,3,1,1,1,1,5,6,2,0,1,53,1,1,1,0,0,3,7,1,4,0,0,0,11,0,2,5,0,0,7,1,7,0,1,0,2,2,4,1,6,0,0,6,0,1,19,2,0,0,2,1,0,2,0,1,1,5,3,3,3,1,0,1,2,1,0,7,2,0,5,2,1,1,7,1,5,7,0,1,0,1,2,0,2,7,1,2,3,0,4,0,6,0,2,5,0,7,4,5,4,0,6,4,9,0,1,2,0,3,0,7,2,1,0,0,0,4,9,6,9,8,4,5,4,0,1,4,4,1,8,2,2,0,0,1,2,0,3,3,3,3,0,5,1,8,0,0,2,17,0,5,2,1,6,5,6,3,1,1,0,2,1,0,1,0,1,1,12,1,15,1,0,3,6,0,3,0,9,3,0,0,3,0,5,0,3,2,0,0,2,2,20,1,0,0,0,15,1,0,1,0,10,1,8,2,6,3,0,1,0,0,4,0,14,7,0,0,0,0,0,2,1,3,2,0,0,2,2,3,0,6,10,2,0,0,1,1,2,0,1,2,0,4,3,2,0,1,2,0,2,8,1,0,1,6,4,4,2,3,0,1,5,2,3,9,1,5,3,0,2,5,3,0,5,0,3,2,3,0,0,3,0,1,0,1,0,1,25,0,0,2,9,1,1,1,4,3,6,1,0,7,0,14,0,3,0,4,0,3,5,0,1,1,2,6,3,4,0,1,3,5,1,0,0,2,0,4,2,5,0,0,1,2,0,4,2,0,0,14,1,1,3,3,0,8,4,1,7,2,0,0,0,0,1,2,1,4,0,0,1,0,3,0,10,13,1,0,3,1,3,3,1,0,5,0,2,0,10,1,9,3,2,1,0,1,0,0,0,15,3,3,7,1,4,0,3,2,4,1,0,0,10,1,2,0,0,3,0,5,0,0,3,0,2,0,1,4,1,4,8,1,0,1,2,1,1,2,2,0,0,2,7,0,5,0,0,0,1,1,9,0,1,4,0,5,0,2,1,0,1,2,2,1,1,0,2,1,5,3,10,1,4,0,2,8,2,2,3,3,3,0,3,7,1,8,1,2,4,0,0,3,0,5,2,2,4,0,8,0,3,5,8,0,0,15,0,4,0,1,1,0,1,0,2,3,6,2,2,0,3,0,0,3,1,1,3,1,0,9,1,0,4,12,0,0,4,6,2,3,1,1,1,0,0,1,0,0,6,3,1,23,3,2,2,1,0,0,2,0,0,0,0,0,0,2,0,0,3,0,8,1,9,0,1,5,8,1,1,15,1,0,0,1,6,3,0,1,0,0,3,4,0,2,1,3,0,0,0,0,0,0,4,16,0,2,5,0,3,0,0,0,0,0,1,3,3,1,0,3,0,1,1,2,1,3,0,0,4,0,3,1,0,2,1,2,0,0,3,7,2,3,0,0,3,0,0,1,0,2,0,0,0,2,4,0,1,5,0,0,4,3,0,1,0,0,3,1,2,2,0,0,0,0,0,1,0,1,0,8,0,2,3,0,4,9,4,1,0,3,3,1,0,2,3,1,2,2,0,2,1,3,0,0,9,0,0,0,3,1,1,1,1,4,3,0,1,8,2,2,2,0,0,3,0,0,0,0,0,0,0,0,3,6,0,3,12,1,1,0,0,1,1,5,1,0,0,2,2,3,0,1,1,0,4,0,3,2,4,6,0,1,0,1,0,4,1,0,7,13,0,1,1,0,7,1,4,3,0,4,0,2,9,3,1,0,0,0,0,12,0,0,6,0,11,4,4,0,0,6,0,6,11,6,0,4,3,3,3,2,1,4,5,3,0,1,2,0,4,3,7,1,4,0,2,6,1,1,7,1,1,0,0,0,9,3,1,1,1,0,3,6,1,3,0,0,1,0,0,0,0,0,1,1,0,1,1,1,1,0,0,0,0,0,0,1,0,0,6,2,4,2,2,0,0,3,1,4,0,0,0,6,3,1,0,4,5,2,2,1,2,0,3,2,1,19,0,0,2,1,1,1,0,1,3,8,0,0,1,3,0,2,8,0,1,3,0,0,0,0,4,2,0,3,0,5,2,0,1,0,0,0,0,1,0,5,0,11,0,0,1,22,1,0,1,0,0,0,0,3,11,0,2,2,1,10,1,0,10,0,0,4,8,2,2,1,6,1,1,0,0,2,2,1,5,1,0,0,1,0,2,0,5,3,1,2,1,6,4,7,1,3,3,6,3,8,0,1,1,0,0,1,0,0,0,1,0,3,0,0,2,3,4,2,4,2,2,3,1,0,0,2,0,4,3,2,0,5,0,4,0,1,0,0,9,4,1,0,0,1,1,5,0,3,1,3,0,1,0,0,1,2,0,0,0,1,2,1,0,1,0,2,0,1,0,2,0,0,7,3,0,0,3,2,1,14,0,5,1,6,6,1,2,11,7,6,1,3,4,0,0,0,0,1,1,3,0,0,1,0,3,6,0,2,10,0,1,1,3,0,2,2,0,1,0,1,2,0,0,0,0,1,0,1,8,0,3,0,0,1,0,3,2,0,8,2,0,0,1,2,3,4,2,5,4,0,0,3,5,0,8,1,1,3,3,0,0,1,0,0,1,1,3,13,0,0,0,1,1,0,0,4,0,0,0,1,2,0,0,4,1,1,6,0,1,2,1,3,3,1,3,1,0,4,1,0,2,0,1,2,8,1,0,2,0,2,1,4,0,0,0,1,1,1,0,0,2,0,1,0,3,0,1,1,0,6,2,0,1,1,1,0,0,2,0,0,3,2,0,0,2,1,3,1,1,0,0,0,2,4,0,1,0,13,0,8,0,0,2,4,0,4,1,1,1,0,0,2,4,0,1,2,0,7,0,0,2,12,1,6,0,5,0,1,2,0,0,0,0,0,3,0,0,0,6,4,1,1,0,2,0,4,2,1,3,1,0,0,0,0,0,0,1,2,4,0,2,4,1,1,0,6,0,3,9,0,1,0,0,0,1,0,3,0,0,0,0,3,0,0,3,3,1,0,0,0,3,0,0,0,2,0,0,1,3,1,0,2,0,0,1,0,0,0,0,0,0,0,0,0,0,0,0,0,0,0,5,0,0,0,1,0,0,0,0,0,0,0,0,0,0,0,0,0,0,0,0,0,0,0,0,7,0,0,0,0,0,0,0,0,0,0,0,0,0,8,0,0,0,0,0,0,0,0,0,0,0,0,0,0,0,0
"2009 Cornwell, Patricia, The Scarpetta Factor",pop,6626,4292,3698,3572,2565,1525,1599,2113,2611,1891,1712,850,1356,2172,1968,1528,1160,1060,850,1182,793,537,807,533,264,748,430,365,529,538,555,485,1044,694,531,689,412,376,349,417,685,519,301,407,746,499,755,368,447,238,230,322,297,250,429,369,569,505,357,274,176,420,378,210,320,287,165,213,243,265,331,396,214,174,303,215,166,532,218,247,210,317,71,198,203,136,220,249,161,84,120,157,124,116,161,154,171,209,133,128,193,91,340,141,121,141,111,114,201,283,86,80,71,94,102,140,73,105,123,234,162,78,84,69,172,108,132,109,116,161,58,60,183,55,47,117,47,68,154,151,57,236,224,202,332,88,120,229,133,379,92,106,75,103,153,135,122,127,104,74,121,95,344,117,60,86,71,106,89,150,44,74,74,71,66,94,83,61,162,154,73,121,41,96,75,76,202,52,66,56,71,80,62,144,77,68,24,70,50,13,119,40,113,34,142,17,79,99,145,51,25,36,7,91,32,43,62,32,69,38,46,85,42,42,126,48,167,89,126,102,21,47,6,83,67,217,101,73,77,39,129,105,138,66,40,61,65,44,213,120,77,52,31,76,32,58,62,39,29,20,53,128,19,25,49,21,107,54,48,54,75,35,29,60,36,65,70,56,63,99,67,65,50,60,73,60,84,35,46,52,39,24,190,11,30,99,49,81,152,115,64,33,30,65,37,58,57,14,38,40,49,19,21,54,65,18,54,60,51,85,15,113,46,10,62,20,21,50,30,49,76,59,34,34,10,87,67,2,67,81,119,59,31,78,116,104,41,38,22,80,60,30,61,28,33,45,104,128,29,52,54,2,59,15,71,6,16,18,50,17,26,18,48,14,55,16,56,14,22,91,74,13,38,10,48,57,0,18,32,51,28,91,21,25,17,44,17,18,31,110,19,36,13,32,49,67,74,40,16,33,12,32,38,13,20,26,92,47,29,46,39,3,8,39,21,18,64,43,25,27,10,50,32,39,4,23,28,32,120,51,48,46,41,51,31,85,20,37,41,15,21,36,39,57,76,101,21,20,16,45,29,4,0,69,79,29,0,25,20,10,46,13,43,4,10,38,20,88,0,31,73,3,25,17,7,19,8,3,45,31,17,33,35,41,25,10,29,32,5,8,22,20,48,22,25,31,24,50,48,40,16,14,57,1,19,49,0,31,3,30,25,33,24,21,27,53,25,34,33,48,6,7,9,53,8,0,37,34,7,37,6,42,16,8,8,20,0,3,32,46,25,40,14,1,50,22,30,59,13,103,47,32,61,30,29,25,19,6,5,2,10,48,18,23,16,20,17,1,18,23,7,24,24,16,3,23,9,19,18,7,37,38,9,14,18,35,1,23,12,8,29,25,25,19,18,0,0,31,3,34,17,8,32,29,2,13,16,9,65,20,14,8,14,17,8,21,55,17,10,26,16,15,27,3,40,0,16,14,22,20,15,9,64,19,24,41,28,14,2,31,0,13,27,30,8,33,12,21,14,12,47,53,13,20,51,28,10,35,22,12,6,13,24,24,46,15,22,4,26,22,35,21,47,10,24,35,4,15,23,17,25,19,7,26,8,27,29,2,15,5,15,19,4,17,8,9,12,18,61,9,2,2,8,15,20,12,38,21,13,27,3,22,21,8,9,14,11,1,9,37,33,15,14,9,0,12,4,19,16,6,23,21,59,9,1,1,10,19,20,27,7,24,13,13,96,6,45,8,20,13,19,12,14,21,21,3,15,8,4,25,3,11,0,23,0,15,12,6,2,38,9,22,14,22,0,23,5,13,26,21,14,10,0,2,25,9,97,11,1,6,60,4,10,15,24,53,12,30,34,2,6,21,11,52,20,23,30,6,2,6,18,11,25,21,13,4,28,25,25,32,36,6,0,22,11,11,24,26,0,12,68,6,7,11,5,14,31,0,6,31,13,2,7,2,21,11,8,72,12,6,35,17,12,22,19,7,10,0,7,9,9,46,2,16,0,15,50,4,30,5,7,22,18,12,13,13,7,20,5,13,27,4,4,24,10,18,7,0,4,4,29,89,6,56,8,17,18,22,14,10,15,0,15,0,15,7,5,14,32,12,17,7,4,3,18,9,13,0,70,1,22,3,6,0,23,11,6,0,8,28,42,71,23,19,8,15,15,9,14,23,13,6,12,20,19,13,0,24,18,1,1,10,8,3,24,27,4,7,24,9,23,5,9,10,9,11,6,16,15,71,3,31,4,60,12,2,15,0,18,6,10,8,34,13,7,18,11,17,5,518,6,0,28,7,3,3,0,0,11,12,16,13,13,8,15,14,5,0,31,9,51,11,6,25,33,22,7,1,22,22,19,40,3,22,10,77,18,2,25,4,45,13,54,7,5,7,8,4,11,10,2,18,4,32,6,0,1,21,1,4,21,5,0,53,5,3,12,36,23,0,0,20,7,12,75,17,33,0,17,15,7,8,4,28,30,2,8,28,9,4,30,0,5,16,22,16,19,2,19,8,10,6,7,25,17,2,8,2,26,2,6,9,12,23,0,1,22,4,7,6,7,14,5,17,2,4,12,3,11,2,4,0,19,2,6,15,11,4,10,7,16,7,5,9,13,8,0,19,2,1,7,6,14,21,11,21,23,7,1,12,8,18,8,17,0,12,2,19,0,0,0,12,14,13,22,0,5,7,7,0,3,21,14,7,6,6,0,7,7,0,39,10,0,11,16,3,29,1,8,9,3,0,17,13,4,3,0,2,5,13,5,15,6,12,4,0,0,1,7,34,6,10,6,1,8,4,20,4,3,5,2,38,1,7,4,0,41,4,30,5,10,2,6,23,6,7,0,14,7,27,23,12,6,15,106,2,0,3,23,8,6,0,23,13,0,4,13,9,14,9,0,38,25,16,0,3,1,17,0,1,11,6,4,5,6,12,7,8,10,6,0,5,12,7,12,15,33,14,4,7,4,4,14,21,18,7,3,2,7,7,3,0,27,5,6,7,6,3,4,4,2,5,33,0,17,0,16,22,11,21,3,4,9,6,68,5,1,5,3,6,3,3,5,10,6,52,15,0,11,6,4,5,22,5,2,0,9,23,13,16,9,11,4,0,12,9,22,25,0,16,75,5,20,8,9,0,0,15,0,33,3,0,13,4,4,3,3,4,2,16,7,1,3,2,36,7,7,0,6,8,0,3,0,4,0,6,1,0,18,1,13,14,8,3,532,38,4,7,19,3,1,28,6,10,28,13,38,12,7,15,0,9,0,0,8,7,4,8,7,11,3,37,33,7,0,0,15,5,7,7,3,20,0,7,6,630,8,6,2,23,32,13,19,0,5,13,11,0,14,8,12,33,8,7,0,1,7,24,8,11,18,8,3,5,17,46,16,11,0,1,2,13,7,19,12,2,513,1,0,6,11,0,2,0,0,3,0,6,10,0,10,4,4,1,0,1,0,0,2,16,5,11,0,14,3,0,34,9,20,6,13,14,11,12,2,1,16,2,7,6,11,0,13,1,4,4,11,2,4,6,5,14,17,13,5,5,9,3,10,2,7,10,17,8,14,6,7,1,10,0,6,8,9,0,22,0,3,16,10,12,20,3,10,2,10,6,12,6,22,11,0,4,9,4,10,6,33,26,6,23,0,1,0,8,6,7,59,14,6,5,3,3,6,1,4,3,0,3,0,4,6,17,1,0,2,14,4,0,9,3,12,12,13,0,12,4,4,6,4,16,10,34,20,2,0,13,0,6,2,3,0,12,11,5,1,7,4,10,32,3,5,7,3,15,1,6,1,0,3,6,4,2,6,16,23,5,8,8,3,7,1,6,16,9,2,0,11,2,3,10,15,0,5,8,0,2,5,3,3,11,2,0,10,7,3,1,1,6,19,10,1,8,0,9,4,4,4,10,0,7,16,13,2,3,3,24,22,9,1,4,7,23,2,0,5,0,11,8,2,8,11,9,2,7,0,5,7,1,0,1,18,6,0,18,1,2,0,1,1,5,0,4,6,1,13,3,9,3,14,0,13,14,0,7,11,29,4,1,3,19,3,5,6,5,5,15,3,33,7,24,0,2,0,3,42,1,5,2,4,7,0,34,4,5,3,2,11,25,4,2,4,3,7,12,10,0,6,0,12,4,3,3,0,0,14,12,0,7,0,0,0,0,9,7,2,0,1,10,0,9,5,17,0,7,0,10,1,2,3,0,1,0,2,5,3,15,1,6,11,3,5,2,11,0,0,2,3,13,1,3,1,3,2,9,0,4,2,10,8,9,1,1,10,3,3,1,8,8,2,6,3,9,0,1,11,43,4,5,2,5,427,1,7,7,0,4,7,11,2,8,0,6,8,0,5,12,2,1,2,11,4,0,0,18,5,0,9,17,1,2,10,3,0,3,9,0,2,2,0,6,14,7,0,8,0,3,9,5,4,2,3,3,16,5,0,2,2,14,3,5,6,19,0,12,0,17,5,13,15,4,4,8,82,0,3,23,7,4,24,6,2,3,4,12,4,19,2,7,7,16,10,25,24,25,7,9,1,0,11,6,6,3,1,8,6,9,5,14,28,34,1,7,2,10,11,8,3,6,5,1,6,0,5,2,2,0,22,5,5,0,3,0,1,3,1,7,3,5,5,2,3,12,0,0,0,9,15,4,1,2,2,16,10,2,6,2,3,0,7,3,1,6,1,1,5,2,2,4,19,2,1,0,3,4,0,0,5,2,10,0,3,1,7,2,3,5,0,0,23,3,4,5,4,5,5,3,18,6,2,17,9,0,1,2,25,3,0,0,22,2,2,17,2,3,7,2,3,4,0,0,8,0,6,5,0,0,11,1,9,1,1,2,5,2,0,5,6,11,8,4,4,2,4,0,0,2,19,0,0,22,7,6,4,0,2,0,5,9,1,3,0,1,2,18,1,5,1,2,23,6,3,1,8,0,3,0,0,7,3,2,6,0,0,1,5,2,8,6,5,5,20,8,10,6,3,0,1,2,0,3,4,4,4,2,4,8,0,1,3,16,7,7,1,3,15,7,5,8,30,2,15,5,3,0,16,1,3,5,2,16,1,7,6,4,9,0,6,0,1,0,4,4,6,2,9,1,3,17,5,11,11,9,0,2,6,2,0,2,10,6,1,4,1,2,8,7,3,0,21,0,22,61,10,0,0,2,9,3,1,4,1,6,1,7,5,18,18,7,93,4,6,6,4,6,3,4,0,0,1,9,0,19,1,7,0,2,0,13,5,2,6,2,5,3,5,2,3,5,3,1,11,5,0,6,6,6,15,0,3,7,0,1,2,7,1,0,17,1,2,7,1,38,1,4,6,3,11,1,0,32,5,4,4,2,23,2,0,0,2,3,2,8,17,1,2,7,2,1,2,4,1,2,0,14,1,1,1,2,14,1,0,3,0,2,19,0,18,1,4,2,8,5,25,1,4,46,0,0,5,1,5,5,3,0,0,0,2,1,5,0,7,2,7,11,11,9,0,2,0,3,11,2,10,2,1,0,0,9,7,0,12,11,3,0,2,0,1,1,15,0,0,1,50,0,7,0,1,2,12,17,11,2,5,5,32,16,4,0,3,4,0,5,2,0,0,21,0,5,20,1,0,1,2,0,14,3,0,6,9,18,7,0,6,7,4,1,1,0,3,2,2,0,6,4,2,2,0,7,6,1,9,5,2,5,5,9,0,0,9,0,1,8,0,3,0,2,1,2,4,13,5,3,2,2,67,4,8,6,0,11,5,14,6,2,11,1,17,6,1,1,3,0,4,11,3,15,6,6,7,1,8,19,0,7,8,2,4,4,0,7,6,1,0,3,7,1,0,5,3,0,2,0,0,3,0,0,0,1,0,0,7,0,0,8,6,1,2,15,1,2,0,1,10,2,3,2,0,4,1,3,7,0,3,4,3,1,6,3,3,1,5,2,7,0,3,3,2,1,3,3,4,3,7,16,3,1,1,8,2,8,6,1,0,3,1,12,0,3,1,1,5,0,5,10,0,3,2,4,6,0,0,5,2,0,4,4,4,0,16,3,26,0,2,4,3,5,2,1,9,1,5,2,3,1,1,4,1,41,4,1,5,1,2,3,0,5,0,1,3,2,6,0,6,3,3,0,6,1,1,1,0,0,7,3,5,9,2,10,6,1,14,3,3,4,4,2,0,3,9,0,1,3,2,4,0,3,3,5,1,8,0,0,1,3,3,0,4,6,6,14,0,0,3,2,2,0,2,4,0,6,0,0,0,8,0,1,4,0,2,6,11,0,3,2,0,0,2,3,12,1,2,6,0,1,14,0,9,2,1,1,0,24,5,6,12,3,23,0,4,0,8,4,4,4,3,5,1,1,1,3,2,3,4,24,0,0,2,1,1,1,0,3,1,4,1,11,4,11,1,11,0,3,2,0,4,8,0,10,5,4,4,8,2,1,7,5,2,2,2,0,11,0,2,1,2,8,4,1,1,0,72,0,2,16,1,1,6,2,1,9,8,3,6,0,0,3,0,6,1,1,4,0,2,1,1,2,0,0,12,3,7,8,1,1,5,0,35,3,2,0,0,3,1,0,4,1,3,2,4,1,13,2,7,0,0,5,0,0,5,1,6,1,13,1,8,4,5,6,0,8,1,2,2,0,0,3,3,6,1,8,0,0,5,5,1,3,0,3,0,1,0,0,4,2,6,2,4,5,2,0,2,3,34,0,0,0,1,1,10,0,0,0,7,0,11,3,0,3,24,17,0,7,1,0,9,0,5,2,0,1,0,0,6,2,1,0,3,6,15,6,0,0,0,9,2,4,4,5,0,12,4,0,0,7,12,2,0,0,0,0,2,0,2,26,0,0,0,0,4,8,7,3,6,3,0,6,5,4,3,3,0,17,0,16,0,5,2,2,6,1,4,0,1,0,2,1,2,3,6,3,0,1,3,0,4,6,10,5,7,5,0,16,0,2,2,2,3,2,5,0,6,0,4,6,5,2,5,4,0,1,7,5,4,2,4,7,0,0,4,0,3,0,4,2,0,10,5,0,5,8,0,7,1,0,3,0,9,5,7,4,10,1,0,2,0,27,2,3,0,3,2,1,1,10,4,2,1,2,18,0,2,1,0,3,1,0,2,1,0,17,2,12,11,4,0,0,2,9,1,0,2,5,2,0,0,0,0,2,1,1,0,2,2,1,1,3,1,2,13,4,18,3,0,2,0,1,2,2,1,0,2,0,6,3,3,2,2,0,3,0,2,3,2,3,1,0,10,2,4,6,4,0,3,1,0,2,3,7,2,3,5,6,4,1,1,1,2,0,2,8,1,1,1,2,2,1,1,2,1,5,17,7,5,13,0,3,3,0,4,0,3,0,0,0,0,1,0,12,3,7,0,2,0,0,0,4,1,5,0,0,0,5,8,2,4,0,11,1,1,10,4,1,6,0,3,2,0,7,4,16,2,0,3,6,6,2,5,1,0,8,0,0,3,10,1,2,2,2,17,5,6,0,1,1,1,5,6,5,0,6,0,3,0,2,0,3,8,5,3,0,3,4,4,2,0,0,9,8,3,7,2,0,6,3,0,2,0,0,1,13,2,0,1,0,2,1,0,0,0,1,0,0,0,3,6,1,7,2,2,16,4,6,1,1,1,5,2,2,6,1,1,5,0,0,11,4,1,4,0,1,9,2,3,0,6,0,0,1,2,1,1,4,8,0,1,2,2,3,2,0,2,1,4,5,4,2,2,2,0,0,1,2,1,5,0,2,1,2,2,8,2,0,2,5,1,2,0,0,1,0,3,1,0,0,2,3,1,4,1,0,2,5,2,0,0,0,5,0,3,8,0,0,3,0,0,4,1,0,1,1,2,0,5,0,3,3,6,0,1,1,0,1,2,1,0,0,2,0,173,6,0,6,1,2,1,1,9,5,1,0,4,4,2,8,1,2,2,3,0,0,6,0,0,3,0,3,0,0,1,0,3,3,1,3,5,3,4,0,0,9,1,0,0,2,0,0,1,5,5,1,0,2,18,1,1,1,2,0,7,3,0,4,5,2,2,5,1,0,2,3,3,0,0,0,5,2,2,0,0,1,1,3,0,5,1,4,10,2,29,0,1,0,3,1,8,1,2,0,10,0,0,0,1,0,12,7,0,0,3,0,3,5,1,0,3,8,11,0,2,1,0,1,16,57,0,7,0,5,4,1,6,0,2,2,9,3,2,8,4,4,3,3,0,0,3,8,1,2,0,1,0,2,13,1,0,3,1,9,5,2,0,5,6,1,0,0,12,27,10,0,5,15,2,2,3,7,0,1,0,3,2,2,0,1,1,1,9,1,4,3,0,2,3,0,3,4,1,3,5,0,2,7,0,12,2,1,2,6,0,5,0,4,0,0,0,0,1,3,2,9,13,5,1,0,1,0,0,0,10,3,1,0,0,8,0,1,1,1,0,3,3,1,2,0,2,0,4,4,1,2,1,1,1,0,6,0,5,3,0,2,1,3,1,3,0,0,7,8,7,0,0,1,10,4,5,0,18,2,2,0,1,2,0,5,0,2,2,0,1,0,2,1,1,0,9,23,0,0,3,3,14,0,3,0,7,0,0,3,2,0,4,0,0,2,5,0,0,6,1,2,4,3,0,0,1,4,7,2,40,3,0,0,1,4,0,2,2,0,5,0,3,16,5,0,2,6,3,0,1,0,0,2,2,3,1,2,1,4,1,0,1,2,6,1,0,1,0,0,1,8,0,0,1,3,0,4,4,0,2,2,0,2,1,0,1,1,0,0,1,6,0,4,0,4,3,0,1,16,0,4,2,0,5,4,0,5,0,6,4,0,1,9,0,3,3,5,0,2,4,7,1,0,0,0,193,1,0,0,0,0,5,3,0,2,2,0,1,3,0,4,21,1,1,1,6,4,1,3,1,0,0,0,0,0,1,7,0,2,4,0,6,0,2,2,0,1,1,2,0,0,2,0,0,5,1,2,6,0,2,1,2,3,4,1,0,4,7,11,0,4,3,0,8,0,6,0,1,3,2,0,2,2,0,8,7,1,0,1,0,0,0,0,1,0,1,0,4,5,1,5,0,0,0,7,0,0,8,0,0,2,5,0,1,0,3,4,0,2,6,0,0,4,1,1,2,0,0,0,0,2,13,0,1,0,4,0,8,1,2,0,6,1,7,3,3,10,7,2,9,2,11,4,2,5,1,4,7,1,0,1,1,0,3,0,1,0,1,9,3,1,9,3,0,3,0,8,1,4,2,2,5,2,1,3,12,2,2,0,2,0,24,11,2,3,1,2,0,4,1,0,2,0,1,0,12,0,1,2,0,2,5,0,1,0,4,0,6,1,7,3,6,2,0,4,0,0,3,0,0,0,4,3,0,0,0,1,4,0,4,2,7,2,0,0,4,2,2,6,1,4,0,0,5,3,0,1,0,2,2,1,0,0,0,3,0,0,1,0,4,0,0,0,0,1,3,0,0,0,10,0,0,12,10,3,1,2,1,0,6,0,3,4,0,1,7,0,3,4,3,33,1,5,3,1,0,0,2,1,1,6,0,0,0,0,1,2,0,0,10,0,0,6,4,2,5,0,0,1,1,0,0,5,0,1,1,4,9,0,0,8,1,0,33,1,0,0,0,1,2,2,2,0,2,2,3,4,0,2,0,0,0,1,2,2,0,2,0,1,1,5,0,1,1,1,0,2,1,0,6,3,2,2,0,3,0,7,0,3,1,1,7,3,0,0,4,0,0,0,0,3,4,0,0,0,5,0,0,1,2,0,4,2,2,0,7,1,3,1,0,2,1,1,4,0,2,2,11,1,4,0,3,2,1,2,0,1,10,0,0,0,1,6,3,2,0,6,5,2,1,0,2,1,4,0,0,2,0,9,0,3,4,0,2,5,2,0,1,2,0,0,0,0,1,13,5,1,3,3,0,6,6,0,0,0,3,0,2,0,2,0,3,0,0,1,2,2,0,7,2,0,22,0,4,3,10,6,0,9,0,3,1,0,18,0,5,1,1,0,0,0,1,6,0,0,0,1,0,2,11,1,0,60,0,3,0,0,6,1,3,2,2,2,4,1,7,3,0,0,1,18,3,8,1,1,1,0,0,7,6,1,12,7,1,0,0,0,1,5,2,0,0,0,4,1,0,1,2,2,0,3,6,5,2,26,0,0,2,0,5,4,1,8,2,5,0,22,2,1,0,1,155,2,1,2,0,3,1,0,1,12,0,0,3,3,0,1,0,0,0,0,1,1,7,2,0,8,2,5,1,0,8,2,1,1,1,0,0,0,2,14,0,5,11,0,4,0,1,0,10,0,1,0,0,0,0,6,4,6,6,1,0,1,5,5,2,2,2,2,1,1,1,0,6,3,1,3,3,4,0,7,4,1,0,3,0,2,12,0,0,9,0,2,2,7,2,6,0,0,2,0,0,0,11,1,0,1,0,0,0,0,5,8,0,3,3,4,0,1,5,4,0,1,0,0,4,1,0,2,0,7,0,0,3,1,3,2,0,4,1,4,0,1,2,2,6,1,1,1,1,4,4,11,2,4,1,5,0,1,1,0,0,0,2,4,2,1,3,1,3,2,0,5,0,8,0,2,10,0,0,3,0,1,1,0,5,3,2,0,4,1,0,0,0,7,1,0,0,6,2,4,4,0,3,0,0,0,2,3,1,2,3,0,0,0,33,0,3,3,4,3,6,0,1,0,2,0,0,1,0,1,0,3,0,5,1,0,6,0,0,0,1,0,12,1,1,0,134,1,3,1,3,0,1,2,1,1,2,4,1,8,0,0,0,0,5,23,0,2,2,4,0,0,4,0,2,0,0,0,0,2,1,1,0,1,2,1,1,0,2,6,18,5,2,0,9,0,0,1,0,0,0,2,0,2,5,1,0,0,5,4,2,12,2,3,2,0,0,4,0,1,0,7,0,0,3,0,3,1,3,3,3,2,0,0,0,2,2,5,10,8,0,16,0,0,5,13,0,1,0,8,0,5,4,0,0,0,0,1,0,0,0,2,3,5,3,2,0,1,0,2,4,1,7,2,0,0,0,0,3,0,0,0,1,0,2,0,1,0,0,4,11,4,3,0,2,2,0,0,1,0,5,1,0,2,0,0,0,0,1,2,1,1,5,0,0,0,0,0,4,0,0,1,1,0,0,2,0,1,0,0,4,3,0,0,0,1,1,0,0,0,0,0,0,0,1,0,0,0,1,2,0,0,0,0,3,0,0,0,5,0,0,0,0,3,0,0,0,0,0,1,0,0,0,0,0,0,0,0,0,0,0,0,0,4,0,0,0,0,0,0,0,0,0,0,0,0,0,0,0,0
"2009 Coulter, Catherine, Knock Out",pop,3901,2583,2899,2062,1545,1534,2382,1260,1438,1165,1808,1505,838,1342,1711,708,478,545,535,832,830,720,422,1012,327,365,671,537,595,386,351,480,513,407,414,372,325,477,275,244,315,342,315,376,327,313,211,326,218,321,400,435,265,272,207,99,160,379,330,211,329,295,194,324,320,154,147,275,229,253,293,266,176,251,272,129,162,390,147,324,205,199,145,302,101,260,164,177,166,163,104,154,166,125,166,118,160,84,177,114,120,162,225,106,166,23,171,198,171,84,163,153,175,231,81,115,154,121,82,101,60,175,93,214,78,195,113,178,207,206,215,91,128,102,134,74,64,171,83,96,110,148,205,156,108,54,88,53,119,147,47,100,114,78,71,141,38,59,87,70,23,87,137,69,85,25,43,42,41,82,45,61,67,118,94,34,33,57,68,68,62,100,78,52,87,50,112,194,88,40,104,25,86,23,72,74,50,18,71,50,90,21,119,36,40,37,50,62,141,177,121,46,11,89,128,45,75,62,39,27,48,21,94,35,86,48,57,94,59,114,80,93,49,153,55,100,61,56,49,31,53,70,57,33,44,84,34,49,42,110,36,20,18,71,95,40,37,67,32,10,32,23,38,35,21,12,39,41,58,24,40,16,37,43,68,84,31,68,41,37,70,20,69,65,12,16,64,49,38,50,124,19,46,50,39,16,55,46,107,65,57,48,110,33,26,49,37,93,34,11,51,11,16,12,18,51,38,25,102,78,16,60,32,45,42,42,25,76,10,34,26,87,21,42,56,19,40,31,27,52,18,19,54,14,37,22,63,54,25,58,39,72,45,34,37,50,12,64,32,34,24,89,34,5,15,49,41,41,60,15,22,102,21,49,42,49,24,21,13,61,30,61,24,74,19,11,0,24,67,33,8,14,13,85,32,26,45,40,32,13,6,56,46,27,17,8,22,38,31,25,58,16,21,39,57,7,36,26,13,20,23,0,4,16,49,22,47,14,58,56,32,34,31,14,1,18,18,24,59,20,22,27,60,42,40,26,26,29,24,26,23,21,38,12,51,24,58,1,21,42,24,20,0,9,11,9,53,14,21,93,12,74,21,3,34,23,29,31,0,25,16,34,53,129,40,38,16,19,30,4,29,16,18,24,9,63,32,20,5,31,14,39,10,16,17,37,64,21,23,35,16,50,28,21,8,11,0,38,45,59,23,36,23,44,18,14,29,30,29,29,4,15,13,49,27,0,26,30,24,6,41,16,33,7,30,6,0,2,24,2,20,15,18,17,25,9,21,21,4,28,18,4,15,67,20,12,28,57,7,60,5,24,32,22,19,19,24,10,16,16,33,12,29,21,4,30,31,7,14,10,12,10,29,16,62,13,3,25,15,14,44,4,8,9,9,3,0,36,31,14,23,5,15,10,3,25,21,2,11,7,8,16,10,10,49,7,6,22,13,4,23,25,9,7,22,0,15,7,19,19,14,29,5,3,38,14,13,15,9,25,24,9,9,26,13,11,18,5,15,2,15,19,8,26,50,12,16,23,19,13,69,38,15,9,9,23,22,5,7,16,13,13,15,8,17,17,2,8,21,6,20,10,4,12,43,16,9,0,9,18,17,3,16,13,40,34,38,19,10,8,0,33,11,10,3,34,13,10,10,10,33,14,1,1,26,20,4,8,13,8,16,15,1,8,0,38,17,9,20,21,25,15,3,14,5,0,11,17,17,12,8,36,6,9,7,18,18,12,28,1,13,36,28,6,4,22,17,7,21,9,7,3,10,12,4,2,20,24,2,3,21,3,10,7,37,4,10,6,4,20,12,5,0,17,2,3,55,4,0,6,6,2,6,23,17,16,6,17,56,0,8,38,4,1,4,1,5,0,9,12,7,5,27,27,5,7,12,11,13,12,3,10,37,9,8,19,7,12,0,10,3,8,3,3,26,11,27,34,8,6,10,31,3,3,6,1,9,1,2,20,18,7,14,12,6,4,1,0,17,8,10,9,18,16,0,6,1,18,11,6,9,22,22,12,3,23,12,20,15,24,13,10,1,14,8,19,3,0,5,5,22,3,17,6,10,4,19,7,13,3,10,0,5,0,7,3,6,6,5,16,14,3,11,14,6,10,3,0,18,9,0,20,19,1,7,13,3,15,8,17,5,0,19,7,3,5,5,3,21,4,8,13,18,12,2,16,6,12,5,0,0,14,14,0,2,8,2,0,1,15,2,0,3,0,1,11,6,9,12,8,1,28,16,1,3,2,5,0,17,1,35,5,13,6,7,3,0,4,6,0,11,0,11,1,6,9,0,0,16,35,8,5,11,1,10,5,5,0,14,6,20,9,3,0,0,0,6,4,2,8,25,7,3,4,14,3,8,17,20,19,11,16,69,8,16,6,39,15,3,11,4,10,4,13,7,0,18,7,23,2,2,45,462,6,6,6,3,2,1,0,1,74,3,6,3,10,2,0,10,34,12,1,2,3,54,10,1,1,5,3,1,615,8,20,11,2,20,17,28,10,2,1,10,20,2,10,14,5,8,11,9,6,14,9,0,10,3,0,12,9,16,4,1,3,10,7,13,23,7,3,24,34,11,4,4,10,6,4,6,0,2,18,2,2,8,5,15,4,11,2,28,27,13,4,16,1,10,8,12,6,1,1,2,10,0,2,17,7,478,0,194,5,1,2,6,15,2,0,4,0,3,8,13,5,13,4,0,7,9,0,5,5,0,14,17,4,6,5,1,25,2,0,6,3,7,2,486,8,19,10,0,6,6,3,0,0,0,14,7,5,5,6,52,14,8,5,16,12,5,2,11,4,1,11,11,0,4,24,10,5,5,10,2,0,7,18,0,1,10,4,4,1,18,7,3,4,17,3,2,5,16,0,4,23,17,1,20,4,4,2,129,0,27,3,0,12,5,5,0,17,3,23,8,1,3,7,20,5,2,5,0,0,3,7,11,3,3,3,0,2,11,5,7,0,14,3,0,9,3,2,2,0,5,3,0,3,4,3,3,2,31,3,11,243,4,5,7,9,6,14,1,10,1,6,6,3,20,4,9,10,3,9,1,0,12,20,2,0,3,1,8,13,4,16,7,4,19,3,8,6,1,13,3,1,5,6,7,1,4,5,4,9,7,7,0,1,0,2,0,22,0,0,3,7,3,11,2,6,6,4,0,14,1,0,2,5,5,0,0,1,0,8,0,8,0,10,0,0,3,0,6,8,3,2,4,1,5,13,2,18,6,3,2,9,0,20,8,9,6,2,22,4,0,0,10,11,3,36,10,2,8,0,3,19,0,23,5,8,12,3,3,5,0,1,20,0,6,2,5,10,13,22,4,1,12,1,5,0,8,5,12,0,10,7,0,4,3,2,3,13,5,8,2,1,6,2,6,0,1,20,20,2,1,6,25,13,3,7,0,4,3,282,2,0,0,0,0,12,2,0,6,8,1,34,2,14,1,0,3,3,4,16,3,1,8,8,3,9,4,9,0,1,12,2,9,0,4,1,5,2,5,8,7,2,14,1,3,0,10,1,6,23,9,12,2,3,5,5,2,17,14,2,23,1,0,0,6,63,10,6,2,1,4,346,6,6,3,7,2,2,0,17,2,1,5,2,6,9,8,9,0,20,15,0,1,6,1,0,3,6,0,4,0,0,3,11,6,2,6,4,8,3,1,2,4,5,0,4,0,8,8,3,9,1,8,2,0,7,5,1,7,1,123,3,2,0,6,6,0,2,4,2,4,0,0,34,0,3,10,8,11,11,10,2,2,0,4,6,2,4,5,5,3,6,2,2,37,0,3,4,0,13,21,2,7,10,12,2,0,5,15,0,11,0,2,0,1,12,6,13,2,0,7,3,0,7,8,0,12,6,8,2,3,2,6,4,2,15,1,10,7,1,14,1,5,6,3,2,0,8,2,9,11,6,2,11,4,0,2,1,0,1,4,0,0,8,4,2,12,3,4,1,7,6,0,9,7,2,2,14,5,7,1,1,1,2,0,12,1,8,2,3,6,1,2,9,0,9,4,0,3,3,0,3,27,0,1,13,12,5,1,4,5,5,6,7,5,8,5,1,1,22,1,3,1,1,4,2,3,2,1,1,0,4,17,3,9,2,0,0,4,1,4,15,3,12,2,0,48,6,3,2,0,0,2,3,0,2,0,2,0,23,8,6,0,3,12,1,0,2,1,3,0,10,2,0,10,3,0,4,4,3,1,3,0,1,7,1,5,6,0,3,4,0,18,0,1,2,2,3,11,5,3,6,1,3,2,1,5,2,0,0,2,1,2,0,9,5,2,3,6,4,0,0,0,4,10,1,2,2,0,24,11,13,0,2,13,1,0,1,0,13,4,0,4,2,11,3,7,6,4,0,0,8,7,10,12,0,5,3,4,3,0,5,3,0,3,3,0,0,0,9,0,2,0,11,15,7,5,4,1,4,6,18,0,0,38,2,1,3,0,9,24,3,6,1,0,4,2,4,2,3,0,0,1,5,2,1,4,4,1,9,8,6,32,5,12,0,0,7,6,1,1,9,0,1,7,16,0,5,3,0,2,3,6,2,0,7,4,1,8,9,0,7,3,5,2,0,1,5,1,9,1,8,16,0,3,10,3,0,0,1,2,2,0,0,5,2,4,1,8,2,0,0,0,2,2,8,11,3,6,5,0,2,1,0,2,19,21,2,1,0,2,6,5,4,1,6,2,6,0,0,0,6,0,0,9,2,2,8,0,2,13,3,3,4,0,0,2,1,2,7,1,13,1,0,0,1,8,0,0,2,0,1,1,0,0,0,4,1,7,3,6,2,2,0,1,7,0,0,9,0,4,5,0,0,2,1,6,7,3,1,6,3,0,3,0,5,6,4,1,7,6,3,1,4,2,2,0,0,0,5,26,0,6,0,1,1,4,6,0,24,0,2,11,11,4,1,1,1,0,0,2,1,0,0,0,1,0,0,1,0,0,1,1,3,3,1,1,0,1,3,2,0,0,2,1,3,3,2,0,0,1,2,1,3,1,0,4,1,0,3,5,6,2,0,1,2,2,3,0,2,1,0,3,6,0,1,2,5,8,0,4,0,4,3,0,0,10,0,1,0,5,1,1,0,4,8,2,2,1,4,0,0,2,0,1,2,6,2,1,2,1,5,3,5,8,4,7,0,1,0,0,2,0,2,2,1,6,3,4,6,12,3,0,2,2,4,16,0,1,4,8,0,8,1,1,3,6,4,8,3,3,5,0,1,1,2,1,2,1,2,27,4,3,16,0,3,1,4,0,0,0,0,3,7,4,3,2,3,0,1,1,8,13,0,2,5,13,1,0,4,0,3,4,2,4,9,0,0,3,4,1,8,0,2,1,2,0,1,1,4,1,0,3,6,12,0,6,2,7,0,3,0,0,0,1,8,1,3,0,8,10,2,1,0,0,4,2,0,1,1,0,0,8,0,3,1,1,2,2,2,0,0,0,0,6,2,5,3,1,0,2,2,1,1,5,0,0,3,1,0,2,1,2,0,0,2,1,0,1,4,6,18,25,8,3,5,2,0,0,5,1,0,2,0,31,2,5,0,0,1,2,0,0,1,1,0,2,0,6,1,4,3,0,2,6,11,3,0,0,3,0,9,3,1,0,0,3,0,0,13,7,5,0,14,1,0,3,2,8,0,3,1,1,2,9,0,2,1,1,3,1,5,11,4,0,0,1,0,0,4,0,0,0,0,0,8,3,3,1,0,3,3,1,1,0,1,1,2,0,1,1,8,9,1,0,3,5,2,4,0,10,1,0,4,4,0,1,0,3,5,232,2,0,1,2,8,0,4,3,0,1,3,2,1,8,5,0,1,0,0,0,0,0,0,1,4,0,1,3,1,1,1,2,0,2,2,0,0,10,1,2,14,0,2,1,0,2,2,2,2,1,2,11,1,15,0,4,0,8,1,0,0,3,3,6,33,0,0,6,0,0,0,0,2,1,1,14,5,0,4,0,0,1,0,0,8,1,0,1,0,7,1,0,0,5,2,0,0,0,3,2,8,7,8,0,0,2,7,0,0,1,10,2,3,0,4,5,17,4,2,1,34,0,0,4,3,1,1,1,1,3,2,0,0,0,3,0,1,0,0,2,4,4,0,3,7,2,2,4,1,1,0,0,4,7,0,3,1,3,0,0,1,0,1,1,2,1,3,0,5,0,2,0,1,5,0,1,1,6,0,3,2,0,0,1,0,3,0,0,0,0,1,1,16,0,2,4,8,0,0,0,3,6,1,2,0,1,2,1,2,1,3,2,1,4,1,2,3,2,3,0,9,2,0,2,2,1,0,6,1,2,0,2,0,3,2,1,0,1,4,6,0,1,0,2,5,1,1,1,12,1,0,0,0,0,0,5,2,0,7,2,4,5,2,3,0,0,5,2,2,1,1,2,0,2,0,0,9,9,3,1,2,7,0,4,0,3,0,1,0,2,1,0,3,6,1,5,26,0,0,0,1,2,1,3,2,6,2,0,1,0,9,0,0,0,4,0,3,4,3,8,0,1,0,2,0,6,4,3,3,26,1,0,0,0,2,0,0,0,2,21,0,1,1,0,0,1,0,0,2,0,0,0,9,0,0,5,2,2,0,0,7,0,0,2,1,0,1,0,3,3,1,0,0,51,1,0,0,0,10,5,1,4,3,2,3,1,1,0,3,2,2,0,2,1,0,0,0,4,11,0,14,0,0,2,6,4,0,5,0,2,0,1,2,0,1,1,12,0,2,3,0,5,2,1,0,0,5,4,0,2,0,0,12,1,1,0,1,0,0,0,3,2,3,4,3,0,1,0,0,0,1,1,3,0,0,4,0,3,11,2,0,0,0,0,0,1,0,2,1,2,1,1,1,1,1,0,14,0,1,8,2,1,0,1,4,0,1,0,1,9,1,12,14,1,0,0,6,1,6,1,1,0,0,0,1,2,1,0,0,0,1,4,4,2,1,1,3,1,0,1,9,3,1,1,1,3,14,1,1,0,2,8,4,1,1,1,1,0,0,2,0,1,1,0,2,1,2,0,0,0,0,1,0,6,1,0,1,1,8,0,2,0,0,1,0,1,4,3,1,1,0,8,0,4,0,1,0,0,2,2,2,1,0,2,4,0,2,10,1,0,0,0,0,5,0,0,5,4,3,2,0,1,4,0,0,1,5,0,2,1,1,3,2,1,2,0,2,0,2,0,1,1,3,0,2,1,9,4,0,13,0,1,2,1,0,0,0,0,2,0,1,2,1,2,2,1,0,2,0,0,0,0,10,0,0,0,0,1,3,1,1,12,1,0,0,0,2,0,15,0,4,3,0,0,3,0,2,3,0,4,3,0,1,5,4,0,0,2,0,5,0,2,0,0,0,1,15,0,1,0,0,0,5,1,1,0,0,1,0,0,1,4,0,1,0,0,4,0,0,2,5,1,9,0,0,2,5,3,1,1,3,1,7,2,3,2,3,1,0,4,2,0,5,0,0,1,3,2,5,0,1,0,2,0,0,0,1,0,3,0,0,1,2,5,2,6,0,2,0,2,0,2,0,6,2,4,1,2,2,9,1,0,6,1,3,4,2,0,0,1,0,0,0,0,0,0,9,6,0,0,2,4,0,0,0,0,3,1,0,1,0,1,0,0,0,1,0,0,0,10,0,1,3,0,2,0,0,3,1,4,0,0,3,0,0,2,0,6,3,1,0,1,2,1,1,0,0,1,0,0,2,0,0,5,0,0,0,0,0,5,0,13,1,4,2,1,2,2,0,3,0,1,0,0,5,0,0,1,1,0,0,2,1,2,0,1,1,3,0,2,0,5,0,9,0,5,1,0,0,3,1,1,1,2,0,0,0,10,1,0,0,3,0,3,0,13,5,0,3,1,0,2,0,1,0,0,9,7,2,0,1,1,0,4,0,0,3,0,3,2,2,0,0,0,1,0,1,0,0,0,0,0,4,0,0,2,0,8,0,5,1,0,2,1,0,0,1,1,8,2,2,0,0,0,21,1,2,0,0,2,0,0,0,1,0,0,1,0,3,2,2,3,0,7,0,1,3,0,0,0,0,4,4,1,0,0,4,3,0,4,0,1,0,0,0,0,0,0,2,0,2,3,0,1,12,0,0,2,0,0,2,0,3,2,0,0,0,0,0,0,0,1,0,1,2,0,1,0,0,4,1,0,2,0,0,3,2,0,0,1,0,1,2,12,1,8,0,2,5,9,3,0,1,5,0,1,1,0,3,0,5,14,2,0,1,14,1,0,0,2,1,0,0,4,5,1,0,0,1,1,0,4,0,4,0,2,1,1,3,1,2,5,2,0,0,1,0,4,3,1,11,0,0,0,2,1,1,0,1,0,0,0,4,1,7,1,5,3,0,0,0,0,0,5,1,0,2,0,0,6,1,7,0,0,0,9,2,1,133,1,2,0,8,1,2,1,0,12,0,1,3,0,0,1,1,9,6,2,0,2,8,7,0,1,0,0,3,1,2,0,0,2,1,0,2,5,0,0,3,0,1,0,0,0,1,1,0,1,2,4,21,0,5,6,0,3,3,1,2,0,0,0,0,0,0,1,0,6,1,2,2,2,1,0,0,0,0,8,2,0,0,1,0,0,1,11,5,0,5,1,0,0,1,3,2,0,0,0,0,0,0,0,5,0,0,0,5,0,0,1,1,8,1,4,0,0,1,2,0,1,2,0,0,1,0,0,0,3,1,1,2,0,0,3,0,2,0,0,0,1,2,11,6,0,0,0,2,11,4,3,0,73,0,0,0,0,2,3,5,1,1,1,1,2,1,0,3,0,2,0,0,0,0,5,0,1,0,1,3,3,0,0,1,0,4,0,1,1,0,6,0,0,2,3,0,0,122,2,1,3,1,1,0,9,2,12,1,0,2,2,0,1,3,0,1,1,0,4,4,1,3,4,1,2,0,1,0,3,0,7,0,2,2,0,4,2,2,0,1,1,4,0,2,1,1,2,1,6,0,0,2,0,0,0,0,0,1,0,32,1,0,0,0,0,0,1,0,1,6,0,1,0,0,0,0,3,0,0,2,0,0,0,0,0,2,0,1,0,0,0,0,1,0,3,3,0,0,0,0,0,0,0,2,2,1,5,0,0,0,0,6,1,1,1,0,2,0,1,0,1,0,0,1,0,1,2,0,0,1,1,0,2,3,4,0,0,0,0,2,1,0,0,0,0,13,0,0,1,0,1,3,0,0,0,4,0,0,5,0,0,1,1,2,0,0,2,7,1,5,2,1,1,0,0,1,5,0,0,1,0,1,1,2,1,1,2,0,2,0,0,4,1,2,0,0,3,6,12,0,0,2,3,0,2,0,2,0,0,1,4,1,0,0,1,0,0,0,0,5,0,1,0,2,0,0,0,1,6,0,3,2,0,2,1,1,1,0,0,1,1,1,0,0,0,4,0,0,0,0,10,1,7,3,0,2,0,0,6,0,0,3,0,0,1,0,1,0,0,0,3,3,0,1,0,5,3,0,2,0,4,0,1,0,1,1,0,0,0,2,0,1,0,0,1,1,0,0,4,0,5,0,2,2,0,0,0,0,0,1,2,0,3,3,0,0,0,0,3,0,0,12,2,3,0,0,0,0,0,0,2,0,4,0,3,0,0,0,1,0,0,0,1,3,0,1,0,2,0,0,1,4,1,1,0,3,0,0,0,1,0,0,0,0,1,1,2,2,0,6,0,0,1,0,0,0,0,0,0,0,35,4,0,0,1,0,0,3,1,0,0,0,4,1,0,0,1,0,5,1,3,0,1,0,1,3,2,1,2,0,6,0,2,3,1,1,2,2,2,0,0,0,0,1,0,0,0,2,10,2,1,1,2,1,0,0,2,0,2,2,0,0,7,0,0,0,0,1,3,2,0,1,2,1,1,2,1,0,1,0,0,1,0,1,4,0,0,1,2,0,0,0,0,1,0,0,1,1,1,0,1,2,3,0,2,0,1,0,4,0,0,3,0,2,0,0,0,1,1,1,0,0,0,2,1,0,0,0,0,0,3,1,0,0,3,6,3,0,0,11,0,0,0,3,1,1,1,0,1,4,0,0,9,1,2,0,0,2,0,1,0,0,2,0,1,3,0,2,4,0,0,0,0,0,0,2,3,0,8,1,1,2,0,0,6,1,0,0,0,0,2,0,0,0,0,3,0,0,1,3,0,1,0,2,1,0,0,1,0,0,0,2,1,0,0,0,1,4,8,0,0,1,0,0,0,2,2,0,7,1,1,0,2,0,0,0,0,5,3,1,0,0,0,1,0,0,1,0,0,0,1,1,0,0,2,0,1,1,0,3,4,0,0,0,0,1,2,1,0,0,0,0,1,1,1,0,4,0,1,2,1,2,0,3,0,1,1,1,0,1,0,1,2,1,0,4,0,0,0,0,0,1,2,1,0,3,0,0,1,0,0,0,1,1,0,3,5,2,1,1,0,0,0,1,0,0,2,0,1,1,1,4,1,1,0,1,0,20,0,4,0,1,0,1,2,1,0,0,0,0,0,2,0,1,0,0,2,4,0,1,2,1,3,0,0,1,1,0,0,0,3,0,0,0,2,0,0,0,0,0,0,3,0,2,0,0,1,0,0,0,0,2,0,0,0,0,1,1,0,2,1,0,0,0,2,2,0,0,0,0,2,0,0,0,0,1,3,1,0,3,1,0,4,1,1,0,0,0,1,0,1,0,0,0,2,0,0,0,4,0,0,1,0,0,0,0,0,0,1,0,0,1,0,0,0,0,0,0,1,0,0,1,1,0,1,0,1,0,2,1,0,2,1,1,0,0,0,0,0,0,0,0,0,0,0,42,2,0,3,1,1,0,2,0,0,0,1,7,1,6,0,0,0,1,1,0,0,0,0,1,0,2,1,1,0,0,2,0,0,1,1,2,0,0,0,0,1,1,2,0,1,0,0,0,2,2,1,2,4,0,0,0,1,0,3,0,0,1,0,2,0,0,0,3,0,0,0,0,8,0,0,0,1,0,1,0,2,2,0,1,0,0,0,0,1,2,0,1,0,0,1,0,0,0,0,0,0,1,0,0,3,0,2,0,0,0,0,1,1,0,1,1,4,0,4,0,2,0,0,4,0,1,0,2,0,0,0,2,2,6,1,0,0,0,0,2,0,0,0,0,0,0,0,0,0,0,1,0,0,0,0,0,0,0,0,3,1,0,0,0,0,0,1,0,3,0,1,0,0,0,0,0,0,0,1,0,0,0,3,0,0,12,0,0,2,0,0,0,0,0,0,0,0,0,0,0,0,0,0,0,0,0,0,0,0,0,0,0,0,0,0,0,0,0,0,0,2,0
"2009 Evanovich, Janet, Plum Spooky",pop,3573,2443,1840,1824,1016,2472,800,1055,1055,658,896,482,412,205,266,567,261,478,403,884,373,325,121,377,727,212,579,134,428,326,194,230,268,281,307,297,208,217,442,182,181,255,192,299,186,161,98,128,111,88,262,127,153,268,129,113,91,196,237,158,143,236,68,71,161,105,30,140,175,101,252,310,83,128,261,108,107,153,111,120,166,229,53,80,81,186,90,124,44,56,42,138,72,94,89,54,140,58,101,34,63,54,162,62,64,12,63,39,146,67,46,30,89,68,33,172,75,25,37,50,168,31,87,76,57,84,36,77,24,36,48,66,95,134,50,45,34,30,70,70,183,42,25,114,38,52,56,56,89,59,22,15,63,38,35,147,69,46,32,20,30,25,76,64,78,14,16,23,25,71,82,17,34,79,120,33,28,30,38,71,37,36,30,43,28,71,65,33,43,15,83,15,35,22,25,27,21,35,29,2,82,12,43,14,23,8,47,64,41,78,33,20,30,66,12,5,30,10,28,26,24,16,14,31,51,26,51,23,101,44,20,48,26,9,27,6,47,49,31,13,35,50,42,41,47,32,27,21,39,26,39,19,19,62,37,27,22,32,16,6,37,117,24,38,13,14,28,15,30,29,34,24,11,25,73,21,12,33,17,21,40,26,38,24,25,43,23,36,15,27,49,4,70,7,16,21,15,41,27,37,50,15,62,32,1,61,22,12,19,2,12,31,11,17,8,20,60,29,20,45,11,38,11,18,7,40,10,37,5,54,14,17,20,38,147,39,16,0,14,20,18,8,26,44,19,22,37,75,18,43,12,10,21,21,18,16,11,13,10,7,35,5,26,19,12,14,11,9,42,16,21,31,33,57,21,12,12,15,18,31,13,13,9,12,10,18,0,7,20,8,6,9,12,96,18,16,13,13,12,14,5,19,29,32,9,10,16,29,26,13,52,18,15,12,7,1,8,21,22,5,31,1,23,11,18,14,12,8,14,52,16,21,28,23,0,43,23,3,0,17,22,27,29,5,8,10,3,6,17,8,32,0,14,26,35,13,21,4,9,22,13,16,0,18,13,21,5,3,1,16,11,2,10,3,43,10,20,40,0,35,5,10,17,29,1,13,18,2,30,22,7,10,17,18,12,9,22,18,8,1,12,5,9,24,5,10,6,6,15,37,21,9,1,3,6,12,0,10,1,15,7,0,10,27,6,10,26,13,8,23,0,10,21,6,3,0,9,1,1,4,4,3,12,12,27,3,0,5,10,19,7,6,12,0,25,5,2,12,2,45,65,4,5,4,7,12,8,28,6,5,0,12,11,20,3,26,14,18,5,13,8,16,14,23,0,14,6,26,15,4,0,6,7,6,17,11,2,15,6,15,5,9,2,10,39,0,7,15,6,28,2,4,8,10,4,8,9,1,8,9,32,30,1,7,5,20,25,31,7,9,44,6,20,3,0,0,5,19,3,14,18,4,11,21,26,50,2,6,0,6,0,13,8,8,27,14,11,1,12,2,15,7,13,8,2,22,12,12,11,7,5,4,8,2,1,20,13,5,6,5,23,10,9,12,19,10,1,1,5,0,7,14,3,12,15,7,0,0,2,13,13,0,5,8,2,5,2,12,19,1,0,5,3,7,6,8,7,12,5,10,15,52,19,0,4,16,3,10,2,11,6,4,26,1,0,18,0,4,10,9,7,4,0,11,1,2,23,7,18,3,7,16,11,6,4,0,17,12,4,0,7,8,12,0,17,10,10,4,1,6,6,7,38,16,0,5,4,4,6,2,6,3,3,8,4,9,18,2,16,9,3,1,0,26,8,1,0,2,0,10,7,4,8,6,18,4,5,0,9,22,11,0,2,1,6,9,1,622,5,0,6,2,16,2,8,24,6,7,9,3,8,26,43,15,0,6,12,0,0,30,10,6,17,3,2,5,22,349,12,26,4,5,2,3,5,2,18,9,1,3,6,0,12,6,1,2,1,0,21,11,11,4,4,6,0,11,9,7,7,1,3,4,14,33,6,10,9,9,5,6,6,5,2,11,5,3,0,0,9,1,4,7,3,8,14,46,7,10,0,8,3,0,6,0,16,1,0,3,0,15,6,1,2,4,13,3,3,0,4,5,4,12,8,0,3,10,2,10,5,0,2,4,18,7,7,0,1,1,7,4,2,10,6,17,0,4,4,4,3,2,0,5,1,1,8,6,4,3,2,15,6,7,1,3,0,5,1,5,22,25,0,9,13,0,61,3,2,0,3,12,5,0,4,6,3,13,1,7,3,0,9,0,7,1,1,5,0,0,0,4,6,4,0,1,26,4,6,0,20,9,11,5,29,0,0,17,3,25,17,8,10,28,0,4,4,4,2,4,4,1,6,4,24,9,5,1,28,43,6,11,0,4,4,3,2,0,6,4,1,0,4,5,0,5,13,1,8,3,0,0,0,5,12,10,11,3,5,0,4,11,5,3,10,1,1,19,5,0,2,2,2,0,3,9,6,4,8,4,8,6,19,23,12,16,4,3,11,4,8,3,2,0,11,1,0,11,1,0,6,6,2,7,1,5,1,6,8,3,4,0,20,6,5,0,2,1,2,19,0,6,3,3,2,1,2,0,1,1,1,3,24,0,1,3,1,6,0,2,2,0,2,2,2,18,0,20,1,3,0,12,0,0,6,0,3,7,0,0,3,1,1,5,10,3,4,31,0,4,1,0,3,0,0,1,4,8,7,5,1,10,1,0,5,6,7,2,0,1,4,8,0,3,0,10,2,0,0,10,13,2,6,19,20,3,3,8,7,2,2,2,1,1,1,4,6,0,9,0,4,10,3,1,5,0,1,1,0,17,2,2,3,3,5,4,2,22,4,5,7,10,3,0,13,4,0,9,1,0,5,5,2,1,16,2,0,1,4,0,0,1,11,8,9,13,3,4,16,17,10,3,0,0,5,4,6,5,9,2,0,0,7,5,10,4,1,1,18,3,1,0,1,0,2,1,3,10,7,0,5,1,4,1,3,0,3,2,5,6,5,7,9,6,2,2,3,2,5,0,13,10,6,3,2,0,3,1,4,3,8,1,9,7,3,1,1,0,3,3,4,0,2,0,3,0,2,1,1,6,8,2,9,0,0,1,3,0,0,6,0,3,0,0,9,1,2,4,0,5,2,6,0,5,3,0,8,4,3,0,14,0,0,101,0,1,274,5,3,0,2,16,8,5,1,12,0,1,0,8,2,4,3,14,1,11,12,4,15,0,1,2,4,3,0,0,6,2,0,8,11,4,6,1,1,11,0,1,0,11,2,3,8,23,0,0,3,0,3,1,3,2,6,1,4,0,1,1,5,0,6,7,4,4,3,1,0,2,1,2,3,1,8,15,4,2,15,3,3,0,9,2,9,2,11,3,5,2,0,0,1,9,6,0,0,0,0,3,0,10,4,2,2,1,1,2,1,10,1,0,0,2,4,2,0,5,1,0,3,9,8,1,0,4,0,16,4,0,6,1,2,4,4,4,3,3,8,9,4,0,0,1,4,4,0,3,4,7,4,10,3,1,7,1,3,8,8,3,3,21,1,11,0,0,3,0,1,5,2,3,0,4,0,0,2,2,0,2,16,4,1,0,0,3,5,0,0,0,3,0,3,9,0,0,0,0,5,1,0,0,2,0,2,7,0,0,5,5,1,2,1,4,22,4,6,0,1,0,1,1,0,0,0,2,0,12,0,4,0,0,0,2,20,1,8,3,0,0,0,10,8,0,21,2,1,2,0,3,2,10,2,0,9,4,1,1,4,0,14,0,3,3,2,0,3,0,4,1,0,2,0,1,31,2,11,0,8,0,1,3,7,4,2,0,6,1,64,2,3,0,6,2,1,1,4,5,3,4,1,3,0,3,81,1,4,9,7,3,3,8,0,2,1,2,1,12,5,1,1,13,4,0,0,2,0,0,1,1,8,4,1,17,0,6,2,2,0,1,1,2,19,0,4,5,0,3,0,4,0,8,0,0,0,0,3,1,0,1,5,4,3,0,0,1,0,6,2,10,10,0,3,3,2,2,7,1,5,2,5,0,5,1,27,0,37,2,6,0,3,7,10,4,16,0,7,6,0,0,0,2,6,0,3,1,1,5,5,13,4,0,6,3,0,5,0,0,5,5,0,1,0,0,0,1,0,8,0,5,2,5,0,6,0,0,0,31,0,2,7,2,2,9,0,0,6,1,1,0,2,3,6,2,1,3,5,0,0,0,1,1,1,0,0,1,0,8,0,1,2,3,3,15,0,0,0,13,1,13,3,0,0,1,8,5,0,0,6,0,16,1,1,1,0,0,8,2,0,2,0,0,0,0,0,8,0,0,1,0,0,4,3,1,5,0,0,7,0,1,2,1,4,5,7,11,77,3,11,0,0,1,0,0,0,3,0,2,0,3,2,3,1,20,1,2,6,0,0,0,0,1,1,6,2,1,1,1,2,1,2,3,2,2,3,1,2,0,5,2,0,0,0,0,1,0,6,0,1,7,28,1,0,0,0,2,2,0,1,1,8,0,1,3,3,0,1,10,4,3,2,1,0,1,9,5,0,0,0,0,1,1,2,0,2,4,0,0,9,0,4,1,2,0,3,0,4,1,1,0,2,0,0,2,4,1,11,0,0,4,3,8,6,3,5,1,2,0,3,5,5,13,6,0,0,1,2,2,0,3,0,0,1,5,0,0,2,5,0,4,9,5,0,0,1,15,2,0,1,1,0,0,9,3,6,0,6,0,3,4,0,147,4,4,12,6,2,2,1,3,0,0,0,2,9,0,0,0,1,0,0,5,0,0,0,0,2,2,0,0,4,1,0,1,4,1,8,6,0,4,3,2,7,2,6,3,1,0,3,0,2,0,0,2,0,1,0,0,0,0,0,1,1,2,0,0,0,19,5,5,3,1,1,1,0,4,4,0,0,0,0,2,0,4,3,0,0,4,0,0,5,0,1,0,1,1,1,0,3,4,3,2,3,2,0,1,0,1,0,8,0,7,0,0,2,2,0,2,4,0,4,0,1,2,2,0,1,0,0,10,1,4,5,1,1,0,0,2,3,0,0,0,0,0,4,0,0,3,10,2,9,12,0,5,0,0,0,4,0,0,3,0,1,3,2,1,2,2,6,1,4,0,8,0,0,0,0,0,1,0,7,0,6,0,0,3,6,0,0,1,0,2,3,2,1,1,2,1,10,3,1,3,3,0,1,0,1,3,1,1,1,3,0,0,0,0,12,0,6,0,1,1,1,0,2,0,0,1,0,0,1,0,1,0,2,1,15,0,2,1,8,5,0,1,1,5,0,4,0,0,2,6,0,0,1,0,0,0,5,3,1,6,0,1,0,3,4,6,6,8,3,0,12,1,2,0,12,0,0,0,2,5,8,6,0,1,4,0,1,0,0,2,0,4,0,4,2,5,2,2,0,0,1,2,2,0,2,0,0,0,3,5,0,5,0,1,1,2,4,1,0,0,0,5,0,0,0,0,14,0,0,6,1,0,3,0,0,2,0,0,2,1,3,0,0,4,1,1,0,0,0,0,1,2,0,0,1,4,0,2,2,0,1,2,1,1,1,0,0,1,1,1,1,0,0,10,5,1,0,3,0,1,2,1,3,1,7,3,0,0,2,0,1,1,5,0,1,3,0,0,1,2,0,0,0,1,0,0,3,3,17,0,1,0,0,1,0,1,0,3,2,1,0,6,0,17,3,0,1,3,4,1,0,0,0,2,3,15,3,0,5,8,2,4,2,0,1,4,2,6,1,0,0,3,1,0,0,0,0,2,3,1,0,2,5,2,1,3,0,3,0,0,1,3,8,0,0,0,0,0,0,1,168,1,0,0,1,2,4,1,2,2,0,0,0,3,3,0,2,1,2,0,1,1,0,6,0,0,0,0,3,0,0,3,1,0,0,0,1,1,1,41,1,0,1,1,0,1,0,0,1,1,3,1,20,1,0,0,2,0,0,1,5,0,1,1,1,2,0,0,0,4,0,0,0,1,1,4,5,4,3,2,1,5,2,0,1,9,3,3,4,2,1,7,2,0,1,0,0,0,0,5,2,3,2,1,0,3,0,0,0,1,2,5,1,0,2,2,1,0,2,3,0,1,5,2,1,0,0,0,0,1,1,0,2,2,4,1,0,0,0,4,1,2,3,0,5,4,0,0,6,1,1,1,17,0,0,1,2,1,7,1,2,0,0,0,0,3,3,0,7,2,0,2,0,0,0,2,0,0,3,0,3,0,0,2,1,6,0,0,3,5,1,1,3,1,0,0,2,0,2,2,3,1,2,0,1,1,0,0,0,1,0,0,0,0,0,1,3,2,2,9,0,3,0,0,0,0,0,0,0,0,0,1,0,0,2,2,1,1,0,0,1,3,0,1,4,1,1,0,5,1,2,1,1,0,0,0,1,4,2,0,4,0,0,2,7,0,0,1,0,0,0,5,0,0,0,1,1,0,1,1,0,2,0,0,3,0,0,0,0,1,0,0,4,0,0,0,0,2,0,153,3,1,0,0,2,1,0,0,0,1,16,0,0,0,0,0,1,2,0,4,10,6,3,0,1,0,98,11,0,0,0,0,0,0,4,0,35,8,2,0,0,3,0,0,3,1,0,0,3,0,0,4,0,6,1,2,0,1,0,1,4,0,0,5,1,0,2,0,1,2,1,0,0,3,0,5,0,0,0,0,1,0,0,0,1,0,1,10,54,8,0,2,0,1,2,0,1,0,2,0,0,0,0,0,0,0,1,9,0,3,0,2,0,0,0,1,7,0,1,2,0,0,1,0,0,2,1,2,1,0,3,7,1,4,3,0,0,0,0,5,2,0,2,2,1,1,1,0,0,0,0,0,0,0,0,0,1,0,0,0,2,1,1,1,4,1,0,7,0,0,4,1,2,1,8,1,0,1,0,0,1,0,0,3,0,0,1,0,2,2,4,1,2,0,0,0,19,0,2,1,1,2,2,4,0,1,0,4,3,0,1,0,0,0,0,1,10,3,0,0,0,0,0,0,0,0,0,0,0,4,1,1,2,4,0,4,0,1,0,0,3,5,3,0,0,7,7,0,0,2,0,1,0,3,0,2,0,0,2,3,0,2,1,0,0,0,0,0,7,0,0,2,1,2,6,0,0,0,0,3,2,1,0,4,0,6,2,2,3,3,1,0,0,0,0,0,2,0,2,0,3,2,0,0,4,0,9,5,2,0,0,2,0,4,2,0,0,6,0,0,4,1,1,0,0,0,2,3,0,1,0,0,0,3,4,0,0,0,8,0,2,0,0,4,2,2,1,0,0,4,2,2,2,0,1,4,2,0,4,0,1,0,1,2,0,1,2,0,0,3,1,0,0,1,0,0,0,2,0,1,0,0,3,0,0,1,1,0,1,0,0,1,0,0,3,0,1,9,0,0,0,0,1,0,0,2,1,1,0,14,6,0,1,0,0,6,0,0,9,0,4,1,3,2,0,2,0,1,0,0,0,1,0,2,0,1,0,1,1,5,2,0,0,0,2,1,0,3,0,0,2,0,1,3,2,0,0,1,3,2,1,2,0,0,2,7,0,3,38,0,3,6,0,6,0,1,0,1,1,0,1,0,0,0,0,0,0,1,3,0,1,0,0,0,1,0,8,3,0,5,0,0,1,0,0,23,3,1,0,3,3,4,3,0,2,0,3,1,1,0,2,0,1,2,2,0,3,15,3,0,0,0,0,0,1,0,0,0,4,0,1,5,0,0,3,0,1,0,0,1,0,0,2,2,8,0,2,1,0,0,1,0,0,0,1,0,0,0,4,0,4,0,0,0,1,2,0,0,0,0,1,0,4,1,1,60,1,0,7,0,0,1,0,0,0,0,8,1,0,0,0,2,4,3,2,0,1,0,0,0,0,0,0,0,2,0,1,5,11,3,0,0,0,0,0,0,0,0,0,0,0,0,1,0,4,1,0,1,2,3,0,0,1,0,0,2,0,11,0,1,0,2,1,2,1,0,0,0,1,0,0,0,0,0,4,4,0,0,1,0,0,0,1,0,0,1,2,0,3,1,0,0,2,2,0,0,0,1,4,0,0,1,0,1,0,1,3,0,1,0,3,0,2,5,1,0,0,5,1,0,0,0,3,0,0,0,0,2,2,5,0,2,0,0,0,0,1,0,0,1,0,1,1,0,0,0,0,0,0,0,13,0,3,0,1,0,0,1,0,3,0,0,0,3,1,0,1,7,2,0,3,3,0,5,0,0,0,2,5,1,2,1,1,4,1,0,5,0,4,1,0,0,0,0,0,0,0,0,2,0,0,2,2,0,0,1,0,0,0,0,4,0,7,1,1,1,0,0,0,0,0,3,1,0,0,41,0,1,3,2,0,2,2,0,1,0,1,0,1,0,4,0,1,0,0,1,1,1,2,4,0,0,7,1,0,0,1,0,2,0,0,1,1,0,0,0,1,1,3,0,0,10,0,2,0,6,0,10,0,0,2,0,0,1,1,0,0,0,0,0,9,0,3,1,4,0,16,1,6,0,1,2,0,9,0,0,0,1,0,0,0,0,0,0,0,1,3,0,0,0,0,0,1,0,1,0,3,0,0,0,0,0,1,2,3,0,0,1,0,1,0,0,2,0,2,1,4,1,1,0,2,3,0,0,0,0,1,0,0,1,1,0,1,0,0,3,0,0,0,0,0,2,0,0,6,1,1,0,1,0,0,7,1,1,0,1,0,0,1,0,1,1,2,0,0,0,8,3,0,0,0,1,2,0,0,1,2,1,3,1,0,11,0,1,1,0,0,0,1,0,1,1,2,0,2,0,3,0,0,1,3,7,0,0,0,0,0,1,0,0,0,0,0,1,1,1,0,1,2,0,0,0,0,1,2,0,3,0,0,0,0,0,1,2,0,0,3,2,0,0,0,0,4,0,1,0,0,0,0,4,0,2,0,0,0,1,0,0,4,0,1,0,0,0,0,1,0,0,0,4,1,1,0,5,1,0,1,2,1,1,0,0,1,1,1,0,2,0,0,0,0,1,2,0,0,0,0,0,1,2,3,0,0,0,0,4,3,1,0,0,0,0,0,0,1,0,1,0,1,0,4,0,0,1,0,1,0,1,1,0,0,0,12,0,0,2,0,1,0,0,4,0,0,1,1,0,2,2,4,0,0,0,1,0,0,0,0,0,0,14,0,0,0,0,0,0,0,0,0,3,0,1,1,0,0,0,0,1,1,0,1,0,1,0,1,0,0,1,0,0,0,0,0,0,0,2,0,5,0,1,1,1,1,0,0,3,2,0,0,1,1,1,0,1,0,0,0,0,2,1,7,0,1,0,0,0,0,0,0,0,0,0,1,0,0,2,0,0,2,3,0,1,4,0,0,1,2,0,0,3,0,2,0,0,0,2,0,1,0,0,1,0,0,0,0,5,0,0,0,0,0,0,3,0,0,3,1,0,1,0,0,0,0,0,1,1,5,1,0,2,0,0,0,0,1,2,2,0,1,2,0,3,2,0,2,2,0,0,8,0,0,0,0,5,0,0,1,1,0,2,3,0,0,3,0,0,1,0,1,0,0,1,0,1,0,5,0,2,0,2,0,0,1,1,1,1,0,1,0,0,1,0,0,2,0,0,0,0,0,0,1,2,0,0,3,1,0,1,0,0,1,0,9,2,0,1,0,1,0,0,0,2,0,1,0,0,4,0,1,1,0,3,2,0,0,0,0,0,0,0,0,0,0,1,1,0,0,0,0,0,5,3,3,3,1,0,0,5,0,0,2,12,1,2,0,0,0,5,0,0,0,0,0,0,0,8,0,0,1,2,0,2,0,2,1,0,0,0,1,2,0,0,0,17,1,0,11,0,2,0,0,0,3,3,2,6,0,3,0,3,2,0,0,0,0,1,1,0,3,1,0,0,1,0,0,0,1,0,1,0,0,0,0,0,5,1,0,0,1,2,0,0,0,0,0,4,1,2,0,3,0,4,0,0,0,0,0,0,0,0,0,0,0,0,0,0,6,0,3,0,2,1,0,0,0,0,0,0,2,0,0,2,0,1,1,6,2,0,0,0,0,2,0,1,0,5,2,0,2,3,4,3,2,0,0,0,0,0,0,1,0,0,0,1,1,0,0,51,2,0,0,0,0,0,0,0,0,0,0,0,1,1,0,1,0,0,0,1,3,1,0,1,0,0,0,3,0,1,1,0,0,0,0,0,1,0,0,0,0,1,0,0,0,0,5,3,0,0,3,0,0,1,1,1,2,0,3,0,0,0,0,0,1,0,1,0,2,0,0,0,0,0,0,1,0,2,4,0,0,0,1,0,0,0,2,0,0,0,0,1,0,0,0,0,0,0,1,4,0,0,0,0,0,0,0,0,1,0,1,2,0,1,0,0,5,0,0,0,0,0,0,0,0,0,2,1,1,1,0,0,2,0,0,0,0,0,0,0,0,0,1,0,0,0,0,0,1,1,2,0,0,0,0,0,5,3,1,0,0,0,0,0,0,1,0,1,0,0,0,1,0,3,1,1,0,0,0,1,1,1,1,1,0,0,1,1,0,2,1,0,2,0,0,0,2,1,0,1,0,0,0,0,0,5,1,0,0,0,1,0,1,1,0,1,0,1,0,0,0,1,1,0,0,0,0,0,0,0,0,0,3,0,0,1,0,2,0,0,2,0,0,0,3,1,1,0,0,4,0,0,0,0,2,0,0,1,1,0,0,0,0,0,1,0,0,0,1,0,0,0,0,0,0,0,0,0,0,0,2,0,0,0,0,2,0,0,2,1,0,0,0,0,0,0,0,0,0,0,0,0,0,0,0,2,0,1,2,0,0,0,3,0,1,0,0,0,0,0,0,0,1,0,0,2,0,1,0,0,0,0,0,0,0,0,0,0,0,0,0,0,0,0,1,0,0,0,2,0,0,1,0,0,0,0,0,0,0,1,0,1,0,1,0,0,0,0,3,1,0,0,0,1,0,0,0,0,0,2,0,1,0,0,0,0,1,0,0,0,0,1,0,1,0,0,2,0,0,0,0,0,2,8,0,0,0,0,0,0,2,0,0,1,1,2,1,1,1,0,0,0,0,7,0,0,1,0,0,2,0,0,0,0,0,0,1,1,0,0,0,0,1,0,0,0,1,0,0,1,0,0,0,0,0,0,9,0,0,0,0,0,0,0,0,0,0,0,0,0,0,0,0,0,0,0,0,0,0,0,0,0,0,0,0,0,0,0,0,0,0,0,0,0,0,0,0,0,0,0,0,0,0,0,0,0,0,0,0,0,0,0,0,0,0,0,0,0,0,0,0,0,0,0
"2011 HarrisC, Charlaine, Dead Reckoning",pop,4084,2662,2961,2295,1567,4068,1309,1335,2064,1108,1093,708,1138,492,588,653,917,656,573,957,595,687,609,394,1150,402,866,315,429,215,304,348,323,476,318,480,461,319,319,303,431,283,271,194,405,332,256,400,344,155,251,201,359,228,233,169,392,270,236,177,183,184,152,142,216,198,129,192,139,141,162,211,148,158,158,236,134,336,196,128,127,89,54,162,149,208,84,119,117,179,88,124,111,103,223,206,134,133,168,138,105,165,115,140,142,94,124,88,135,116,139,49,100,99,63,135,97,93,117,90,144,57,94,116,117,113,103,136,138,115,53,83,65,80,98,149,94,108,87,113,141,87,146,78,142,101,91,94,87,112,75,125,80,65,43,74,62,94,43,34,59,133,165,86,58,39,72,116,79,71,403,39,51,62,80,17,72,57,46,182,55,102,73,62,77,43,76,64,39,43,61,72,100,58,29,39,10,69,52,188,56,91,61,31,63,43,33,24,141,74,8,24,17,52,28,52,49,22,54,29,52,44,78,21,38,37,58,25,95,77,64,27,25,80,52,92,98,59,54,45,60,51,27,28,27,59,23,41,82,43,60,20,24,15,37,49,35,54,25,32,30,79,55,32,45,51,39,35,13,30,79,62,78,25,64,126,20,36,48,67,47,54,47,23,58,2,71,38,34,28,39,10,33,35,29,33,54,51,45,84,56,31,65,42,51,33,29,13,26,18,27,120,27,31,57,36,29,28,31,35,83,16,27,12,17,27,24,36,36,41,30,15,52,15,15,43,25,12,43,31,17,28,35,19,22,28,32,42,27,19,62,12,44,18,38,32,22,126,30,8,12,37,18,27,27,44,26,30,28,35,14,12,9,71,8,38,23,25,17,26,13,34,10,20,11,8,0,18,27,21,8,26,13,35,27,21,18,22,41,25,19,92,20,58,30,47,31,70,24,20,18,21,13,10,21,17,19,19,18,42,27,0,33,26,26,22,31,26,29,22,35,28,27,58,5,32,24,26,2,32,23,22,19,26,41,10,18,22,23,23,12,4,21,59,13,24,31,11,23,22,10,18,0,2,27,38,14,6,13,37,14,14,20,3,14,35,14,11,0,9,29,48,25,13,21,14,21,9,36,16,20,15,13,26,34,12,15,19,5,37,22,11,15,13,23,22,54,26,23,16,15,8,21,14,40,26,0,15,13,16,14,21,23,24,22,37,18,8,20,35,1,18,20,25,4,0,8,23,18,14,10,34,36,13,22,4,0,0,10,5,16,21,10,1,19,17,18,27,10,3,18,19,24,5,17,18,14,11,22,4,10,12,34,19,16,13,15,16,9,42,18,30,23,13,19,11,19,10,14,5,20,1,17,7,11,19,7,30,8,10,22,5,20,77,11,0,0,15,9,8,16,25,11,11,8,15,8,8,19,12,32,22,41,33,13,16,21,11,7,89,16,40,9,1,55,0,10,10,9,5,17,20,9,29,16,29,21,8,3,26,0,21,12,14,7,22,14,1,7,3,16,17,7,20,8,9,18,12,19,31,9,15,5,4,13,11,16,6,33,16,10,30,11,24,17,28,1,16,13,9,21,0,1,8,23,5,10,0,24,1,4,0,15,9,19,14,1,3,9,10,15,8,0,16,6,6,13,5,8,7,20,9,0,3,12,8,7,9,9,8,22,5,21,2,0,26,25,16,2,13,8,17,0,29,0,0,5,7,11,0,11,11,12,3,16,1,20,12,7,1,17,8,6,2,9,12,5,5,1,18,11,4,7,16,0,17,8,9,6,21,1,19,8,8,8,12,3,6,5,10,15,4,0,8,6,11,1,12,0,7,9,23,5,31,7,9,0,16,11,8,8,39,13,1,9,4,1,0,19,6,8,3,17,10,6,4,21,4,4,5,16,1,36,21,1,7,8,20,0,20,2,12,9,8,10,5,25,0,7,25,26,4,0,8,11,9,41,0,1,5,3,14,18,19,3,1,1,0,7,17,18,2,2,11,0,11,0,8,21,15,17,3,10,8,10,11,2,17,8,14,4,7,21,5,10,14,2,0,4,3,10,2,25,11,5,4,13,6,22,7,2,0,12,0,11,2,4,4,11,11,9,3,7,6,8,7,3,3,36,0,6,19,13,17,5,4,9,11,8,36,12,4,4,9,4,2,1,24,18,10,4,5,5,6,2,14,34,11,12,1,0,7,54,220,10,6,12,2,8,10,36,0,21,5,9,13,4,8,7,2,0,21,6,5,6,10,10,0,14,9,10,5,13,9,13,7,1,3,9,0,5,0,9,2,3,23,0,0,3,15,3,17,3,0,14,6,11,0,7,13,6,12,27,2,2,1,1,13,3,13,7,9,3,8,27,3,8,3,21,11,14,6,13,7,6,1,15,2,2,35,13,11,0,1,16,0,7,3,8,9,8,4,0,2,9,7,7,6,443,0,0,0,4,4,6,6,11,0,5,19,1,2,6,12,5,1,4,18,14,3,10,0,11,7,0,5,14,12,12,19,3,5,5,17,9,6,10,12,11,5,4,4,8,22,2,33,13,5,9,8,6,5,125,4,6,20,8,0,0,0,10,12,2,0,2,6,0,3,2,3,6,27,5,6,7,3,5,8,6,10,2,0,7,4,2,5,2,8,5,9,3,1,6,5,0,3,23,30,0,53,24,14,29,5,10,6,0,0,12,0,0,1,6,3,7,2,0,2,4,0,18,12,0,10,3,8,9,2,0,13,0,0,13,7,9,2,0,6,3,1,0,17,4,7,2,0,0,12,8,5,3,11,5,1,6,6,1,7,13,4,12,4,0,28,4,0,6,4,3,8,4,6,6,0,4,0,0,14,22,19,2,14,7,9,9,1,0,2,0,20,6,0,1,13,0,3,15,3,2,3,1,0,1,4,0,7,14,10,0,19,2,5,2,3,7,18,6,13,7,20,0,15,12,0,12,4,23,2,2,3,11,22,2,3,13,2,65,5,4,5,4,0,6,2,0,8,0,0,14,1,8,1,0,151,8,6,7,7,6,3,1,2,9,9,9,2,5,0,12,2,4,1,3,0,5,2,4,0,11,0,10,1,15,1,9,1,3,6,8,12,6,4,3,10,5,0,16,2,15,5,2,6,5,0,2,0,0,12,0,0,1,0,3,3,6,2,6,2,5,1,13,3,3,0,4,0,4,1,18,2,0,0,0,8,0,1,0,0,1,8,12,6,1,3,0,6,2,4,2,6,1,9,1,8,7,1,3,1,6,13,15,10,0,0,23,3,3,3,6,7,6,2,1,5,0,5,4,4,4,9,6,13,0,2,1,0,5,1,1,2,8,7,6,0,6,11,5,0,13,2,8,3,5,4,0,6,4,1,7,0,1,14,1,7,1,2,12,2,12,5,10,7,7,6,6,0,0,0,1,2,6,0,0,0,0,2,0,1,1,0,3,1,0,2,4,3,3,0,0,4,3,3,11,7,9,2,0,10,1,2,3,7,3,27,6,0,3,6,2,6,9,7,5,2,10,9,8,12,2,5,1,7,2,9,11,16,3,1,1,8,8,1,10,5,10,7,3,6,11,3,2,5,4,0,1,24,7,2,4,6,3,1,1,2,5,6,6,2,13,9,0,5,1,0,4,3,3,0,3,3,0,1,0,6,14,2,7,9,3,3,6,1,2,0,4,4,0,7,0,1,6,1,5,2,3,5,15,3,11,0,8,0,3,0,1,0,6,28,2,3,14,9,3,9,0,0,0,7,4,5,1,5,3,3,3,3,0,4,3,9,4,3,9,1,4,10,3,0,0,0,5,12,6,5,14,7,0,8,0,0,13,4,4,3,0,0,0,13,3,15,1,0,0,1,0,2,25,0,5,6,2,2,2,6,0,3,3,10,2,0,6,3,18,8,2,1,4,6,0,5,4,8,7,1,3,0,1,0,3,3,3,2,0,0,1,13,7,4,6,3,2,2,5,3,0,1,8,11,2,0,3,4,7,0,0,9,23,3,6,10,1,0,6,0,13,3,14,3,7,0,1,0,0,3,10,0,4,5,1,2,0,4,7,6,6,3,3,2,3,8,3,2,1,5,2,3,4,3,1,4,0,0,1,4,4,1,6,5,15,0,10,10,3,5,1,5,5,0,3,2,3,10,0,0,4,6,0,4,0,0,0,5,5,7,0,0,7,3,0,6,1,4,0,4,1,14,3,2,2,24,1,5,2,1,7,2,3,10,6,4,4,6,0,0,3,0,0,5,16,7,0,5,0,0,2,7,4,0,10,0,0,4,1,15,1,5,5,1,1,4,9,2,0,2,2,0,4,0,0,6,0,0,9,4,0,7,3,0,0,3,0,3,3,0,8,5,5,2,8,10,2,0,0,5,2,7,3,0,3,7,3,2,0,5,3,0,7,4,0,1,2,6,0,3,0,3,3,0,2,3,10,4,0,4,0,4,2,4,4,3,11,9,1,1,4,0,3,8,3,1,6,6,0,0,9,5,0,0,3,3,0,3,4,5,2,14,2,8,5,4,8,0,15,1,3,3,3,0,1,10,8,0,4,4,7,9,1,3,0,0,1,5,1,9,0,1,4,2,3,17,4,0,3,3,6,0,8,1,5,0,0,6,1,6,1,1,3,1,2,7,3,2,0,0,0,1,0,4,2,3,5,2,17,2,3,1,0,8,23,1,4,7,3,3,0,5,4,7,0,2,0,0,6,9,0,1,11,2,4,0,11,4,4,3,7,7,0,0,0,6,1,2,1,0,0,2,0,2,7,4,2,2,2,0,1,4,0,1,6,3,4,7,13,0,6,1,0,3,0,0,0,0,2,3,0,0,1,2,2,3,5,5,1,3,0,2,11,2,3,4,5,8,2,0,1,5,2,5,0,0,0,21,0,195,4,0,2,18,3,9,0,2,0,3,3,1,6,0,0,0,1,0,1,0,5,139,0,2,0,1,23,10,0,2,6,1,3,5,0,0,0,3,0,1,7,0,1,1,1,4,11,2,0,1,4,0,0,0,4,3,3,3,8,1,5,0,1,2,4,1,2,6,2,2,2,4,0,5,4,6,0,14,0,2,0,8,3,0,4,0,4,1,0,0,0,2,5,1,3,11,2,3,0,2,2,2,0,1,0,0,4,3,1,4,1,3,1,4,2,0,1,0,0,3,98,13,10,9,7,2,1,4,0,10,4,0,10,5,2,4,4,0,10,3,8,0,0,6,2,3,4,0,1,5,6,1,2,2,5,5,1,4,2,3,15,4,9,3,0,5,3,1,0,1,9,0,1,2,1,2,0,1,3,2,0,0,4,7,4,0,9,1,3,5,0,1,3,2,0,0,2,5,0,0,3,7,5,1,1,1,7,12,7,2,10,2,3,0,4,4,2,0,1,1,0,96,2,4,4,3,0,4,0,0,0,0,3,1,0,1,4,2,5,5,3,0,1,0,0,0,3,13,7,0,0,3,5,9,3,0,0,0,6,3,1,1,0,1,0,0,2,3,3,6,4,0,82,3,0,0,3,3,5,6,2,0,2,2,2,0,0,2,1,0,1,0,3,2,2,3,3,0,1,1,0,8,0,0,1,3,4,4,4,5,0,10,0,0,5,0,0,2,0,2,1,0,0,2,2,3,3,2,6,0,0,10,0,0,0,2,5,2,5,6,5,8,3,3,10,2,4,2,0,0,0,4,0,0,1,0,2,9,0,0,0,5,5,3,0,2,1,1,1,1,5,2,7,6,1,12,6,11,0,6,3,5,6,4,1,1,1,0,10,8,4,5,5,7,5,6,0,0,0,3,2,3,2,3,0,10,2,3,2,1,4,0,0,0,0,1,6,0,0,0,0,0,9,2,0,5,1,1,2,8,0,3,6,10,2,8,1,1,1,5,1,0,0,1,3,0,5,1,4,5,1,2,2,1,3,0,0,0,2,0,4,9,1,0,4,1,5,5,0,3,1,1,3,1,0,0,0,2,0,3,1,2,0,5,3,0,0,0,3,0,2,0,0,3,0,0,0,3,0,5,7,2,0,1,0,2,3,5,4,4,2,1,2,1,3,3,1,0,3,0,5,2,6,0,2,23,1,5,2,1,0,0,0,2,3,2,1,0,3,10,3,0,2,11,3,3,4,1,0,2,1,4,0,7,0,2,1,2,5,0,0,2,0,1,4,1,3,10,4,3,0,0,3,0,0,1,3,26,0,2,2,0,2,5,0,0,4,0,0,2,3,0,1,1,4,3,0,0,36,2,0,0,1,5,0,1,0,1,7,6,0,8,4,0,4,0,14,4,0,5,6,0,4,5,2,2,4,1,0,3,2,2,2,0,4,0,3,1,2,0,0,0,0,0,0,2,0,2,2,2,0,0,4,0,1,4,2,1,2,1,2,3,6,0,8,2,1,0,1,4,1,0,0,0,2,3,19,1,3,0,4,3,3,4,3,0,2,2,2,6,0,9,0,3,8,1,2,0,4,3,2,3,2,5,2,1,5,1,2,31,0,0,0,1,0,2,3,0,0,3,0,4,1,0,5,2,0,3,2,1,5,1,1,6,6,0,4,7,0,0,1,3,0,1,0,1,0,3,2,0,1,9,0,0,2,0,1,5,2,4,0,0,5,2,1,5,0,15,1,2,0,1,1,0,1,1,0,3,1,6,0,4,0,6,4,4,0,1,4,1,3,0,2,1,1,0,1,7,4,0,0,0,1,3,2,34,0,0,3,0,1,1,1,1,4,1,0,0,0,1,0,1,1,0,0,3,0,0,1,0,1,4,2,4,1,1,0,0,2,1,0,3,0,2,0,1,3,0,0,10,1,7,1,0,7,0,0,4,4,1,0,1,0,6,2,1,3,9,0,3,6,1,4,5,1,3,0,3,9,0,1,1,2,0,2,0,0,0,7,1,7,1,0,2,2,2,2,1,2,1,0,3,3,3,8,3,0,0,0,1,1,7,1,1,2,6,2,192,9,1,4,9,3,5,5,8,2,1,0,3,2,3,9,0,1,0,1,0,5,3,4,2,2,1,7,2,2,1,0,0,3,3,0,8,1,5,2,0,0,4,0,2,0,1,0,1,8,2,4,0,0,0,3,2,2,0,0,6,0,1,1,0,2,0,0,11,0,1,4,1,0,6,0,0,1,2,3,3,0,1,2,0,0,8,0,4,0,2,1,4,0,0,0,0,2,1,0,5,0,1,3,2,3,4,0,6,1,0,0,0,3,0,8,0,0,0,0,0,3,0,2,69,0,5,3,4,4,0,1,4,1,1,1,0,3,10,0,7,0,0,2,0,1,0,7,0,0,4,4,5,0,4,4,6,3,1,1,0,3,1,1,0,8,3,2,0,2,0,0,0,0,4,0,0,6,1,0,4,0,0,0,0,0,0,2,2,1,0,0,0,0,0,3,0,1,2,1,1,1,0,5,4,0,0,1,1,2,0,0,2,2,2,5,2,0,3,2,73,4,0,2,0,0,1,2,3,7,1,7,0,2,0,1,0,0,1,0,2,0,1,0,6,0,1,0,0,3,7,1,0,3,3,0,3,0,4,0,0,0,0,0,1,4,0,1,1,2,0,1,2,8,0,0,0,0,2,2,0,0,6,2,3,3,1,2,0,0,0,2,5,0,2,3,0,4,0,0,8,9,3,6,3,0,0,1,1,0,0,2,1,0,3,0,1,7,2,4,2,0,0,2,1,2,3,1,1,1,3,4,0,1,0,6,1,0,0,2,0,0,0,5,6,0,0,4,2,1,0,3,0,1,0,0,4,0,0,2,10,29,0,4,1,2,16,2,1,0,2,0,37,0,0,5,4,6,5,0,0,2,0,11,0,2,0,11,0,0,0,0,0,4,2,0,0,3,3,20,0,1,2,5,7,0,0,0,3,0,1,3,0,2,1,0,0,0,0,0,0,5,3,4,2,14,2,102,1,4,0,0,2,1,4,2,0,7,0,3,1,0,2,2,1,0,3,0,3,2,3,4,0,0,1,0,2,0,0,4,2,4,1,2,1,6,15,1,3,0,0,2,0,0,0,0,0,2,1,1,0,0,5,0,2,4,5,1,2,0,0,1,0,4,2,0,0,1,0,1,1,2,7,6,0,0,0,1,1,0,3,3,0,0,0,0,0,1,0,2,1,5,0,3,0,4,2,1,0,2,3,1,3,5,1,0,0,0,4,2,0,2,0,5,1,1,1,3,0,0,4,2,2,0,0,0,2,0,0,0,2,0,1,2,3,1,1,4,1,12,0,0,0,3,1,0,0,0,1,4,0,0,1,2,1,0,1,0,0,0,9,1,3,0,0,0,0,0,1,2,1,0,0,3,12,0,3,0,2,2,1,1,2,0,7,0,0,1,1,1,0,0,0,0,4,3,1,5,1,0,0,6,2,0,1,2,2,1,1,1,0,1,0,0,0,4,1,0,2,6,2,0,1,0,0,3,0,4,1,6,0,1,10,3,0,1,0,0,0,0,1,1,1,1,1,0,2,2,0,1,0,7,0,2,0,1,3,0,0,3,4,3,0,0,2,0,0,1,1,1,0,0,0,0,5,4,0,1,1,1,1,2,1,2,0,0,5,0,0,0,0,2,2,0,2,0,6,0,0,0,1,6,0,8,0,1,6,1,9,3,1,7,0,0,9,2,0,2,1,0,0,4,11,2,3,1,0,3,1,0,0,1,1,0,2,2,3,2,2,0,0,1,0,1,1,6,0,5,3,0,1,11,2,1,1,1,0,1,0,6,2,1,1,0,1,1,0,0,2,3,1,0,1,2,0,3,1,0,2,1,3,1,1,0,7,2,0,2,5,1,0,2,0,1,0,0,0,2,0,3,0,2,3,0,1,9,1,0,0,0,0,0,1,1,2,0,0,0,0,0,3,0,1,1,1,5,0,0,0,0,7,0,0,0,2,0,1,0,0,1,9,1,5,0,5,7,0,1,2,0,0,2,0,0,0,0,1,2,0,2,4,0,1,0,0,0,2,9,2,1,1,3,0,0,1,0,0,1,0,3,2,1,1,1,0,0,0,0,0,0,0,1,0,0,0,0,0,1,0,0,0,0,0,1,0,1,0,0,0,0,0,0,0,0,0,0,0,2,0,0,4,2,1,1,0,0,0,3,1,0,1,1,0,5,2,2,2,0,4,3,0,1,0,2,1,3,1,0,0,1,2,0,0,2,1,2,0,0,0,0,0,2,1,0,0,0,1,1,3,2,1,0,0,1,2,0,5,6,0,4,0,2,1,0,0,1,0,0,0,4,0,4,3,2,0,2,2,3,0,1,0,1,0,5,1,17,5,4,1,2,1,3,0,0,0,0,2,2,0,1,5,3,0,1,0,1,0,0,24,1,1,0,0,0,0,5,0,2,6,6,0,6,3,3,3,1,0,2,0,1,3,0,1,0,0,0,0,1,2,0,7,0,1,0,0,0,0,0,0,4,0,0,0,1,0,1,0,1,0,0,0,0,2,1,2,0,1,7,0,3,0,6,0,1,0,2,6,0,0,5,1,1,2,3,0,0,0,2,5,1,2,0,0,0,0,0,4,0,0,0,2,0,1,3,11,0,0,1,1,0,0,0,1,2,1,0,0,0,1,3,2,0,0,41,2,5,0,0,4,0,0,1,2,3,2,0,6,1,1,0,0,1,1,1,0,1,4,0,2,0,0,1,0,7,2,1,4,1,2,1,1,0,0,2,0,0,5,1,4,0,3,0,0,0,0,0,0,1,0,3,0,0,1,1,2,1,0,3,1,7,4,1,0,0,5,0,0,0,0,6,4,0,1,0,1,3,2,1,1,3,1,0,0,1,2,0,0,1,2,0,4,1,1,4,0,8,0,1,0,2,1,0,0,4,1,7,0,1,0,0,0,5,0,3,0,3,3,2,0,1,0,2,1,1,1,0,2,1,2,2,1,0,1,3,2,0,5,1,0,1,0,1,0,3,1,1,1,6,0,0,1,0,0,0,4,2,1,3,0,0,0,0,0,1,0,0,0,0,0,0,0,0,0,0,0,1,0,1,21,3,0,0,1,0,4,3,4,0,0,1,0,0,1,2,3,3,7,2,2,0,0,0,1,2,0,1,1,4,1,1,7,1,2,0,3,0,3,1,4,1,1,1,0,0,0,3,0,0,2,0,0,2,2,0,1,2,1,0,2,2,1,0,0,0,0,0,2,0,2,0,0,0,0,0,1,0,0,3,6,1,0,0,0,0,0,0,0,1,0,2,1,1,0,2,0,0,0,7,6,2,4,4,0,1,3,0,0,0,0,0,0,3,2,0,0,2,2,0,0,0,0,1,1,0,4,0,2,0,0,0,1,1,4,0,6,0,0,0,4,3,0,2,0,0,0,1,4,0,2,0,1,0,3,1,1,0,3,0,0,0,0,0,3,2,3,0,0,1,1,0,0,2,3,1,6,0,2,0,0,0,2,1,1,0,0,0,1,0,0,0,2,16,0,0,0,0,2,0,0,0,0,0,0,0,0,0,4,3,0,1,1,2,0,0,1,0,0,2,1,1,2,4,0,4,2,0,0,1,0,0,0,1,0,2,0,2,0,1,1,0,1,0,1,0,4,0,0,3,1,0,2,1,1,0,0,0,1,1,0,0,0,3,0,0,0,1,5,0,3,1,0,2,2,0,1,1,2,1,1,0,5,5,1,2,1,1,2,0,0,2,6,0,0,0,4,1,0,0,3,0,1,0,0,0,4,1,0,1,2,0,10,0,0,0,0,0,1,1,3,2,0,2,2,1,1,1,2,0,0,0,0,0,0,1,0,0,3,0,1,0,2,0,0,4,2,0,0,0,1,0,1,0,2,1,1,1,1,1,0,0,2,3,1,0,4,0,0,4,0,0,1,0,0,0,5,0,0,0,0,2,2,0,0,0,2,3,0,0,0,1,0,0,0,0,0,2,1,1,0,2,1,1,0,2,2,2,1,3,2,0,0,0,2,1,3,0,0,0,1,0,0,1,0,2,5,0,0,1,3,0,0,0,1,2,0,0,1,0,1,0,0,0,1,0,0,0,0,0,0,0,4,1,0,1,1,1,4,0,0,0,0,0,2,0,0,0,0,1,0,1,1,0,0,0,1,0,0,1,0,0,0,0,0,0,0,0,0,0,0,0,0,1,0,0,0,0,0,0,0,1,0,0,0,0,0,0,1,0,0,0,0,0,0,0,1,0,0,0,0,0,0,0,0,2,0,0,0,0,0,0,0,3,3,0,0,0,2,0,0,0,0,0,0,4,0,0,0,0,0,0,0,0,0,0,0,0,0,0,0,0,0,0,0,0,0,0,0,0,0
"2012 Crais, Robert, Taken",pop,4921,2398,1658,1670,925,1198,1107,895,1080,616,844,794,265,528,534,484,543,662,416,250,431,563,429,440,273,281,392,558,297,295,332,264,258,215,399,231,413,128,285,192,305,210,125,221,152,298,233,223,258,345,272,261,118,272,169,163,167,187,159,66,118,117,171,149,149,125,187,109,183,147,163,164,113,155,74,143,263,138,70,184,108,67,244,93,90,122,157,93,80,68,51,109,81,117,53,63,61,98,109,78,44,34,99,76,60,61,67,103,110,102,72,48,106,94,63,212,152,30,102,198,20,98,88,101,134,113,70,62,85,53,95,92,55,97,41,39,31,57,121,18,138,63,0,36,44,91,56,68,64,49,50,20,86,46,64,55,55,46,132,32,15,47,54,22,88,42,18,35,42,43,14,34,26,59,87,110,27,54,40,49,22,70,73,85,68,76,30,53,82,29,50,57,33,45,25,37,16,42,71,22,40,9,65,33,32,80,21,71,32,56,34,34,98,88,31,43,73,50,17,32,38,35,37,48,80,48,29,46,35,9,36,46,47,61,29,0,38,49,38,37,27,14,52,28,56,71,57,31,47,30,27,26,38,29,51,30,15,33,59,19,21,25,11,11,36,11,31,18,58,55,8,12,8,29,54,16,44,67,7,28,50,13,38,14,28,49,33,4,18,21,71,15,88,29,29,42,38,28,28,19,31,33,51,23,8,15,59,24,40,14,8,9,26,18,11,72,70,37,40,43,10,25,23,39,21,16,6,11,22,48,28,24,42,52,36,12,19,2,36,20,53,26,36,34,23,33,34,46,14,30,6,44,18,21,18,23,12,12,30,9,57,31,17,25,16,37,31,12,32,1,18,21,25,61,40,18,10,10,16,13,35,22,63,32,19,44,0,16,17,33,32,16,12,33,22,16,28,43,18,16,9,23,33,30,46,9,12,20,31,15,35,20,14,10,14,1,26,18,21,2,5,2,5,53,26,22,22,14,14,21,6,19,12,7,28,22,30,10,0,13,16,15,24,14,12,39,15,39,23,11,36,18,20,12,25,23,25,3,24,12,19,15,0,21,14,23,15,29,3,28,12,13,13,15,26,17,13,34,0,17,18,28,17,36,6,11,20,3,7,13,7,27,35,15,24,48,26,21,6,4,16,26,22,37,20,5,3,37,17,6,48,10,8,3,31,15,0,22,12,25,22,11,11,16,3,20,12,13,12,1,1,17,26,2,66,23,11,2,19,8,9,21,0,22,21,12,0,0,30,42,15,5,6,8,11,14,20,8,7,7,21,16,15,0,12,6,13,16,10,0,2,18,8,26,16,23,12,22,12,11,8,7,22,15,299,25,26,2,10,5,10,22,24,7,24,4,8,34,8,19,15,4,6,7,12,0,0,10,17,7,8,66,20,13,1,15,13,8,7,18,10,40,13,6,8,13,25,40,18,23,34,19,30,15,43,0,6,60,5,26,19,7,4,51,22,11,11,9,8,22,111,17,11,14,10,10,13,2,20,11,6,10,15,12,3,8,14,6,5,2,2,11,27,6,13,4,8,0,4,18,24,9,16,35,5,20,2,0,21,25,9,1,10,18,16,29,6,1,2,27,4,4,33,20,4,10,8,9,8,3,0,7,1,20,11,20,7,8,8,11,17,83,40,9,14,5,9,4,5,33,7,31,0,194,0,13,2,7,34,10,12,23,0,33,2,0,10,6,9,12,17,3,2,2,16,13,29,6,13,15,25,10,11,13,15,12,3,36,18,2,13,4,24,3,0,4,8,22,2,0,9,1,1,2,16,9,0,2,7,6,10,13,1,26,22,0,1,11,1,7,4,3,11,10,13,7,0,7,2,7,17,3,6,0,4,7,0,0,11,0,30,5,5,13,17,2,8,12,9,18,5,24,0,13,5,7,6,5,0,9,15,14,14,14,8,20,6,0,11,22,13,6,2,10,8,3,1,6,2,10,10,4,7,26,19,4,5,0,7,17,5,23,4,8,0,10,8,8,1,4,0,8,7,6,4,6,6,2,22,1,12,22,1,37,9,8,1,17,5,5,14,101,4,24,0,20,1,0,13,7,21,0,4,0,10,4,11,13,1,7,4,0,17,11,0,5,9,0,5,14,22,12,8,0,4,6,16,6,10,2,16,9,23,9,5,17,12,2,6,36,10,11,17,2,7,7,1,12,1,6,0,7,0,3,6,3,2,0,1,11,14,33,9,29,3,7,1,4,29,12,8,13,4,5,36,0,8,0,22,2,14,12,3,10,14,6,0,14,4,0,7,0,10,0,1,8,0,0,8,20,4,12,7,1,21,7,0,0,14,9,8,8,14,22,0,11,7,12,4,4,19,11,17,2,1,2,2,3,14,7,1,17,20,12,3,2,8,11,18,19,2,11,1,0,7,0,14,5,15,0,4,5,0,10,11,18,8,0,0,0,0,16,10,8,11,15,9,0,1,1,10,3,2,5,0,26,12,2,9,1,12,0,8,14,48,0,4,8,10,20,13,4,6,9,3,3,5,6,10,17,5,1,26,16,0,0,9,11,6,11,1,10,0,2,3,2,12,3,10,0,9,4,1,0,12,3,15,6,5,17,6,0,1,7,4,3,6,4,3,3,8,32,4,6,4,18,8,5,19,3,0,3,1,7,0,1,13,5,0,1,2,3,3,6,12,9,1,1,10,453,3,5,1,13,9,14,0,3,11,0,2,8,0,3,33,6,3,4,0,2,0,0,3,4,6,7,0,5,2,8,0,3,1,19,7,0,0,9,8,15,1,11,4,37,5,3,20,2,3,4,0,7,0,12,9,0,13,1,13,8,6,2,7,0,2,3,0,6,2,1,2,0,4,1,4,4,24,3,0,2,4,0,8,5,0,14,12,1,5,2,7,2,4,7,0,5,13,2,0,5,13,3,3,5,1,4,3,16,4,9,0,8,7,3,9,4,2,2,1,1,7,3,13,7,8,6,11,2,4,6,0,3,0,2,0,9,3,5,0,2,0,1,2,0,1,5,1,10,7,4,1,4,0,2,5,5,8,18,10,1,5,8,2,17,1,3,4,0,5,1,3,0,1,41,8,7,3,6,5,0,0,12,3,0,12,1,2,10,5,4,7,9,1,14,3,0,0,1,0,2,6,0,6,5,2,8,0,18,1,4,0,7,1,12,1,11,7,0,2,8,0,3,0,0,0,5,3,0,2,5,7,1,0,0,0,3,3,1,0,4,4,8,2,6,0,2,35,3,18,2,6,5,0,0,2,6,1,3,13,1,8,0,5,0,0,4,11,13,2,1,3,5,0,5,5,0,10,7,2,0,1,5,5,0,6,2,0,0,8,0,6,5,4,6,0,10,0,1,5,7,2,2,1,0,102,2,1,1,2,1,4,0,15,7,2,0,0,0,2,2,4,1,4,0,0,3,0,13,6,0,2,19,7,2,3,15,9,0,1,12,5,2,2,4,2,0,1,7,7,1,3,5,13,3,4,0,2,3,3,0,1,2,3,6,3,7,2,15,2,3,5,2,5,3,26,21,1,1,3,3,1,0,4,0,2,9,17,0,13,0,2,1,4,0,2,4,2,1,1,6,1,9,10,5,2,4,6,7,4,2,0,1,3,1,2,5,7,0,3,4,0,11,0,5,3,11,0,4,0,0,4,3,1,0,0,4,0,3,0,1,4,8,2,0,6,2,0,0,5,10,2,10,4,6,2,4,0,1,14,0,3,1,5,2,0,7,0,4,1,1,21,4,3,11,0,8,4,13,1,4,12,1,2,1,4,0,12,0,6,25,10,0,7,4,2,8,10,5,0,7,5,0,0,0,2,0,0,0,1,1,8,0,12,1,48,24,3,8,3,3,9,0,5,12,1,9,2,4,1,6,1,2,2,1,0,6,12,7,0,2,3,2,1,3,4,3,13,2,3,3,3,3,2,0,7,1,3,3,6,5,2,3,6,11,0,0,2,0,4,13,4,1,1,3,7,3,0,5,0,4,0,3,7,2,14,3,4,9,1,0,7,2,0,7,4,0,5,10,20,4,15,4,0,1,4,3,1,3,7,1,3,1,0,2,2,0,19,0,2,3,0,1,1,3,1,2,2,4,15,1,8,2,11,4,17,2,4,0,5,3,9,2,0,0,10,2,0,4,0,0,5,8,3,2,1,7,12,3,0,3,13,3,0,2,93,3,3,2,5,8,6,17,9,0,3,0,4,0,13,2,9,0,3,0,0,0,5,3,0,5,2,3,1,4,0,3,4,1,3,1,0,1,2,5,76,5,1,3,4,0,2,9,9,0,3,2,1,4,4,3,0,1,2,5,0,2,4,4,0,2,0,3,4,0,1,5,6,1,1,1,1,3,0,12,2,6,1,1,10,1,10,0,0,3,0,263,2,0,0,4,0,2,0,2,4,4,11,0,4,3,14,1,1,5,0,1,3,2,1,2,0,6,3,6,6,5,2,8,1,0,2,1,0,0,3,4,4,1,1,5,0,10,0,0,0,2,0,1,0,5,4,0,5,14,5,2,0,0,2,2,3,0,1,5,3,1,0,5,2,3,9,4,4,2,6,3,0,1,5,2,0,1,2,1,6,0,4,2,4,0,1,1,0,9,0,0,1,6,1,2,4,1,0,0,0,3,5,2,4,2,0,3,7,1,0,0,0,6,2,4,3,2,3,0,14,26,4,2,7,13,0,0,0,1,0,0,1,0,1,0,6,0,8,4,2,2,6,0,0,0,0,12,5,20,3,5,0,0,2,6,0,0,4,2,6,1,0,0,2,2,3,1,5,3,5,3,0,3,0,0,4,0,0,1,0,0,2,4,2,2,17,5,0,1,0,6,2,7,0,6,0,2,4,0,0,1,21,1,0,2,5,1,0,0,7,0,3,2,5,1,0,3,0,2,4,11,2,3,2,3,2,3,5,0,1,0,0,6,3,2,4,0,0,44,0,1,3,0,0,1,0,3,0,15,3,3,1,5,6,3,0,5,3,0,0,1,0,0,0,2,2,0,2,1,7,0,14,1,1,4,0,3,1,3,10,6,3,1,3,3,0,2,1,3,0,7,5,0,20,0,1,0,1,1,9,0,2,9,3,1,2,2,0,1,0,0,0,3,4,2,2,5,1,3,3,3,3,0,4,0,16,0,5,2,0,1,3,6,3,10,7,6,1,0,3,0,0,3,0,2,4,3,2,1,2,11,0,6,14,1,1,5,0,2,0,1,0,2,9,6,3,1,5,5,1,1,3,2,3,1,0,0,0,2,0,8,1,1,1,2,0,2,0,3,3,0,3,20,7,2,3,4,3,4,4,10,0,4,0,5,1,0,3,1,0,3,4,3,1,0,6,2,7,1,1,1,2,0,5,3,0,0,2,1,0,0,1,4,2,3,0,2,20,15,0,0,2,1,7,0,0,0,1,3,3,1,5,0,1,5,5,0,0,0,0,0,11,1,1,0,2,8,3,1,8,2,0,1,0,2,0,1,3,0,11,0,1,6,0,12,1,0,4,6,0,5,4,0,3,1,0,1,4,0,0,0,13,2,0,0,0,5,2,2,0,0,3,0,11,1,1,12,0,2,0,3,0,0,2,1,0,2,0,1,0,2,0,14,0,0,7,1,12,0,0,2,4,0,0,1,0,0,0,1,1,1,5,4,0,0,0,7,0,5,3,0,0,0,0,1,5,0,0,0,0,0,0,2,0,2,0,0,9,6,0,1,8,2,2,0,1,1,0,0,1,0,1,4,5,4,9,33,1,4,1,7,13,0,7,6,4,9,0,0,2,2,1,7,1,3,6,1,2,9,1,4,3,1,0,0,7,0,0,2,1,0,2,4,0,0,0,6,3,6,8,1,0,0,5,6,1,3,5,2,5,3,0,0,0,0,3,1,3,0,2,1,4,0,1,0,4,2,0,0,0,0,0,1,2,8,2,2,0,4,6,9,1,5,1,4,2,1,0,3,0,6,0,0,2,0,0,15,0,5,0,0,0,1,73,0,0,0,3,2,0,0,0,4,0,15,1,0,3,4,0,4,1,8,1,12,0,1,0,11,1,0,1,5,0,2,3,0,1,2,0,0,0,3,0,1,1,0,1,4,0,0,7,4,0,0,0,7,0,0,1,3,8,3,3,1,3,0,4,2,13,0,1,2,0,3,2,0,3,1,0,0,0,0,6,0,0,2,1,2,1,0,0,0,5,1,1,0,1,3,3,0,32,0,4,5,0,0,0,0,1,2,0,0,2,0,1,0,2,3,0,2,2,0,0,2,3,11,0,1,1,0,0,0,0,5,2,1,0,4,0,0,1,0,1,0,1,6,16,0,0,0,1,8,0,2,1,2,4,3,0,0,2,5,1,0,0,0,3,5,7,4,0,1,6,1,8,0,0,0,3,2,2,1,12,3,4,0,3,17,0,1,2,4,2,0,6,0,0,1,7,0,0,3,1,0,1,0,8,5,0,0,2,4,4,26,0,2,0,3,0,4,0,7,0,0,1,13,12,3,0,0,0,0,0,0,11,1,0,0,0,0,0,0,0,0,0,3,0,2,1,1,1,15,5,0,4,1,2,0,0,4,0,0,10,4,3,0,10,1,0,3,2,4,5,23,0,0,5,3,0,2,2,0,0,0,0,3,1,0,0,0,1,2,3,2,0,6,1,0,0,3,2,7,0,0,4,1,1,0,1,0,0,2,0,0,3,0,1,0,0,5,0,0,3,5,0,0,4,0,6,2,0,0,0,1,0,0,0,1,0,0,2,2,0,3,0,0,4,2,1,3,4,4,0,0,2,0,0,3,0,4,0,0,1,0,5,0,1,1,7,2,0,7,0,8,3,0,2,0,0,0,2,0,0,4,0,0,0,0,0,1,0,0,0,1,2,2,5,6,0,3,2,3,4,0,7,0,1,5,18,0,0,1,9,2,0,9,0,3,1,0,3,1,2,7,0,0,1,0,0,0,5,3,2,5,1,6,2,2,1,0,15,0,0,0,6,0,3,1,0,2,2,0,4,2,3,0,0,1,1,1,0,2,2,1,0,0,0,3,0,2,2,0,2,0,8,0,2,0,6,0,0,1,2,0,0,1,0,0,0,0,2,1,0,3,4,8,2,0,0,1,0,0,0,2,1,3,1,0,0,0,143,1,1,0,0,0,2,2,7,2,0,1,2,2,0,1,0,1,0,2,5,1,0,2,12,0,2,2,0,5,1,0,0,1,0,0,0,4,0,0,0,0,0,4,2,0,2,1,1,1,1,1,0,1,0,0,0,0,3,2,3,0,0,0,0,4,9,1,0,0,0,4,3,1,2,0,4,2,3,13,0,0,1,0,1,0,1,0,1,7,0,6,8,9,0,1,0,0,0,0,2,0,0,2,5,0,0,0,6,3,1,17,1,1,1,1,0,0,1,1,0,0,0,3,2,3,0,3,0,0,0,0,0,1,2,0,0,5,1,1,0,0,9,1,0,0,0,6,1,2,4,1,1,3,0,3,1,0,3,1,0,9,2,0,0,2,1,0,3,8,0,10,0,1,1,0,1,0,0,7,1,4,2,6,0,0,0,0,3,14,0,0,4,0,3,0,4,1,0,0,3,13,3,2,0,1,2,0,1,2,1,5,4,0,1,6,1,0,8,0,0,3,0,1,0,0,1,0,0,6,6,0,1,0,1,7,0,0,0,1,0,1,0,0,1,1,1,2,0,0,3,1,1,1,0,0,1,0,0,0,3,3,1,0,2,0,2,2,0,0,9,2,0,0,0,3,1,0,0,0,1,4,0,0,0,5,0,8,0,0,0,0,0,1,0,0,0,1,0,7,2,0,3,0,2,0,0,0,0,1,6,4,0,2,0,0,3,0,2,1,0,0,0,1,9,1,3,0,0,0,2,0,0,0,2,0,0,1,0,3,0,0,0,1,0,0,0,2,0,1,2,0,1,0,0,2,1,1,4,0,0,3,0,1,0,0,0,2,0,0,2,1,2,1,0,0,1,9,0,1,2,0,0,0,0,19,2,5,2,1,5,0,2,1,0,0,0,3,13,1,2,2,0,1,0,2,1,0,0,13,0,0,5,1,0,5,0,1,1,1,0,0,2,0,1,8,4,0,4,0,8,0,1,91,0,0,0,0,8,2,0,2,1,0,2,0,0,0,0,0,0,0,0,1,0,0,0,0,0,1,0,1,0,0,4,2,3,0,0,0,0,6,2,2,0,4,0,0,3,4,3,1,0,1,0,0,1,0,0,0,1,0,0,4,1,6,2,0,0,0,0,0,1,1,1,3,0,0,0,1,1,0,5,1,1,6,1,0,1,0,0,1,2,0,0,2,2,1,0,1,3,2,1,0,4,4,0,0,0,1,0,3,1,2,5,1,0,0,1,2,3,0,1,0,0,0,0,8,0,0,5,1,0,0,0,0,1,1,0,0,1,7,0,1,4,0,0,1,1,0,0,0,0,0,1,0,2,0,1,0,4,2,0,0,0,0,0,0,1,1,1,2,0,0,0,0,1,0,0,2,1,0,1,2,0,1,0,0,0,0,1,0,1,1,0,28,0,1,0,0,0,0,0,0,1,0,3,0,0,0,0,2,4,0,26,5,2,0,0,2,2,2,2,5,7,4,6,1,0,3,3,3,2,7,0,2,0,1,0,2,0,0,0,2,0,16,0,5,2,4,0,0,0,0,0,1,2,1,1,0,2,0,1,0,0,0,0,1,3,2,0,0,1,0,1,2,2,1,0,0,0,0,0,1,0,3,6,1,4,2,1,2,0,2,0,0,1,1,1,2,0,0,1,0,0,2,1,0,5,9,0,2,4,3,2,0,10,0,0,0,0,5,0,0,0,3,1,5,2,0,0,0,1,0,1,0,0,0,5,0,0,0,0,0,0,1,0,1,0,0,3,5,6,0,2,0,0,0,1,2,0,8,0,0,1,0,2,0,1,2,11,1,1,2,3,0,1,0,0,0,3,2,0,0,1,1,2,0,0,1,0,1,0,0,0,2,0,1,0,12,0,2,0,2,3,0,1,0,0,0,3,2,2,0,0,3,21,2,0,1,3,0,2,0,0,0,0,0,1,0,1,3,0,0,0,3,2,3,5,0,0,0,3,1,0,0,0,0,0,0,0,0,0,0,0,0,1,0,0,2,0,0,9,15,1,1,0,1,0,2,2,3,0,0,2,0,5,0,1,0,0,3,4,0,0,1,0,1,1,2,1,0,3,1,1,0,0,0,1,2,3,6,9,0,1,0,0,0,1,1,8,2,4,0,1,0,1,1,3,10,0,0,0,1,0,4,3,0,0,0,7,2,9,0,0,0,1,0,0,0,0,1,0,0,1,0,0,1,0,1,0,0,3,2,1,13,0,2,3,0,0,2,0,0,0,5,0,0,0,1,0,1,1,0,0,0,2,0,0,0,1,1,0,0,6,0,0,2,1,0,0,0,0,0,0,3,0,1,4,6,0,1,0,0,1,0,0,1,0,0,0,0,1,1,0,0,1,0,0,0,1,0,0,0,5,0,1,0,0,0,0,0,0,4,0,2,0,0,0,0,0,2,1,3,0,0,0,0,0,0,2,2,0,0,1,3,3,0,2,2,0,0,0,1,0,1,4,2,0,0,0,2,0,0,2,0,4,2,4,0,0,0,0,0,0,1,1,0,0,2,2,1,0,0,0,4,1,0,0,1,0,0,1,0,1,0,0,0,0,0,0,0,0,1,0,1,0,0,0,1,1,0,3,1,0,1,2,0,0,0,2,0,3,2,0,4,3,0,0,0,0,1,0,0,0,0,0,4,0,0,0,2,2,5,1,4,1,0,1,0,1,6,2,0,1,0,34,0,3,2,1,1,0,0,1,0,1,0,1,1,0,5,1,0,0,0,0,0,1,0,2,0,0,0,0,5,3,1,0,2,8,0,0,0,2,0,0,2,0,1,1,1,2,0,1,0,0,0,0,5,0,0,0,0,0,1,0,0,0,0,0,0,0,0,0,0,0,0,1,0,0,5,2,0,1,1,0,0,0,1,3,1,2,0,0,3,0,0,3,3,1,0,0,1,0,0,2,0,1,0,2,5,1,4,0,0,0,0,0,0,1,0,0,0,1,0,1,0,1,0,1,1,0,1,0,0,0,4,0,0,1,0,1,2,0,4,0,0,0,0,1,1,0,0,0,0,0,0,5,0,0,0,5,0,1,0,1,2,1,0,0,0,4,0,2,0,0,2,2,2,5,0,2,4,4,1,2,0,0,0,0,0,0,0,0,0,1,0,4,0,1,1,2,0,1,2,0,0,0,5,0,7,0,0,0,0,0,1,0,1,0,1,0,0,2,0,0,0,0,0,0,1,0,1,3,0,2,3,0,2,1,0,0,0,0,0,1,0,0,2,0,0,1,1,0,0,0,0,0,0,0,0,0,1,0,0,0,0,1,1,0,1,0,1,0,1,0,1,3,0,1,4,0,1,0,0,3,0,4,0,0,0,2,1,0,0,0,1,0,0,1,1,0,1,2,0,2,1,0,1,4,0,0,0,0,0,1,1,0,5,6,0,0,1,0,2,0,0,1,0,0,0,0,1,0,1,1,2,3,0,0,0,1,1,0,1,0,0,0,0,1,1,3,0,1,1,1,0,0,0,0,1,0,2,0,0,0,0,0,0,0,3,1,3,1,0,1,0,0,0,0,1,1,0,0,1,0,0,0,5,0,1,0,0,1,0,1,0,0,0,0,1,4,0,1,0,0,2,1,0,3,0,1,0,0,3,0,1,0,0,0,0,2,1,1,0,0,0,2,1,0,0,1,0,2,0,0,1,0,0,0,0,3,0,0,1,1,0,0,0,1,0,2,0,1,0,0,1,0,0,0,0,1,3,0,0,0,0,0,1,1,0,0,1,0,0,0,1,0,1,0,2,0,1,5,0,0,0,0,0,0,0,0,1,0,7,0,0,0,0,0,0,0,0,0,0,0,0,1,3,0,2,0,0,0,0,4,0,0,0,0,0,0,0,0,0,0,0,3,0,1,0,0,0,0,0,2,1,0,0,1,1,0,0,1,3,3,0,0,1,2,0,0,2,2,0,2,1,0,0,0,0,0,0,1,0,1,0,1,0,0,0,1,0,0,0,0,1,0,0,0,0,0,0,0,0,0,0,0,0,2,0,0,0,0,0,0,0,0,0,0,0,0,0,0,0,0,0,1,0,0,0,0,0,0,0,0,3,0,0,0,0,0,0,0,0,3,0,0,0,0,0,0,0,0,0,0,0,0,0,0,0,0,0,0,0,0,0,0,0,0,0,0,0
"2012 Grisham, John, The Racketeer",pop,5489,3616,2371,3118,2065,2337,1224,1712,880,831,818,829,637,273,178,753,351,769,794,200,658,629,613,324,726,604,447,425,274,1001,366,226,245,420,475,470,263,316,711,395,292,184,382,493,338,261,260,324,212,235,185,169,129,193,361,284,190,217,235,198,151,170,252,200,171,216,165,156,425,131,243,341,162,136,147,132,295,53,237,168,120,255,86,139,86,23,163,211,50,123,199,141,91,115,91,170,156,131,89,104,135,98,66,84,28,61,82,95,118,73,43,81,86,56,131,92,158,81,54,57,49,278,41,48,111,42,126,86,45,72,20,30,89,56,33,149,181,52,73,78,35,75,10,97,119,33,72,78,115,60,89,31,17,123,123,165,198,49,132,39,101,9,21,28,72,36,34,53,54,42,18,180,33,112,66,83,83,85,77,102,53,40,62,59,26,66,47,31,46,59,64,151,40,87,58,58,44,72,13,113,88,10,39,64,56,113,77,73,20,57,22,66,45,94,32,61,65,7,40,19,42,84,66,28,53,13,38,93,78,55,42,93,14,17,48,0,8,38,27,70,59,99,62,60,75,40,109,32,48,36,19,16,61,27,35,49,17,64,22,27,33,108,15,63,48,21,47,23,90,88,26,16,52,64,26,37,89,38,16,25,23,57,31,32,70,30,29,26,30,22,7,207,71,31,7,44,29,51,39,22,42,39,85,29,26,61,103,14,19,22,27,42,89,40,55,6,74,24,41,96,38,52,23,29,1,21,1,49,28,19,9,59,46,19,19,51,24,13,70,28,42,35,72,79,35,14,35,76,24,37,50,18,23,37,17,79,69,0,37,62,61,4,66,7,54,8,57,63,49,8,35,32,76,11,54,12,29,18,8,39,23,7,48,8,101,25,0,25,16,10,10,18,37,6,26,18,3,10,24,29,23,11,20,20,27,18,21,34,41,5,4,36,13,40,31,13,39,25,77,20,17,0,7,64,32,21,38,8,42,51,8,21,25,9,7,2,24,24,0,30,30,29,61,17,24,28,16,16,36,24,10,47,22,32,4,19,20,7,20,16,27,39,0,20,16,38,7,12,9,29,45,50,20,11,19,24,15,27,0,67,21,26,17,18,6,12,25,1,25,30,27,23,2,16,26,8,26,19,11,23,22,29,21,15,22,13,0,2,20,49,30,7,23,2,25,10,0,33,4,20,12,6,6,32,8,19,24,41,13,16,4,12,16,23,3,1,8,24,43,29,4,34,13,14,10,11,0,0,42,6,14,19,44,30,4,38,31,20,28,11,31,13,17,6,5,43,9,2,4,2,14,51,26,18,7,24,14,10,24,18,19,12,9,7,1,12,18,18,13,43,16,29,9,65,18,4,7,5,11,8,1,0,11,2,22,0,0,9,5,48,12,4,14,21,4,20,11,17,13,9,11,40,6,22,4,31,34,9,18,50,14,8,12,17,0,0,25,3,4,24,18,20,13,11,47,14,5,10,3,19,0,7,33,13,2,2,9,6,5,8,22,14,4,21,5,28,6,3,15,3,9,11,8,11,36,17,41,4,9,28,15,15,41,12,20,2,7,17,16,33,11,19,2,20,11,22,6,12,14,37,21,3,3,14,8,4,2,19,17,25,5,6,0,14,41,19,18,6,6,26,2,36,32,1,8,11,28,3,6,6,7,30,0,2,0,6,3,9,30,28,4,3,9,15,2,2,10,10,58,3,11,3,9,10,15,1,33,5,12,78,3,23,14,0,13,15,17,22,1,19,8,28,4,7,0,28,7,9,7,10,7,9,27,15,1,9,1,15,29,50,5,2,0,4,3,15,129,19,0,2,3,6,18,12,4,4,0,53,24,26,14,11,12,19,5,25,6,1,4,4,16,5,9,1,18,8,12,21,18,30,9,16,6,7,14,10,4,30,6,16,12,7,3,7,7,8,9,0,4,26,6,4,43,7,31,4,2,10,3,31,5,6,26,7,28,6,11,0,11,7,18,19,14,63,0,5,44,12,5,21,4,12,13,3,8,10,12,8,7,17,17,15,12,9,3,7,12,0,4,4,4,21,17,3,13,17,5,22,7,1,14,260,11,0,16,3,85,31,13,27,15,0,23,2,4,4,16,0,1,4,0,6,5,43,41,2,27,6,12,4,5,0,2,13,9,13,34,6,7,6,9,26,1,0,0,5,9,5,27,2,0,12,1,3,3,25,6,0,15,6,20,4,1,3,7,5,5,17,21,4,0,0,14,28,10,4,15,0,9,24,3,5,7,0,7,6,0,10,8,0,5,0,26,0,3,10,1,0,50,1,21,29,40,1,9,10,7,0,7,2,19,16,22,2,17,22,19,5,2,15,11,13,3,35,15,1,16,0,9,5,5,24,50,17,4,11,0,6,4,19,13,7,0,7,24,0,21,7,0,12,6,3,0,25,3,2,26,7,0,0,0,31,13,21,16,5,7,0,16,5,12,0,24,10,30,2,77,20,5,196,3,0,8,7,6,35,1,3,13,13,7,3,6,1,8,3,4,6,24,7,12,14,1,5,0,4,13,14,7,6,0,1,9,16,4,23,14,19,7,0,2,2,27,0,3,1,0,9,48,4,2,6,25,11,1,2,0,30,8,2,4,35,6,16,9,13,3,7,3,8,6,29,6,4,0,57,3,2,0,0,1,1,9,4,4,8,22,0,3,0,13,11,12,5,2,5,0,2,5,0,3,12,0,9,8,3,2,1,86,9,1,0,33,11,3,2,0,11,5,14,0,9,4,1,3,0,0,15,3,18,10,3,5,3,0,2,22,3,3,12,10,11,0,0,1,0,18,1,27,16,3,9,2,0,4,22,0,19,6,12,27,7,9,2,20,0,0,1,0,1,6,0,16,8,0,16,4,16,7,6,0,18,4,15,0,4,8,6,0,2,1,6,5,1,9,4,3,11,9,0,0,12,6,20,16,5,6,12,1,0,7,1,10,18,3,5,14,1,4,9,0,1,0,1,0,9,3,0,3,19,2,8,26,36,9,3,3,1,8,9,0,15,6,2,18,1,7,8,6,3,1,7,13,0,4,1,24,4,9,7,4,0,5,1,4,37,0,4,12,94,11,20,1,0,4,21,10,27,2,8,52,3,3,14,13,13,0,3,0,13,3,0,15,2,4,5,1,2,9,9,0,3,3,12,1,13,8,0,4,53,0,0,0,3,3,1,0,0,24,0,3,12,0,10,0,0,5,8,10,0,3,9,20,12,13,0,13,150,13,2,0,5,0,0,6,3,3,9,6,3,5,14,5,13,0,2,124,10,4,7,11,6,0,4,8,0,1,5,3,4,7,3,1,0,14,15,12,0,8,14,11,11,8,3,0,1,9,7,10,12,13,11,0,4,2,7,4,0,4,1,12,8,6,1,2,2,0,3,0,12,2,0,0,0,0,2,0,7,5,10,10,10,7,6,3,8,11,0,7,13,12,1,7,5,2,10,1,2,3,1,12,18,48,7,25,0,7,7,6,5,9,7,9,10,1,4,41,0,1,6,3,5,10,10,1,2,0,1,1,7,10,2,1,27,4,6,17,10,6,24,15,1,4,0,3,6,10,37,0,17,4,0,4,3,4,8,0,7,2,3,0,8,0,7,2,2,1,0,33,5,2,6,0,10,6,8,9,2,4,3,2,13,6,0,2,2,0,1,4,6,3,6,2,0,8,3,4,0,1,2,14,16,1,3,0,2,6,3,15,3,6,19,6,1,0,98,0,3,14,0,20,3,2,1,1,1,26,8,12,0,8,13,2,6,1,10,3,0,16,1,2,3,1,3,11,4,119,7,42,1,8,3,5,2,1,1,18,3,10,0,23,0,1,18,4,3,6,3,4,15,2,1,2,4,4,14,0,9,3,24,4,2,7,25,9,1,37,25,0,8,2,9,1,5,5,3,8,8,7,2,5,5,11,0,7,3,11,7,3,10,18,1,0,3,0,1,4,1,3,5,12,2,7,11,4,3,0,5,0,1,5,10,1,0,9,1,5,0,17,0,2,1,1,8,3,0,3,3,6,11,5,17,3,2,59,2,4,4,10,11,2,10,0,3,7,30,1,4,6,7,3,1,10,3,4,10,0,22,3,10,1,8,4,5,4,5,18,0,0,4,3,3,0,0,11,3,0,2,0,0,0,0,1,5,1,1,15,5,0,6,4,1,1,0,1,4,0,10,5,14,2,3,1,0,9,11,4,11,7,1,2,2,7,16,0,7,2,20,1,4,19,10,7,0,3,6,6,2,3,4,0,0,1,1,12,1,8,3,0,1,0,9,0,1,6,9,10,3,2,11,0,9,5,12,0,2,6,1,0,11,0,10,4,2,15,4,4,5,3,2,5,0,0,10,7,0,6,19,5,4,7,1,0,5,3,0,13,8,0,9,14,10,0,2,0,2,17,4,1,1,7,5,16,0,0,2,0,8,3,3,3,9,4,4,1,16,11,12,32,0,9,3,3,0,6,4,0,1,1,6,0,2,2,20,3,2,0,3,1,8,4,9,7,16,3,11,3,0,8,3,3,1,2,7,18,13,5,5,27,8,3,16,0,0,5,11,12,4,0,4,4,2,2,14,8,0,1,2,8,0,1,1,6,5,0,11,1,0,7,4,0,0,0,0,0,5,1,6,3,6,2,7,4,1,1,3,3,0,1,3,6,9,6,8,1,2,2,3,1,6,0,0,4,10,0,0,2,2,0,0,6,2,12,6,0,3,0,0,5,3,6,1,2,0,12,2,0,0,4,8,14,1,8,5,9,11,0,1,2,8,12,23,5,2,9,0,71,1,0,0,0,0,9,2,0,0,2,7,9,4,4,7,0,1,0,6,4,3,2,13,2,2,5,7,0,2,12,0,0,18,0,3,67,0,7,4,3,5,1,6,0,0,0,8,0,3,8,0,1,5,1,1,11,0,9,0,0,2,0,2,4,0,0,4,2,3,15,7,8,5,3,1,3,10,1,2,5,1,15,5,2,2,2,1,3,0,1,0,0,4,4,1,9,3,5,6,9,1,2,18,1,11,6,5,1,10,1,8,35,2,0,1,0,6,3,0,7,0,0,0,9,3,1,9,0,2,4,13,2,11,4,5,0,0,3,2,2,0,4,0,1,3,2,17,16,3,5,6,3,0,3,0,17,3,0,8,4,2,2,2,0,1,4,3,4,3,8,2,2,1,3,3,7,0,4,2,1,4,1,0,1,4,16,19,2,9,1,27,1,3,4,5,3,6,1,4,6,12,5,3,8,13,0,2,1,4,0,0,2,9,0,4,9,0,17,0,4,5,2,0,1,5,1,7,5,33,5,2,0,11,1,0,4,1,0,8,1,1,14,61,2,4,2,5,1,3,4,11,1,0,0,2,3,6,3,0,2,1,7,0,4,3,3,10,1,0,6,0,3,5,4,3,12,3,10,7,1,0,1,0,3,0,2,0,1,0,3,0,7,0,10,3,11,5,5,10,0,0,0,0,7,3,5,2,9,0,0,6,2,0,5,4,3,2,1,8,1,0,2,3,0,1,11,0,2,2,0,1,5,1,4,1,11,7,0,3,1,0,6,3,8,3,0,4,1,1,15,0,18,0,0,5,1,1,6,2,0,9,1,2,1,1,3,2,218,1,0,0,2,2,2,6,6,8,2,8,2,7,27,0,8,1,0,2,3,6,0,0,0,0,1,4,0,3,0,1,3,3,5,9,5,0,5,10,5,0,0,5,0,10,4,2,7,0,5,0,2,2,4,9,14,0,2,7,3,3,1,3,16,0,2,32,0,8,5,3,10,1,10,4,1,3,1,0,3,12,4,1,15,1,0,0,0,2,0,0,0,6,0,2,2,1,6,1,14,1,4,2,0,12,1,9,5,7,1,5,3,2,0,3,5,0,1,1,2,0,0,0,1,1,11,0,0,0,0,2,2,0,3,12,12,6,2,5,2,1,11,3,4,1,3,3,0,3,2,2,0,5,17,0,5,0,0,1,8,0,2,1,4,0,0,2,0,9,11,38,0,1,6,1,4,1,5,5,2,4,1,2,15,1,1,2,2,3,7,17,1,0,4,0,7,3,3,2,0,0,0,0,1,2,11,0,10,2,6,0,2,7,5,2,1,13,7,3,1,0,14,9,12,0,3,6,3,17,0,1,0,0,1,0,8,4,0,1,1,1,0,1,0,3,0,0,2,3,3,0,11,7,16,0,0,0,3,4,1,0,0,3,0,2,0,0,0,5,4,37,1,0,7,6,28,8,4,1,0,24,3,0,2,0,0,4,0,0,3,0,4,4,0,1,10,14,1,1,29,7,10,0,0,1,5,8,0,0,7,2,9,4,2,2,1,3,1,0,0,0,45,2,1,3,0,3,1,0,2,1,4,1,3,3,1,8,2,1,1,2,0,6,4,3,1,9,9,1,2,11,2,7,4,0,5,1,0,5,3,0,12,8,1,2,0,0,6,9,0,2,3,0,2,3,0,0,1,8,0,2,0,3,6,0,0,1,1,1,2,5,1,0,6,0,1,7,3,8,0,1,3,2,8,0,0,3,15,1,2,5,1,0,6,1,3,6,2,0,0,8,0,0,5,1,1,0,10,9,4,3,6,5,2,4,0,0,3,2,0,2,2,2,0,8,0,1,14,2,0,3,0,5,1,7,0,1,4,1,1,11,4,3,1,0,7,1,11,0,0,0,1,2,6,1,7,0,4,0,5,2,0,2,8,9,0,3,2,0,1,6,2,0,0,8,0,0,0,4,0,0,3,4,61,3,1,0,8,2,2,0,4,6,0,4,2,0,0,2,9,12,0,0,3,2,0,6,6,14,0,0,0,5,1,0,10,3,0,2,1,1,1,4,1,0,0,7,4,3,0,1,1,10,0,2,11,0,3,6,4,0,20,5,6,1,1,1,0,0,0,3,12,1,1,4,0,3,0,9,0,4,1,1,11,0,3,0,23,6,4,0,12,0,0,1,0,3,1,7,1,1,0,0,3,0,8,0,1,3,0,1,5,5,0,6,0,3,15,4,4,14,3,9,1,5,4,1,0,0,0,1,2,2,1,0,1,3,0,0,0,0,1,9,16,0,0,3,0,1,0,28,7,0,0,5,2,1,0,2,1,2,0,0,1,1,4,3,0,0,2,19,0,1,0,5,0,2,8,5,1,6,0,6,7,5,1,2,0,3,0,0,1,7,2,0,2,0,0,1,0,1,0,0,0,6,0,3,0,0,2,0,0,2,3,5,12,0,4,0,2,1,1,0,1,0,16,3,7,6,5,0,2,0,3,0,4,2,0,0,4,1,1,7,2,2,5,3,0,3,4,1,10,1,3,0,0,0,0,6,0,2,7,8,2,5,0,1,2,0,0,14,2,0,3,0,10,3,4,1,6,0,1,1,0,2,0,1,2,0,5,6,0,7,1,4,0,0,0,6,2,2,0,1,0,2,2,0,1,1,2,1,2,1,4,4,2,5,3,0,3,1,6,19,0,8,0,1,45,1,0,1,0,12,4,0,7,1,0,0,14,3,15,13,4,14,3,0,9,0,0,0,3,5,0,2,1,16,2,0,2,0,0,0,1,1,0,5,1,1,2,1,5,0,0,16,2,1,1,1,1,6,2,2,19,0,0,0,0,8,1,0,0,1,0,0,22,0,0,0,7,0,0,3,0,0,0,2,0,0,6,5,0,0,2,0,21,4,2,3,4,6,6,8,0,0,0,0,2,0,4,1,0,18,4,0,3,0,2,10,6,0,0,2,0,0,2,2,4,5,0,0,3,9,0,3,5,2,1,2,4,0,3,0,4,0,0,0,0,0,0,0,0,0,1,0,2,48,7,0,2,1,1,1,0,1,0,6,3,2,0,0,4,0,0,3,29,0,4,1,3,3,5,2,4,0,5,1,1,3,0,0,8,8,0,3,0,0,0,1,0,1,2,0,2,6,1,2,3,1,2,2,5,5,0,4,3,0,0,2,0,5,3,4,0,5,7,2,0,3,5,0,1,0,0,2,1,6,1,3,0,5,1,0,0,9,4,0,2,1,0,4,5,1,0,0,0,7,1,1,4,2,1,5,6,18,4,4,6,7,1,0,1,73,2,4,0,0,0,1,18,1,3,0,4,0,7,0,0,6,1,1,3,1,0,3,0,8,4,0,5,1,0,0,0,1,8,0,2,0,0,1,10,0,3,0,3,18,1,2,0,5,2,0,0,0,0,3,2,0,1,0,4,4,3,1,1,2,2,0,2,1,3,5,0,2,21,2,3,0,3,4,0,1,0,1,2,1,1,2,3,1,6,0,5,0,3,2,0,0,1,1,2,5,5,0,0,3,1,0,5,2,10,0,1,8,0,4,0,0,0,0,6,1,1,2,2,1,2,0,1,0,1,1,3,2,9,0,9,0,0,1,0,0,4,0,0,1,20,1,1,0,4,2,0,3,2,0,0,4,10,5,1,0,0,7,1,0,0,1,1,0,26,1,3,0,1,4,2,1,2,0,0,3,0,0,2,3,3,3,0,0,1,0,0,1,11,3,1,0,0,18,1,0,0,5,8,0,0,2,4,0,0,0,0,0,1,1,4,2,0,0,0,3,3,2,1,2,1,0,4,5,4,3,1,2,4,0,0,5,0,3,2,1,2,0,1,7,0,1,0,1,12,0,2,0,2,11,0,6,1,2,1,5,1,2,0,0,0,1,0,1,2,0,3,4,10,1,0,0,0,5,0,1,9,3,2,1,0,2,0,1,0,0,3,2,1,10,4,2,8,1,0,1,0,0,1,12,0,4,1,1,2,5,5,2,3,0,0,0,5,1,0,4,0,0,0,0,0,0,0,2,1,0,0,0,3,1,0,2,0,0,0,3,1,0,5,2,3,5,4,4,1,12,2,0,0,0,1,0,2,4,4,1,2,0,0,0,0,2,1,1,0,0,0,0,4,0,0,7,1,2,3,1,3,0,4,0,0,8,0,3,6,20,5,1,0,0,3,0,0,0,2,8,2,0,3,0,2,0,0,0,0,0,1,0,1,0,6,0,3,1,0,0,3,0,0,2,10,2,2,2,1,8,1,0,0,0,3,0,1,0,3,0,1,0,2,0,5,0,7,0,0,0,0,3,0,0,0,2,4,1,1,2,1,1,2,1,4,2,3,3,0,0,4,0,2,2,0,0,0,0,1,0,0,2,1,4,3,4,5,0,6,0,0,3,9,12,0,2,0,3,0,0,2,0,0,15,0,0,3,2,3,1,1,0,1,2,1,5,5,1,0,0,3,0,0,1,3,0,5,0,3,1,1,2,1,8,2,1,0,0,9,2,0,0,0,2,1,0,1,0,0,0,0,0,2,0,0,2,0,2,0,0,5,1,2,1,0,0,7,0,1,0,1,4,0,4,7,2,0,0,0,0,7,0,0,1,7,0,0,0,0,0,0,115,5,2,0,0,3,133,1,0,2,0,0,10,10,11,1,2,1,0,2,0,4,0,1,2,6,1,2,3,11,7,4,0,3,1,2,0,2,0,12,1,2,0,2,0,7,0,0,0,1,3,0,4,7,0,3,0,0,0,3,7,1,0,0,0,0,1,1,6,1,3,1,4,9,3,0,1,0,0,0,0,4,0,0,1,2,4,0,0,0,2,0,0,3,0,1,5,1,1,0,1,0,4,5,0,0,6,2,0,3,1,0,5,0,4,1,1,0,1,0,0,0,3,0,0,1,1,6,0,0,0,2,3,0,0,3,1,2,0,2,0,1,4,5,0,1,0,5,0,15,1,2,1,1,0,2,0,1,1,3,1,0,1,2,3,5,0,2,5,0,0,1,1,8,1,5,0,0,3,2,0,0,0,4,0,5,0,0,2,5,1,1,0,1,8,4,1,0,1,0,10,5,1,27,6,0,0,6,3,2,2,0,2,1,3,0,1,0,1,1,0,0,0,0,0,1,1,0,3,6,0,9,0,5,0,0,0,0,4,1,9,0,2,0,0,0,12,0,0,0,0,3,0,0,0,2,5,0,1,2,1,2,0,0,0,0,3,1,4,3,0,0,0,1,1,4,1,0,2,5,2,1,0,4,0,3,0,4,2,1,1,1,0,0,2,0,1,0,4,2,0,2,0,0,0,2,0,2,1,0,0,3,0,0,1,0,1,4,0,4,1,0,2,3,2,0,2,1,0,0,14,0,1,0,2,2,3,0,0,0,0,0,0,1,2,4,4,2,0,4,0,0,2,0,3,0,0,1,2,2,0,1,0,1,0,2,0,25,0,0,2,0,2,5,4,0,0,0,1,5,0,1,4,0,0,0,2,5,5,0,1,15,1,5,0,0,0,5,0,0,0,5,0,1,0,0,0,0,0,1,4,2,11,6,0,0,6,2,1,0,3,0,1,3,1,1,3,0,0,2,0,0,0,0,1,0,23,0,3,1,0,0,1,4,0,0,0,0,1,1,1,0,2,0,1,1,0,4,6,0,0,0,0,0,6,0,0,1,0,1,0,1,0,4,3,1,0,0,2,2,3,1,3,5,4,2,3,0,1,1,2,0,0,0,1,1,1,0,1,0,10,0,1,4,0,0,0,0,0,2,0,0,0,0,0,1,7,0,0,3,3,0,2,0,0,0,0,0,1,2,2,2,1,0,0,0,0,1,11,4,3,3,0,3,1,0,0,6,3,0,0,1,0,2,0,0,2,0,3,1,0,0,0,0,1,0,2,1,0,0,1,2,0,1,4,0,0,0,1,1,3,0,0,0,0,0,0,0,1,7,6,0,1,8,0,7,0,0,2,1,2,0,3,3,0,2,0,0,0,0,4,1,4,4,0,1,2,1,0,3,0,3,1,0,4,2,0,1,0,0,0,0,1,0,1,3,0,0,0,3,3,1,7,1,0,1,0,2,2,4,0,2,14,0,0,2,0,0,1,0,1,2,0,4,0,4,0,5,1,2,3,0,0,0,1,1,3,0,0,0,1,0,0,0,1,1,2,1,0,0,0,0,8,4,2,0,0,1,0,0,0,1,3,1,0,0,0,1,0,1,2,0,1,1,5,0,0,1,2,0,1,2,1,1,0,5,0,1,0,2,1,3,2,1,1,0,0,0,0,0,0,0,0,0,1,4,0,0,0,1,2,0,0,0,0,0,3,0,0,3,1,0,0,0,2,0,0,1,0,1,0,0,0,0,0,2,0,0,0,1,0,0,0,0,0,0,0,0,0,0,0,0,0,0,0,0,0,0,0,0,0,0,0,0,0,0,0,0,0,0,0,0,0,0,0,0,0,0,0,0,0,0,0,0,0,0,0,0,0,0,0
"2013 Crais, Robert, Suspect",pop,4340,2588,1697,1623,856,646,1417,786,1206,614,912,1050,292,908,1162,529,534,648,406,139,444,565,463,501,103,278,177,377,354,217,298,293,279,176,383,202,365,128,177,146,295,226,112,211,187,351,210,222,176,241,298,195,115,231,170,147,152,166,103,63,143,137,133,137,120,124,162,89,120,149,132,168,86,159,96,140,191,195,46,151,111,88,226,80,100,122,80,95,64,69,55,70,102,99,64,70,63,77,101,83,51,33,81,68,85,66,76,124,104,80,75,39,35,102,68,144,119,29,89,83,34,66,82,114,69,88,62,39,139,81,155,57,62,116,76,28,30,91,101,26,76,58,6,73,42,70,37,52,65,58,32,6,82,54,48,44,39,75,97,67,37,107,65,34,74,35,30,32,55,19,17,31,32,76,101,98,16,38,32,39,27,81,29,93,85,48,43,54,107,25,45,54,44,61,50,22,0,61,22,19,36,36,44,29,41,23,42,46,23,60,2,38,59,61,14,31,64,64,13,42,42,27,36,47,71,26,33,46,26,16,40,41,60,76,38,5,42,43,20,21,30,16,45,40,46,45,57,36,53,26,38,40,41,71,52,29,15,21,47,18,34,48,14,19,23,24,40,12,53,35,19,12,13,29,55,17,27,43,18,25,57,44,27,39,34,76,47,7,17,46,45,16,62,21,34,32,39,21,47,18,33,30,87,20,10,15,4,51,30,12,7,2,28,30,11,38,57,60,43,38,14,30,29,6,26,22,9,11,20,62,13,18,28,73,13,11,26,6,27,31,45,44,54,38,34,30,33,20,15,21,2,49,32,30,16,10,60,20,22,14,34,33,10,13,16,28,15,10,19,4,24,53,26,22,27,13,12,10,10,19,42,22,19,17,22,49,0,11,24,33,238,15,15,20,20,20,14,23,23,12,6,44,48,28,10,18,16,12,27,39,52,10,10,5,22,1,24,23,10,6,4,3,8,20,31,13,27,20,12,20,14,12,17,9,1,18,20,14,3,18,41,6,28,8,26,34,8,12,14,8,42,14,13,12,18,20,24,12,25,18,33,23,1249,17,20,30,45,16,6,37,15,26,14,7,22,11,25,66,0,36,24,22,21,35,4,15,32,4,17,19,12,31,30,6,14,54,36,26,3,11,22,17,12,39,19,8,4,25,23,5,27,16,24,19,18,9,0,10,16,21,10,9,9,7,6,15,15,10,5,1,3,21,27,10,27,1,9,0,23,14,13,11,1,9,21,13,0,1,22,33,13,16,9,21,8,11,16,7,7,11,68,7,9,19,18,8,4,12,28,1,1,32,8,23,14,21,10,0,21,32,12,6,14,13,1,16,10,3,19,2,5,23,19,35,21,2,5,35,12,5,26,5,14,10,18,541,1,10,34,9,18,81,9,13,0,8,44,0,8,20,14,20,8,11,22,14,21,30,12,5,23,34,18,6,56,0,6,47,31,43,15,11,10,42,30,14,31,27,8,7,0,21,6,14,3,40,6,6,12,4,15,7,12,4,7,3,12,15,7,13,23,16,33,0,29,9,8,1,4,26,7,10,8,8,4,12,19,3,23,12,10,3,9,20,19,21,2,2,6,4,4,4,8,11,7,8,0,10,6,5,0,24,4,12,9,13,11,7,17,12,18,23,6,1,18,9,3,1,3,32,22,6,2,2,0,29,2,10,14,8,14,37,0,22,67,0,10,17,11,26,1,13,8,1,17,20,16,2,11,6,11,10,8,15,32,4,10,21,29,2,18,7,9,2,2,4,5,35,2,9,14,1,7,3,3,8,1,11,10,30,9,13,6,31,12,1,0,17,0,4,6,2,2,20,4,10,0,10,3,9,35,1,2,0,3,9,1,1,7,1,32,7,5,7,10,8,7,5,4,14,1,22,0,19,73,22,3,16,2,4,4,19,4,9,7,6,3,0,14,20,15,3,12,13,7,0,2,15,3,6,2,11,6,19,8,8,1,0,9,20,10,23,3,2,0,2,3,29,0,4,3,9,15,10,4,8,7,6,11,0,4,14,1,37,8,8,4,0,4,6,21,40,4,20,1,23,1,7,17,6,11,0,5,0,7,91,3,6,1,4,7,17,12,11,1,20,4,0,6,16,14,5,6,1,1,1,8,8,9,1,18,6,10,4,4,5,5,2,1,22,4,14,17,6,15,9,2,18,2,0,0,6,4,0,3,6,4,3,4,6,8,0,9,17,2,5,7,2,18,15,0,13,10,42,27,0,4,0,27,19,6,7,5,51,18,7,0,14,1,1,8,0,5,3,14,9,0,0,2,20,13,3,14,0,6,8,0,5,22,11,14,8,35,57,0,54,4,8,10,1,8,7,31,5,4,9,8,1,12,7,2,12,11,9,4,5,12,8,3,35,2,6,0,0,2,0,4,9,4,1,7,27,0,27,10,1,5,3,5,0,4,0,9,4,16,17,5,0,2,4,0,2,2,1,3,4,3,1,2,2,12,0,17,11,7,3,5,3,13,10,11,14,8,10,6,10,8,5,10,6,2,1,16,7,0,0,7,9,9,7,2,4,1,1,6,3,6,5,18,0,16,0,9,1,3,0,8,7,2,1,6,0,5,5,11,2,14,6,5,2,5,0,5,8,4,19,3,9,5,5,1,6,2,12,0,0,0,2,0,1,0,4,2,1,8,3,1,5,6,0,2,14,2,4,11,7,0,2,16,0,6,2,0,11,3,1,13,1,0,2,1,0,3,5,4,1,0,3,1,4,0,18,3,7,2,0,0,5,9,15,2,2,8,29,2,46,8,2,0,10,2,5,0,13,1,0,6,1,9,1,6,4,5,0,2,9,0,8,2,5,15,2,8,2,0,4,16,2,10,57,3,0,5,8,0,13,14,1,2,3,2,3,10,5,0,0,10,0,0,0,13,12,4,37,2,1,10,10,3,28,0,12,10,7,11,2,0,0,2,0,9,8,5,5,12,9,36,7,9,2,2,0,8,7,1,4,22,1,9,2,0,5,10,0,2,7,2,28,5,3,0,5,5,10,4,4,2,21,14,4,12,1,0,0,2,6,4,1,2,2,5,4,4,5,12,2,1,2,5,7,2,12,9,16,10,0,2,4,11,5,19,14,1,2,7,0,0,0,0,6,0,0,4,0,4,7,5,8,1,45,0,8,8,5,1,1,0,0,1,0,0,0,0,9,0,7,1,0,0,27,2,2,0,0,0,5,4,39,3,1,0,5,5,1,1,1,9,2,7,1,8,3,0,0,7,10,5,20,3,2,8,5,6,1,0,1,3,11,7,4,5,3,0,3,3,0,4,7,13,0,4,3,6,0,0,4,3,0,11,2,5,4,2,5,0,16,0,0,7,1,7,1,2,6,3,9,8,2,1,10,1,1,2,11,4,1,0,0,0,1,1,1,2,0,0,1,0,16,3,0,3,2,3,4,3,4,10,0,0,3,3,2,2,1,7,0,1,5,3,4,10,3,8,2,11,0,5,0,1,4,0,8,8,7,6,3,1,0,2,2,5,9,4,4,5,2,0,0,3,7,1,0,5,0,0,0,8,0,0,1,0,1,4,0,8,2,6,1,2,10,0,20,8,4,8,1,9,5,0,3,0,2,1,14,8,1,10,0,4,4,0,37,0,5,8,5,2,1,2,2,5,3,4,1,0,5,0,13,0,7,7,15,10,0,1,5,2,1,2,0,1,34,9,10,9,22,2,7,3,5,8,1,4,3,0,0,4,4,4,2,10,7,1,2,0,1,2,17,8,1,9,3,14,6,3,5,2,0,8,0,10,0,0,6,1,13,0,3,1,5,2,30,1,1,0,0,0,1,1,2,1,0,32,0,0,0,4,11,6,8,3,2,7,24,2,10,2,0,0,0,1,1,1,4,1,7,7,7,0,0,4,8,1,7,7,0,1,0,3,0,3,1,2,0,0,1,6,7,7,1,2,0,1,10,0,0,5,1,7,15,10,0,0,2,8,2,0,7,3,4,10,2,3,3,1,0,26,7,0,0,4,27,0,2,7,12,4,2,0,4,10,0,1,3,12,2,0,0,5,6,1,3,0,3,0,0,9,2,4,2,0,5,5,9,0,2,9,3,1,1,0,5,3,31,17,2,2,0,5,2,6,5,0,0,4,3,0,2,0,0,0,12,2,2,0,2,2,10,0,14,5,4,0,10,3,5,4,6,0,2,3,4,16,1,0,1,5,2,16,1,3,1,0,0,1,1,20,3,0,3,3,3,0,4,0,2,1,23,1,1,0,0,1,3,1,1,1,1,1,1,0,9,0,0,13,10,6,2,1,3,0,7,0,6,0,6,1,1,0,4,0,4,0,0,4,11,9,1,2,4,1,5,0,8,1,1,1,22,6,2,1,10,0,6,11,0,1,0,0,3,2,2,0,2,27,4,0,1,1,0,4,8,6,7,0,0,26,3,66,2,1,6,0,0,6,1,4,13,18,1,2,0,1,0,3,3,0,5,1,4,0,16,5,1,9,2,0,2,3,3,8,5,6,19,1,0,0,1,0,11,1,1,0,8,3,2,4,9,4,0,4,6,0,3,4,0,1,2,10,0,10,1,0,2,6,0,10,3,6,0,1,1,1,1,0,1,2,4,1,6,1,2,1,0,0,6,4,23,4,1,1,7,0,1,5,3,1,4,0,1,3,5,1,5,1,2,0,3,3,2,0,1,2,2,0,0,1,1,0,0,7,2,4,2,3,3,0,0,3,0,0,10,1,15,7,16,1,1,19,3,1,0,5,1,15,2,0,0,13,5,2,2,1,6,2,0,0,2,232,1,0,0,3,2,0,0,5,0,3,0,3,3,0,0,0,4,1,2,4,1,1,3,3,0,1,2,7,0,0,2,4,1,0,0,8,0,3,1,1,5,0,0,0,1,7,3,3,0,3,1,7,5,5,0,2,0,0,1,0,18,0,0,0,0,1,0,7,2,4,1,2,2,0,3,4,1,0,3,5,3,0,3,2,1,4,0,0,0,0,4,2,2,4,1,1,0,9,3,1,8,2,3,0,0,13,9,2,4,4,24,2,3,19,1,0,12,8,0,0,0,5,0,0,1,1,4,2,16,3,0,4,0,1,1,3,4,1,1,1,0,0,6,0,0,7,0,2,0,2,7,15,0,2,0,0,2,4,5,0,0,2,0,0,10,4,4,0,1,2,4,1,10,3,2,3,0,0,6,2,1,2,13,2,3,1,1,1,2,1,2,1,3,5,3,6,2,7,1,4,1,7,1,0,0,0,6,2,1,2,4,0,5,2,2,0,0,2,2,10,0,9,4,12,1,0,4,5,6,0,6,0,3,3,3,0,1,5,1,1,0,3,8,3,0,2,2,2,0,0,0,5,3,2,5,0,16,2,4,2,4,0,5,17,1,0,0,0,0,3,1,1,0,3,2,5,1,6,0,0,4,2,1,1,0,0,0,0,0,1,2,0,0,1,1,12,0,0,0,0,1,0,1,7,0,2,0,0,2,0,0,1,0,4,7,0,2,7,0,5,0,0,5,1,0,5,0,4,19,3,0,0,6,1,0,0,1,0,0,4,2,1,8,0,4,0,3,2,0,0,0,0,4,0,4,4,0,0,1,1,2,0,5,4,4,4,5,3,191,1,4,2,1,0,0,2,3,1,2,1,3,0,8,1,1,1,1,0,0,4,1,0,2,0,2,0,0,1,1,1,0,4,5,7,3,0,2,2,2,9,0,3,0,6,1,3,0,0,3,3,1,2,0,12,6,1,3,11,0,6,3,3,2,0,1,8,3,0,4,1,6,0,0,0,2,1,4,7,2,1,0,4,0,0,0,0,0,0,0,0,0,4,3,3,2,4,0,0,2,35,0,0,4,12,2,0,0,1,2,0,0,1,1,4,3,11,0,0,1,4,0,10,1,0,1,3,1,1,0,3,0,2,1,2,2,42,4,2,4,4,1,2,0,0,0,0,2,0,0,4,0,10,7,0,4,0,0,1,1,2,0,0,3,1,1,2,4,0,0,1,9,1,3,0,4,1,3,2,4,0,6,0,1,0,6,0,0,1,31,1,12,8,3,3,1,55,1,0,1,0,0,0,0,3,4,3,0,5,6,0,0,2,3,1,0,1,0,1,3,13,2,2,0,4,1,3,13,0,0,1,0,4,0,0,2,0,0,2,8,0,0,3,0,1,3,0,0,2,1,16,4,0,0,2,0,3,0,0,8,2,6,170,0,7,0,1,0,0,0,2,5,0,0,0,2,0,0,1,0,2,1,9,6,0,5,1,0,0,2,6,1,2,2,2,4,0,0,4,0,2,3,0,2,5,3,1,1,2,7,0,2,2,7,4,2,0,0,1,0,18,5,0,3,0,31,3,2,0,30,3,2,3,0,1,6,0,1,2,0,8,3,4,2,3,11,2,1,2,5,3,0,1,2,0,0,2,3,0,1,1,0,1,0,8,1,1,3,4,0,3,4,0,1,2,0,0,7,0,1,0,4,4,0,0,2,1,0,10,0,3,0,0,0,0,0,0,3,0,4,0,0,0,0,1,2,1,0,0,1,1,7,3,1,1,0,0,7,0,0,2,0,5,0,8,1,0,8,2,1,4,2,0,1,2,1,0,1,0,1,0,1,0,7,0,1,0,1,1,2,0,1,0,3,4,1,0,0,1,1,0,0,2,2,4,0,0,0,0,1,2,0,8,0,0,34,0,2,0,1,2,5,1,1,0,1,4,1,1,0,0,0,0,1,3,6,1,1,2,6,0,0,36,0,1,1,0,2,1,2,0,0,5,0,0,7,7,0,0,0,1,0,4,5,4,7,0,4,0,7,1,8,3,0,1,2,0,0,1,2,2,3,0,0,0,10,0,2,0,0,5,0,6,0,2,5,1,3,1,2,6,1,9,1,1,2,0,7,1,0,8,2,1,3,0,0,3,2,1,0,1,1,2,0,1,0,0,1,3,0,1,1,3,1,0,3,7,1,0,0,1,0,8,0,4,0,0,5,4,2,5,1,2,1,0,0,1,0,0,6,3,3,1,2,0,2,0,1,9,0,7,1,8,0,1,3,1,0,0,4,0,0,0,1,0,0,0,0,1,0,0,0,1,2,11,2,0,2,1,0,0,0,0,3,0,0,1,0,0,0,7,5,0,7,5,0,1,0,3,0,3,1,0,1,0,1,0,1,1,0,1,1,5,0,1,0,2,0,2,0,0,5,0,0,1,7,4,1,0,2,0,0,5,0,9,0,2,0,0,1,0,0,0,1,0,0,0,1,0,0,2,81,0,0,0,1,2,0,2,2,3,1,0,0,11,2,1,0,0,0,2,0,3,121,0,0,0,1,0,3,2,1,0,0,0,0,0,0,2,0,0,0,2,2,0,1,0,0,14,11,7,8,20,0,1,3,2,0,0,0,0,3,0,0,0,0,1,0,1,1,0,5,7,0,1,1,1,0,0,0,6,4,0,1,1,4,0,1,7,0,0,5,134,1,4,1,4,1,0,1,5,0,2,2,3,0,1,0,0,2,0,3,3,0,2,4,0,0,1,5,5,12,3,0,1,1,1,0,0,0,2,7,4,2,3,0,0,2,3,1,0,2,1,0,1,2,2,1,4,2,3,0,2,5,5,0,2,1,0,7,0,0,0,0,3,0,2,2,0,0,0,2,3,5,1,2,1,3,1,0,0,2,5,0,3,2,0,0,5,2,4,2,0,0,2,1,1,0,3,6,2,3,4,0,1,12,2,0,0,3,1,0,0,4,0,1,0,0,0,3,0,0,0,3,1,0,0,0,0,0,0,0,0,0,0,2,2,4,2,0,3,0,2,0,1,0,1,0,3,3,0,16,0,0,1,0,6,0,0,0,0,0,2,4,9,2,0,3,3,2,5,0,0,3,2,0,0,12,1,2,0,1,1,0,0,0,0,1,2,0,5,0,0,0,12,1,4,0,2,1,2,1,3,0,0,31,0,0,1,2,0,1,2,1,7,2,0,0,5,0,0,0,0,1,0,6,5,0,1,0,2,3,3,0,5,0,0,0,1,1,0,2,5,9,1,0,0,1,0,0,4,8,0,0,0,1,1,0,0,0,0,0,0,1,0,0,4,0,0,0,0,0,0,1,0,0,4,0,0,0,1,0,1,3,0,1,0,1,0,0,0,1,3,0,1,0,1,3,3,0,0,2,1,0,7,1,0,1,0,0,1,0,0,5,2,3,3,2,3,1,0,5,0,0,0,0,0,0,0,0,0,0,1,5,1,1,0,1,0,0,0,1,0,1,2,0,1,0,1,0,0,0,4,4,0,1,0,0,0,2,2,2,1,1,1,1,1,0,0,0,5,1,8,0,0,0,0,2,0,0,3,0,2,2,0,0,0,0,0,2,8,0,0,0,0,9,2,0,2,2,1,0,1,3,2,0,0,0,0,1,0,0,4,0,0,0,1,0,0,0,0,6,1,0,4,1,2,0,1,1,1,0,0,4,2,0,1,0,2,1,0,0,0,0,3,0,0,1,0,0,2,0,1,7,0,0,4,0,0,0,3,0,4,0,4,4,0,0,0,0,0,0,0,1,1,1,0,2,0,1,1,0,1,0,6,0,6,1,2,5,13,2,7,0,1,0,0,1,2,0,0,24,0,0,0,0,0,3,1,0,0,1,0,3,3,5,3,0,0,0,0,0,0,1,1,0,2,2,0,0,8,0,0,0,0,0,3,1,0,0,0,1,1,0,3,0,0,0,0,0,0,0,0,4,8,5,0,0,0,1,0,1,0,4,0,3,0,4,0,1,0,1,0,4,1,0,2,1,0,1,1,0,11,0,0,0,0,0,0,1,0,0,0,1,0,1,6,0,0,0,1,2,1,0,12,0,0,14,0,1,0,0,0,1,0,0,0,3,0,7,4,0,1,0,0,0,0,0,0,1,0,1,0,0,0,4,1,1,1,0,0,0,1,1,0,0,1,0,0,1,0,0,0,0,1,0,0,1,0,0,0,0,0,4,0,0,0,1,0,1,0,1,1,0,0,0,0,0,3,0,9,1,4,2,0,0,0,3,0,0,1,0,0,0,0,0,0,1,2,1,0,0,0,1,2,1,3,6,1,0,9,1,0,0,2,0,0,0,0,0,1,1,5,0,1,0,6,0,0,1,0,6,3,0,0,3,0,0,1,2,0,4,2,0,1,0,0,0,4,1,1,0,3,2,0,2,1,1,0,1,0,0,1,0,0,1,0,0,0,1,17,0,9,1,0,0,1,2,0,0,2,3,1,0,1,0,3,0,0,0,1,0,0,1,5,0,2,0,2,0,2,6,0,1,1,0,0,0,0,0,0,0,1,0,0,0,0,3,1,0,1,1,3,0,0,4,2,0,3,2,1,1,0,1,0,1,0,1,0,0,0,0,0,0,7,5,0,0,0,2,0,0,5,1,0,0,0,0,0,0,0,0,1,0,1,1,3,0,0,4,0,0,0,8,0,4,1,0,3,0,1,1,0,0,1,0,0,0,12,0,2,2,0,0,2,56,6,0,0,1,1,1,0,1,0,0,0,0,0,2,0,0,0,0,0,1,0,0,1,2,12,0,0,0,3,2,0,0,1,0,2,4,1,0,9,0,0,0,0,2,0,1,0,0,6,2,0,0,0,0,0,2,0,1,6,1,0,3,2,0,3,6,0,17,0,0,0,0,1,0,1,1,0,0,0,0,1,0,0,0,0,2,0,0,0,0,0,0,3,0,1,0,1,0,5,0,0,3,0,0,2,1,1,3,1,0,0,1,0,0,1,0,0,1,0,1,0,0,0,0,0,0,0,0,1,0,2,1,1,0,1,0,0,0,0,0,2,0,0,0,0,0,6,0,2,0,0,0,0,0,1,2,0,1,0,1,1,0,1,0,1,0,0,2,14,0,1,1,1,0,0,0,2,0,0,2,0,1,0,0,2,0,1,0,0,3,1,3,0,0,0,9,0,0,0,0,0,0,0,0,0,0,1,0,5,0,2,0,0,4,1,0,1,0,0,1,1,0,2,0,2,1,0,6,1,0,1,1,0,1,1,1,0,1,0,1,0,0,5,0,4,0,0,0,2,0,0,0,0,0,2,0,0,0,2,2,0,0,0,0,0,1,0,0,1,1,0,3,1,3,3,1,0,1,0,0,0,0,1,1,0,1,0,0,1,0,3,1,6,0,1,2,0,0,0,1,0,4,0,0,0,0,0,1,0,8,0,0,5,0,2,1,6,0,2,0,0,0,0,0,0,0,1,0,0,1,0,0,0,0,2,3,0,1,1,1,9,1,1,1,1,0,0,4,1,3,0,0,0,1,0,0,0,0,0,0,2,0,0,1,1,0,2,0,7,0,0,1,0,0,0,0,0,0,0,1,2,8,0,0,0,0,0,0,2,0,2,0,0,1,1,1,1,1,0,0,7,0,0,3,0,1,0,0,0,1,0,2,0,1,0,3,0,0,2,1,3,0,0,0,4,1,0,0,0,0,0,5,5,0,2,1,5,2,0,2,3,0,0,0,2,1,0,0,0,0,0,2,2,0,0,3,0,3,1,1,1,0,0,0,0,0,0,0,0,0,6,0,0,1,3,2,0,0,0,8,0,0,0,0,4,0,1,0,0,0,0,0,0,10,0,0,8,0,2,2,0,1,2,2,3,3,0,0,2,0,2,0,0,0,0,3,1,1,0,0,0,3,0,1,0,0,6,0,2,4,0,0,0,1,1,1,6,0,0,0,0,0,1,0,0,0,0,2,1,0,0,0,0,3,8,0,1,0,0,0,1,7,0,0,3,1,0,3,0,0,0,0,0,0,1,0,1,2,0,6,0,1,0,0,0,0,0,0,1,0,0,0,0,0,2,0,0,0,4,0,0,0,0,0,0,1,1,1,1,1,1,0,0,0,0,1,1,0,0,0,0,0,0,0,0,0,1,0,0,0,1,0,0,0,0,1,0,0,2,0,0,0,0,2,1,0,0,1,0,0,0,0,0,0,0,1,1,3,0,2,1,0,0,0,0,1,0,0,0,0,0,0,0,2,0,0,0,0,1,0,0,0,0,0,0,0,2,1,0,2,0,1,0,0,0,1,0,0,0,0,0,0,0,0,0,0,0,0,0,2,0,0,0,0,0,0,0,3,0,0,0,0,0,0,0,0,0,0,0,0,1,0,0,0,0,5,0,0,0,0,0,0,0,0,0,0,0,0,0,0,0,0,0,0,0,0,0,0,0,0,0,0,0,0,0,0,0,0,0,0,0,0,0,0,0,0,0,0,0,0,0,0,0,0,0,0
"2016 Connelly, Michael, The Wrong Side of Goodbye",pop,6814,3075,3076,2522,1978,1123,2999,1661,2096,1523,1171,1194,1382,715,625,1062,1085,716,742,955,614,588,525,565,169,385,308,346,454,301,538,464,462,464,346,375,394,269,300,286,350,192,507,353,347,327,262,262,404,358,453,204,294,283,337,278,250,286,211,232,307,182,226,165,146,236,95,175,137,182,239,183,132,195,214,145,178,198,109,163,137,151,105,165,128,175,193,151,96,67,52,193,122,202,114,166,103,121,110,167,96,33,196,107,100,66,102,67,138,115,120,102,50,41,142,158,73,130,122,65,233,154,135,63,100,130,109,91,226,105,154,120,111,141,88,28,41,47,133,92,143,80,20,82,132,182,106,119,116,58,96,37,105,71,56,71,34,38,82,43,42,48,76,59,95,59,50,86,56,83,18,108,53,89,104,58,37,59,77,88,41,102,57,99,43,101,59,62,84,55,119,64,30,66,39,44,32,90,67,25,39,36,101,51,76,73,93,40,32,30,26,58,36,99,49,63,55,89,44,31,50,70,63,64,123,48,40,124,106,34,67,41,32,40,43,5,23,72,27,36,48,34,52,25,49,21,52,37,32,38,24,18,33,42,18,59,39,67,38,22,38,50,15,24,81,13,50,13,77,28,13,29,35,49,45,40,38,48,28,27,55,59,23,47,32,69,30,15,47,31,95,14,124,22,49,70,44,62,47,22,15,31,86,29,16,22,45,17,55,15,36,6,33,51,20,49,53,11,32,50,16,52,54,8,8,49,3,22,47,64,83,11,42,20,5,39,28,6,51,36,27,26,30,73,35,26,27,54,35,37,32,22,24,16,28,50,179,15,25,44,42,102,19,15,39,15,59,38,28,13,16,43,33,37,22,15,40,4,9,41,38,16,19,21,30,83,1599,13,17,7,12,21,76,57,19,28,7,28,23,10,40,23,35,23,48,22,19,17,47,8,15,18,11,11,13,2,33,35,29,13,22,2,5,34,54,46,16,36,21,32,36,18,31,14,7,14,21,18,0,31,21,29,22,29,24,50,6,16,40,12,38,28,3,28,8,25,21,23,26,24,15,17,3,60,14,36,1,9,4,10,36,11,22,0,24,27,17,33,0,10,24,22,12,23,41,7,18,8,24,53,17,46,17,14,22,10,12,24,35,13,17,31,98,39,24,13,6,18,37,27,14,8,9,5,11,14,0,25,4,37,12,20,23,14,8,55,8,9,36,18,10,5,20,11,29,0,7,9,50,42,9,29,21,27,16,16,0,2,14,17,26,44,27,15,6,3,9,17,10,10,30,10,23,1,34,25,14,3,32,6,23,20,30,20,7,18,8,6,12,14,7,25,23,16,0,16,13,13,8,10,20,20,30,34,9,7,15,34,20,17,7,4,22,2,16,0,105,3,28,10,11,9,14,21,6,12,4,7,13,11,17,35,4,14,14,31,57,23,3,7,19,41,20,0,27,0,6,17,32,10,7,2,8,19,22,23,36,16,6,5,0,4,10,19,2,12,11,10,11,6,18,36,14,13,33,12,1,7,8,18,6,6,18,0,11,10,24,4,6,18,8,37,13,9,8,8,4,14,13,10,8,14,4,31,16,10,6,30,4,9,7,21,1,11,19,9,39,44,18,13,6,18,4,12,13,9,23,11,20,17,14,40,20,4,10,7,12,23,2,24,19,21,0,3,0,4,7,21,22,17,1,5,3,11,5,6,43,7,12,12,3,2,2,17,40,7,40,6,6,15,32,5,14,0,14,14,8,2,12,13,25,10,0,5,2,20,4,1,13,17,0,1,11,11,7,2,10,15,12,17,1,14,0,9,12,4,2,12,0,4,5,1,3,5,8,12,0,12,12,3,26,9,4,6,1,9,15,0,1,2,21,22,20,22,15,12,21,31,17,14,7,9,2,11,42,6,5,33,0,7,4,12,4,8,5,15,13,0,12,27,2,1,10,13,15,3,2,105,9,7,4,26,22,13,25,13,23,0,3,9,17,13,1,29,2,1,14,11,3,9,3,5,9,8,12,16,16,7,10,5,16,28,14,57,4,24,9,0,2,1,7,27,14,19,0,6,12,36,2,5,5,0,1,0,12,1,24,15,4,11,11,1,7,9,7,12,17,1,20,19,22,5,3,0,30,1,9,2,7,2,17,12,14,19,8,4,19,16,2,24,13,3,6,11,1,12,3,4,2,0,0,5,6,0,15,15,3,3,3,20,24,0,14,5,1,4,9,13,8,22,1,3,9,45,31,3,6,0,9,2,8,3,25,1,9,10,0,21,4,0,6,1,6,2,7,3,1,0,2,2,27,21,19,1,4,8,0,0,16,7,30,24,23,89,6,37,2,11,3,21,8,33,10,4,6,8,16,8,7,3,14,8,19,15,10,7,32,7,16,16,5,14,4,20,4,0,13,7,0,1,9,0,0,16,8,53,8,38,0,0,0,3,13,9,25,13,10,0,8,3,7,2,14,8,11,7,11,3,10,15,26,0,13,3,6,20,0,6,3,10,15,9,2,5,6,3,3,1,11,6,8,2,6,3,0,1,18,10,8,4,0,6,7,10,6,2,19,3,19,0,14,2,2,1,7,4,2,10,2,1,1,1,0,9,5,0,14,16,7,2,3,1,0,3,2,35,71,11,7,20,0,7,9,1,0,24,1,9,0,5,1,9,5,1,10,1,4,0,9,0,16,32,3,16,5,18,0,3,6,0,6,15,0,10,1,3,7,1,0,6,4,0,5,9,3,4,0,4,2,2,0,8,2,3,5,0,0,4,4,23,6,18,12,28,6,1,14,4,23,8,2,32,1,15,7,0,17,1,49,6,9,1,3,0,2,17,0,19,8,7,38,9,5,10,23,11,0,1,0,2,0,0,11,11,0,9,2,3,2,0,0,13,24,12,0,6,6,1,0,10,5,3,11,5,3,13,3,5,12,1,0,17,15,0,7,4,2,1,1,1,3,1,8,19,5,7,1,0,10,7,1,4,2,4,1,11,1,0,7,32,2,4,25,1,20,1,2,5,12,14,4,2,0,14,42,2,10,3,1,5,14,1,12,1,5,7,11,8,18,3,3,1,14,5,0,0,2,20,6,31,6,6,3,1,13,4,4,3,9,4,30,11,1,38,18,0,0,0,0,8,12,0,24,1,2,4,1,4,1,19,1,0,2,0,5,4,3,0,0,5,0,0,0,9,0,6,10,0,5,12,5,4,0,6,0,13,0,16,12,1,1,13,1,6,0,0,50,3,3,2,3,4,0,0,8,7,0,5,6,19,1,61,22,14,0,1,3,5,14,14,10,4,0,3,4,0,7,69,0,37,2,3,14,0,9,1,6,0,3,0,3,17,5,5,0,0,0,6,6,0,4,1,6,2,33,6,1,0,0,0,1,3,16,16,7,1,0,1,2,12,5,0,0,0,0,0,0,6,6,39,8,1,10,6,1,0,0,1,0,19,1,4,1,4,5,2,5,17,14,0,6,17,14,7,9,0,12,8,7,2,4,2,9,4,10,5,5,2,0,8,8,12,7,16,0,0,0,0,4,12,7,4,2,4,2,0,1,14,2,1,2,7,2,0,3,0,4,2,3,16,1,0,9,0,3,5,5,4,0,4,0,1,2,1,9,8,11,0,11,10,0,11,0,3,8,7,15,7,9,1,4,1,5,0,2,5,0,1,1,8,21,4,1,0,2,3,6,6,1,8,1,12,1,23,9,2,7,3,3,13,0,17,4,3,0,0,3,2,3,5,10,7,0,2,1,12,21,9,30,0,11,3,0,3,7,10,9,0,12,1,28,1,2,13,6,1,0,6,1,4,8,6,4,4,1,0,2,3,4,3,18,0,5,2,0,0,2,24,1,9,0,1,3,3,8,3,3,4,0,11,2,4,8,5,4,5,1,23,0,2,7,2,2,0,2,16,10,1,1,0,14,9,9,0,7,2,3,7,1,4,7,0,1,6,0,6,3,0,1,3,11,2,4,4,105,2,0,5,0,2,1,5,6,2,14,0,24,1,1,0,5,27,0,6,7,10,9,6,0,3,2,4,1,3,18,4,11,0,5,4,4,4,0,3,2,0,11,1,9,5,0,3,4,2,0,11,1,8,8,2,0,0,1,5,3,0,11,35,5,0,2,12,0,0,8,6,0,11,0,0,0,1,13,11,14,2,4,5,0,4,33,2,0,3,1,3,0,8,8,1,2,3,4,0,6,4,0,13,10,6,1,0,1,0,0,6,0,1,0,0,6,3,0,3,3,4,0,1,5,2,0,0,0,1,3,1,3,6,0,1,3,7,0,0,13,3,0,12,6,4,0,0,1,4,0,1,2,1,0,6,0,2,4,0,2,14,2,4,0,6,7,0,0,0,2,0,2,43,3,5,7,1,0,6,6,0,4,4,0,59,42,5,0,2,3,2,15,0,8,0,2,8,50,0,0,3,0,4,1,6,2,18,4,5,3,4,17,6,28,4,3,1,1,0,0,4,0,1,4,4,2,1,4,8,7,5,0,4,2,3,13,12,32,1,1,15,2,0,3,4,8,0,5,0,3,3,11,1,7,4,16,3,3,3,19,0,5,3,6,3,16,0,7,3,3,0,5,2,16,0,11,2,7,14,0,3,0,10,3,0,1,1,8,0,0,0,4,8,1,6,1,4,11,1,7,0,1,0,1,4,2,5,54,2,2,4,7,0,6,2,1,0,4,2,0,0,4,0,7,1,2,7,9,4,0,3,0,0,27,0,1,4,1,4,10,7,3,2,1,5,6,0,1,0,3,2,0,47,9,7,0,3,0,5,1,0,0,3,0,0,1,0,2,1,0,0,3,2,2,3,3,3,4,0,0,2,1,2,8,3,2,5,6,1,0,3,13,1,0,4,0,1,0,0,8,0,2,2,1,6,0,3,1,2,0,3,9,0,6,4,23,0,0,0,1,0,0,0,0,1,0,0,0,16,0,3,4,16,3,1,36,3,11,1,4,5,2,12,2,2,0,0,5,0,2,1,0,0,5,12,7,1,0,2,2,4,12,0,0,5,1,10,4,0,4,1,3,3,1,2,0,5,5,0,1,0,14,1,1,0,1,6,0,2,0,1,1,17,3,3,0,7,0,0,0,3,2,2,2,1,1,9,2,1,5,5,0,3,6,0,24,0,19,3,0,1,4,3,2,0,1,3,4,5,4,6,0,5,2,1,8,8,1,0,4,6,0,0,0,3,2,24,9,4,3,0,3,14,0,8,0,0,5,1,1,4,2,7,4,5,7,6,0,7,0,0,3,1,2,8,3,0,4,1,0,3,4,12,3,0,2,7,4,1,6,12,2,0,0,50,3,3,2,3,1,7,1,0,2,7,3,2,6,0,6,4,15,4,3,3,2,3,10,64,0,0,1,2,11,2,0,7,0,6,4,0,4,2,45,4,8,1,4,4,20,20,0,0,4,2,6,5,4,0,0,0,0,1,2,0,5,4,7,4,9,6,0,0,0,0,2,2,3,0,10,0,0,1,1,0,3,1,20,0,0,6,1,0,1,1,0,1,3,0,4,259,2,1,1,10,4,3,1,7,0,8,0,0,3,3,0,1,0,0,1,3,0,1,2,0,0,1,2,0,8,6,0,7,3,1,6,1,3,2,0,1,5,0,0,0,3,0,2,1,2,8,2,3,5,1,0,6,0,4,1,0,0,0,3,0,0,3,0,16,0,0,0,2,1,3,0,9,3,4,23,4,2,15,0,1,1,0,1,0,5,3,6,2,3,2,13,0,6,1,13,2,1,2,8,1,23,3,0,5,1,3,0,0,0,4,5,0,2,1,1,2,19,6,3,0,0,0,0,3,2,0,15,2,0,8,9,0,6,2,5,1,0,5,23,15,2,4,8,0,0,2,0,1,0,0,7,1,0,9,44,0,1,2,6,1,7,1,0,0,0,5,3,0,15,13,1,3,5,1,1,3,2,0,2,2,1,3,0,3,1,3,3,0,3,1,9,0,16,2,0,0,2,0,0,0,0,1,0,0,3,0,0,0,2,1,1,0,2,1,2,3,2,6,5,2,3,0,0,19,3,8,5,0,5,0,27,5,2,4,1,1,0,0,2,10,1,0,12,1,0,0,3,1,0,3,1,0,3,2,0,4,2,4,21,4,9,1,2,6,0,1,0,1,3,3,4,0,3,2,1,0,2,0,0,3,0,0,0,3,4,0,6,4,9,3,2,0,0,7,6,0,3,1,0,1,0,0,1,7,0,6,1,4,3,2,1,3,0,3,0,1,1,3,1,5,0,2,0,0,12,0,1,0,0,3,4,14,2,7,6,0,4,0,1,0,4,3,1,0,2,4,3,1,1,1,0,4,0,0,0,0,0,0,12,2,9,3,1,0,2,5,0,8,0,2,0,0,1,1,5,0,0,11,13,2,1,0,6,29,2,3,6,8,17,0,6,2,0,1,0,3,0,5,0,8,0,0,9,21,0,2,2,7,0,4,0,5,9,7,0,6,0,0,0,2,7,3,0,2,0,5,0,0,3,0,7,4,0,6,0,1,6,1,7,0,0,0,0,0,1,1,1,2,0,1,9,3,4,0,0,0,0,0,0,0,1,1,0,1,0,4,4,5,1,1,0,0,1,0,0,3,1,2,0,1,0,1,5,4,2,0,1,1,0,0,0,1,2,6,1,8,2,14,3,0,0,1,2,1,0,1,0,1,0,0,5,0,3,0,1,4,0,0,7,5,0,6,8,6,0,0,0,0,0,0,0,4,1,17,4,2,1,2,1,3,0,0,0,3,0,1,4,6,0,6,2,0,0,0,1,1,0,0,1,1,2,0,0,6,0,0,0,4,5,1,3,3,3,0,0,1,0,1,3,1,0,0,1,11,4,5,0,2,19,1,3,0,0,0,0,0,2,8,6,0,0,2,2,4,2,13,0,2,2,1,0,1,0,14,0,3,7,1,4,0,3,0,4,1,2,0,4,2,2,4,15,1,1,6,1,1,1,0,2,0,5,0,0,4,0,2,14,5,4,4,0,0,2,0,1,0,24,6,6,2,1,0,0,1,0,20,7,0,4,9,7,1,3,5,0,0,0,6,6,0,0,1,0,0,2,0,2,1,0,3,1,0,2,0,0,8,2,1,1,1,7,3,3,0,1,6,0,0,0,0,0,1,1,2,7,3,0,1,2,1,0,0,0,4,1,2,1,4,1,3,1,0,0,0,3,0,2,0,2,0,0,1,4,13,1,0,0,1,1,0,1,0,1,2,0,0,0,6,0,0,0,6,0,7,0,0,3,0,4,0,7,2,2,1,1,3,0,4,0,2,0,0,1,5,1,0,1,2,8,0,0,0,0,0,0,1,0,2,0,0,0,2,0,0,0,4,4,1,1,0,0,2,0,0,0,0,15,27,4,0,1,0,2,1,0,0,0,0,0,0,0,0,1,2,0,3,1,0,0,0,4,0,3,3,0,1,1,2,11,11,2,1,2,0,1,1,16,4,1,1,0,2,3,1,0,1,2,4,0,0,1,4,3,0,1,0,0,4,1,8,2,0,5,1,0,1,5,1,0,15,1,3,4,0,0,0,0,0,5,0,3,0,1,0,2,5,3,0,2,0,1,3,12,4,5,10,2,3,8,0,1,3,1,2,10,0,1,0,0,0,17,0,3,0,3,5,0,1,2,1,1,4,11,5,2,0,2,5,1,0,0,4,0,0,0,0,13,1,3,0,0,0,3,1,0,0,1,7,2,1,3,0,2,3,3,0,0,1,4,0,2,1,2,0,3,3,6,4,0,0,5,10,0,19,1,0,1,0,0,2,0,0,1,0,0,1,1,0,5,0,4,0,3,0,0,1,2,4,2,0,0,0,0,1,0,0,2,0,0,1,2,2,5,3,0,6,1,4,0,0,3,4,1,2,1,1,0,5,0,4,4,0,0,0,0,2,2,0,0,0,0,0,8,1,2,0,12,3,1,5,4,0,0,0,1,3,1,3,2,0,1,2,9,2,0,2,8,0,0,0,0,5,0,2,1,11,4,0,0,2,3,0,0,0,0,1,0,0,10,0,0,6,0,0,1,0,5,0,2,6,1,3,0,3,0,0,1,0,1,1,0,2,1,0,4,14,3,0,0,0,6,1,0,2,0,0,2,1,0,4,1,0,1,0,1,2,0,0,2,0,2,0,0,1,1,0,0,0,3,4,0,6,0,0,0,0,2,1,0,8,0,0,2,0,0,1,1,2,1,0,1,0,1,0,0,0,3,0,1,0,3,6,1,0,2,8,0,0,1,0,0,1,3,4,2,0,2,0,2,9,0,0,0,0,1,2,1,3,12,2,0,4,2,2,0,2,0,1,0,2,6,0,0,4,0,5,0,5,1,4,0,7,0,0,0,1,1,1,4,2,0,0,2,17,0,4,0,3,12,1,1,0,3,1,0,0,2,0,1,0,0,1,0,0,0,6,0,0,0,2,0,1,1,0,1,0,16,4,0,1,0,0,5,0,1,0,0,0,0,12,0,0,3,0,0,1,0,0,2,1,15,1,0,0,0,0,2,0,3,1,14,0,5,0,0,2,0,1,0,0,6,0,2,7,1,1,0,3,0,0,0,2,0,0,0,5,2,2,46,12,1,0,0,2,0,1,1,0,4,1,0,1,1,2,0,1,0,0,0,0,1,0,3,0,2,3,0,2,0,0,2,1,2,1,1,0,0,0,2,2,0,0,0,0,30,0,0,0,0,0,0,0,2,0,0,0,4,0,2,2,6,0,1,1,1,1,0,5,0,1,0,10,1,2,0,7,2,1,0,0,3,2,0,0,1,8,0,3,1,1,0,159,1,0,0,1,0,7,161,0,4,0,0,2,0,1,1,0,0,0,0,0,0,2,2,3,0,0,0,0,0,2,0,0,0,3,10,27,8,0,0,0,1,1,0,0,0,1,1,0,0,0,1,1,0,0,2,0,1,2,0,0,3,0,2,0,0,3,4,1,3,0,0,0,0,1,1,1,2,0,1,2,1,0,0,4,0,1,0,0,1,0,3,0,0,1,0,1,5,0,0,2,1,4,0,1,1,0,0,0,0,0,7,0,1,10,0,1,1,0,1,4,1,0,1,0,0,0,0,1,0,0,1,0,11,0,2,0,7,1,1,0,0,6,0,1,0,0,1,0,5,1,1,9,0,4,5,2,0,0,0,0,5,7,1,0,2,0,3,3,1,3,0,0,1,2,0,2,0,2,4,0,5,0,2,2,1,1,2,0,15,0,3,1,1,1,0,1,1,0,1,6,0,5,7,14,1,1,1,1,0,10,0,1,2,0,7,2,1,13,0,1,0,0,0,0,1,10,0,0,0,0,0,2,0,4,0,0,9,2,7,0,0,1,0,0,1,23,1,5,0,2,4,7,0,3,4,0,2,0,0,0,2,0,0,0,0,0,0,0,5,0,0,0,21,0,0,0,1,0,3,16,5,0,0,0,0,1,1,0,2,0,0,3,2,0,5,1,7,7,0,1,0,0,1,0,3,0,1,0,4,0,0,0,5,1,3,0,0,3,0,2,1,0,0,0,0,0,2,5,0,0,0,0,1,0,1,7,0,0,1,1,8,0,0,3,0,2,0,0,1,4,0,1,1,0,0,0,0,0,0,0,1,0,1,0,0,0,0,2,1,2,29,0,0,0,0,0,4,1,0,1,0,3,0,2,0,0,0,0,0,0,0,0,1,0,1,0,0,1,1,1,9,2,1,0,8,0,1,0,0,4,3,0,0,0,2,1,1,2,0,2,4,0,3,0,0,3,0,0,1,1,0,1,0,0,5,15,1,0,0,0,5,7,1,5,0,0,1,0,0,0,0,0,3,0,1,16,1,1,2,0,6,1,0,0,0,2,0,2,0,0,3,0,5,0,3,2,0,0,4,0,0,2,1,0,11,1,2,0,1,0,1,1,0,2,2,2,2,0,8,1,0,2,0,3,4,4,1,3,0,1,1,0,1,0,0,0,110,0,1,1,0,0,1,0,0,0,1,0,0,7,0,1,0,4,4,0,4,14,0,1,1,2,24,7,0,1,10,5,0,2,0,0,3,0,0,1,8,3,0,0,5,3,0,4,1,1,1,1,1,0,2,1,1,0,1,0,0,0,1,3,1,1,0,0,0,0,0,10,2,5,12,3,0,3,4,2,0,0,0,0,0,5,0,1,0,0,3,0,0,0,1,0,3,0,0,0,5,0,1,0,0,2,0,1,1,0,6,0,0,1,1,1,0,2,2,0,0,10,0,0,2,0,0,0,2,0,2,0,0,4,0,0,0,7,3,5,11,0,7,1,4,1,2,3,0,3,0,1,2,0,1,0,0,0,0,2,1,6,3,2,2,2,0,4,5,0,0,2,0,1,0,1,0,0,0,0,3,0,0,0,2,1,1,0,0,1,0,0,3,1,4,0,1,10,0,0,0,1,0,1,0,1,0,0,0,1,0,1,0,0,3,0,2,2,1,1,1,0,0,1,1,2,0,2,3,2,2,1,17,5,1,6,0,1,0,0,5,1,0,0,1,3,1,0,0,0,0,1,0,0,5,0,4,0,0,0,0,4,0,0,1,0,14,0,1,2,0,2,0,0,1,1,1,0,0,1,2,4,2,5,1,0,1,0,1,2,1,0,1,0,2,14,10,3,5,3,9,0,2,0,1,0,0,0,0,1,4,2,0,1,0,0,0,0,7,1,0,1,1,0,15,2,3,1,0,2,1,1,5,0,0,1,0,0,2,0,0,0,0,2,0,1,3,0,0,1,3,3,0,9,3,0,0,8,0,0,2,0,0,1,1,2,0,2,0,0,7,0,7,4,2,7,1,0,2,12,1,0,1,0,1,0,1,0,0,0,6,7,1,0,1,0,0,0,1,5,0,5,1,1,1,2,0,1,3,7,0,2,3,2,5,0,1,1,2,1,3,1,0,2,0,0,0,7,0,1,1,0,0,0,0,0,0,2,0,1,0,0,0,0,2,3,4,0,0,1,1,1,0,2,0,0,1,0,0,0,1,1,0,0,0,0,1,0,2,0,0,5,1,2,0,0,1,0,0,0,2,0,18,0,1,4,0,1,0,0,0,0,0,0,0,0,1,32,0,6,2,0,0,0,0,0,0,1,0,3,1,0,0,3,0,1,1,0,2,0,0,0,0,0,0,0,1,0,2,0,0,0,0,0,0,0,1,0,0,0,1,0,0,0,0,0,0,0,0,0,0,2,0,0,0,0,0,0,0,1,0,0,0,0,0,0,0,0,0,0,0,0,0,0,0,0,0,0,0,0,0,0
"2016 Patterson, James, Cross the Line",pop,4170,2477,1639,1863,1324,1599,746,1191,858,652,780,553,686,540,491,674,462,471,395,1469,537,371,291,304,385,213,366,233,314,202,318,367,230,205,225,249,327,180,498,257,165,210,232,204,187,190,175,172,104,246,210,188,139,199,235,168,170,155,143,140,181,106,134,92,126,97,93,137,143,110,141,132,130,112,200,101,198,88,80,114,152,75,62,148,109,134,92,103,61,84,37,105,41,154,96,117,100,86,109,168,54,38,142,64,90,59,52,92,61,69,64,45,148,107,69,77,74,64,60,55,171,50,115,65,60,66,64,73,39,61,83,86,81,65,55,44,82,45,87,55,66,57,70,83,44,77,55,20,62,51,38,20,59,50,51,50,30,54,110,31,38,37,40,34,79,32,21,29,34,66,60,41,50,52,90,35,47,52,42,37,30,36,23,72,36,33,30,73,56,46,75,57,44,34,16,33,7,47,48,22,37,23,47,27,48,24,47,37,37,51,9,35,46,22,25,23,47,65,23,25,20,18,70,44,44,37,21,26,55,20,34,26,23,29,34,43,20,46,31,23,43,37,64,26,50,62,83,28,51,62,40,17,16,33,35,28,21,32,37,26,40,43,20,16,27,21,20,17,66,36,16,41,15,26,27,16,46,48,21,33,28,15,24,16,42,28,40,18,37,26,40,17,55,28,59,30,25,35,28,16,25,18,25,33,25,35,32,13,16,12,19,12,28,36,13,28,45,20,23,66,16,24,16,11,9,24,19,16,23,41,64,22,59,47,60,41,37,0,25,21,32,27,23,23,22,14,17,27,17,44,24,26,28,29,22,12,31,7,20,28,47,40,22,26,19,34,19,14,37,20,18,91,40,24,50,16,22,17,9,12,18,20,40,16,22,24,0,5,21,24,16,17,9,7,22,18,20,11,30,31,25,25,20,13,25,9,18,13,15,11,42,12,17,4,15,3,23,20,33,11,15,0,6,19,28,28,15,4,19,7,18,11,11,24,9,22,19,5,18,15,16,27,34,12,19,27,4,13,12,12,21,22,16,21,9,17,12,5,18,28,20,6,0,10,12,28,17,21,7,25,38,6,33,2,32,10,17,15,0,13,18,5,15,66,2,11,32,7,9,21,12,25,12,15,14,11,16,14,9,14,35,46,18,24,20,9,21,12,14,17,21,5,11,12,14,20,0,12,27,45,8,26,11,13,18,18,24,3,11,3,28,7,9,20,9,1,3,8,2,15,10,22,11,26,11,9,0,1,16,14,18,8,8,8,17,13,17,18,7,26,10,7,9,10,6,22,16,10,7,4,14,15,15,13,12,13,13,4,10,8,10,9,15,16,2,11,6,10,114,14,12,19,14,17,37,18,8,18,1,11,6,11,6,8,7,0,1,4,8,12,11,23,7,21,4,12,6,3,9,10,8,28,10,8,18,20,21,7,26,8,27,13,13,7,6,0,12,19,7,6,11,5,11,13,17,13,15,5,6,15,0,11,7,13,5,11,3,1,22,9,2,11,13,12,11,14,14,14,6,7,13,8,14,2,17,2,5,2,3,10,12,14,11,17,16,6,6,6,8,15,5,9,51,10,9,22,2,23,3,24,8,2,4,7,15,8,8,7,12,12,5,14,6,11,8,9,7,18,2,15,10,9,26,3,6,10,16,4,6,28,32,10,17,32,1,7,4,13,22,7,3,5,6,11,1,1,5,3,8,14,6,10,6,5,5,4,9,3,3,33,8,11,11,11,15,6,10,10,5,7,8,7,6,8,0,11,2,4,8,1,6,3,8,7,8,3,4,9,13,10,12,12,1,10,5,2,51,9,0,11,2,1,7,3,2,5,1,6,25,12,12,0,12,0,9,6,0,0,11,4,8,11,9,10,20,8,11,16,25,29,11,15,10,4,28,10,5,16,0,12,4,7,1,2,6,8,6,0,13,23,8,11,12,7,6,5,43,35,5,14,7,1,11,11,13,9,0,0,10,12,18,16,4,21,0,8,4,14,7,7,8,3,9,8,4,9,5,4,10,6,17,5,8,5,2,14,3,0,7,9,17,10,2,9,5,3,5,9,2,6,2,0,4,0,6,7,1,12,7,7,8,0,6,5,14,4,5,2,16,18,2,10,8,105,13,9,1,13,6,5,8,2,19,8,11,12,10,8,3,7,16,10,12,8,5,1,16,8,5,0,0,5,4,1,18,3,8,1,4,8,5,0,2,8,3,7,8,5,6,15,3,7,5,24,10,0,8,53,12,9,8,4,13,5,8,3,0,8,5,0,11,0,6,2,8,7,0,0,0,4,1,13,30,0,6,16,1,0,4,8,21,9,17,54,15,9,3,11,16,8,15,7,3,3,7,8,3,1,0,12,8,5,17,7,3,4,18,10,13,7,10,4,0,1,11,0,8,6,1,0,2,6,0,24,5,11,4,3,0,0,0,37,11,12,4,4,9,0,3,6,3,4,4,5,5,1,29,7,15,3,6,0,4,6,15,8,6,5,5,6,12,3,2,3,7,6,4,3,5,2,5,2,15,7,0,28,5,7,5,10,4,3,2,4,6,5,4,0,23,1,17,4,5,3,2,3,5,4,2,4,2,27,6,6,5,4,12,9,7,0,12,19,6,4,7,9,94,11,13,6,9,12,4,4,0,3,1,2,0,1,1,6,5,4,7,5,5,2,16,0,1,7,3,11,2,8,1,3,3,0,6,16,0,2,18,2,7,0,1,9,10,0,3,7,20,16,0,1,6,5,0,5,5,5,10,258,0,2,3,6,2,5,14,5,7,4,6,6,3,5,12,5,0,3,8,0,12,4,10,2,5,3,7,0,21,20,0,2,4,4,16,1,3,9,18,5,14,6,1,10,7,0,14,4,0,10,6,0,3,3,61,1,25,2,0,2,8,1,0,27,8,6,5,8,8,11,5,1,3,4,0,6,5,6,11,3,14,2,0,0,9,6,8,2,4,6,36,0,2,2,0,0,2,0,3,6,4,10,7,2,2,5,18,0,10,3,4,9,2,4,0,0,7,15,12,1,4,46,11,5,1,2,7,0,5,11,11,4,11,0,1,0,9,1,1,3,6,7,2,4,11,2,9,0,4,0,10,4,12,4,9,3,5,11,4,0,0,12,0,7,5,0,3,6,0,2,3,36,3,6,0,5,4,0,0,0,1,0,1,2,0,4,0,1,0,7,2,0,5,4,2,7,2,7,0,2,9,22,3,9,6,4,2,5,2,5,2,2,18,1,6,1,0,0,14,5,0,12,10,4,0,10,16,6,0,6,15,4,1,3,4,2,0,1,1,0,3,6,0,5,1,1,7,0,1,2,3,0,4,3,2,6,6,5,0,25,3,1,1,3,6,4,4,5,1,8,6,3,0,12,8,3,3,1,3,0,0,67,3,2,3,0,12,348,0,1,0,4,10,2,4,0,5,3,3,7,4,0,1,7,8,5,2,3,5,3,3,3,18,6,1,2,4,9,2,1,6,3,3,6,4,5,5,4,8,2,0,5,0,7,11,4,1,1,4,10,1,3,5,2,2,2,3,4,0,7,14,11,7,1,6,4,5,0,7,4,1,16,3,9,3,4,11,0,6,3,15,3,2,0,0,1,5,16,0,3,12,56,4,7,0,15,0,3,0,5,1,3,6,0,0,1,6,12,2,4,0,4,0,8,3,5,4,0,3,3,1,0,1,3,2,10,2,4,0,5,2,3,3,2,3,12,3,1,39,12,0,18,7,6,6,3,4,8,0,8,6,8,2,4,9,1,5,1,5,0,3,0,9,1,4,0,6,3,1,7,9,2,0,7,2,1,5,6,1,0,5,1,2,13,5,0,3,7,0,6,1,19,2,2,7,1,5,8,0,5,1,6,0,0,3,1,12,1,8,2,31,11,1,6,7,0,1,6,6,4,7,7,9,3,6,13,1,0,1,0,6,0,8,7,4,0,2,7,0,0,6,2,7,5,4,4,0,4,0,1,0,0,6,3,1,0,1,5,8,2,6,14,0,0,1,6,0,5,1,4,3,2,4,2,8,4,2,1,0,0,8,2,4,1,11,6,0,2,0,0,4,3,7,13,2,8,2,1,2,3,0,4,0,3,1,3,4,3,2,4,4,0,0,1,1,5,0,0,4,6,0,1,0,0,1,6,5,0,19,7,4,5,0,5,3,1,0,6,5,1,4,10,5,2,3,0,1,4,2,0,3,3,4,1,1,3,2,0,0,10,3,1,1,0,0,3,3,6,3,3,0,10,3,12,3,0,4,2,10,3,3,0,2,2,1,4,0,2,5,9,2,4,9,7,0,6,0,10,0,8,1,5,30,2,0,4,3,0,0,5,1,2,4,4,2,1,0,7,0,4,5,18,5,6,13,5,0,2,0,0,2,8,0,3,4,9,0,2,2,1,4,0,8,0,3,1,3,12,0,1,0,1,5,4,0,7,1,2,2,9,2,4,4,3,3,2,2,0,3,8,0,0,6,0,2,4,10,8,24,1,0,0,1,1,15,0,0,5,10,3,4,0,9,6,0,1,1,5,13,3,3,2,15,9,6,2,1,2,0,5,0,3,1,7,10,5,2,1,2,0,1,3,6,0,2,1,2,2,1,2,2,13,0,1,4,5,0,0,0,2,17,15,1,5,0,3,7,1,3,3,5,7,1,3,1,3,1,1,4,0,5,3,4,2,0,0,2,4,0,0,2,0,1,1,2,1,6,6,2,3,2,0,17,4,5,3,0,2,0,2,2,0,5,4,0,4,6,0,1,1,0,0,6,5,3,4,0,2,5,0,0,8,0,0,1,0,3,5,0,0,3,2,3,0,3,3,5,0,0,4,3,3,13,1,0,8,8,21,0,2,5,0,0,1,0,1,25,0,9,0,0,5,4,2,0,0,1,2,3,5,5,0,1,5,8,1,8,0,0,0,0,4,7,4,0,0,0,0,2,1,0,1,3,4,5,4,3,2,4,1,6,1,0,3,0,0,8,2,4,0,0,0,1,2,1,2,2,3,2,0,2,5,0,3,5,3,1,1,3,5,1,10,2,0,1,1,13,0,4,2,2,0,0,0,1,2,2,2,2,0,3,2,3,0,1,4,3,0,3,3,2,1,1,4,0,13,3,2,2,1,7,7,1,5,0,0,0,0,0,0,1,0,2,1,1,9,20,1,2,1,0,1,2,6,6,4,1,1,9,3,1,1,5,0,1,3,2,4,0,1,2,2,4,1,1,1,5,8,1,1,1,2,2,9,5,1,0,0,2,0,2,3,1,2,1,1,3,2,0,0,3,2,4,1,1,4,8,8,6,5,5,0,0,1,3,1,0,2,4,1,6,4,0,4,0,0,0,1,10,1,1,1,5,1,3,0,1,4,0,0,0,5,7,2,0,5,1,5,0,0,0,1,13,4,0,1,0,4,17,8,2,0,10,5,4,5,1,0,0,0,0,1,2,0,1,3,4,3,2,9,6,0,0,1,1,2,0,2,5,0,1,3,1,1,5,0,0,3,1,1,6,0,2,2,0,3,2,0,3,0,3,2,12,3,1,0,1,0,0,0,0,0,1,4,0,6,1,3,0,1,0,1,2,0,0,2,0,0,5,2,3,0,3,3,1,3,14,3,0,3,5,0,0,1,6,1,0,3,1,0,2,3,2,1,0,2,0,4,11,1,0,0,2,0,0,2,0,3,0,2,5,1,0,7,10,1,2,4,5,1,4,6,1,1,2,0,2,1,1,0,0,1,2,13,5,0,10,5,0,2,6,1,0,6,1,7,0,2,0,2,3,2,0,7,2,0,0,6,0,6,0,0,3,0,0,0,0,1,3,0,3,1,0,3,2,1,1,6,5,0,4,1,28,6,4,3,5,0,2,1,0,2,5,2,2,5,1,5,3,1,0,3,1,4,1,1,4,0,1,1,9,1,0,2,3,3,1,5,1,9,1,0,25,6,0,1,0,0,2,2,0,1,3,0,8,0,15,2,0,0,1,3,0,0,0,5,3,0,1,2,0,1,21,7,1,4,5,0,1,2,0,1,0,11,1,0,1,4,3,0,3,0,4,3,2,1,2,0,0,1,0,0,5,0,0,0,1,2,2,0,2,3,1,2,0,0,2,2,1,1,0,7,1,2,1,3,1,0,0,4,6,0,0,1,3,0,4,3,0,0,1,3,1,1,1,0,2,0,2,1,10,0,7,0,1,0,5,2,3,0,0,6,3,7,0,0,4,2,0,0,2,0,1,1,1,0,1,1,0,1,4,0,3,1,1,0,12,7,1,0,0,1,6,0,1,13,3,2,4,0,3,0,3,0,6,5,1,1,1,3,3,4,1,2,1,3,1,1,0,0,1,1,19,0,38,4,5,3,4,0,0,7,5,0,2,1,1,1,0,2,1,2,3,2,4,0,0,0,0,1,0,0,4,0,1,2,2,1,2,1,0,7,0,4,0,0,4,5,3,2,0,1,1,8,0,2,0,0,0,1,0,3,0,2,0,1,1,1,1,1,1,0,2,0,1,6,3,1,2,0,3,3,1,10,0,1,2,2,0,4,1,6,3,3,5,0,1,0,0,3,0,0,6,1,10,0,2,2,3,1,4,0,6,1,0,0,2,1,0,1,1,9,0,1,2,2,2,2,0,0,0,2,1,2,0,3,3,0,4,0,2,3,1,0,1,0,5,0,0,0,0,6,8,30,1,0,0,0,2,1,0,1,0,5,0,1,2,2,0,1,1,0,0,3,0,1,2,1,0,2,2,1,1,2,1,0,0,3,0,0,1,1,0,0,3,0,0,0,3,3,0,0,4,1,0,2,0,2,0,2,0,5,1,1,4,0,3,2,5,3,2,0,1,4,0,2,10,6,1,2,1,0,0,0,5,0,1,1,1,1,4,1,3,1,3,1,2,0,0,0,3,5,1,0,0,7,0,5,2,6,0,0,3,1,2,0,5,1,3,1,1,3,4,0,0,3,3,0,11,1,0,23,0,1,3,0,0,1,2,0,5,1,0,2,2,5,0,0,0,0,6,11,3,1,8,4,0,0,0,2,0,3,1,1,7,1,1,1,0,0,2,3,0,1,0,3,0,0,0,0,3,16,0,0,0,7,0,2,0,3,0,3,2,1,3,3,5,0,1,0,0,4,0,2,0,2,0,1,2,0,0,0,2,6,0,1,0,0,0,2,1,3,5,0,4,0,2,2,15,2,0,0,0,1,2,0,2,1,0,1,0,2,1,0,6,0,1,1,0,3,1,1,0,3,0,3,3,5,8,0,0,0,1,0,1,10,2,0,0,1,2,1,5,3,3,0,2,1,0,1,2,2,1,0,1,0,1,1,4,1,1,2,0,4,0,0,1,0,0,1,3,1,2,0,2,1,0,3,1,0,1,0,1,2,0,1,1,0,0,2,0,1,2,0,1,4,0,0,0,1,0,1,0,0,0,0,3,5,0,2,27,0,5,7,0,1,0,2,0,2,0,0,84,4,0,0,0,1,0,5,2,1,0,0,1,1,3,1,2,5,0,0,4,2,0,0,0,14,0,0,0,1,0,2,0,5,1,0,3,0,0,74,9,5,2,2,3,0,0,2,2,0,0,1,1,0,0,4,5,6,1,1,12,0,0,0,2,0,1,1,0,1,0,1,6,2,0,3,2,1,0,3,1,0,1,7,1,2,2,0,1,5,2,3,3,0,1,1,0,2,0,0,4,2,0,0,3,0,2,0,4,3,5,1,2,0,2,5,1,0,0,3,2,0,1,3,0,3,2,1,2,1,0,0,4,2,2,0,1,61,3,1,0,1,0,2,3,1,0,0,1,0,2,0,0,3,1,0,0,2,4,2,1,3,0,0,1,1,3,4,1,0,0,0,4,4,3,5,0,0,3,0,2,1,0,0,0,3,5,2,6,5,0,0,0,0,0,0,0,4,0,0,3,0,3,5,2,3,2,0,1,0,1,4,0,2,1,7,0,10,1,3,2,2,1,1,0,2,0,1,1,0,0,0,0,2,4,0,5,3,7,0,2,6,3,0,0,1,2,1,2,1,0,7,2,5,0,0,0,1,1,1,4,3,0,5,1,4,4,5,0,1,6,0,0,5,1,1,0,3,4,0,0,0,1,2,0,3,1,6,1,0,1,2,2,2,2,1,1,5,0,0,0,1,1,0,0,0,1,2,2,0,1,1,0,0,5,1,0,1,0,0,1,0,0,5,1,0,0,2,1,1,4,0,0,13,0,0,0,0,1,0,5,3,3,3,1,0,0,2,1,0,2,2,0,1,1,1,1,0,1,0,1,9,0,0,2,0,0,1,0,0,7,0,1,2,0,2,0,1,1,1,0,2,1,0,0,0,0,1,0,0,2,2,1,7,0,0,0,0,0,2,0,3,0,0,4,0,3,2,0,0,1,0,2,1,6,0,1,0,2,1,3,5,1,0,0,1,1,1,1,1,3,0,3,1,6,3,0,2,2,2,0,4,0,0,2,0,1,0,3,0,9,0,2,2,0,2,0,3,0,0,3,0,0,1,2,0,2,0,0,0,1,1,6,1,3,1,3,0,0,0,0,0,3,3,2,0,2,0,0,0,8,3,1,2,3,0,0,1,0,3,1,1,1,2,3,0,1,1,1,0,1,0,0,2,0,3,0,0,2,0,1,0,0,0,1,2,0,8,0,6,2,2,0,1,0,1,4,1,2,0,0,4,0,2,0,1,5,1,0,0,1,3,5,3,3,1,0,1,0,0,1,6,1,5,0,0,2,0,2,4,0,0,0,3,0,1,0,3,1,0,0,1,0,1,0,0,3,1,0,4,2,2,1,0,0,1,0,1,2,12,0,0,0,0,3,0,0,0,0,1,1,1,3,0,2,0,7,0,1,4,0,0,1,5,1,1,3,3,2,14,0,0,2,0,2,3,0,1,1,2,0,1,4,0,0,3,0,0,3,2,2,1,0,1,3,1,4,0,2,2,0,0,0,0,0,0,0,1,0,0,0,0,2,5,0,0,1,1,0,5,1,0,4,0,2,0,2,1,1,1,2,2,8,2,0,1,1,4,0,0,1,0,0,0,1,0,1,0,1,3,0,0,0,6,0,3,3,0,1,0,0,4,0,0,1,1,0,0,1,3,0,5,3,0,0,0,0,1,2,0,1,3,5,0,1,2,0,0,2,0,0,0,0,0,1,0,2,0,0,2,1,5,1,1,0,0,0,1,2,3,2,0,2,2,0,3,0,3,0,7,6,1,6,0,2,0,0,0,0,1,4,0,1,0,1,1,5,1,0,0,0,5,0,4,1,1,0,0,6,0,1,0,0,1,0,0,0,0,0,1,0,0,1,0,0,4,0,0,0,1,2,2,1,1,0,3,0,3,0,1,0,1,0,1,3,4,0,0,7,1,2,0,0,1,0,0,0,0,1,1,2,0,0,0,0,0,1,0,0,0,1,0,0,3,2,0,1,0,0,3,1,2,2,3,1,0,2,0,1,1,1,3,1,0,2,1,1,0,1,0,1,2,0,4,0,0,2,0,0,0,1,1,0,0,0,0,1,1,0,0,0,0,1,0,0,0,0,2,3,6,0,0,0,1,10,0,1,1,2,0,1,2,0,0,4,1,2,0,0,1,1,0,0,0,0,0,0,6,0,1,0,1,0,1,6,0,0,1,1,0,0,0,0,1,0,3,0,4,1,5,1,2,1,1,0,0,1,1,0,0,0,1,0,1,0,0,0,2,2,0,5,0,1,0,2,0,0,2,2,0,1,7,0,2,2,0,0,1,1,2,0,0,1,1,0,0,0,1,0,4,0,4,0,2,3,1,1,1,0,2,0,0,0,0,0,0,0,2,4,4,1,0,0,1,1,1,0,0,1,0,1,1,1,3,0,4,2,1,2,0,1,0,1,0,0,1,0,1,1,0,1,0,2,0,1,2,2,1,0,0,3,0,2,0,0,2,1,5,1,0,1,6,1,0,0,0,1,5,0,0,0,0,1,0,1,0,1,0,0,3,2,0,2,0,0,1,0,1,0,0,0,1,0,4,0,1,6,0,2,0,0,0,0,0,1,2,1,1,2,0,1,5,1,0,0,0,0,0,0,1,0,1,1,1,1,0,0,0,1,0,0,0,1,0,2,1,0,0,1,0,3,1,7,0,0,0,0,6,1,0,0,0,0,0,0,0,0,1,0,0,0,0,1,0,5,1,12,0,0,1,0,0,4,2,0,2,1,1,3,4,1,4,10,0,0,1,0,1,0,2,1,0,0,0,0,1,2,0,2,0,0,0,0,1,0,1,0,2,1,1,0,0,0,2,5,0,0,2,0,0,0,0,1,0,2,0,0,1,0,0,3,0,0,2,1,1,1,3,3,0,0,2,0,2,3,3,3,0,0,1,2,0,3,0,1,2,1,4,0,3,2,0,0,2,1,1,2,0,0,2,1,2,0,1,2,1,1,3,2,1,0,1,0,2,1,2,5,0,2,1,1,2,0,0,2,0,0,0,1,4,1,5,2,1,0,0,0,3,0,0,2,2,0,0,0,1,0,4,5,1,1,0,0,0,0,1,0,0,1,0,0,0,0,1,5,2,2,1,0,0,0,1,0,1,0,4,3,0,0,2,0,1,3,1,2,0,0,1,1,0,2,1,0,0,0,0,4,1,2,1,2,1,2,0,1,0,0,0,1,3,1,4,1,1,0,0,1,1,3,0,0,0,2,0,2,2,1,0,0,0,0,0,1,0,0,0,0,0,2,0,0,0,4,0,0,1,1,0,1,0,2,0,0,0,2,1,0,1,0,0,3,0,14,0,0,0,1,1,0,0,2,0,2,0,0,1,4,0,0,0,2,0,0,1,0,0,1,0,0,0,1,0,0,0,0,0,0,0,0,0,0,0,1,1,0,5,0,1,2,0,0,2,1,0,3,2,0,0,0,1,0,2,4,1,0,0,0,3,0,1,1,0,1,2,1,0,1,2,0,4,0,0,0,0,0,0,0,1,0,1,0,2,0,1,0,0,0,0,1,0,4,0,0,0,1,0,1,0,0,2,0,1,8,3,1,1,0,0,2,0,0,0,3,0,0,0,0,2,0,0,0,0,0,0,0,2,2,0,0,0,0,0,0,3,0,0,0,1,0,0,1,0,0,2,0,0,0,0,1,1,0,0,0,0,0,0,0,0,0,0,2,0,0,0,2,1,0,0,0,0,0,0,1,0,0,4,0,0,0,0,0,1,0,0,5,0,0,0,0,0,1,0,0,0,0,5,0,0,0,0,0,0,0,0,0,0,0,0,2,0,0,0
